alpha,beta,gamma,ENZ_CA,SUB_CA,TOT_CA,clashes
-20,-70,-120,3,2,5,3
-10,-70,-110,3,3,6,3
-20,-60,-120,4,6,10,6
-30,-70,-130,8,6,14,14
-10,-60,-110,7,9,16,12
-20,-80,-120,11,7,18,16
-20,-50,-120,8,11,19,17
-10,-60,-100,10,9,19,22
-10,-70,-120,9,12,21,14
-30,-80,-130,12,9,21,21
-20,-60,-110,11,12,23,17
-20,-40,-110,9,15,24,22
-20,-50,-110,11,13,24,18
-30,-70,-120,13,11,24,18
-50,-80,-150,13,11,24,29
0,-70,-100,11,13,24,20
-30,-60,-120,11,14,25,22
-20,-70,-110,14,11,25,19
-10,-80,-110,14,11,25,18
-20,-70,-130,13,13,26,21
-40,-70,-140,14,12,26,29
-40,-80,-140,15,11,26,28
-60,-80,-160,15,12,27,36
-30,-40,-120,12,15,27,23
-30,-50,-120,14,16,30,26
-40,-70,-130,16,14,30,28
-10,-50,-110,13,17,30,45
-60,-80,-170,15,16,31,34
-30,-60,-130,16,15,31,26
0,-70,-110,17,14,31,22
-70,-80,-170,17,14,31,39
-90,-80,160,17,16,33,37
-80,-80,170,17,16,33,34
-160,-30,80,20,13,33,34
-50,-80,-160,16,17,33,33
-180,-20,70,18,16,34,35
-30,-80,-140,18,16,34,27
-30,-40,-110,17,17,34,40
-50,-70,-150,19,15,34,38
180,-20,70,18,16,34,35
-110,-80,140,17,17,34,40
-100,-80,150,17,17,34,39
-20,-60,-130,16,18,34,36
-10,-60,-120,19,16,35,30
-160,-40,80,17,18,35,38
-180,-30,70,19,16,35,31
-170,-20,70,17,18,35,43
-50,80,-30,12,23,35,47
180,-30,70,19,16,35,31
-180,30,90,19,17,36,57
-30,80,-60,13,23,36,64
180,-10,70,15,21,36,40
170,-30,70,17,19,36,41
-20,-40,-120,15,21,36,39
-70,-80,-180,17,19,36,36
-180,-10,70,15,21,36,40
180,30,90,19,17,36,57
-70,-80,180,17,19,36,36
-40,-80,-150,19,18,37,34
-30,-50,-110,19,18,37,57
180,-20,80,19,18,37,35
-30,-70,-140,18,19,37,38
-40,80,-40,14,23,37,49
-180,-20,80,19,18,37,35
170,-20,70,18,19,37,42
-40,80,-50,13,24,37,60
-30,-60,-110,19,19,38,60
180,40,80,20,18,38,46
-60,80,-30,14,24,38,58
-10,-50,-100,17,21,38,48
-80,-80,180,20,18,38,46
-50,80,-40,14,24,38,58
-180,40,80,20,18,38,46
-80,-80,-180,20,18,38,46
-170,-30,80,22,16,38,32
-20,-80,-130,21,17,38,29
-10,-80,-120,21,18,39,28
180,30,100,18,21,39,58
-180,30,100,18,21,39,58
180,-40,70,22,17,39,42
0,-80,-100,20,19,39,34
-180,-40,70,22,17,39,42
-120,-80,130,18,21,39,44
-60,80,-20,13,26,39,50
170,-30,60,22,17,39,47
-50,-70,-160,20,20,40,48
-170,-20,60,18,22,40,71
-180,-10,60,21,19,40,52
-160,-70,90,23,17,40,62
-180,-10,80,19,21,40,45
-140,-70,110,22,18,40,39
-170,-80,80,20,20,40,54
180,-10,60,21,19,40,52
-60,-70,-160,23,17,40,45
-40,-60,-130,19,21,40,42
-170,40,80,17,23,40,46
180,-10,80,19,21,40,45
-30,-50,-130,19,21,40,46
-160,-40,70,23,18,41,64
-30,80,-50,15,26,41,52
-30,50,-70,21,20,41,62
-160,-80,90,20,21,41,54
-180,40,90,20,21,41,60
-20,-50,-100,19,22,41,51
-150,-70,100,22,19,41,47
-170,-30,70,20,21,41,49
-10,-70,-100,21,20,41,34
-90,-80,170,21,20,41,46
180,40,90,20,21,41,60
-50,-70,-140,22,20,42,47
-160,-40,90,22,20,42,38
-100,-80,160,21,21,42,49
-170,40,100,23,19,42,60
-30,-40,-100,20,22,42,74
-140,-80,110,20,22,42,50
-140,-80,120,20,22,42,51
170,-20,60,22,20,42,47
-20,-30,-110,20,22,42,45
-70,80,-20,15,27,42,62
-130,-80,130,21,22,43,51
-170,-40,80,23,20,43,40
-160,-30,70,23,20,43,53
-180,10,80,22,21,43,61
170,-80,60,19,24,43,50
-170,-70,80,23,20,43,67
-40,-60,-140,21,22,43,53
160,-80,50,20,23,43,47
-20,-40,-100,18,25,43,56
170,-10,70,20,23,43,46
-170,40,90,22,21,43,51
-150,-40,80,24,19,43,44
180,10,80,22,21,43,61
-40,-70,-150,22,21,43,46
150,-80,40,21,23,44,50
-180,40,100,21,23,44,73
-60,-70,-170,25,19,44,53
180,30,110,22,22,44,64
-180,30,110,22,22,44,64
-180,-30,80,23,21,44,45
-30,-80,-120,25,19,44,36
-180,-30,60,22,22,44,67
-140,-70,120,26,18,44,56
-180,-80,70,21,23,44,56
-20,40,-80,20,24,44,64
180,20,80,23,21,44,64
180,-30,80,23,21,44,45
180,-30,60,22,22,44,67
-150,-80,100,21,23,44,54
180,40,100,21,23,44,73
170,20,80,25,19,44,62
-180,20,80,23,21,44,64
-130,-70,120,23,21,44,45
180,-80,70,21,23,44,56
-130,-70,130,25,19,44,53
-170,-20,80,21,23,44,47
0,-80,-110,20,24,44,35
-110,-80,150,22,23,45,51
-170,-60,80,26,19,45,59
-170,-30,90,22,23,45,55
-30,30,-70,19,26,45,64
-150,-70,110,26,19,45,53
180,30,80,27,18,45,60
10,-80,-100,20,25,45,43
-20,50,-80,19,26,45,72
-30,-50,-100,23,22,45,98
-40,70,-50,17,28,45,75
-180,30,80,27,18,45,60
10,-80,-90,21,24,45,53
-40,-60,-120,22,23,45,78
-130,-80,120,21,24,45,50
-20,-80,-110,28,18,46,37
-20,-20,-100,25,21,46,50
-10,-80,-100,26,20,46,39
-20,-20,-110,24,22,46,61
-120,-80,140,22,24,46,52
-180,-20,60,24,22,46,64
-40,-80,-130,27,19,46,40
-20,40,-70,20,26,46,58
180,-20,60,24,22,46,64
-40,70,-60,22,24,46,82
-10,40,-90,22,24,46,63
180,0,80,24,23,47,58
170,-10,60,22,25,47,52
-170,-10,70,23,24,47,53
180,0,60,22,25,47,59
-30,70,-60,18,29,47,74
-110,90,20,23,24,47,70
50,90,-140,23,24,47,70
0,90,-90,23,24,47,70
-50,80,-50,20,27,47,89
-80,90,-10,23,24,47,70
-130,90,40,23,24,47,70
60,90,-150,23,24,47,70
-120,90,30,23,24,47,70
90,90,180,23,24,47,70
-170,10,80,26,21,47,67
-30,70,-70,21,26,47,82
-160,-60,90,28,19,47,46
30,90,-120,23,24,47,70
-180,20,70,25,22,47,70
170,-80,70,23,24,47,54
-160,90,70,23,24,47,70
80,90,-170,23,24,47,70
-90,90,0,23,24,47,70
130,90,140,23,24,47,70
180,20,70,25,22,47,70
-100,90,10,23,24,47,70
-180,0,60,22,25,47,59
-50,90,-40,23,24,47,70
70,90,-160,23,24,47,70
150,90,120,23,24,47,70
-180,0,80,24,23,47,58
100,90,170,23,24,47,70
40,90,-130,23,24,47,70
-140,90,50,23,24,47,70
-70,90,-20,23,24,47,70
160,90,110,23,24,47,70
140,90,130,23,24,47,70
-170,-10,60,23,24,47,70
120,90,150,23,24,47,70
-170,90,80,23,24,47,70
-60,90,-30,23,24,47,70
180,90,90,23,24,47,70
-30,90,-60,23,24,47,70
-160,-20,70,24,23,47,47
20,90,-110,23,24,47,70
-70,80,-10,19,28,47,57
-150,90,60,23,24,47,70
110,90,160,23,24,47,70
-20,90,-70,23,24,47,70
10,90,-100,23,24,47,70
-40,90,-50,23,24,47,70
90,90,-180,23,24,47,70
170,90,100,23,24,47,70
-180,90,90,23,24,47,70
-10,90,-80,23,24,47,70
-30,-30,-110,24,23,47,60
-170,30,100,23,25,48,62
180,10,70,25,23,48,62
-180,20,90,23,25,48,76
180,20,90,23,25,48,76
180,-70,70,26,22,48,76
-180,10,70,25,23,48,62
-180,0,70,24,24,48,55
-40,-50,-120,23,25,48,77
-180,-70,70,26,22,48,76
-50,-80,-140,28,20,48,45
0,-60,-100,26,22,48,43
-150,-80,110,22,26,48,55
180,0,70,24,24,48,55
-180,40,110,24,25,49,65
50,-90,-50,26,23,49,57
110,-90,10,26,23,49,57
160,-90,60,26,23,49,57
-180,20,100,26,23,49,72
-140,-90,120,26,23,49,57
180,20,100,26,23,49,72
-100,-90,160,26,23,49,57
-110,-90,150,26,23,49,57
40,-90,-60,26,23,49,57
90,-90,-10,26,23,49,57
-50,-60,-140,25,24,49,53
150,-90,50,26,23,49,57
-80,80,-10,19,30,49,70
120,-90,20,26,23,49,57
180,40,110,24,25,49,65
-130,-90,130,26,23,49,57
140,-90,40,26,23,49,57
-30,-90,-130,26,23,49,57
-160,-50,80,25,24,49,60
20,-90,-80,26,23,49,57
-180,-90,80,26,23,49,57
-150,-90,110,26,23,49,57
100,-90,0,26,23,49,57
-50,-90,-150,26,23,49,57
-60,-90,-160,26,23,49,57
-30,-40,-130,25,24,49,67
-170,-90,90,26,23,49,57
130,-90,30,26,23,49,57
-10,-90,-110,26,23,49,57
-170,-50,80,26,23,49,48
180,-90,80,26,23,49,57
0,-60,-110,28,21,49,51
-90,-90,170,26,23,49,57
60,-90,-40,26,23,49,57
-20,-50,-130,25,24,49,59
80,-90,-20,26,23,49,57
0,-90,-100,26,23,49,57
-160,-50,90,26,23,49,44
10,-90,-90,26,23,49,57
-170,0,60,23,26,49,74
-120,-90,140,26,23,49,57
-170,30,90,22,27,49,63
-40,-90,-140,26,23,49,57
-170,-10,80,23,26,49,53
-20,-90,-120,26,23,49,57
-160,-90,100,26,23,49,57
-120,80,30,21,28,49,74
-80,-90,180,26,23,49,57
-80,-90,-180,26,23,49,57
-150,-40,90,25,24,49,47
70,-90,-30,26,23,49,57
30,-90,-70,26,23,49,57
-70,-90,-170,26,23,49,57
170,-90,70,26,23,49,57
-10,-90,-120,24,26,50,51
-170,-90,80,24,26,50,51
130,-90,20,24,26,50,51
-140,-90,110,24,26,50,51
-170,-50,90,27,23,50,62
-180,-40,80,24,26,50,60
50,-90,-60,24,26,50,51
-80,-90,170,24,26,50,51
-60,-90,-170,24,26,50,51
-110,-90,140,24,26,50,51
20,-90,-90,24,26,50,51
110,-90,0,24,26,50,51
180,-40,80,24,26,50,60
70,-90,-40,24,26,50,51
-150,-90,100,24,26,50,51
-180,-90,70,24,26,50,51
-20,-90,-130,24,26,50,51
-160,-80,100,23,27,50,56
100,-90,-10,24,26,50,51
-70,-90,180,24,26,50,51
-170,-20,90,26,24,50,60
-30,40,-70,21,29,50,83
-50,-90,-160,24,26,50,51
-20,70,-70,19,31,50,79
-50,-70,-130,25,25,50,89
-90,-90,160,24,26,50,51
-170,-40,60,25,25,50,102
10,-90,-100,24,26,50,51
0,-90,-110,24,26,50,51
-30,-90,-140,24,26,50,51
170,0,70,23,27,50,54
40,-90,-70,24,26,50,51
-120,-90,130,24,26,50,51
-50,-60,-150,25,25,50,60
-40,20,-70,20,30,50,73
120,-90,10,24,26,50,51
90,-90,-20,24,26,50,51
-10,20,-80,23,27,50,66
30,-90,-80,24,26,50,51
-160,-90,90,24,26,50,51
-40,-90,-150,24,26,50,51
170,-90,60,24,26,50,51
-20,80,-70,20,30,50,79
-10,-40,-110,24,26,50,64
160,-90,50,24,26,50,51
-70,-90,-180,24,26,50,51
-130,-90,120,24,26,50,51
150,-90,40,24,26,50,51
140,-90,30,24,26,50,51
80,-90,-30,24,26,50,51
-100,-90,150,24,26,50,51
180,-90,70,24,26,50,51
60,-90,-50,24,26,50,51
-150,-50,90,24,26,50,63
-170,-40,70,25,26,51,66
-50,70,-50,24,27,51,83
180,-10,90,26,25,51,64
180,-40,60,25,26,51,71
180,-30,90,24,27,51,65
-90,80,0,21,30,51,78
-20,60,-80,24,27,51,84
-20,80,-60,21,30,51,65
-30,60,-70,25,26,51,88
-20,30,-80,24,27,51,72
-50,70,-40,19,32,51,81
-20,60,-70,26,25,51,80
-160,-60,80,25,26,51,69
-20,-60,-100,25,26,51,74
-180,-40,60,25,26,51,71
-50,-60,-130,25,26,51,88
-180,-10,90,26,25,51,64
-180,-30,90,24,27,51,65
160,-80,60,25,26,51,52
-40,80,-60,22,29,51,96
-20,30,-70,21,31,52,59
-160,-40,100,27,25,52,82
170,50,90,26,26,52,60
170,30,100,28,24,52,78
-30,20,-80,21,31,52,94
-160,-30,90,28,24,52,56
-180,-60,70,32,20,52,84
-20,-30,-100,27,25,52,52
-70,-70,-170,29,23,52,57
-110,80,20,23,29,52,83
-180,-80,80,25,27,52,60
-10,50,-90,23,29,52,90
-10,-40,-100,25,27,52,62
140,-80,30,26,26,52,58
180,-80,80,25,27,52,60
-150,-60,90,29,23,52,61
170,-40,60,29,23,52,60
180,-60,70,32,20,52,84
0,10,-100,25,27,52,84
-170,-30,60,25,27,52,92
-140,80,50,24,28,52,78
-20,60,-60,23,29,52,76
-170,-40,90,26,26,52,58
170,30,90,28,25,53,87
-40,-70,-120,28,25,53,84
-10,20,-90,25,28,53,88
-10,60,-90,25,28,53,90
180,-50,80,27,26,53,64
160,-30,50,26,27,53,56
180,-50,70,30,23,53,67
-160,-70,100,29,24,53,63
-100,80,10,24,29,53,81
-30,-60,-140,26,27,53,66
-10,60,-80,24,29,53,91
-180,-70,80,28,25,53,71
-170,-80,90,25,28,53,60
-20,70,-80,24,29,53,93
-60,80,-40,22,31,53,94
-180,-50,70,30,23,53,67
-180,-50,80,27,26,53,64
170,-20,50,26,27,53,82
180,-70,80,28,25,53,71
-10,70,-90,23,30,53,103
-10,70,-80,22,31,53,82
180,10,90,26,28,54,80
180,0,90,26,28,54,76
-150,-70,90,27,27,54,83
-180,0,90,26,28,54,76
-10,60,-70,21,33,54,81
140,-80,40,27,27,54,61
-160,-20,80,27,27,54,58
-10,30,-80,27,27,54,64
-60,-80,-150,30,24,54,54
-170,20,80,30,24,54,71
-10,-50,-120,28,26,54,63
-180,10,90,26,28,54,80
-20,50,-70,27,27,54,67
-70,80,-30,22,32,54,98
-20,-10,-100,29,25,54,75
170,10,70,28,27,55,60
-10,80,-70,23,32,55,73
-180,-40,90,24,31,55,66
-30,80,-70,23,32,55,102
-130,80,40,24,31,55,77
-80,80,0,22,33,55,64
-10,0,-90,30,25,55,104
-40,60,-60,27,28,55,90
180,10,60,25,30,55,66
-180,-20,90,28,27,55,66
-150,-40,100,28,27,55,74
-10,30,-90,26,29,55,67
180,-20,90,28,27,55,66
-10,10,-90,28,27,55,109
-10,80,-80,22,33,55,91
170,-30,80,25,30,55,73
180,-40,90,24,31,55,66
-20,20,-80,24,31,55,91
-30,60,-60,28,27,55,77
150,-80,50,26,29,55,56
-180,10,60,25,30,55,66
-170,-70,90,28,27,55,70
-70,-70,180,31,25,56,61
150,80,100,26,30,56,117
-160,-60,100,31,25,56,63
-150,-30,80,24,32,56,69
-30,80,-40,26,30,56,82
-170,-40,100,26,30,56,79
-160,-70,110,32,24,56,79
-70,-70,-180,31,25,56,61
170,20,90,29,27,56,84
180,50,80,27,29,56,65
-20,70,-50,25,31,56,83
-40,-50,-130,28,28,56,61
-20,70,-60,22,34,56,75
-170,20,70,28,28,56,81
-170,-50,70,26,30,56,82
-180,30,70,29,27,56,78
-150,-60,100,29,27,56,53
-180,50,80,27,29,56,65
-150,-70,120,32,24,56,83
180,30,70,29,27,56,78
130,-80,30,30,27,57,63
-180,50,90,26,31,57,92
170,20,70,30,27,57,59
-30,40,-60,25,32,57,79
-170,-20,100,31,26,57,95
180,50,90,26,31,57,92
-120,-70,130,29,28,57,64
-30,-70,-110,29,28,57,83
-30,70,-40,24,33,57,94
-180,-30,100,29,28,57,94
-70,-80,-160,30,27,57,64
-150,-80,120,33,24,57,63
-30,70,-50,25,32,57,80
180,-30,100,29,28,57,94
160,80,90,27,30,57,119
-60,-70,-150,30,27,57,65
-40,-40,-130,27,30,57,69
-160,-50,70,32,26,58,94
-120,-70,140,31,27,58,70
-30,30,-60,25,33,58,72
-170,30,80,30,28,58,71
-170,20,90,27,31,58,83
170,-30,90,29,29,58,81
-20,0,-90,33,25,58,102
170,-40,70,28,30,58,73
-40,-40,-120,27,31,58,76
-170,-50,100,28,30,58,80
170,-60,60,33,25,58,85
170,80,90,28,30,58,98
-170,0,70,27,31,58,70
-10,0,-80,31,28,59,96
-170,-60,90,32,27,59,72
170,-30,50,30,29,59,83
-10,10,-100,30,29,59,109
-40,-50,-110,29,30,59,125
0,70,-100,26,33,59,106
170,-10,80,28,31,59,70
170,80,80,28,31,59,121
-180,-40,100,28,31,59,83
-40,70,-40,24,35,59,80
0,70,-90,26,33,59,91
-150,80,60,28,31,59,86
0,80,-80,25,34,59,79
160,-40,50,34,25,59,67
-30,30,-80,23,36,59,88
-130,-70,110,27,32,59,80
170,-40,90,32,27,59,79
0,0,-90,32,27,59,95
180,-40,100,28,31,59,83
-170,10,70,29,31,60,76
180,-10,50,29,31,60,81
170,10,80,29,31,60,78
180,80,80,29,31,60,95
-170,-80,100,33,27,60,61
-90,80,10,23,37,60,69
-180,80,80,29,31,60,95
-80,-70,-180,32,28,60,81
-40,60,-50,32,28,60,82
-20,-30,-120,32,28,60,84
0,80,-90,23,37,60,100
-20,-50,-140,32,28,60,105
-30,20,-70,28,32,60,82
-80,-70,180,32,28,60,81
-180,-10,50,29,31,60,81
-160,-80,110,33,27,60,62
170,30,110,29,31,60,89
-80,80,-20,26,34,60,107
10,70,-100,26,34,60,91
-170,-70,100,32,28,60,83
170,-50,70,36,25,61,85
-110,80,30,27,34,61,84
-90,80,-10,28,33,61,109
-180,60,90,28,33,61,86
-10,0,-100,32,29,61,108
-110,80,10,28,33,61,112
170,0,60,29,32,61,66
-180,-60,90,30,31,61,89
-50,-80,-170,27,34,61,66
180,60,90,28,33,61,86
180,-30,50,30,31,61,101
-170,-50,60,29,32,61,119
170,0,80,28,33,61,82
180,-60,90,30,31,61,89
0,60,-100,28,33,61,109
-160,-50,100,31,30,61,85
-180,20,60,29,32,61,77
-10,40,-80,27,34,61,75
-160,-70,80,30,31,61,97
-170,-30,100,31,30,61,97
140,80,110,29,32,61,120
0,20,-100,29,32,61,80
180,20,60,29,32,61,77
-40,30,-70,26,35,61,108
-180,-30,50,30,31,61,101
-130,-60,120,31,30,61,67
-160,-30,100,30,31,61,101
-20,80,-80,25,36,61,112
170,30,80,34,27,61,79
-50,90,-50,30,32,62,110
-60,-80,180,27,35,62,72
40,90,-140,30,32,62,110
-80,90,-20,30,32,62,110
-10,-70,-130,31,31,62,66
150,90,110,30,32,62,110
-20,90,-80,30,32,62,110
0,90,-100,30,32,62,110
100,90,160,30,32,62,110
180,-50,90,31,31,62,87
90,90,170,30,32,62,110
-150,90,50,30,32,62,110
50,90,-150,30,32,62,110
-90,90,-10,30,32,62,110
30,90,-130,30,32,62,110
-70,90,-30,30,32,62,110
160,90,100,30,32,62,110
-10,20,-100,32,30,62,96
140,90,120,30,32,62,110
20,90,-120,30,32,62,110
-60,90,-40,30,32,62,110
-40,90,-60,30,32,62,110
130,90,130,30,32,62,110
-180,90,80,30,32,62,110
170,-50,60,36,26,62,79
-170,90,70,30,32,62,110
120,90,140,30,32,62,110
180,80,70,29,33,62,126
-180,-60,80,32,30,62,87
0,-80,-90,31,31,62,61
-30,90,-70,30,32,62,110
170,-60,70,32,30,62,104
-140,90,40,30,32,62,110
-130,90,30,30,32,62,110
60,90,-160,30,32,62,110
-40,-60,-110,33,29,62,132
-100,90,0,30,32,62,110
-180,80,70,29,33,62,126
-30,-20,-100,34,28,62,85
-110,-70,140,28,34,62,79
-140,-70,100,29,33,62,83
-50,-60,-120,33,29,62,141
-30,-50,-140,35,27,62,96
10,90,-110,30,32,62,110
70,90,-170,30,32,62,110
170,90,90,30,32,62,110
-120,-70,120,30,32,62,82
-140,-60,100,35,27,62,67
110,90,150,30,32,62,110
10,80,-100,26,36,62,103
-10,90,-90,30,32,62,110
80,90,-180,30,32,62,110
-160,90,60,30,32,62,110
-120,90,20,30,32,62,110
-180,-50,90,31,31,62,87
20,-80,-80,29,33,62,83
170,-70,70,30,32,62,79
-40,-80,-160,30,32,62,66
-110,90,10,30,32,62,110
180,-60,80,32,30,62,87
-60,-80,-180,27,35,62,72
-120,-80,120,29,33,62,82
-120,80,20,30,32,62,116
180,90,80,30,32,62,110
80,90,180,30,32,62,110
-40,-60,-150,32,31,63,90
-140,-80,130,36,27,63,70
160,-30,60,31,32,63,71
-150,-50,100,31,32,63,77
170,-50,80,33,30,63,94
20,-80,-90,30,33,63,73
-20,-70,-140,28,35,63,72
170,-40,80,31,32,63,80
-20,20,-90,29,34,63,117
-130,-80,110,30,33,63,81
-30,-30,-120,31,32,63,77
-130,-60,110,32,31,63,78
-20,10,-90,30,33,63,118
-100,80,20,28,35,63,78
-60,70,-40,29,34,63,99
170,-70,60,34,29,63,96
0,60,-90,29,34,63,99
-160,-60,110,30,33,63,104
-140,-80,100,30,33,63,80
-170,0,80,33,30,63,76
-30,-30,-100,29,34,63,93
170,-20,80,27,36,63,79
-170,-80,70,29,35,64,85
-140,80,40,30,34,64,112
180,-70,90,33,31,64,86
180,-40,50,29,35,64,109
-40,80,-30,29,35,64,83
-20,10,-80,29,35,64,106
-110,-70,150,29,35,64,83
-60,70,-30,21,43,64,100
180,-80,90,35,29,64,61
-80,-70,170,32,32,64,72
-10,80,-90,26,38,64,118
-180,-40,50,29,35,64,109
-180,-70,90,33,31,64,86
130,-80,20,33,31,64,64
160,80,100,31,33,64,100
-20,80,-50,28,36,64,88
-80,-80,160,28,36,64,75
170,-40,100,34,30,64,101
-130,-70,140,35,29,64,103
-140,-60,110,35,29,64,67
160,-20,50,34,30,64,65
-160,80,60,30,34,64,106
-170,10,60,30,34,64,98
-180,-80,90,35,29,64,61
-70,-80,170,28,36,64,77
-80,-80,-170,31,33,64,78
-170,-60,70,35,29,64,91
-100,80,0,28,36,64,114
160,-50,90,31,33,64,101
-90,-80,150,29,35,64,76
-140,-70,130,37,28,65,94
-150,-50,80,36,29,65,92
160,-80,70,33,32,65,69
-10,50,-80,30,35,65,104
160,-20,60,32,33,65,69
-10,60,-60,27,38,65,85
170,-80,80,34,31,65,70
-150,-60,110,33,32,65,90
-170,-60,100,34,31,65,90
170,40,80,34,31,65,84
170,10,90,30,35,65,90
-130,80,30,31,34,65,114
-10,30,-100,33,32,65,92
-10,70,-70,26,39,65,80
-20,40,-90,34,31,65,100
-120,-80,150,37,28,65,85
-100,-80,140,31,34,65,80
0,10,-110,29,36,65,99
-150,-60,80,33,32,65,96
-180,-60,60,36,29,65,97
-40,70,-70,29,36,65,114
-30,10,-80,28,37,65,92
-120,80,40,29,36,65,89
180,-60,60,36,29,65,97
-40,70,-30,27,38,65,98
-40,-40,-110,32,34,66,108
-180,40,70,33,33,66,92
170,60,100,34,32,66,86
-180,-20,100,33,33,66,103
-30,-10,-100,37,29,66,81
180,-20,100,33,33,66,103
180,40,70,33,33,66,92
-150,80,50,31,35,66,112
-30,-80,-150,31,35,66,64
-170,-10,90,34,32,66,81
-60,80,-10,30,36,66,89
-10,10,-80,34,32,66,110
170,-40,50,35,31,66,81
-20,-40,-130,36,30,66,100
160,-40,60,31,35,66,81
-10,70,-60,27,39,66,94
-130,-80,140,38,28,66,80
120,-80,20,32,34,66,76
100,-90,10,32,35,67,79
-170,80,70,32,35,67,101
-10,-60,-130,34,33,67,85
-120,-90,150,32,35,67,79
-30,50,-60,31,36,67,80
-160,-20,90,34,33,67,84
150,-80,60,33,34,67,70
-40,-50,-140,31,36,67,90
-10,40,-100,32,35,67,105
130,-90,40,32,35,67,79
-50,-90,-140,32,35,67,79
160,-60,50,36,31,67,101
-20,50,-60,30,37,67,90
-110,-90,160,32,35,67,79
-70,-90,-160,32,35,67,79
-50,-80,-130,31,36,67,101
-10,50,-100,31,36,67,115
-170,-70,110,35,32,67,109
120,-90,30,32,35,67,79
-100,-70,160,31,36,67,97
30,-90,-60,32,35,67,79
-160,-90,110,32,35,67,79
-30,-90,-120,32,35,67,79
-180,-90,90,32,35,67,79
-160,-80,80,31,36,67,90
-80,-90,-170,32,35,67,79
-180,10,100,32,35,67,94
70,-90,-20,32,35,67,79
-150,-90,120,32,35,67,79
170,20,100,32,35,67,93
10,-90,-80,32,35,67,79
-130,80,50,31,36,67,100
160,-90,70,32,35,67,79
0,20,-90,34,33,67,83
90,-90,0,32,35,67,79
-180,-70,100,33,34,67,104
20,-90,-70,32,35,67,79
-140,-90,130,32,35,67,79
-20,50,-90,31,36,67,99
-30,-70,-150,33,34,67,87
180,-20,50,30,37,67,101
-50,70,-30,27,40,67,81
40,-90,-50,32,35,67,79
180,-90,90,32,35,67,79
-20,-70,-100,32,35,67,93
-90,-90,180,32,35,67,79
170,-10,50,33,34,67,90
60,-90,-30,32,35,67,79
180,-70,100,33,34,67,104
160,-30,70,28,39,67,95
110,-90,20,32,35,67,79
-170,-90,100,32,35,67,79
80,-90,-10,32,35,67,79
0,40,-100,31,36,67,107
50,-90,-40,32,35,67,79
10,70,-110,29,38,67,114
170,-90,80,32,35,67,79
-60,-90,-150,32,35,67,79
170,-50,90,31,36,67,89
-10,-90,-100,32,35,67,79
0,-90,-90,32,35,67,79
180,10,100,32,35,67,94
-20,-90,-110,32,35,67,79
-40,-90,-130,32,35,67,79
-130,-90,140,32,35,67,79
140,-90,50,32,35,67,79
150,-90,60,32,35,67,79
-100,-90,170,32,35,67,79
-40,50,-60,34,33,67,92
170,50,80,34,33,67,86
-180,-20,50,30,37,67,101
-90,-90,-180,32,35,67,79
110,-90,-10,31,37,68,77
-60,-60,-150,34,34,68,94
30,90,-140,32,36,68,139
170,90,80,32,36,68,139
80,90,170,32,36,68,139
110,90,140,32,36,68,139
-140,-90,100,31,37,68,77
-160,90,50,32,36,68,139
-20,-90,-140,31,37,68,77
-160,80,70,32,36,68,100
140,90,110,32,36,68,139
-30,-90,-150,31,37,68,77
90,-90,-30,31,37,68,77
120,-90,0,31,37,68,77
50,-90,-70,31,37,68,77
150,-90,30,31,37,68,77
-150,90,40,32,36,68,139
-130,90,20,32,36,68,139
-120,-90,120,31,37,68,77
180,-90,60,31,37,68,77
-30,90,-80,32,36,68,139
-80,-90,160,31,37,68,77
-10,90,-100,32,36,68,139
70,90,-180,32,36,68,139
170,-90,50,31,37,68,77
-60,90,-50,32,36,68,139
-100,90,-10,32,36,68,139
-40,90,-70,32,36,68,139
-100,-90,140,31,37,68,77
120,90,130,32,36,68,139
60,-90,-60,31,37,68,77
40,90,-150,32,36,68,139
-40,-80,-120,31,37,68,97
-180,90,70,32,36,68,139
-160,-20,100,34,34,68,122
20,90,-130,32,36,68,139
160,-40,80,37,31,68,100
160,-40,70,36,32,68,99
-20,90,-90,32,36,68,139
-90,-90,150,31,37,68,77
-170,-90,70,31,37,68,77
-50,80,-20,32,36,68,86
-170,90,60,32,36,68,139
40,-90,-80,31,37,68,77
-70,90,-40,32,36,68,139
10,90,-120,32,36,68,139
150,90,100,32,36,68,139
70,90,180,32,36,68,139
-120,90,10,32,36,68,139
-30,10,-90,35,33,68,96
30,-90,-90,31,37,68,77
-110,-90,130,31,37,68,77
10,-90,-110,31,37,68,77
80,-90,-40,31,37,68,77
-70,-90,170,31,37,68,77
-50,90,-60,32,36,68,139
-110,-80,130,32,36,68,84
-160,-90,80,31,37,68,77
160,-90,40,31,37,68,77
-110,-80,160,35,33,68,90
-90,90,-20,32,36,68,139
100,90,150,32,36,68,139
0,-90,-120,31,37,68,77
50,90,-160,32,36,68,139
-90,-80,-180,34,34,68,90
130,-90,10,31,37,68,77
-180,-90,60,31,37,68,77
100,-90,-20,31,37,68,77
-160,-30,60,35,33,68,105
-80,90,-30,32,36,68,139
-130,-90,110,31,37,68,77
130,90,120,32,36,68,139
140,-90,20,31,37,68,77
180,90,70,32,36,68,139
0,90,-110,32,36,68,139
-10,-80,-130,34,34,68,67
-90,-80,180,34,34,68,90
-30,-60,-100,34,34,68,121
160,90,90,32,36,68,139
-170,80,60,33,35,68,135
90,90,160,32,36,68,139
-150,-90,90,31,37,68,77
-110,90,0,32,36,68,139
20,-90,-100,31,37,68,77
70,-90,-50,31,37,68,77
-60,-90,180,31,37,68,77
-10,-90,-130,31,37,68,77
-60,-90,-180,31,37,68,77
60,90,-170,32,36,68,139
-50,-90,-170,31,37,68,77
0,70,-80,29,39,68,78
-140,90,30,32,36,68,139
-40,-90,-160,31,37,68,77
-20,60,-90,34,35,69,106
-170,-70,70,36,33,69,105
-30,70,-80,31,38,69,123
180,-60,100,35,34,69,101
-90,-70,170,33,36,69,94
180,0,100,35,34,69,101
-20,-20,-120,35,34,69,106
-30,60,-50,33,36,69,96
-180,0,100,35,34,69,101
-50,70,-60,32,37,69,111
170,40,110,33,36,69,113
-170,40,70,30,39,69,88
180,-50,60,32,37,69,92
-180,-50,60,32,37,69,92
-170,10,90,36,33,69,105
-180,-60,100,35,34,69,101
0,30,-100,30,39,69,105
0,10,-90,38,31,69,92
-140,80,60,33,37,70,112
170,40,100,32,38,70,112
170,90,110,33,37,70,93
-20,90,-60,33,37,70,93
-60,-70,-140,36,34,70,112
-70,-70,-160,36,34,70,94
30,80,-120,33,37,70,127
130,90,150,33,37,70,93
-120,90,40,33,37,70,93
-140,90,60,33,37,70,93
-170,30,110,34,36,70,97
-70,80,0,31,39,70,102
10,80,-110,29,41,70,130
-170,-30,110,37,33,70,133
160,90,120,33,37,70,93
50,90,-130,33,37,70,93
-50,90,-30,33,37,70,93
100,90,-180,33,37,70,93
70,90,-150,33,37,70,93
120,90,160,33,37,70,93
-30,90,-50,33,37,70,93
-60,-80,-140,31,39,70,109
-30,50,-80,30,40,70,103
-150,-80,90,34,36,70,88
-60,90,-20,33,37,70,93
-180,90,100,33,37,70,93
90,90,-170,33,37,70,93
-20,30,-60,31,39,70,78
20,90,-100,33,37,70,93
110,90,170,33,37,70,93
-130,90,50,33,37,70,93
-170,90,90,33,37,70,93
-180,-80,60,32,38,70,90
-40,90,-40,33,37,70,93
-80,90,0,33,37,70,93
0,90,-80,33,37,70,93
60,90,-140,33,37,70,93
160,-70,50,34,36,70,111
-110,90,30,33,37,70,93
-30,-80,-110,34,36,70,95
180,90,100,33,37,70,93
30,90,-110,33,37,70,93
-90,-70,160,31,39,70,80
80,90,-160,33,37,70,93
20,80,-110,32,38,70,112
20,80,-120,30,40,70,135
-30,-40,-140,35,35,70,126
-150,90,70,33,37,70,93
-30,-10,-90,37,33,70,82
-100,90,20,33,37,70,93
-10,90,-70,33,37,70,93
160,-50,80,38,32,70,111
-90,90,10,33,37,70,93
10,90,-90,33,37,70,93
180,-80,60,32,38,70,90
140,90,140,33,37,70,93
-160,90,80,33,37,70,93
-70,90,-10,33,37,70,93
170,-60,80,35,35,70,112
40,90,-120,33,37,70,93
150,90,130,33,37,70,93
100,90,180,33,37,70,93
-140,-40,90,35,36,71,75
-170,70,80,33,38,71,106
-20,20,-70,33,38,71,92
-150,-50,70,33,38,71,101
-170,60,80,31,40,71,120
-150,-30,100,34,37,71,116
170,-50,100,36,35,71,106
-170,20,100,36,35,71,99
-20,60,-50,30,41,71,103
-20,-10,-90,39,32,71,97
-10,-40,-120,37,34,71,102
-40,-70,-160,37,34,71,94
-20,70,-90,32,39,71,134
20,70,-110,33,38,71,115
0,60,-80,27,44,71,94
10,80,-90,33,38,71,102
-20,0,-100,40,31,71,111
-40,20,-80,34,37,71,104
160,-80,40,34,37,71,85
-60,80,-50,32,39,71,140
-10,60,-100,35,36,71,129
-160,-60,70,34,37,71,114
-20,30,-90,32,39,71,101
-60,-60,-160,37,34,71,86
-70,70,-30,33,38,71,118
-60,-70,-180,36,35,71,93
-170,-50,110,38,33,71,119
-100,-70,150,30,41,71,93
-60,-70,180,36,35,71,93
130,80,120,33,38,71,130
-40,-40,-140,36,36,72,117
-50,-50,-130,33,39,72,125
160,-50,50,39,33,72,99
-100,-80,170,36,36,72,93
-180,-50,100,35,37,72,93
160,-10,60,34,38,72,102
160,-60,60,35,37,72,113
-160,-10,70,37,35,72,95
-20,-80,-140,34,38,72,69
0,-70,-90,38,34,72,87
-160,-40,110,39,33,72,123
0,80,-100,30,42,72,127
-170,80,80,33,39,72,107
30,-80,-80,33,39,72,100
0,-60,-90,37,35,72,85
-160,-50,110,35,37,72,113
170,-70,80,36,36,72,96
180,-50,100,35,37,72,93
-160,-70,120,33,39,72,120
180,-50,50,33,40,73,121
-180,-50,50,33,40,73,121
170,-80,50,34,39,73,93
-20,-60,-140,38,35,73,95
-20,80,-90,33,40,73,148
-180,60,80,32,41,73,92
-70,80,-40,33,40,73,141
170,40,70,38,35,73,96
160,-50,70,40,33,73,117
-170,0,90,36,37,73,101
170,40,90,37,36,73,108
180,60,80,32,41,73,92
170,60,90,40,33,73,96
180,-40,110,36,37,73,121
0,0,-80,39,34,73,94
-170,30,70,34,39,73,105
-180,-40,110,36,37,73,121
-120,-70,150,38,35,73,110
-150,-30,90,34,39,73,89
-20,30,-100,34,39,73,133
170,-70,90,32,41,73,113
-30,80,-80,33,41,74,143
-170,50,80,36,38,74,117
-30,60,-80,34,40,74,106
-30,0,-80,38,36,74,97
0,60,-70,33,41,74,104
-170,-40,110,37,37,74,125
-100,80,-10,34,40,74,152
-20,40,-60,32,42,74,89
0,-80,-120,38,36,74,79
-150,-30,70,36,38,74,103
-30,-20,-110,37,37,74,110
-10,20,-110,37,37,74,128
-10,20,-70,35,39,74,94
170,30,70,38,36,74,81
-80,80,-30,34,40,74,147
10,-70,-100,33,41,74,73
150,80,110,37,37,74,106
110,-80,10,37,37,74,86
-160,-40,60,39,36,75,109
-160,40,90,38,37,75,95
180,-70,60,41,34,75,116
-30,40,-80,32,43,75,119
140,-80,50,37,38,75,76
-10,-50,-130,40,35,75,111
-60,70,-20,31,44,75,98
0,50,-90,33,42,75,147
-50,80,-60,34,41,75,141
0,-50,-100,40,35,75,101
-170,-60,60,35,40,75,138
10,80,-120,36,39,75,153
180,60,100,32,43,75,126
-160,-20,60,37,38,75,100
170,10,60,40,35,75,81
-150,-40,110,36,39,75,131
-180,-60,110,37,38,75,131
-40,20,-60,38,37,75,74
-150,-80,130,34,41,75,127
-160,-80,120,35,40,75,121
-180,20,110,38,37,75,101
-180,70,100,36,39,75,108
-180,-70,60,41,34,75,116
-160,0,60,31,44,75,114
180,20,110,38,37,75,101
-110,-70,130,36,39,75,102
180,-60,110,37,38,75,131
-60,-60,-140,39,36,75,132
-180,60,100,32,43,75,126
180,70,100,36,39,75,108
-140,-60,90,41,34,75,94
170,40,120,37,39,76,112
-170,20,110,39,37,76,124
-160,-50,60,35,41,76,128
160,-40,90,40,36,76,111
160,-50,40,42,34,76,111
120,-80,10,40,36,76,84
-90,80,-20,35,41,76,152
170,-50,50,40,36,76,105
-140,-60,120,40,36,76,108
170,-40,40,39,37,76,110
20,70,-120,33,43,76,133
-110,80,0,36,40,76,153
-120,80,10,36,40,76,141
-120,-60,130,38,38,76,89
130,-80,40,38,38,76,79
-170,-60,110,39,37,76,122
-40,80,-70,34,42,76,141
-150,-40,70,39,37,76,85
-50,-70,-170,41,35,76,96
170,-30,100,40,37,77,115
-30,10,-70,39,38,77,109
-180,-30,110,37,40,77,135
-160,-30,110,36,41,77,148
160,-20,70,36,41,77,117
170,20,60,41,36,77,78
-20,10,-100,40,37,77,122
170,0,90,33,44,77,106
-120,-80,160,37,40,77,132
-70,-70,170,36,41,77,108
-140,-70,140,35,42,77,136
-10,-30,-110,40,37,77,125
170,-20,90,35,42,77,118
-170,-10,50,38,39,77,113
-160,-10,80,41,36,77,99
180,-30,110,37,40,77,135
-40,10,-80,39,38,77,111
160,-30,40,40,37,77,88
30,-80,-70,37,40,77,105
-70,-80,-150,35,42,77,121
20,80,-130,38,39,77,160
-30,0,-90,39,38,77,105
160,-50,60,43,34,77,109
-20,-80,-100,39,38,77,100
0,10,-80,38,39,77,108
-110,-80,170,35,42,77,133
-150,-70,130,35,43,78,132
-80,80,10,34,44,78,113
-10,-20,-110,40,38,78,115
-10,80,-100,36,42,78,154
0,80,-110,38,40,78,156
0,50,-100,36,42,78,126
-160,30,90,33,45,78,107
120,80,130,35,43,78,141
-100,-80,180,34,44,78,134
-20,-20,-90,34,44,78,84
-160,30,80,35,43,78,103
140,80,120,38,40,78,110
-100,-80,-180,34,44,78,134
170,-60,50,46,32,78,104
40,80,-140,36,42,78,157
150,-50,80,42,36,78,122
-160,20,80,43,35,78,95
-30,-10,-110,43,35,78,113
-30,-50,-150,42,36,78,132
0,0,-100,40,38,78,127
10,60,-90,29,49,78,112
40,80,-130,38,40,78,141
-30,20,-90,40,38,78,120
-20,-40,-140,40,38,78,136
-150,80,70,36,42,78,125
-160,-40,120,40,38,78,169
-130,80,20,37,41,78,152
-160,80,50,37,41,78,145
0,-50,-110,37,41,78,106
170,-80,90,39,39,78,113
160,-70,80,36,42,78,119
-20,20,-100,41,38,79,130
-20,0,-80,39,40,79,119
-160,0,70,34,45,79,113
-40,30,-60,37,42,79,114
-50,-70,-120,39,40,79,152
10,60,-100,32,47,79,114
150,-50,70,42,37,79,129
-170,-20,110,37,42,79,143
-170,40,110,39,40,79,104
170,-70,50,41,38,79,129
-50,60,-50,46,33,79,112
160,-40,40,43,36,79,98
140,-80,20,38,41,79,96
-70,-60,-160,41,38,79,123
0,30,-90,35,44,79,109
30,80,-130,35,44,79,140
-10,50,-60,36,43,79,109
-170,-80,110,37,42,79,113
-90,-80,-170,36,43,79,136
-130,-80,150,39,40,79,137
10,-70,-90,36,44,80,84
-140,-80,140,38,42,80,138
-10,60,-50,39,41,80,103
-10,10,-110,41,39,80,132
-120,-60,120,36,44,80,92
180,-80,100,39,41,80,111
-170,70,70,36,44,80,117
170,10,100,38,42,80,101
0,-70,-120,39,41,80,90
-100,-70,140,37,43,80,114
0,20,-110,38,42,80,108
-180,-80,100,39,41,80,111
150,-40,50,42,38,80,104
-10,70,-100,35,45,80,142
-140,-50,90,39,41,80,110
180,-60,50,39,41,80,136
-140,-50,100,37,43,80,124
-170,-40,50,37,43,80,128
-140,80,30,38,42,80,156
-10,80,-60,34,46,80,102
-40,60,-70,34,46,80,126
-20,-10,-110,43,37,80,112
-180,0,50,41,39,80,105
150,-60,40,44,36,80,119
-170,60,90,34,46,80,142
170,-60,90,39,41,80,101
180,0,50,41,39,80,105
30,80,-140,40,40,80,163
-160,40,80,36,44,80,108
-170,20,60,36,44,80,112
170,-30,40,38,42,80,111
20,80,-100,38,42,80,116
160,0,60,42,38,80,113
170,70,80,39,41,80,137
-180,-60,50,39,41,80,136
-170,-10,100,36,44,80,131
-30,20,-60,39,41,80,101
160,-60,80,37,44,81,116
150,-80,30,39,42,81,92
150,-40,40,44,37,81,107
10,70,-90,35,46,81,94
180,80,90,37,44,81,118
150,-30,50,40,41,81,92
-80,-80,-160,36,45,81,132
-180,80,90,37,44,81,118
160,-60,70,43,38,81,122
-140,-40,100,33,48,81,115
40,80,-150,42,39,81,164
0,50,-110,38,43,81,154
-60,70,-50,40,41,81,120
-150,80,40,38,43,81,150
-50,-50,-120,39,42,81,148
160,-10,50,42,39,81,118
-130,-70,100,39,42,81,124
-130,-60,130,40,41,81,112
-80,-70,160,40,41,81,108
150,-50,40,44,37,81,127
-50,-60,-160,42,39,81,99
180,-50,110,40,42,82,129
-20,50,-100,38,44,82,153
180,50,100,36,46,82,154
-180,70,70,40,42,82,138
-180,-70,110,40,42,82,138
170,-70,100,40,42,82,133
-160,-10,60,40,42,82,110
-170,-70,120,40,42,82,145
160,-70,40,41,41,82,142
180,-70,110,40,42,82,138
150,-60,50,42,40,82,118
-180,50,100,36,46,82,154
180,70,70,40,42,82,138
-10,-10,-100,40,42,82,147
-30,-60,-150,42,40,82,121
0,20,-80,37,45,82,114
0,-60,-120,39,43,82,96
-150,70,60,40,42,82,148
-40,50,-70,37,45,82,123
-170,-30,50,40,42,82,126
-180,-50,110,40,42,82,129
-10,50,-70,35,47,82,125
160,-80,80,41,41,82,115
-20,40,-100,38,44,82,148
170,-50,40,42,40,82,117
-40,-70,-110,42,41,83,151
180,70,80,37,46,83,118
-10,-20,-100,41,42,83,109
-180,50,70,41,42,83,115
180,-10,100,39,44,83,135
180,50,70,41,42,83,115
-160,-20,110,41,42,83,165
-30,50,-90,38,45,83,158
0,70,-70,35,48,83,110
-150,70,70,40,43,83,144
-180,70,80,37,46,83,118
-150,-30,110,37,46,83,161
-30,0,-100,47,36,83,128
-160,70,70,40,43,83,132
-180,-10,100,39,44,83,135
30,70,-120,38,45,83,137
0,60,-60,37,46,83,114
150,-70,40,38,45,83,126
160,80,80,44,39,83,162
-30,-30,-130,41,42,83,117
-70,70,-20,31,52,83,124
-160,80,80,40,43,83,142
-70,-60,-170,44,39,83,107
-160,-30,120,40,44,84,175
-90,80,20,37,47,84,126
180,70,90,39,45,84,123
-150,-50,110,38,46,84,139
-20,-40,-90,39,45,84,135
160,-70,70,39,45,84,118
-170,70,60,42,42,84,147
150,80,90,45,39,84,155
140,80,100,45,39,84,156
-10,40,-110,39,45,84,148
-170,50,90,43,41,84,141
-20,70,-40,43,41,84,130
170,-10,90,38,46,84,131
-170,0,50,43,41,84,130
-160,20,70,42,42,84,101
130,80,130,41,43,84,116
-180,70,90,39,45,84,123
170,70,110,40,44,84,130
120,-80,30,42,43,85,95
10,-80,-80,43,42,85,103
10,-80,-110,41,44,85,98
-170,-50,120,44,41,85,166
-140,-70,90,40,45,85,130
-10,10,-70,47,38,85,110
-10,-20,-120,44,41,85,160
-40,-50,-150,43,42,85,137
-130,-70,150,39,46,85,150
30,70,-130,38,47,85,143
-30,30,-90,41,44,85,130
110,-80,0,44,41,85,103
50,80,-160,43,42,85,172
-10,-30,-100,49,36,85,124
-10,-50,-140,45,41,86,167
160,-70,60,37,49,86,108
50,80,-150,39,47,86,163
-50,-50,-140,38,48,86,108
-90,-70,150,41,45,86,119
170,-60,100,39,47,86,132
-170,70,90,43,43,86,125
-10,-40,-130,44,42,86,143
130,80,110,44,42,86,161
0,70,-110,38,48,86,165
-110,-70,160,38,48,86,134
-70,-70,-150,43,43,86,147
-160,-70,130,38,48,86,160
-20,-30,-90,44,42,86,116
-10,30,-70,40,46,86,104
170,0,50,47,40,87,113
170,80,100,41,46,87,134
180,70,110,47,40,87,123
-20,10,-70,44,43,87,111
150,-60,60,43,44,87,124
10,60,-110,41,46,87,145
-30,-10,-80,42,45,87,116
170,80,70,43,44,87,174
-160,-70,70,45,42,87,143
160,0,70,47,40,87,120
-30,-20,-90,49,38,87,135
-60,-60,-130,43,44,87,180
-180,70,110,47,40,87,123
-160,70,80,41,46,87,134
160,-60,90,39,49,88,140
-160,-60,120,43,45,88,173
180,30,60,42,46,88,113
-10,0,-110,44,44,88,145
160,70,80,47,41,88,139
-160,70,90,43,45,88,142
150,-80,70,43,45,88,123
-150,-60,120,41,47,88,143
170,50,100,44,44,88,141
-100,80,30,43,45,88,140
-170,-20,50,41,47,88,136
-70,-60,-150,45,43,88,175
-150,-70,80,40,48,88,136
-180,80,60,43,45,88,191
0,40,-90,42,46,88,114
170,30,60,41,47,88,104
180,80,60,43,45,88,191
-180,30,60,42,46,88,113
180,60,70,44,45,89,147
-20,-30,-130,48,41,89,142
120,80,120,46,43,89,171
160,-30,80,40,49,89,120
-170,-50,50,39,50,89,147
-160,10,60,41,48,89,134
-50,60,-60,40,49,89,127
0,40,-110,42,47,89,157
-170,10,50,41,48,89,149
-180,-30,40,41,48,89,133
-40,-50,-100,42,47,89,180
60,80,-170,45,44,89,176
-160,70,60,43,46,89,138
-170,-70,60,47,42,89,157
70,80,180,43,46,89,183
-180,60,70,44,45,89,147
-10,-10,-90,46,43,89,164
70,80,-180,43,46,89,183
180,-30,40,41,48,89,133
150,-50,60,48,41,89,139
-170,-40,120,45,44,89,177
-140,70,50,41,49,90,148
-180,10,110,45,45,90,128
-140,70,60,43,47,90,138
160,20,70,47,43,90,126
-170,10,100,48,42,90,138
170,20,110,44,46,90,121
150,70,90,47,43,90,141
-140,-40,110,39,51,90,158
150,-70,50,39,51,90,129
0,0,-110,43,47,90,144
170,70,70,47,43,90,153
180,10,110,45,45,90,128
-170,70,100,48,42,90,133
-150,-60,70,41,49,90,147
40,-80,-70,42,48,90,132
-50,20,-70,40,50,90,115
-160,20,90,45,45,90,120
10,-60,-100,49,41,90,108
-30,-20,-120,48,42,90,132
-160,30,100,43,47,90,128
-160,40,100,45,45,90,109
-160,-60,60,41,49,90,149
-80,70,-20,41,49,90,133
-40,-40,-100,42,48,90,152
-20,10,-110,49,41,90,159
-120,-70,110,43,47,90,123
-80,-70,-170,44,47,91,133
-10,30,-110,46,45,91,148
110,80,140,39,52,91,167
160,-70,90,46,45,91,138
-30,70,-90,42,49,91,179
110,80,130,45,46,91,184
-20,0,-110,48,43,91,151
-40,40,-70,41,50,91,156
-10,-10,-110,45,46,91,168
-20,-10,-80,46,45,91,113
150,-70,60,42,49,91,136
-170,-60,120,46,45,91,173
-120,-60,140,42,49,91,129
-60,-70,-130,45,46,91,178
-160,10,70,44,47,91,114
-40,10,-70,46,45,91,113
-110,80,40,42,49,91,146
-10,0,-70,53,38,91,125
-10,70,-50,42,50,92,125
-10,-40,-140,48,44,92,166
10,70,-120,46,46,92,179
170,70,90,41,51,92,141
-50,70,-70,43,49,92,181
150,-70,70,38,54,92,137
-140,-50,80,48,44,92,120
160,50,90,46,46,92,136
20,70,-100,40,52,92,119
0,30,-110,39,53,92,155
20,70,-130,47,45,92,190
-110,-60,130,42,50,92,126
-20,-50,-90,48,44,92,139
-170,50,70,43,49,92,149
180,40,120,47,45,92,128
130,-80,10,43,49,92,111
-180,40,120,47,45,92,128
170,60,110,42,50,92,150
-130,-60,100,48,44,92,125
-70,70,-40,42,50,92,137
-10,50,-110,41,51,92,154
140,-70,30,41,51,92,139
140,-70,40,40,52,92,141
-10,40,-70,37,55,92,118
150,-40,60,50,43,93,132
-50,70,-20,46,47,93,121
-160,70,50,43,50,93,169
160,-10,70,44,49,93,130
-20,-10,-120,48,45,93,164
0,60,-110,43,50,93,161
-40,50,-80,42,51,93,163
20,-80,-100,43,50,93,117
-10,-30,-120,44,49,93,166
-30,70,-30,50,43,93,132
120,80,140,45,48,93,131
150,-50,50,49,44,93,141
100,-80,-10,48,45,93,117
-120,-60,110,46,47,93,123
-170,80,50,45,48,93,189
-20,-20,-130,51,42,93,170
-20,60,-100,43,51,94,172
60,80,-160,44,50,94,179
-170,-30,120,44,50,94,164
-160,-50,120,48,46,94,182
-120,-80,110,43,51,94,146
160,20,80,50,44,94,141
-10,-60,-90,45,49,94,121
-30,-40,-90,45,49,94,164
160,80,110,45,49,94,144
-40,70,-80,44,50,94,186
-30,40,-90,42,52,94,154
170,60,80,46,48,94,144
-170,60,70,41,53,94,145
20,60,-110,42,52,94,144
-180,10,50,44,50,94,122
0,80,-70,42,52,94,123
80,80,170,46,48,94,193
-100,-80,130,44,50,94,141
160,10,70,45,49,94,133
160,-60,40,52,42,94,133
50,80,-140,43,51,94,180
-40,40,-60,45,49,94,148
180,10,50,44,50,94,122
150,-30,40,46,48,94,116
100,80,150,41,53,94,178
160,70,90,46,48,94,154
-120,80,50,45,49,94,152
-130,80,60,46,49,95,150
-150,-70,140,42,53,95,173
-110,-80,120,44,51,95,141
-140,-50,110,47,48,95,162
-60,-60,-170,47,48,95,122
-10,-10,-80,50,45,95,142
-10,40,-60,41,54,95,138
110,80,150,43,52,95,150
150,-60,70,44,51,95,138
-130,-80,100,44,51,95,152
-30,60,-90,42,53,95,171
-150,-50,60,46,50,96,131
-20,-50,-150,50,46,96,161
20,60,-100,36,60,96,132
100,80,140,48,48,96,194
10,-70,-110,47,49,96,118
10,60,-80,41,55,96,135
-160,10,80,48,48,96,124
140,-80,60,47,49,96,132
-150,-40,120,46,50,96,189
-140,-60,130,47,49,96,165
-20,20,-60,49,47,96,128
-90,-80,140,45,51,96,140
-30,-50,-90,48,48,96,182
-80,70,-30,45,51,96,148
160,50,80,47,49,96,149
-10,-70,-90,50,46,96,128
170,70,100,42,54,96,149
-30,0,-110,52,44,96,170
-30,-40,-150,50,46,96,179
140,70,100,45,51,96,148
-130,-60,140,45,51,96,163
10,10,-120,46,50,96,171
-160,80,40,46,51,97,199
10,70,-80,42,55,97,122
-160,20,100,52,45,97,157
90,80,160,44,53,97,192
-130,70,50,44,53,97,138
180,40,60,48,49,97,161
180,-40,40,48,49,97,144
40,70,-140,48,49,97,167
-100,-70,170,44,53,97,151
-180,40,60,48,49,97,161
-160,-80,70,46,51,97,172
-50,-50,-150,42,55,97,135
-40,-60,-160,47,50,97,152
-110,-70,120,46,51,97,127
-20,50,-50,39,58,97,132
-170,40,60,46,51,97,157
-80,-70,-160,47,50,97,183
-180,-40,40,48,49,97,144
-20,70,-100,44,53,97,181
-110,90,-10,47,51,98,192
-50,-60,-110,45,53,98,193
60,90,180,47,51,98,192
70,90,170,47,51,98,192
180,90,60,47,51,98,192
160,90,80,47,51,98,192
-140,90,20,47,51,98,192
-60,90,-60,47,51,98,192
170,10,50,49,49,98,112
130,90,110,47,51,98,192
60,90,-180,47,51,98,192
30,70,-140,50,48,98,193
150,90,90,47,51,98,192
-20,90,-100,47,51,98,192
80,90,160,47,51,98,192
-180,90,60,47,51,98,192
120,-80,0,48,50,98,122
170,50,70,50,48,98,146
-100,90,-20,47,51,98,192
160,30,100,53,45,98,164
140,90,100,47,51,98,192
-30,90,-90,47,51,98,192
-130,-50,110,46,52,98,193
0,50,-80,38,60,98,147
-50,90,-70,47,51,98,192
150,-30,60,48,50,98,130
120,90,120,47,51,98,192
-80,90,-40,47,51,98,192
170,90,70,47,51,98,192
-40,50,-50,48,50,98,139
30,-80,-90,45,53,98,131
50,90,-170,47,51,98,192
40,90,-160,47,51,98,192
-150,90,30,47,51,98,192
100,90,140,47,51,98,192
-10,90,-110,47,51,98,192
110,90,130,47,51,98,192
-170,-80,60,47,51,98,170
20,90,-140,47,51,98,192
-160,90,40,47,51,98,192
-130,90,10,47,51,98,192
-170,90,50,47,51,98,192
-120,90,0,47,51,98,192
-40,60,-80,44,54,98,179
10,10,-110,45,53,98,133
10,20,-100,42,56,98,138
0,90,-120,47,51,98,192
-70,90,-50,47,51,98,192
30,90,-150,47,51,98,192
-90,90,-30,47,51,98,192
0,10,-120,45,53,98,175
10,90,-130,47,51,98,192
-40,90,-80,47,51,98,192
90,90,150,47,51,98,192
-140,-80,90,46,52,98,156
-80,-80,150,46,52,98,143
-40,10,-90,51,48,99,147
-30,10,-60,49,50,99,142
-160,-80,130,43,56,99,179
-40,60,-40,47,52,99,157
180,70,60,49,50,99,170
-150,80,30,47,52,99,200
170,-20,100,47,52,99,163
180,30,120,51,48,99,145
-80,70,-10,38,61,99,147
10,10,-100,44,55,99,139
50,-80,-60,49,50,99,145
180,-50,120,49,50,99,183
10,20,-110,43,56,99,147
-170,80,90,45,54,99,168
-180,70,60,49,50,99,170
-140,80,70,49,50,99,163
-10,-50,-90,46,53,99,123
-10,60,-110,44,55,99,186
-120,70,40,48,51,99,149
-160,30,70,45,54,99,140
-180,30,120,51,48,99,145
-180,-50,120,49,50,99,183
-10,0,-120,52,47,99,193
-20,40,-110,49,51,100,198
-20,50,-110,49,51,100,202
70,80,-170,44,56,100,201
-170,30,60,48,52,100,170
150,70,80,53,47,100,180
100,-80,0,49,51,100,120
-150,-50,120,46,54,100,202
40,-80,-60,45,55,100,139
-150,70,80,47,53,100,157
-160,60,80,41,59,100,197
-110,-60,140,45,55,100,140
-20,-30,-140,52,48,100,176
150,-70,30,50,50,100,149
-10,-10,-120,50,50,100,186
10,60,-70,42,58,100,143
-120,-70,160,45,55,100,176
-150,-20,90,50,51,101,158
140,70,90,50,51,101,185
-40,30,-80,47,54,101,151
-40,-40,-150,52,49,101,184
-10,-20,-130,53,48,101,191
0,20,-120,47,54,101,183
-170,30,120,48,53,101,174
-150,-40,60,53,48,101,151
80,80,160,52,49,101,197
-160,60,70,40,61,101,196
-20,0,-70,55,46,101,143
-140,-80,150,46,55,101,178
-160,-20,120,45,56,101,196
-40,-80,-170,47,54,101,158
-90,70,-10,43,58,101,159
-150,-80,140,43,58,101,180
-10,10,-120,56,45,101,198
140,-60,40,53,48,101,148
-50,60,-40,57,44,101,164
160,60,90,50,51,101,173
-10,-60,-140,53,48,101,175
-120,70,30,48,53,101,139
-20,60,-110,49,52,101,203
-10,70,-110,47,54,101,195
-70,70,-10,42,59,101,136
140,-70,50,47,54,101,150
0,50,-60,44,58,102,145
-180,-70,50,53,49,102,166
180,-70,50,53,49,102,166
-90,-70,180,49,53,102,153
-40,80,-80,49,53,102,201
-110,70,10,49,53,102,186
160,70,70,54,48,102,178
-180,-20,110,53,49,102,165
-30,40,-100,48,54,102,195
-110,-60,120,50,52,102,147
-20,10,-60,54,48,102,136
50,80,-170,53,49,102,207
-30,10,-100,55,47,102,156
-90,-70,-180,49,53,102,153
-40,-60,-100,46,56,102,201
180,-20,110,53,49,102,165
30,80,-110,46,56,102,148
-140,-60,80,48,54,102,139
0,80,-120,49,53,102,203
-150,-80,80,49,53,102,169
-150,70,50,46,56,102,178
-160,40,70,50,52,102,146
-130,-60,90,50,52,102,152
-10,50,-50,50,52,102,128
170,-20,40,46,56,102,134
10,60,-120,47,55,102,196
-10,-20,-90,47,56,103,163
-160,-10,90,54,49,103,155
-20,20,-110,53,50,103,192
40,80,-160,54,49,103,213
-50,-40,-140,50,53,103,140
-170,-20,120,50,53,103,168
-70,80,-50,49,54,103,201
180,-50,40,48,55,103,155
-10,80,-110,51,52,103,200
-150,-20,80,54,49,103,131
30,80,-150,52,51,103,214
150,80,120,50,53,103,160
-30,-10,-120,57,46,103,163
60,80,-150,49,54,103,191
150,-70,80,51,52,103,157
-140,-70,150,46,57,103,188
-40,-30,-120,44,59,103,150
-160,0,80,52,51,103,149
-180,-50,40,48,55,103,155
170,-40,110,52,51,103,172
-160,50,80,51,52,103,200
-180,-80,50,49,55,104,179
20,-80,-70,48,56,104,144
160,80,70,54,50,104,195
0,0,-120,50,54,104,178
-30,-80,-160,47,57,104,165
150,-40,70,52,52,104,155
-20,0,-120,54,50,104,191
0,70,-60,46,58,104,163
180,-80,50,49,55,104,179
100,80,160,44,60,104,173
-60,-80,170,48,56,104,153
-150,-30,120,48,56,104,202
-70,-60,-140,52,52,104,228
-130,70,40,47,57,104,153
-50,80,-70,51,53,104,202
-30,50,-100,54,50,104,207
0,-50,-120,47,57,104,149
-30,-70,-160,50,54,104,180
160,-20,40,57,47,104,117
-30,-70,-100,50,54,104,167
-30,80,-90,50,54,104,207
170,-60,40,54,50,104,158
-140,70,40,49,55,104,179
-100,80,-20,49,55,104,210
10,80,-130,51,53,104,211
-120,70,20,51,54,105,176
-130,70,30,48,57,105,170
-180,20,50,49,56,105,143
160,-30,90,47,58,105,159
-60,80,-60,51,54,105,202
-50,-80,-180,49,56,105,151
70,80,170,56,49,105,196
-150,-20,100,51,54,105,180
-140,-40,80,54,51,105,121
0,30,-80,50,55,105,141
-130,-50,100,55,50,105,184
-110,-80,-180,45,60,105,187
-50,-80,180,49,56,105,151
-150,-60,130,47,58,105,208
180,20,50,49,56,105,143
-160,30,110,52,53,105,152
-30,60,-40,49,56,105,162
160,40,80,53,52,105,155
-110,-80,180,45,60,105,187
-20,80,-100,50,55,105,202
-20,-60,-150,56,49,105,174
-170,0,100,52,53,105,171
-10,-80,-90,53,52,105,125
-20,-60,-90,53,53,106,171
-170,10,110,54,52,106,175
-70,-60,-180,49,57,106,162
-30,-30,-140,55,51,106,177
-80,80,-40,51,55,106,204
0,50,-120,45,61,106,201
60,80,180,58,48,106,198
30,60,-120,47,59,106,188
-50,60,-70,47,59,106,202
-10,-30,-130,52,54,106,186
130,-70,20,50,56,106,166
160,70,100,47,59,106,176
-30,50,-50,45,61,106,143
160,60,100,56,50,106,157
-180,-30,120,52,54,106,190
180,-30,120,52,54,106,190
-70,-70,-140,51,55,106,221
-70,-60,180,49,57,106,162
160,10,60,56,50,106,155
40,70,-130,50,56,106,169
-40,-70,-170,48,58,106,180
-130,-70,90,49,57,106,157
-140,80,20,51,55,106,205
0,70,-120,51,55,106,220
-30,40,-50,54,52,106,154
-80,-60,-170,53,53,106,179
60,80,-180,58,48,106,198
180,80,100,45,62,107,183
90,80,150,56,51,107,205
-110,70,20,46,61,107,165
-180,80,100,45,62,107,183
-170,50,100,49,58,107,196
-30,-30,-90,53,54,107,178
-80,-80,-150,48,59,107,200
10,50,-110,50,57,107,186
-40,70,-90,50,57,107,213
-100,-80,-170,47,60,107,189
-160,-60,130,51,56,107,214
-140,-70,80,52,55,107,165
-110,80,-10,51,56,107,206
140,-60,30,57,50,107,158
-30,60,-100,53,54,107,216
10,0,-100,53,55,108,156
80,80,-180,47,61,108,206
-130,-80,160,49,59,108,179
-60,70,-60,51,57,108,192
20,70,-140,55,53,108,233
-10,-30,-140,52,56,108,192
170,-30,110,52,56,108,165
170,70,120,52,56,108,164
170,-70,40,55,53,108,189
20,80,-140,54,54,108,220
80,80,180,47,61,108,206
160,-20,80,48,60,108,179
-10,-10,-130,58,50,108,204
-90,80,-30,51,57,108,209
-90,70,0,42,66,108,151
-170,-80,120,48,60,108,178
0,-50,-130,56,52,108,194
-120,-80,170,46,62,108,179
-100,70,10,43,65,108,163
160,0,50,55,53,108,167
160,20,90,57,52,109,169
-70,-80,160,50,59,109,156
-160,60,90,44,65,109,217
160,50,100,53,56,109,170
160,60,110,54,55,109,186
10,30,-110,50,59,109,217
-50,70,-80,49,60,109,221
150,80,80,59,50,109,205
-30,0,-70,58,51,109,155
40,-80,-80,52,57,109,155
-20,-70,-150,54,55,109,175
150,70,100,48,61,109,168
0,10,-70,56,53,109,147
-20,30,-110,51,58,109,205
170,80,60,57,52,109,213
110,80,120,53,56,109,216
-100,-70,130,53,56,109,153
-90,-80,-160,48,61,109,195
-120,80,0,51,58,109,200
-170,20,120,57,52,109,178
0,-10,-120,52,57,109,206
170,0,100,50,59,109,159
-110,-60,150,48,61,109,186
-60,-50,-140,52,57,109,195
-180,50,110,49,61,110,194
0,50,-70,45,65,110,162
-70,-80,-140,48,62,110,195
-30,70,-100,52,58,110,215
10,70,-130,54,56,110,232
-110,70,30,55,55,110,169
-180,20,120,56,54,110,150
0,70,-130,55,55,110,236
-10,60,-120,52,58,110,205
130,-70,30,50,60,110,161
-10,40,-120,51,59,110,215
10,0,-90,53,57,110,166
10,80,-80,52,58,110,151
180,20,120,56,54,110,150
-30,20,-100,57,53,110,171
170,-50,110,55,55,110,162
180,50,110,49,61,110,194
90,-80,-20,55,55,110,146
-90,-70,-170,53,57,110,205
-170,-60,50,51,59,110,167
-160,10,90,51,59,110,182
-150,80,80,54,56,110,173
-150,-70,70,52,58,110,180
140,80,90,58,52,110,198
140,80,130,54,56,110,171
-100,70,0,48,62,110,182
-50,-50,-110,51,59,110,194
-180,-80,110,50,60,110,185
180,-80,110,50,60,110,185
-130,80,10,50,60,110,205
-20,70,-110,51,59,110,222
10,20,-90,49,61,110,147
-160,80,90,53,58,111,187
180,50,60,59,52,111,193
130,80,100,56,55,111,200
-10,20,-120,58,53,111,212
-150,70,40,53,58,111,198
-40,50,-90,53,58,111,223
-110,-70,170,48,63,111,205
110,-80,-10,56,55,111,140
0,-60,-130,57,54,111,194
-180,50,60,59,52,111,193
-120,-60,100,58,53,111,161
-120,70,10,54,57,111,204
20,60,-120,52,59,111,184
140,-60,50,53,58,111,156
170,70,60,59,52,111,194
180,-40,120,55,56,111,188
-180,-40,120,55,56,111,188
10,-60,-110,59,52,111,143
-50,-70,180,55,56,111,180
-50,-70,-180,55,56,111,180
-140,70,70,53,58,111,156
10,-60,-90,56,55,111,135
-150,-20,70,58,53,111,139
30,-90,-50,55,57,112,168
-70,-90,-150,55,57,112,168
-40,60,-90,53,59,112,221
-20,-90,-100,55,57,112,168
60,-90,-20,55,57,112,168
-160,-90,120,55,57,112,168
40,-90,-40,55,57,112,168
-10,50,-120,54,58,112,205
130,-90,50,55,57,112,168
-60,-90,-140,55,57,112,168
100,80,130,54,58,112,220
-60,-60,180,58,54,112,185
180,-90,100,55,57,112,168
20,-90,-60,55,57,112,168
-100,-90,180,55,57,112,168
-60,-60,-180,58,54,112,185
-110,-90,170,55,57,112,168
160,30,110,55,57,112,184
170,-90,90,55,57,112,168
-140,-90,140,55,57,112,168
140,-50,60,57,55,112,175
-40,-90,-120,55,57,112,168
120,-90,40,55,57,112,168
0,60,-120,49,63,112,219
-30,30,-100,53,59,112,212
-50,-60,-170,56,56,112,174
-180,-60,120,54,58,112,186
-170,60,60,50,62,112,178
-160,-40,130,54,58,112,220
-170,60,100,48,64,112,204
10,-90,-70,55,57,112,168
-120,-90,160,55,57,112,168
-130,-90,150,55,57,112,168
30,70,-110,47,65,112,165
0,-10,-80,60,52,112,179
-40,-30,-110,50,62,112,182
70,-90,-10,55,57,112,168
100,-90,20,55,57,112,168
-170,-90,110,55,57,112,168
50,-90,-30,55,57,112,168
90,-90,10,55,57,112,168
110,-90,30,55,57,112,168
-180,-90,100,55,57,112,168
-130,-70,160,50,62,112,210
-100,-90,-180,55,57,112,168
150,-90,70,55,57,112,168
180,-60,120,54,58,112,186
-90,-90,-170,55,57,112,168
-150,-90,130,55,57,112,168
-10,-90,-90,55,57,112,168
-50,-90,-130,55,57,112,168
80,-90,0,55,57,112,168
-80,-90,-160,55,57,112,168
170,-80,40,54,58,112,185
140,-90,60,55,57,112,168
160,-90,80,55,57,112,168
0,-90,-80,55,57,112,168
90,80,170,48,64,112,196
-30,-90,-110,55,57,112,168
160,10,80,53,60,113,156
-100,70,20,51,62,113,160
-10,-40,-90,55,58,113,154
-120,-60,150,52,61,113,174
-60,-60,-120,51,62,113,218
-10,70,-120,55,58,113,216
20,60,-90,43,70,113,166
-40,20,-90,58,55,113,160
-130,70,20,54,59,113,196
10,20,-130,55,58,113,236
-170,50,60,56,57,113,199
30,70,-150,57,56,113,242
-30,-60,-160,60,53,113,197
170,50,110,52,61,113,239
-60,70,-10,50,63,113,153
80,80,150,58,55,113,221
160,40,100,53,60,113,195
-160,-50,50,52,62,114,173
160,-90,30,55,59,114,163
170,-10,100,55,59,114,219
20,-90,-110,55,59,114,163
30,-90,-100,55,59,114,163
-160,-90,70,55,59,114,163
10,-90,-120,55,59,114,163
-130,-90,100,55,59,114,163
-10,-70,-140,53,61,114,174
-20,60,-40,59,55,114,172
-160,10,50,50,64,114,166
-170,20,50,54,60,114,195
40,-90,-90,55,59,114,163
-10,-90,-140,55,59,114,163
-120,-90,110,55,59,114,163
150,-90,20,55,59,114,163
180,-90,50,55,59,114,163
-50,-90,180,55,59,114,163
-20,-10,-70,58,56,114,158
80,-90,-50,55,59,114,163
0,-10,-90,53,61,114,227
-50,-90,-180,55,59,114,163
160,20,60,55,59,114,165
-30,-90,-160,55,59,114,163
-50,-40,-130,58,56,114,163
-10,10,-60,59,55,114,170
70,-90,-60,55,59,114,163
140,-90,10,55,59,114,163
0,-90,-130,55,59,114,163
-80,-90,150,55,59,114,163
-160,50,70,54,60,114,224
-140,-60,140,50,64,114,231
90,-90,-40,55,59,114,163
-100,-90,130,55,59,114,163
60,-90,-70,55,59,114,163
-60,-90,170,55,59,114,163
-30,80,-30,52,62,114,188
170,-90,40,55,59,114,163
120,80,110,55,59,114,210
-40,80,-20,50,64,114,188
-150,-90,80,55,59,114,163
-140,-90,90,55,59,114,163
-70,-90,160,55,59,114,163
110,-90,-20,55,59,114,163
-90,-90,140,55,59,114,163
10,10,-130,57,57,114,238
150,-60,30,65,49,114,173
-110,-90,120,55,59,114,163
-170,-90,60,55,59,114,163
-40,-90,-170,55,59,114,163
40,70,-150,55,59,114,206
130,-90,0,55,59,114,163
120,-90,-10,55,59,114,163
-180,-90,50,55,59,114,163
100,-90,-30,55,59,114,163
-20,-90,-150,55,59,114,163
50,-90,-80,55,59,114,163
-180,-20,40,55,60,115,169
-10,20,-60,57,58,115,153
140,-50,50,55,60,115,178
180,-20,40,55,60,115,169
-20,-40,-150,58,57,115,196
130,80,140,56,59,115,182
130,70,110,51,64,115,180
-170,70,50,57,58,115,194
50,80,-180,59,56,115,232
60,-80,-50,60,55,115,167
-30,50,-110,53,62,115,252
110,-80,20,57,58,115,133
160,40,110,56,59,115,193
-90,70,10,44,71,115,160
10,20,-120,51,64,115,203
160,-40,100,60,55,115,178
50,80,180,59,56,115,232
30,80,-160,58,57,115,240
-40,-50,-160,59,56,115,194
140,70,110,55,60,115,174
160,30,90,60,55,115,170
-40,40,-80,51,64,115,200
0,-50,-90,61,54,115,157
-80,-60,-160,58,58,116,226
-30,20,-50,60,56,116,139
180,80,50,60,56,116,222
-10,30,-120,58,58,116,219
-40,10,-60,54,62,116,141
160,0,80,54,62,116,175
-150,30,90,56,60,116,188
10,70,-140,59,57,116,246
-180,80,50,60,56,116,222
-80,70,0,44,72,116,156
-20,80,-40,53,63,116,194
-20,30,-50,57,59,116,140
-50,80,-10,52,64,116,197
20,80,-150,58,58,116,239
20,70,-90,48,69,117,160
-140,-50,120,55,62,117,244
-60,-80,-130,51,66,117,193
40,80,-170,61,56,117,239
160,70,110,53,64,117,206
-160,-30,130,58,59,117,224
150,-40,80,58,59,117,196
0,60,-130,58,59,117,228
-140,70,30,56,61,117,204
-60,-70,170,60,57,117,183
-10,30,-60,57,60,117,152
-70,-70,160,61,56,117,184
-40,70,-20,59,58,117,161
0,-40,-110,61,56,117,172
-100,-60,140,53,64,117,192
10,60,-130,55,62,117,234
-40,-30,-130,53,64,117,190
-120,-70,100,53,64,117,165
-40,90,-30,56,62,118,221
10,30,-100,50,68,118,217
-110,90,40,56,62,118,221
160,10,50,61,57,118,182
180,90,110,56,62,118,221
-10,90,-60,56,62,118,221
-80,90,10,56,62,118,221
120,90,170,56,62,118,221
160,40,90,57,61,118,172
60,90,-130,56,62,118,221
100,90,-170,56,62,118,221
-50,20,-80,58,60,118,174
-60,80,0,52,66,118,208
-60,90,-10,56,62,118,221
160,90,130,56,62,118,221
-20,90,-50,56,62,118,221
-150,-30,60,61,57,118,192
10,90,-80,56,62,118,221
90,80,140,58,60,118,226
40,90,-110,56,62,118,221
130,90,160,56,62,118,221
-100,90,30,56,62,118,221
-20,40,-50,60,58,118,151
-180,90,110,56,62,118,221
90,90,-160,56,62,118,221
20,90,-90,56,62,118,221
0,-50,-140,64,54,118,223
-120,90,50,56,62,118,221
-150,90,80,56,62,118,221
110,90,-180,56,62,118,221
-160,90,90,56,62,118,221
170,20,50,55,63,118,127
170,30,120,54,64,118,164
-30,90,-40,56,62,118,221
50,90,-120,56,62,118,221
10,0,-110,57,61,118,180
-70,80,10,54,64,118,215
-90,90,20,56,62,118,221
-70,90,0,56,62,118,221
-170,90,100,56,62,118,221
0,90,-70,56,62,118,221
140,90,150,56,62,118,221
110,90,180,56,62,118,221
80,90,-150,56,62,118,221
10,10,-90,57,61,118,156
170,80,110,51,67,118,213
-40,0,-90,61,57,118,155
-130,90,60,56,62,118,221
0,50,-130,59,59,118,223
-20,-80,-150,58,60,118,178
170,90,120,56,62,118,221
-80,80,20,56,62,118,216
-140,90,70,56,62,118,221
-50,90,-20,56,62,118,221
150,90,140,56,62,118,221
-160,-40,50,54,64,118,186
-140,-40,120,55,63,118,232
50,70,-150,60,58,118,193
30,90,-100,56,62,118,221
70,90,-140,56,62,118,221
-30,-10,-70,60,59,119,196
150,-20,50,53,66,119,165
-170,80,100,54,65,119,207
-90,70,-20,55,64,119,186
50,-80,-70,59,60,119,175
130,-80,50,60,59,119,157
140,-70,60,54,65,119,175
70,80,160,62,57,119,232
180,80,110,53,66,119,230
50,-80,-50,57,62,119,180
-50,-80,-120,51,68,119,187
-160,-30,50,54,65,119,193
10,80,-140,59,60,119,243
-20,-20,-140,62,57,119,206
10,-70,-80,56,63,119,163
-30,-20,-130,60,59,119,193
0,-20,-120,60,59,119,217
-180,80,110,53,66,119,230
0,-40,-120,58,61,119,212
60,80,170,63,57,120,230
-10,-30,-90,66,54,120,174
-170,40,120,59,61,120,198
40,70,-160,61,59,120,240
0,80,-130,59,61,120,236
170,60,70,64,56,120,198
-10,0,-130,58,62,120,231
140,-70,20,57,63,120,167
-160,50,90,58,62,120,212
-10,-20,-140,64,56,120,199
-10,-80,-140,59,61,120,184
170,10,110,56,64,120,159
130,70,100,58,62,120,208
-30,30,-50,57,63,120,171
30,60,-110,51,69,120,181
-40,0,-80,56,64,120,158
-160,20,60,59,61,120,185
-160,20,110,59,61,120,199
0,40,-130,57,63,120,233
0,-10,-130,62,58,120,215
0,-10,-110,57,63,120,210
0,30,-120,55,65,120,209
170,-70,110,57,63,120,197
0,-70,-130,59,61,120,196
170,-60,110,59,62,121,186
160,40,120,56,65,121,190
170,-80,100,53,68,121,197
-100,-70,-180,50,71,121,216
20,-70,-100,58,63,121,167
20,-70,-90,55,66,121,160
-50,60,-80,58,63,121,256
140,-50,40,60,61,121,189
-100,-70,180,50,71,121,216
150,-30,70,57,64,121,166
160,70,120,54,67,121,200
-30,-50,-160,58,63,121,215
-140,80,80,58,63,121,184
150,-60,80,56,65,121,170
-170,-10,110,59,62,121,203
180,-10,40,56,65,121,178
10,20,-140,60,61,121,264
-180,-10,40,56,65,121,178
-140,-50,70,60,61,121,153
0,40,-120,51,70,121,212
-130,-60,150,52,69,121,231
20,60,-130,58,63,121,245
150,-20,40,59,62,121,161
0,30,-130,59,62,121,229
70,80,-160,55,66,121,219
-170,-40,130,60,62,122,226
-90,-70,140,58,64,122,168
0,20,-130,60,62,122,241
-70,70,-50,56,66,122,209
-80,-60,-180,56,66,122,177
-160,40,60,65,57,122,215
130,-70,40,59,63,122,186
160,40,70,60,62,122,181
80,-80,-30,58,64,122,175
-130,70,60,59,63,122,173
0,-10,-100,55,67,122,245
150,70,110,55,67,122,218
160,80,120,51,71,122,233
-80,-60,180,56,66,122,177
-10,70,-130,61,61,122,233
-150,-20,110,58,64,122,223
30,-80,-60,55,67,122,180
-160,80,100,59,63,122,189
-50,50,-60,59,64,123,196
-80,-70,-150,60,63,123,257
150,70,70,64,59,123,236
-60,70,-70,56,67,123,245
-60,80,-70,59,64,123,238
160,-50,100,63,60,123,171
-70,70,0,57,66,123,196
-100,-60,150,58,65,123,201
0,-40,-100,65,58,123,185
-160,-50,130,58,65,123,243
-20,-10,-130,66,57,123,220
-10,-10,-70,69,54,123,162
-170,-30,40,56,67,123,210
-150,30,80,57,66,123,201
160,20,100,56,67,123,189
0,20,-70,59,64,123,170
-50,80,-80,59,64,123,235
160,30,60,53,70,123,205
10,50,-100,55,68,123,210
-40,70,-100,61,62,123,230
0,0,-130,66,58,124,232
40,80,-120,56,68,124,201
-30,70,-110,62,62,124,229
180,-10,110,61,63,124,218
0,0,-70,68,56,124,159
-50,50,-80,62,62,124,245
140,-40,40,63,61,124,188
-180,60,60,65,59,124,203
-20,80,-110,60,64,124,234
-40,80,-90,59,65,124,235
180,60,60,65,59,124,203
10,50,-120,53,71,124,214
-170,-40,40,56,68,124,206
70,-80,-40,62,62,124,182
20,80,-90,55,69,124,189
-40,-80,-110,53,71,124,193
-150,60,70,53,71,124,258
0,-20,-110,64,60,124,230
-140,-60,70,63,61,124,164
-180,-10,110,61,63,124,218
100,-80,-20,61,63,124,158
160,-70,30,65,60,125,203
-30,80,-100,60,65,125,238
180,70,50,64,61,125,215
10,30,-120,56,69,125,229
-180,0,40,60,65,125,185
-10,40,-50,63,62,125,168
-20,-70,-90,61,64,125,196
-30,-60,-90,61,64,125,240
-160,-10,100,63,62,125,220
-30,10,-110,66,59,125,207
120,-70,20,61,64,125,187
-180,-20,120,64,61,125,194
180,0,40,60,65,125,185
0,10,-130,62,63,125,245
-180,70,50,64,61,125,215
180,-20,120,64,61,125,194
-70,80,-60,59,66,125,242
-10,-40,-150,60,65,125,228
160,60,80,62,63,125,212
0,-40,-130,62,63,125,244
120,70,120,55,70,125,206
-20,80,-120,66,60,126,229
-170,30,50,57,69,126,226
-30,-10,-130,65,61,126,239
170,-10,40,60,66,126,185
-160,0,90,63,63,126,222
90,-80,-10,62,64,126,172
-40,50,-100,61,65,126,276
-110,-70,110,58,68,126,187
60,-80,-40,62,64,126,191
-130,-50,120,62,64,126,241
140,70,80,64,62,126,236
-120,-50,120,56,70,126,220
-150,80,90,62,64,126,186
-160,40,110,62,64,126,188
-160,-70,60,59,67,126,201
-80,-60,170,59,67,126,207
-30,60,-110,61,65,126,260
-120,90,-10,61,66,127,242
10,60,-140,65,62,127,257
-10,80,-130,66,61,127,230
50,90,180,61,66,127,242
140,90,90,61,66,127,242
-90,90,-40,61,66,127,242
-10,80,-120,62,65,127,242
-80,90,-50,61,66,127,242
70,90,160,61,66,127,242
0,90,-130,61,66,127,242
150,90,80,61,66,127,242
160,-80,30,60,67,127,205
-40,90,-90,61,66,127,242
50,90,-180,61,66,127,242
-140,90,10,61,66,127,242
-20,90,-110,61,66,127,242
60,90,170,61,66,127,242
150,-50,30,67,60,127,192
-10,90,-120,61,66,127,242
120,90,110,61,66,127,242
30,90,-160,61,66,127,242
-130,90,0,61,66,127,242
130,90,100,61,66,127,242
-30,40,-110,63,64,127,278
-30,90,-100,61,66,127,242
110,90,120,61,66,127,242
160,30,70,57,70,127,169
-110,70,0,62,65,127,219
-150,90,20,61,66,127,242
100,90,130,61,66,127,242
-20,-30,-150,62,65,127,225
0,70,-140,65,62,127,229
-100,90,-30,61,66,127,242
-110,90,-20,61,66,127,242
40,90,-170,61,66,127,242
-60,90,-70,61,66,127,242
-170,80,40,63,64,127,236
10,90,-140,61,66,127,242
160,90,70,61,66,127,242
90,80,-180,63,64,127,218
-170,90,40,61,66,127,242
20,-70,-80,56,71,127,168
-50,70,-90,60,67,127,236
-170,-50,130,60,67,127,244
80,90,150,61,66,127,242
-160,60,60,54,73,127,212
-180,30,50,63,64,127,177
-170,80,110,60,67,127,196
-160,0,50,59,68,127,186
180,30,50,63,64,127,177
-60,-50,-130,56,71,127,228
-160,90,30,61,66,127,242
-170,0,110,63,64,127,234
-180,90,50,61,66,127,242
-70,90,-60,61,66,127,242
90,90,140,61,66,127,242
20,90,-150,61,66,127,242
90,80,180,63,64,127,218
170,90,60,61,66,127,242
-50,90,-80,61,66,127,242
180,90,50,61,66,127,242
10,-50,-100,70,58,128,214
-140,-30,120,61,67,128,267
-80,80,-50,61,67,128,246
170,80,120,56,72,128,246
-10,-50,-150,69,59,128,233
160,-10,40,65,63,128,178
-180,-70,120,60,68,128,215
-30,80,-110,68,60,128,237
20,70,-150,64,64,128,262
180,-70,120,60,68,128,215
10,40,-120,58,70,128,240
160,30,80,62,66,128,173
120,80,150,60,68,128,208
80,80,-170,61,67,128,226
-20,0,-60,66,62,128,218
170,40,60,65,64,129,188
140,-70,70,68,61,129,225
30,60,-130,55,74,129,221
-20,20,-50,65,64,129,161
-90,80,-40,62,67,129,248
160,-80,90,59,70,129,211
-40,40,-90,61,68,129,253
-40,-20,-100,67,62,129,221
-170,-50,40,61,68,129,219
-160,70,40,67,62,129,234
-10,10,-130,65,64,129,269
-40,60,-100,59,70,129,269
-20,70,-120,64,65,129,240
-150,-40,130,56,73,129,256
-130,80,70,62,67,129,193
-100,70,-10,61,69,130,208
-20,40,-120,66,64,130,283
0,80,-140,68,62,130,240
140,-60,60,60,70,130,196
60,-80,-60,63,67,130,191
30,70,-160,66,64,130,276
0,-80,-130,64,66,130,199
-140,-30,110,62,68,130,222
10,30,-140,65,65,130,266
-40,-60,-170,66,64,130,223
70,-80,-50,64,66,130,187
160,-60,100,64,66,130,203
-60,60,-40,65,65,130,215
170,-30,30,68,62,130,190
-120,-70,170,56,74,130,250
0,30,-140,65,65,130,276
0,-40,-140,69,61,130,226
-160,80,30,64,66,130,248
-170,50,110,65,66,131,223
-20,60,-120,66,65,131,251
180,0,110,64,67,131,205
40,70,-170,66,65,131,275
-80,70,-40,56,75,131,218
10,40,-110,63,68,131,228
160,-70,100,61,70,131,198
-110,80,-20,62,69,131,252
10,70,-70,56,75,131,218
70,-80,-30,68,63,131,208
20,60,-140,66,65,131,277
-180,0,110,64,67,131,205
-130,-50,90,64,67,131,213
-50,50,-70,62,69,131,219
-30,0,-120,69,62,131,234
0,40,-80,61,70,131,193
-140,-30,100,61,70,131,202
-40,20,-50,71,60,131,174
0,-60,-140,69,62,131,282
-80,80,-60,66,65,131,255
-60,80,-80,66,65,131,247
-20,10,-120,69,63,132,243
40,70,-120,59,73,132,204
-50,80,-90,68,64,132,245
-140,80,10,64,68,132,252
180,10,120,64,68,132,202
-70,80,-70,66,66,132,251
-80,-70,150,67,65,132,187
-10,80,-50,62,70,132,208
170,50,60,70,62,132,214
-10,60,-130,67,65,132,265
-180,10,120,64,68,132,202
10,0,-120,59,73,132,216
-50,-50,-160,65,67,132,215
90,-80,-30,65,67,132,173
50,70,-140,67,65,132,224
160,-40,30,69,63,132,176
-150,60,60,55,77,132,275
-120,80,-10,61,72,133,248
120,-70,10,61,72,133,203
-40,80,-100,68,65,133,241
160,50,70,71,62,133,223
-140,-30,90,59,74,133,214
-100,-60,160,60,73,133,244
-30,-80,-100,59,74,133,205
-140,-40,70,64,69,133,210
180,60,50,68,65,133,240
-100,80,-30,64,69,133,248
-140,-50,130,62,71,133,318
-150,-60,60,63,70,133,196
-130,80,0,63,70,133,240
-40,-30,-100,60,73,133,248
-170,-70,130,61,72,133,243
50,70,-160,68,65,133,218
-180,60,50,68,65,133,240
-150,80,20,66,67,133,258
-50,30,-70,60,73,133,229
-40,30,-90,64,69,133,230
10,50,-130,64,69,133,251
-90,-60,170,58,75,133,224
-40,-10,-90,61,73,134,204
0,-30,-120,66,68,134,281
-50,-70,-110,65,69,134,249
30,60,-140,64,70,134,271
150,-10,50,66,68,134,195
-10,-30,-150,68,66,134,228
80,-80,-40,66,68,134,192
-120,-60,160,58,76,134,249
0,50,-50,65,69,134,177
10,30,-130,63,71,134,265
0,-20,-130,67,67,134,233
170,0,40,67,67,134,195
-160,30,60,59,75,134,216
10,50,-90,59,76,135,210
-130,-50,130,64,71,135,288
130,-70,50,66,69,135,229
-60,-50,-150,60,75,135,203
160,-50,30,75,60,135,199
0,-80,-80,67,68,135,168
160,10,90,60,75,135,198
150,-80,20,63,72,135,212
170,-40,30,67,68,135,179
-180,80,120,64,71,135,214
140,-40,50,70,65,135,202
-50,20,-60,72,63,135,150
-50,60,-90,64,71,135,269
-170,40,50,68,67,135,240
0,-10,-140,74,61,135,258
-70,-60,170,70,65,135,233
-60,70,-80,63,72,135,257
10,-70,-120,67,68,135,201
150,70,120,60,75,135,256
150,80,70,74,61,135,242
180,80,120,64,71,135,214
-150,-30,130,58,77,135,257
50,70,-170,67,69,136,247
10,80,-150,72,64,136,256
80,-80,-20,68,68,136,200
0,-30,-130,67,69,136,272
-150,-10,90,72,64,136,250
60,70,-160,68,68,136,241
-40,0,-100,72,64,136,199
180,60,110,64,72,136,226
-10,0,-60,69,67,136,212
-30,30,-110,64,72,136,290
50,80,-130,62,74,136,236
-180,60,110,64,72,136,226
-120,80,60,67,69,136,206
-180,40,50,66,70,136,224
0,60,-140,71,65,136,264
-90,-60,160,64,72,136,221
-70,70,-60,60,76,136,276
-60,60,-50,65,71,136,204
180,40,50,66,70,136,224
-170,-60,130,66,70,136,259
150,-80,80,64,72,136,227
-30,-20,-140,69,67,136,249
160,80,130,58,78,136,269
150,80,130,58,78,136,267
-90,80,30,66,71,137,229
-150,20,80,69,68,137,191
-170,-30,130,68,69,137,226
-130,-60,80,69,68,137,180
170,80,50,73,64,137,257
-90,80,-50,67,70,137,260
-150,-50,130,61,76,137,286
-20,-20,-80,63,74,137,215
40,80,180,74,63,137,253
40,80,-180,74,63,137,253
-20,20,-120,68,69,137,275
160,80,60,74,63,137,250
160,-10,80,66,71,137,201
-80,70,10,65,72,137,217
160,-20,90,60,77,137,229
-170,70,110,64,74,138,209
170,50,120,67,71,138,234
-160,-20,130,69,69,138,232
-120,70,50,68,70,138,209
-40,40,-50,65,73,138,224
-40,-10,-100,71,67,138,190
20,80,-160,72,66,138,257
-170,60,50,61,77,138,231
-70,-60,-130,62,76,138,280
160,50,110,66,72,138,276
-150,70,90,68,70,138,223
-10,40,-130,68,70,138,285
-120,-50,130,65,73,138,249
140,-50,30,73,65,138,205
-40,-70,-100,68,70,138,259
-60,-70,-120,66,72,138,259
-20,50,-120,69,69,138,274
-20,80,-130,73,66,139,250
-130,-80,90,69,70,139,229
-160,-10,50,69,70,139,198
170,60,60,74,65,139,241
150,-20,60,62,77,139,240
-30,10,-50,75,64,139,218
-10,-60,-150,74,65,139,251
-90,-60,180,64,75,139,271
100,-80,10,68,71,139,185
-150,60,80,60,79,139,274
-40,80,-110,71,68,139,259
-20,30,-120,65,74,139,291
150,70,130,63,76,139,245
-170,-70,50,69,70,139,223
-90,-60,-180,64,75,139,271
-160,70,100,67,72,139,213
-150,-20,120,61,78,139,254
30,80,-170,74,65,139,251
-160,50,60,64,75,139,270
100,80,170,72,67,139,226
-150,-60,140,61,78,139,269
130,-70,10,68,71,139,205
-150,30,100,69,70,139,227
-160,10,100,66,73,139,255
-130,-70,170,63,76,139,320
10,-80,-120,69,71,140,210
50,80,170,76,64,140,257
-30,-30,-150,69,71,140,234
-150,70,30,68,72,140,260
0,10,-140,69,71,140,326
-50,70,-100,66,74,140,281
-120,-50,110,65,75,140,247
0,-70,-80,73,67,140,205
10,70,-150,74,66,140,240
-120,-80,100,69,71,140,227
0,40,-140,71,69,140,291
-110,-80,110,67,73,140,227
-160,-10,110,68,72,140,264
0,20,-140,69,71,140,303
10,50,-140,73,67,140,267
40,90,-180,72,69,141,260
-120,90,-20,72,69,141,260
-180,90,40,72,69,141,260
-160,90,20,72,69,141,260
-140,-70,160,63,78,141,300
120,90,100,72,69,141,260
110,90,110,72,69,141,260
-100,90,-40,72,69,141,260
10,-60,-120,72,69,141,234
90,90,130,72,69,141,260
-110,-60,160,63,78,141,242
160,90,60,72,69,141,260
30,90,-170,72,69,141,260
-70,90,-70,72,69,141,260
10,90,-150,72,69,141,260
-90,90,-50,72,69,141,260
150,90,70,72,69,141,260
-80,90,-60,72,69,141,260
60,90,160,72,69,141,260
-140,90,0,72,69,141,260
-130,90,-10,72,69,141,260
50,90,170,72,69,141,260
-10,-10,-140,74,67,141,250
-10,90,-130,72,69,141,260
0,-20,-140,72,69,141,257
70,90,150,72,69,141,260
-170,90,30,72,69,141,260
80,90,140,72,69,141,260
40,90,180,72,69,141,260
140,90,80,72,69,141,260
160,70,130,69,72,141,238
0,-30,-140,75,66,141,264
0,90,-140,72,69,141,260
-60,90,-80,72,69,141,260
-30,90,-110,72,69,141,260
-110,90,-30,72,69,141,260
-150,90,10,72,69,141,260
-40,90,-100,72,69,141,260
-100,-80,120,66,75,141,229
180,90,40,72,69,141,260
-90,-70,-160,63,78,141,299
170,90,50,72,69,141,260
-90,-80,130,69,72,141,232
-160,-20,50,69,72,141,209
130,90,90,72,69,141,260
100,90,120,72,69,141,260
20,90,-160,72,69,141,260
-50,90,-90,72,69,141,260
150,-10,60,76,65,141,231
-20,90,-120,72,69,141,260
0,70,-150,75,67,142,264
-170,50,50,70,72,142,254
30,60,-100,58,84,142,225
-40,10,-100,72,70,142,243
-20,-60,-160,71,71,142,242
140,70,120,64,78,142,254
10,50,-80,57,85,142,211
-50,-60,-180,74,68,142,237
-150,40,80,68,74,142,244
-30,80,-120,75,67,142,272
-140,-80,80,71,71,142,248
-50,-60,180,74,68,142,237
-20,10,-50,73,69,142,209
-170,10,120,71,71,142,218
110,80,160,68,74,142,219
110,80,110,71,71,142,265
-20,-50,-160,73,69,142,254
-80,-60,-150,69,73,142,287
30,80,-100,63,79,142,224
30,-70,-80,66,77,143,235
-90,-60,-170,70,73,143,315
-80,-80,140,69,74,143,248
20,60,-150,74,69,143,283
-110,-60,110,71,72,143,207
150,-40,30,74,69,143,202
0,0,-140,73,70,143,308
180,50,120,67,76,143,222
-10,-20,-80,64,79,143,270
-10,60,-40,69,74,143,224
-10,30,-130,70,73,143,306
0,-20,-100,67,76,143,293
-180,50,120,67,76,143,222
-50,-40,-150,75,68,143,215
-40,-30,-140,69,74,143,243
-170,70,40,72,71,143,266
10,20,-150,71,73,144,307
30,60,-150,71,73,144,310
-50,50,-50,75,69,144,217
120,80,100,72,72,144,262
160,60,70,78,66,144,252
10,-10,-110,66,78,144,289
170,80,130,62,82,144,228
-150,-10,80,74,70,144,236
-160,60,50,66,78,144,251
-30,60,-120,72,72,144,288
20,70,-160,75,69,144,259
10,10,-140,73,71,144,304
-170,-20,130,73,71,144,229
160,-30,30,72,72,144,205
40,60,-130,62,82,144,250
0,60,-50,67,77,144,210
0,-30,-110,77,67,144,272
-110,-70,-180,64,80,144,311
-30,20,-110,71,73,144,249
-110,-70,180,64,80,144,311
60,80,160,77,68,145,263
140,-80,10,68,77,145,217
-60,70,-90,68,77,145,288
10,40,-130,63,82,145,287
-50,50,-90,69,76,145,311
-110,80,50,74,71,145,223
160,0,40,75,70,145,236
130,80,90,75,70,145,261
-20,-10,-140,77,68,145,262
10,-10,-130,73,72,145,279
140,80,140,64,81,145,287
-40,20,-100,69,76,145,236
20,-80,-110,72,73,145,216
-160,0,100,71,74,145,299
-180,-60,40,72,74,146,221
120,-70,30,68,78,146,237
-30,0,-60,81,65,146,246
20,60,-80,63,83,146,222
0,50,-140,74,72,146,294
-90,70,-30,65,81,146,247
160,-30,100,68,78,146,233
-180,30,130,71,75,146,232
180,-50,130,73,73,146,286
-40,-20,-90,73,73,146,254
-40,-40,-90,69,77,146,252
-150,-10,100,76,70,146,279
-10,30,-50,74,72,146,210
160,-60,30,78,68,146,217
-170,20,130,71,75,146,242
120,70,110,65,81,146,247
-20,0,-130,75,71,146,270
180,-60,40,72,74,146,221
140,80,80,80,66,146,254
-180,-50,130,73,73,146,286
-100,-70,120,69,77,146,226
40,60,-140,64,82,146,247
-100,-60,170,66,80,146,274
0,80,-60,69,77,146,237
160,40,60,69,77,146,247
180,30,130,71,75,146,232
-50,-60,-100,69,77,146,265
-100,80,-40,73,73,146,260
-70,-70,-130,71,76,147,302
130,70,120,66,81,147,217
-20,50,-40,71,76,147,231
-160,-70,140,67,80,147,287
-140,70,20,72,75,147,260
160,60,120,67,80,147,279
10,40,-100,72,75,147,260
-180,50,50,73,74,147,254
10,10,-80,79,68,147,210
180,50,50,73,74,147,254
-150,-70,150,69,79,148,295
-10,70,-140,75,73,148,267
-170,-10,40,67,81,148,251
10,-80,-70,74,74,148,213
-10,50,-130,73,75,148,288
-140,60,50,63,85,148,305
160,70,60,83,65,148,263
-170,0,40,68,80,148,226
60,70,-170,75,73,148,242
-160,50,100,74,74,148,254
-50,80,-100,74,74,148,271
170,30,50,72,76,148,205
10,-10,-100,68,80,148,285
-170,-10,120,76,72,148,228
-30,70,-120,73,75,148,288
-10,20,-130,71,77,148,311
-10,70,-40,70,78,148,218
150,-30,30,73,75,148,222
170,-20,110,69,79,148,225
-70,70,-70,69,80,149,278
50,70,-180,74,75,149,283
150,-10,40,78,71,149,236
-80,-70,-140,69,80,149,330
-100,-70,-170,63,86,149,307
150,-70,20,77,72,149,232
-40,-20,-110,76,73,149,239
10,-50,-130,78,71,149,282
50,70,180,74,75,149,283
-100,80,40,76,74,150,235
-20,-10,-60,78,72,150,255
0,80,-150,76,74,150,248
-180,80,40,80,70,150,275
-40,-70,180,75,75,150,264
0,40,-70,69,81,150,248
0,40,-60,69,81,150,255
10,-60,-130,84,66,150,289
-80,70,-50,67,83,150,290
-30,-60,-170,70,80,150,257
-90,70,20,70,80,150,216
10,50,-70,61,89,150,216
-140,-30,80,69,81,150,226
-160,30,120,73,77,150,242
140,-50,70,70,80,150,207
10,-10,-120,64,86,150,251
-10,80,-140,76,74,150,243
180,80,40,80,70,150,275
-140,70,80,74,76,150,233
-40,-70,-180,75,75,150,264
150,-50,90,75,75,150,202
-10,-70,-150,72,78,150,267
10,0,-140,79,71,150,333
150,60,90,73,77,150,280
-60,60,-80,71,80,151,296
150,80,140,65,86,151,297
10,0,-80,72,79,151,225
10,0,-130,73,78,151,294
-40,70,-110,73,78,151,284
170,-40,120,73,78,151,241
-180,-10,120,77,74,151,262
-140,-60,150,66,85,151,303
0,10,-60,74,77,151,242
-150,40,90,76,75,151,238
10,-10,-140,83,68,151,324
-20,60,-130,77,74,151,290
180,-10,120,77,74,151,262
-10,60,-140,80,71,151,287
150,50,90,75,76,151,258
-50,30,-60,64,87,151,248
-150,-80,70,73,78,151,257
160,20,50,72,79,151,236
-50,20,-90,69,82,151,247
-40,30,-100,67,84,151,291
170,70,50,84,67,151,266
-60,80,-90,76,75,151,275
140,-60,20,79,72,151,239
-150,80,10,81,70,151,285
-130,-40,120,69,82,151,321
-30,-40,-160,77,74,151,252
-160,20,120,74,77,151,266
130,70,90,73,78,151,266
-160,80,20,80,71,151,286
30,-80,-100,72,79,151,234
-50,-70,170,73,78,151,260
170,-50,120,73,79,152,243
-50,70,-10,78,74,152,208
-80,-60,160,73,79,152,274
150,-70,90,79,73,152,246
-20,70,-130,78,74,152,280
-30,-20,-80,80,72,152,254
-100,-60,130,74,78,152,240
-40,40,-100,71,81,152,315
30,70,-170,79,73,152,286
-180,-40,130,76,76,152,253
180,-40,30,76,76,152,248
-180,-40,30,76,76,152,248
-60,-50,-160,68,84,152,229
-130,70,10,74,78,152,262
180,-40,130,76,76,152,253
-50,40,-70,72,80,152,284
170,40,130,78,74,152,193
-30,-70,-170,76,76,152,261
-160,10,110,77,75,152,293
170,-50,30,76,76,152,208
70,80,150,79,73,152,274
60,70,-150,72,80,152,295
10,30,-150,76,76,152,299
10,-50,-110,78,74,152,257
-170,-20,40,72,81,153,264
10,40,-140,77,76,153,308
110,70,130,74,79,153,267
-40,60,-110,75,78,153,308
-40,-50,-90,70,83,153,249
-170,80,30,83,70,153,296
-130,-80,170,70,83,153,285
-60,60,-70,73,80,153,297
-10,-20,-150,76,77,153,264
-110,80,-30,80,73,153,273
-40,-60,-90,73,80,153,276
20,-60,-90,75,78,153,224
-10,0,-140,83,70,153,296
170,40,50,77,76,153,240
120,-80,40,73,80,153,206
-110,-60,170,67,86,153,311
10,80,-160,80,73,153,262
100,80,120,78,75,153,277
130,-60,30,73,80,153,225
-140,-40,130,69,84,153,324
60,80,-140,70,83,153,265
-70,80,-80,77,77,154,277
0,-50,-150,80,74,154,290
40,60,-150,69,85,154,283
150,60,100,75,79,154,298
0,-70,-140,79,75,154,278
-160,70,30,79,75,154,297
-150,50,70,72,82,154,281
0,30,-150,81,73,154,324
-150,50,80,79,75,154,287
-60,60,-60,74,80,154,255
-50,60,-100,75,79,154,317
-60,-60,170,78,76,154,261
130,-60,20,73,81,154,257
-50,-40,-120,73,81,154,267
150,60,80,80,74,154,301
-30,60,-30,82,73,155,273
-120,-80,-180,71,84,155,292
-20,-70,-160,75,80,155,273
-120,-80,180,71,84,155,292
-130,-40,110,68,87,155,276
-160,-10,120,76,79,155,280
90,80,130,81,74,155,280
-10,20,-50,78,77,155,227
40,-80,-50,68,87,155,227
180,70,120,74,81,155,236
180,60,40,80,75,155,305
180,40,130,80,75,155,251
160,30,120,76,79,155,263
-180,40,130,80,75,155,251
160,80,140,72,83,155,264
-180,70,120,74,81,155,236
-180,60,40,80,75,155,305
140,-80,70,73,82,155,261
0,20,-150,80,75,155,335
-10,40,-140,79,77,156,347
40,70,180,82,74,156,305
-150,20,70,73,83,156,225
-70,-80,150,77,79,156,270
-20,-20,-150,81,75,156,262
-20,70,-30,76,80,156,221
30,70,-100,64,92,156,227
0,40,-150,87,69,156,306
10,70,-160,87,69,156,269
-160,0,110,76,80,156,333
10,-10,-90,77,79,156,274
150,60,110,74,82,156,305
10,60,-150,81,75,156,277
-10,-10,-60,79,77,156,256
20,-60,-100,82,74,156,222
40,70,-180,82,74,156,305
-20,-80,-90,72,85,157,241
-180,0,120,84,73,157,286
170,60,50,81,76,157,281
-40,60,-30,80,77,157,261
-140,80,0,83,74,157,296
140,-30,40,78,79,157,207
180,0,120,84,73,157,286
-120,-70,180,68,89,157,338
40,60,-120,67,90,157,251
-40,0,-70,82,75,157,226
-160,-30,140,73,84,157,291
60,70,180,79,78,157,283
-130,-50,140,73,84,157,349
10,-50,-120,78,79,157,304
80,80,140,83,74,157,278
-40,0,-110,83,74,157,243
-120,-50,140,75,82,157,302
-120,-70,-180,68,89,157,338
-60,60,-30,72,85,157,280
60,70,-180,79,78,157,283
-10,30,-140,77,80,157,352
-40,-10,-80,77,80,157,240
140,-40,30,84,73,157,234
160,-20,30,78,79,157,231
-150,60,50,70,88,158,301
-80,90,-70,84,74,158,279
-10,90,-140,84,74,158,279
170,90,40,84,74,158,279
90,-80,0,77,81,158,224
160,0,90,69,89,158,253
-50,30,-80,75,83,158,290
-30,90,-120,84,74,158,279
160,90,50,84,74,158,279
-40,-30,-150,74,84,158,274
-180,90,30,84,74,158,279
40,90,170,84,74,158,279
-180,70,40,84,74,158,295
-100,90,-50,84,74,158,279
180,70,40,84,74,158,295
20,90,-170,84,74,158,279
-150,90,0,84,74,158,279
10,90,-160,84,74,158,279
-120,90,-30,84,74,158,279
-140,90,-10,84,74,158,279
140,90,70,84,74,158,279
-110,90,-40,84,74,158,279
160,50,60,79,79,158,274
-50,90,-100,84,74,158,279
-90,90,-60,84,74,158,279
180,90,30,84,74,158,279
120,90,90,84,74,158,279
30,90,-180,84,74,158,279
150,90,60,84,74,158,279
30,90,180,84,74,158,279
50,90,160,84,74,158,279
-40,90,-110,84,74,158,279
-150,40,70,72,86,158,276
-170,90,20,84,74,158,279
-70,90,-80,84,74,158,279
130,90,80,84,74,158,279
-130,90,-20,84,74,158,279
110,90,100,84,74,158,279
60,90,150,84,74,158,279
-30,50,-120,79,79,158,334
100,90,110,84,74,158,279
70,90,140,84,74,158,279
90,90,120,84,74,158,279
140,-30,50,76,82,158,232
-60,90,-90,84,74,158,279
80,90,130,84,74,158,279
0,90,-150,84,74,158,279
-20,90,-130,84,74,158,279
-90,-60,150,77,81,158,255
-160,90,10,84,74,158,279
-40,-60,-180,74,85,159,272
-150,50,60,71,88,159,325
-40,50,-110,80,79,159,350
-40,-60,180,74,85,159,272
0,70,-50,76,83,159,246
130,-80,0,73,86,159,230
-50,60,-30,76,83,159,255
-50,40,-60,77,82,159,295
70,70,-180,77,82,159,278
-60,-50,-120,71,88,159,289
70,70,180,77,82,159,278
-150,20,90,80,79,159,262
170,-60,120,78,81,159,288
-140,60,60,76,83,159,310
30,60,-160,78,81,159,311
-100,70,-20,78,82,160,287
0,-40,-150,83,77,160,280
130,80,150,73,87,160,315
-170,30,130,76,84,160,256
0,-10,-70,80,80,160,215
20,-70,-110,75,85,160,235
180,10,40,77,83,160,220
-150,10,70,72,88,160,236
150,60,120,77,83,160,304
-180,10,40,77,83,160,220
-20,-40,-160,79,81,160,269
-60,-70,160,75,85,160,271
-120,80,-20,85,75,160,290
0,-30,-100,81,80,161,288
0,60,-150,86,75,161,313
0,-10,-150,82,79,161,361
-130,80,-10,84,77,161,293
-180,-20,130,81,80,161,254
180,-60,130,78,83,161,333
-180,-30,130,82,79,161,269
140,-60,70,76,85,161,272
20,80,-170,86,75,161,265
180,-30,130,82,79,161,269
170,-30,120,79,82,161,266
180,-20,130,81,80,161,254
0,-60,-80,81,80,161,237
-20,30,-130,78,83,161,373
170,10,40,80,81,161,208
70,70,-170,74,87,161,291
-180,-60,130,78,83,161,333
-70,70,-80,75,87,162,313
10,-60,-80,80,82,162,230
-50,-50,-170,81,81,162,294
-110,-80,-170,72,90,162,291
20,70,-170,90,72,162,274
-160,-40,140,75,87,162,306
-160,-60,50,76,86,162,248
-120,-60,90,82,80,162,217
-150,-10,110,80,82,162,320
130,-60,40,80,82,162,253
150,40,80,75,87,162,297
-30,-10,-140,80,82,162,318
10,30,-90,76,86,162,295
-150,10,60,70,92,162,232
-140,-80,160,73,89,162,292
-20,-30,-80,77,86,163,264
10,80,-70,76,87,163,277
30,80,-180,89,74,163,278
-150,0,70,75,88,163,297
-120,70,0,80,83,163,277
-30,-70,-90,76,87,163,296
-140,-50,140,75,88,163,377
-100,-60,180,77,86,163,337
-20,-40,-80,77,86,163,274
30,80,180,89,74,163,278
160,-10,90,76,87,163,309
10,-10,-150,84,79,163,368
-90,-70,-150,75,88,163,359
40,80,170,87,76,163,284
-70,-50,-150,79,84,163,316
-50,40,-80,82,81,163,327
-100,-60,-180,77,86,163,337
110,70,120,73,90,163,274
170,-20,30,82,81,163,231
-150,70,20,86,77,163,318
-80,80,-70,80,83,163,287
-40,-10,-110,81,83,164,237
-60,-80,160,81,83,164,268
-110,70,40,82,82,164,237
50,70,170,81,83,164,324
130,-70,60,86,78,164,298
-10,-10,-150,87,77,164,319
0,50,-150,87,77,164,320
0,-20,-150,84,80,164,348
40,60,-160,80,84,164,337
30,-70,-90,75,89,164,244
-30,-80,-170,80,84,164,284
-90,70,-40,72,93,165,311
10,60,-60,74,91,165,222
150,50,100,80,85,165,288
-150,-80,150,76,89,165,296
120,-80,-10,76,89,165,239
-30,50,-40,77,88,165,289
-150,-10,70,78,87,165,252
-100,-80,-160,75,90,165,291
-90,-60,-160,78,87,165,380
140,-40,60,78,87,165,283
-10,-60,-80,80,85,165,279
10,-70,-130,78,87,165,298
-170,60,40,78,87,165,309
-170,-40,140,80,85,165,320
-20,40,-130,82,84,166,346
-30,-10,-60,85,81,166,296
-30,-40,-80,82,84,166,291
150,-30,80,80,86,166,253
-40,-40,-160,84,82,166,297
-80,-80,-140,72,94,166,307
0,-30,-150,82,84,166,304
20,70,-80,76,90,166,262
-20,-30,-160,84,82,166,275
0,30,-70,79,87,166,262
-170,0,120,86,80,166,294
150,0,60,84,82,166,269
-160,-80,60,81,86,167,275
-110,-50,130,79,88,167,278
-10,50,-140,87,80,167,329
-50,10,-80,80,87,167,247
-130,-60,160,73,94,167,308
70,80,-150,82,85,167,287
0,-20,-90,73,94,167,372
-90,-70,130,79,88,167,266
-150,30,70,83,84,167,270
170,-10,110,80,87,167,302
-90,-80,-150,74,93,167,290
-20,0,-50,85,82,167,284
-170,70,30,87,80,167,335
140,70,70,84,83,167,308
-30,40,-120,83,84,167,383
-150,-50,50,83,84,167,261
-40,-50,-170,83,84,167,274
50,80,160,88,79,167,283
70,90,-130,77,91,168,342
-40,-80,180,80,88,168,284
-60,90,0,77,91,168,342
150,90,150,77,91,168,342
180,90,120,77,91,168,342
-110,90,50,77,91,168,342
-50,-80,170,82,86,168,279
-10,20,-140,82,86,168,365
-40,-80,-180,80,88,168,284
60,70,170,84,84,168,307
70,70,170,81,87,168,306
60,90,-120,77,91,168,342
-140,90,80,77,91,168,342
-10,10,-50,85,83,168,242
160,90,140,77,91,168,342
-150,-20,130,73,95,168,305
160,60,60,85,83,168,300
-70,-70,150,79,89,168,283
130,90,170,77,91,168,342
170,90,130,77,91,168,342
-170,90,110,77,91,168,342
20,90,-80,77,91,168,342
120,90,-180,77,91,168,342
0,90,-60,77,91,168,342
-160,90,100,77,91,168,342
90,90,-150,77,91,168,342
-180,90,120,77,91,168,342
-100,90,40,77,91,168,342
40,90,-100,77,91,168,342
10,90,-70,77,91,168,342
-50,90,-10,77,91,168,342
80,90,-140,77,91,168,342
120,70,100,80,88,168,292
-120,90,60,77,91,168,342
-40,90,-20,77,91,168,342
-80,90,20,77,91,168,342
110,90,-170,77,91,168,342
90,70,160,83,85,168,313
-100,70,30,83,85,168,246
-30,90,-30,77,91,168,342
-150,90,90,77,91,168,342
140,70,130,75,93,168,330
50,90,-110,77,91,168,342
-150,20,60,79,89,168,309
100,90,-160,77,91,168,342
-20,90,-40,77,91,168,342
0,20,-60,79,89,168,296
140,90,160,77,91,168,342
-130,90,70,77,91,168,342
-90,90,30,77,91,168,342
180,20,40,79,89,168,260
-10,90,-50,77,91,168,342
120,90,180,77,91,168,342
-180,20,40,79,89,168,260
-70,90,10,77,91,168,342
170,50,50,84,84,168,279
30,90,-90,77,91,168,342
40,80,-110,78,90,168,280
150,80,60,92,77,169,280
100,70,140,82,87,169,313
-20,50,-130,85,84,169,347
-180,-70,40,81,88,169,270
-140,60,40,77,92,169,350
0,-60,-150,88,81,169,330
0,-40,-90,86,83,169,304
-10,-40,-160,84,85,169,297
180,-70,40,81,88,169,270
150,0,50,83,86,169,250
180,20,130,77,92,169,258
-110,-50,120,76,93,169,287
170,50,130,85,84,169,239
-180,20,130,77,92,169,258
120,80,160,78,91,169,342
-150,-50,140,77,92,169,361
-160,40,120,81,89,170,268
20,80,-80,83,87,170,313
120,-70,40,83,87,170,289
-30,-50,-170,83,87,170,316
0,0,-150,85,85,170,392
-30,30,-120,86,84,170,355
-90,80,-60,86,84,170,308
-150,40,100,83,87,170,256
10,-60,-140,87,83,170,337
-150,60,40,82,88,170,345
60,80,150,87,83,170,297
-130,-70,80,81,89,170,239
-170,10,40,83,88,171,264
20,60,-160,94,77,171,307
20,50,-140,80,91,171,330
10,10,-150,88,83,171,334
50,-80,-80,78,93,171,247
-150,-40,140,79,92,171,340
50,-80,-40,75,96,171,265
30,70,180,92,79,171,296
40,-80,-90,77,94,171,250
-160,-60,140,81,90,171,336
-60,-60,-110,86,85,171,330
0,0,-60,87,84,171,266
160,10,40,82,89,171,284
-40,30,-50,82,89,171,291
-140,-30,130,78,93,171,356
170,80,40,92,79,171,301
170,20,120,82,89,171,242
-180,-30,30,83,88,171,259
80,70,150,79,92,171,353
180,-30,30,83,88,171,259
110,-80,30,82,89,171,261
30,70,-180,92,79,171,296
-160,-50,140,81,90,171,346
10,40,-150,87,84,171,330
170,60,120,78,93,171,328
70,70,160,83,88,171,334
140,-30,30,88,84,172,249
140,80,70,89,83,172,282
-50,-60,170,83,89,172,293
-130,-40,100,77,95,172,275
-160,-80,140,80,92,172,300
-20,-50,-80,85,87,172,293
-60,-80,-120,76,96,172,328
-20,-60,-170,85,87,172,308
-50,-70,-100,85,87,172,323
0,10,-150,87,85,172,369
80,70,170,82,90,172,307
-170,-60,40,84,88,172,299
10,-50,-90,84,88,172,289
-170,40,130,80,92,172,290
20,50,-110,75,97,172,319
150,-60,20,96,76,172,294
10,-50,-140,89,83,172,297
170,60,40,86,86,172,300
110,70,110,83,89,172,324
160,80,50,92,80,172,285
100,70,130,83,89,172,324
10,0,-150,86,86,172,359
10,-20,-120,89,83,172,312
-80,70,-60,78,94,172,317
-150,10,90,86,86,172,335
-160,50,50,81,91,172,331
-30,-20,-150,83,90,173,317
-30,60,-130,93,80,173,335
150,80,150,76,97,173,276
10,-20,-130,93,80,173,314
50,70,-130,78,95,173,303
-30,-30,-80,86,87,173,318
-150,60,90,78,95,173,340
-20,60,-140,92,81,173,334
50,60,-160,79,94,173,330
130,70,130,79,94,173,320
-80,-60,-140,85,88,173,345
-30,10,-120,89,84,173,310
150,30,60,86,87,173,316
-150,10,80,86,88,174,284
-110,70,-10,82,92,174,299
-20,-80,-160,88,86,174,308
-10,10,-140,90,84,174,347
-110,-50,140,80,94,174,319
50,80,-120,85,89,174,326
-30,0,-130,83,91,174,319
-120,-50,100,82,92,174,293
160,30,50,84,90,174,280
20,50,-100,76,98,174,295
-70,-80,-130,74,100,174,321
-100,-70,-160,78,96,174,374
150,-40,90,88,86,174,295
60,-80,-70,82,92,174,261
140,-30,60,87,87,174,280
-50,70,-110,89,85,174,359
-100,80,-50,89,85,174,319
-170,50,40,86,88,174,314
150,40,70,81,94,175,315
140,80,150,74,101,175,349
10,60,-160,91,84,175,339
-160,40,50,90,85,175,327
-130,-40,130,80,95,175,398
120,-70,0,79,96,175,280
-150,-20,60,88,87,175,269
150,50,80,89,86,175,290
-170,20,40,83,92,175,283
70,-80,-60,83,92,175,261
130,-50,30,82,93,175,307
-30,20,-120,82,93,175,344
-40,70,-120,89,86,175,351
110,-70,10,86,89,175,258
-70,-50,-160,85,90,175,309
-160,20,50,83,92,175,313
-30,-50,-80,87,88,175,310
170,-60,30,89,86,175,288
20,30,-120,85,90,175,377
-10,50,-40,87,88,175,253
-160,60,100,79,96,175,318
150,40,60,87,89,176,330
-10,-60,-160,93,83,176,331
-40,30,-110,87,89,176,359
-140,-70,70,78,98,176,265
-30,70,-130,90,86,176,339
-150,0,90,88,88,176,363
-10,-50,-160,88,88,176,309
160,-40,110,87,89,176,277
20,50,-130,78,98,176,319
-160,-10,130,89,87,176,305
150,70,60,93,83,176,302
80,70,-180,82,94,176,335
80,70,180,82,94,176,335
-180,40,40,88,88,176,309
-110,80,-40,89,87,176,332
180,40,40,88,88,176,309
-40,10,-110,95,81,176,336
130,80,80,93,83,176,293
-60,-70,-110,89,87,176,320
-10,-30,-80,82,94,176,324
-10,50,-150,95,82,177,351
-40,-70,-90,82,95,177,352
150,60,70,90,87,177,313
-40,40,-110,89,88,177,377
10,50,-150,93,84,177,321
110,-70,0,84,93,177,259
130,-50,40,88,89,177,296
130,-80,60,87,90,177,296
80,-80,-50,84,93,177,250
-80,-70,140,84,93,177,287
150,40,90,90,87,177,307
-130,60,40,73,104,177,305
-60,50,-70,91,86,177,347
160,50,120,81,96,177,337
10,30,-160,94,83,177,323
160,-50,110,86,91,177,277
-10,-80,-150,88,89,177,314
-20,10,-130,92,85,177,337
-60,60,-90,88,89,177,348
-170,-50,140,85,92,177,354
160,70,50,94,83,177,309
20,-60,-110,89,89,178,285
150,60,60,90,88,178,320
-180,80,30,93,85,178,320
110,70,140,87,91,178,326
-110,-70,-170,77,101,178,387
-10,-30,-160,89,89,178,318
60,70,160,86,92,178,357
180,80,30,93,85,178,320
-40,60,-120,98,80,178,345
-10,0,-50,88,90,178,286
-20,20,-130,84,94,178,369
-20,-60,-80,85,93,178,323
-140,70,10,91,87,178,330
-50,50,-100,91,87,178,380
-100,-60,120,84,94,178,304
130,80,160,77,101,178,384
-180,50,40,90,89,179,318
70,-90,0,86,93,179,294
170,70,40,92,87,179,317
-100,-90,-170,86,93,179,294
150,-90,80,86,93,179,294
170,-90,100,86,93,179,294
-50,30,-90,82,97,179,330
60,-90,-10,86,93,179,294
80,70,160,81,98,179,328
-60,-90,-130,86,93,179,294
130,-90,60,86,93,179,294
-150,0,100,87,92,179,394
-150,-90,140,86,93,179,294
-120,-90,170,86,93,179,294
-50,10,-70,85,94,179,222
-130,-90,160,86,93,179,294
120,-90,50,86,93,179,294
-180,-90,110,86,93,179,294
-40,-90,-110,86,93,179,294
-50,-90,-120,86,93,179,294
10,40,-90,90,89,179,325
-110,-90,-180,86,93,179,294
-70,-90,-140,86,93,179,294
110,-80,-20,81,98,179,240
90,-80,-40,83,96,179,231
30,-90,-40,86,93,179,294
100,-90,30,86,93,179,294
-110,-90,180,86,93,179,294
-170,-80,50,86,93,179,287
80,-90,10,86,93,179,294
150,70,140,79,100,179,305
180,-90,110,86,93,179,294
90,-90,20,86,93,179,294
-30,-90,-100,86,93,179,294
-80,-90,-150,86,93,179,294
-40,20,-110,86,93,179,330
110,-90,40,86,93,179,294
-150,10,100,89,90,179,382
40,-90,-30,86,93,179,294
-90,-90,-160,86,93,179,294
20,-90,-50,86,93,179,294
50,-90,-20,86,93,179,294
-10,-90,-80,86,93,179,294
140,-90,70,86,93,179,294
-20,-90,-90,86,93,179,294
-10,40,-150,95,84,179,368
-140,-90,150,86,93,179,294
-170,-90,120,86,93,179,294
20,50,-120,77,102,179,324
10,-90,-60,86,93,179,294
0,-90,-70,86,93,179,294
-160,0,120,87,92,179,346
160,-90,90,86,93,179,294
180,50,40,90,89,179,318
-160,-90,130,86,93,179,294
80,80,-160,87,93,180,319
20,50,-150,98,82,180,348
-150,20,100,89,91,180,319
-120,-60,170,75,105,180,346
140,-70,10,89,91,180,268
10,20,-80,82,98,180,292
20,-60,-120,92,88,180,320
-170,-80,130,87,93,180,310
-170,80,20,95,85,180,323
100,70,150,86,94,180,332
-130,-50,80,86,94,180,289
-140,60,70,82,98,180,350
10,-20,-140,98,82,180,347
140,-70,80,92,89,181,307
-150,-40,50,87,94,181,311
-160,30,50,83,98,181,319
-170,-30,140,89,92,181,312
-160,-40,40,83,98,181,314
-120,-50,150,82,99,181,369
20,10,-140,90,91,181,361
-60,70,-100,93,88,181,365
-10,20,-150,95,87,182,401
170,20,40,90,92,182,262
-160,60,40,85,97,182,340
150,-20,70,85,97,182,315
-160,80,10,97,85,182,333
-10,-70,-80,86,96,182,279
-110,-50,150,83,99,182,346
-150,50,90,90,92,182,321
-30,-30,-160,86,96,182,301
70,80,140,94,88,182,308
90,70,140,84,98,182,370
-140,80,-10,97,85,182,343
-40,80,-120,90,92,182,320
-170,60,30,93,89,182,356
-150,80,0,97,85,182,345
-40,-30,-90,91,91,182,353
20,0,-110,84,99,183,305
180,70,30,91,92,183,358
180,-50,30,87,96,183,311
40,-70,-80,87,96,183,296
-180,-50,30,87,96,183,311
-160,50,110,88,95,183,328
-150,0,80,92,91,183,335
40,70,170,98,85,183,326
40,60,-170,93,90,183,348
-40,-60,170,90,93,183,339
-10,60,-150,94,89,183,350
120,70,130,83,100,183,278
-180,70,30,91,92,183,358
-10,30,-150,98,86,184,384
-180,10,130,96,88,184,322
-150,0,60,84,100,184,301
-170,-60,140,90,94,184,379
170,0,110,98,86,184,296
-170,40,40,86,98,184,313
180,10,130,96,88,184,322
150,-10,70,99,85,184,324
150,20,70,90,94,184,320
70,70,-160,87,97,184,358
-30,80,-130,90,94,184,310
140,80,160,84,100,184,322
30,60,-170,102,82,184,316
-50,80,-110,93,91,184,325
90,70,150,87,97,184,350
10,-40,-130,95,89,184,373
-140,60,30,93,92,185,382
20,-80,-60,90,95,185,281
-20,50,-140,98,87,185,366
-50,40,-90,90,95,185,391
150,40,100,88,97,185,326
120,80,90,97,88,185,311
20,10,-130,82,103,185,366
-170,60,110,84,101,185,344
-180,-10,130,95,90,185,301
100,-80,-30,84,101,185,249
-10,80,-150,88,97,185,313
-50,-80,-110,85,100,185,343
20,20,-110,90,95,185,353
160,40,50,92,93,185,316
-120,80,-30,93,92,185,337
-130,-40,90,86,99,185,300
180,-10,130,95,90,185,301
-170,50,120,94,91,185,313
150,10,50,92,93,185,315
-160,-50,40,93,92,185,305
-130,70,70,91,95,186,306
0,-80,-140,91,95,186,329
-30,-60,-180,89,97,186,340
80,-80,-10,90,96,186,280
-130,80,-20,94,92,186,338
20,50,-90,81,105,186,303
0,50,-160,96,90,186,359
-160,-20,140,94,92,186,328
-20,40,-40,92,94,186,273
180,50,130,93,93,186,299
100,70,120,86,100,186,360
-180,50,130,93,93,186,299
20,-70,-120,92,94,186,323
-40,0,-120,96,90,186,333
-30,-60,180,89,97,186,340
0,70,-160,94,92,186,327
110,80,170,86,100,186,371
20,60,-170,100,86,186,339
160,60,50,89,97,186,311
0,-30,-90,94,93,187,348
170,-70,30,92,95,187,317
70,70,150,88,99,187,383
-20,70,-140,93,94,187,344
-140,-20,90,91,96,187,330
180,60,30,92,95,187,347
150,30,70,92,95,187,298
0,-70,-150,96,91,187,373
-150,-10,120,90,97,187,331
-160,10,120,89,98,187,342
170,-80,110,88,99,187,323
20,0,-120,90,97,187,337
160,50,50,93,94,187,309
-90,-60,140,90,97,187,315
-150,40,60,90,97,187,340
-180,60,30,92,95,187,347
-180,30,40,88,99,187,303
-30,80,-20,87,100,187,342
140,70,140,85,102,187,328
-20,-10,-150,98,89,187,342
50,60,-170,90,97,187,377
180,30,40,88,99,187,303
-150,-60,150,85,103,188,424
100,80,-180,91,97,188,363
180,-20,30,96,92,188,280
-120,-70,90,90,98,188,245
150,10,60,96,92,188,305
130,-60,50,92,96,188,305
30,80,-90,92,96,188,361
100,80,180,91,97,188,363
-40,50,-40,83,105,188,327
-180,-20,30,96,92,188,280
160,-20,100,90,98,188,312
130,70,80,97,91,188,340
50,60,-150,83,105,188,330
170,70,130,85,103,188,293
80,80,130,97,91,188,319
-40,-20,-120,94,94,188,306
80,70,140,88,100,188,388
0,40,-50,95,93,188,277
150,50,70,95,93,188,323
-140,-90,80,89,100,189,318
-70,-90,150,89,100,189,318
140,-90,0,89,100,189,318
150,-90,10,89,100,189,318
-60,-90,160,89,100,189,318
-20,80,-140,92,97,189,318
-50,-90,170,89,100,189,318
-90,-90,130,89,100,189,318
-110,-90,110,89,100,189,318
-10,-90,-150,89,100,189,318
-10,-80,-80,93,96,189,281
130,-90,-10,89,100,189,318
90,-90,-50,89,100,189,318
90,80,-170,91,98,189,359
110,-90,-30,89,100,189,318
10,-90,-130,89,100,189,318
-160,-90,60,89,100,189,318
-30,-90,-170,89,100,189,318
-20,-90,-160,89,100,189,318
30,-90,-110,89,100,189,318
-170,-10,130,89,100,189,301
-180,-90,40,89,100,189,318
-10,70,-150,94,95,189,331
60,-90,-80,89,100,189,318
-20,-70,-170,93,96,189,336
30,-70,-70,85,104,189,276
-150,-90,70,89,100,189,318
100,-90,-40,89,100,189,318
-170,-90,50,89,100,189,318
20,-90,-120,89,100,189,318
-80,-90,140,89,100,189,318
180,-90,40,89,100,189,318
-120,-90,100,89,100,189,318
0,-90,-140,89,100,189,318
170,-90,30,89,100,189,318
120,-90,-20,89,100,189,318
-10,-20,-70,91,98,189,352
-40,-90,-180,89,100,189,318
-130,-90,90,89,100,189,318
160,-90,20,89,100,189,318
140,60,100,90,99,189,342
50,-90,-90,89,100,189,318
-100,-90,120,89,100,189,318
-20,-20,-70,92,97,189,343
80,-90,-60,89,100,189,318
70,-90,-70,89,100,189,318
-40,-90,180,89,100,189,318
40,-90,-100,89,100,189,318
0,80,-160,92,98,190,320
-70,60,-40,84,106,190,320
150,50,110,89,101,190,357
-80,70,-70,88,102,190,366
170,-10,30,98,92,190,307
-140,-20,100,92,98,190,356
10,40,-70,90,100,190,352
-40,-70,170,90,100,190,324
40,70,-110,85,105,190,303
-40,10,-50,95,95,190,282
-160,70,20,98,92,190,370
180,-80,120,88,102,190,326
-180,-80,120,88,102,190,326
-130,70,0,92,98,190,339
110,80,100,96,94,190,319
60,-80,-30,81,110,191,315
-40,-10,-120,98,93,191,300
20,20,-120,87,104,191,361
-60,80,-100,94,97,191,343
-70,-70,-120,97,94,191,354
10,70,-60,91,100,191,323
-160,80,110,94,97,191,264
20,-60,-130,98,93,191,366
-180,-80,40,90,101,191,337
90,70,130,90,101,191,391
180,-80,40,90,101,191,337
-70,60,-20,89,102,191,394
-10,80,-40,99,92,191,364
-50,-40,-110,90,101,191,375
-30,-60,-80,92,99,191,342
-140,-30,70,91,100,191,293
160,-40,20,92,99,191,320
-20,0,-140,95,96,191,353
-170,70,20,93,98,191,385
-150,-70,60,86,105,191,294
150,20,60,99,92,191,336
150,-60,90,87,104,191,284
-170,80,120,90,102,192,275
20,-70,-70,91,101,192,264
140,60,90,95,97,192,338
-170,0,130,98,94,192,353
10,-80,-130,95,97,192,343
-150,-30,140,92,100,192,351
-10,-70,-160,97,95,192,346
-150,30,60,96,96,192,352
10,20,-160,99,93,192,350
-140,-50,60,96,96,192,276
-170,30,40,87,105,192,323
10,80,-170,95,97,192,331
-170,10,130,92,101,193,317
-20,30,-140,102,91,193,411
-70,60,-30,86,107,193,351
160,-10,30,101,92,193,316
160,-80,100,94,99,193,333
170,40,40,95,98,193,318
-140,-40,140,85,108,193,423
10,-30,-130,99,94,193,391
150,-20,30,95,98,193,298
-90,70,-50,86,107,193,320
-10,-50,-80,94,99,193,301
110,-70,20,98,95,193,300
-110,-60,100,93,100,193,282
70,-80,-20,87,106,193,305
-30,0,-50,94,100,194,336
30,-70,-100,89,105,194,291
30,60,-180,104,90,194,374
-180,50,30,97,97,194,357
-20,80,-30,96,98,194,354
60,80,-130,90,104,194,392
140,60,80,100,94,194,327
160,20,110,93,101,194,292
-70,70,-90,99,95,194,374
10,-40,-120,98,96,194,389
30,60,180,104,90,194,374
0,30,-60,101,93,194,333
-130,60,50,84,110,194,325
180,50,30,97,97,194,357
50,60,-140,88,106,194,357
10,-20,-110,94,100,194,402
-60,70,0,89,106,195,282
40,60,180,102,93,195,364
10,50,-160,105,90,195,364
-60,50,-60,100,95,195,347
-100,70,-30,85,110,195,374
170,50,40,94,101,195,317
170,-20,120,97,98,195,319
120,80,170,86,109,195,431
-90,-70,120,93,102,195,345
-140,-70,170,90,105,195,412
-20,-10,-50,97,98,195,369
170,-10,120,96,99,195,348
-70,-60,160,101,94,195,322
-10,0,-150,103,92,195,403
-170,-20,140,96,99,195,340
-50,60,-110,105,90,195,349
40,60,-180,102,93,195,364
-60,50,-80,97,99,196,374
100,80,110,100,96,196,329
150,30,90,92,104,196,342
20,0,-130,94,102,196,401
-50,-50,-100,97,99,196,361
170,-30,20,98,98,196,339
-40,-10,-70,104,92,196,328
90,70,170,92,104,196,362
140,60,110,91,105,196,394
-40,-80,-100,91,105,196,353
-40,90,-120,106,91,197,329
0,90,-160,106,91,197,329
-100,90,-60,106,91,197,329
-30,-70,180,98,99,197,337
70,90,130,106,91,197,329
10,90,-170,106,91,197,329
-120,90,-40,106,91,197,329
100,90,100,106,91,197,329
0,40,-160,100,97,197,377
-130,-70,-180,90,107,197,419
120,90,80,106,91,197,329
160,90,40,106,91,197,329
20,90,180,106,91,197,329
130,90,70,106,91,197,329
90,90,110,106,91,197,329
-160,90,0,106,91,197,329
170,90,30,106,91,197,329
-60,90,-100,106,91,197,329
-150,90,-10,106,91,197,329
180,90,20,106,91,197,329
-150,-70,160,93,104,197,426
-110,90,-50,106,91,197,329
110,90,90,106,91,197,329
170,0,30,95,102,197,314
-30,90,-130,106,91,197,329
-20,90,-140,106,91,197,329
-130,-70,180,90,107,197,419
-130,90,-30,106,91,197,329
-20,60,-30,105,92,197,325
150,30,100,94,103,197,345
50,90,150,106,91,197,329
10,50,-60,91,106,197,289
-70,90,-90,106,91,197,329
-80,90,-80,106,91,197,329
-170,90,10,106,91,197,329
-180,90,20,106,91,197,329
-50,90,-110,106,91,197,329
-10,90,-150,106,91,197,329
-30,-70,-180,98,99,197,337
60,90,140,106,91,197,329
90,80,120,99,98,197,330
80,90,120,106,91,197,329
150,90,50,106,91,197,329
-90,90,-70,106,91,197,329
140,90,60,106,91,197,329
30,90,170,106,91,197,329
170,-80,30,93,104,197,353
-140,90,-20,106,91,197,329
20,10,-110,93,104,197,337
40,90,160,106,91,197,329
-60,-50,-170,95,102,197,322
20,90,-180,106,91,197,329
-50,30,-100,95,103,198,387
-110,-60,-180,87,111,198,399
180,-40,140,98,100,198,385
-20,10,-40,103,95,198,322
-180,-40,140,98,100,198,385
0,60,-160,103,95,198,357
160,10,100,95,103,198,322
0,80,-50,99,99,198,399
10,40,-160,101,97,198,338
-140,-20,110,96,102,198,395
20,80,180,100,98,198,323
100,-80,20,100,98,198,322
-50,80,0,89,109,198,347
-40,-20,-80,99,99,198,365
-70,-80,140,93,105,198,373
0,-20,-80,90,108,198,406
20,80,-180,100,98,198,323
50,70,160,103,95,198,362
-70,-50,-170,92,106,198,322
20,70,-180,103,95,198,353
-110,-60,180,87,111,198,399
130,-60,10,92,106,198,350
20,70,180,103,95,198,353
10,40,-80,97,102,199,380
-140,-60,160,92,107,199,439
-130,60,30,90,109,199,351
20,30,-110,93,106,199,394
20,30,-130,96,103,199,401
-40,80,-10,88,111,199,344
150,30,50,102,97,199,384
-120,-40,130,92,107,199,418
150,-50,20,103,96,199,328
10,-20,-150,105,94,199,412
150,10,70,104,95,199,330
20,0,-100,88,111,199,304
150,0,40,96,103,199,296
150,0,70,104,95,199,336
-120,60,30,86,113,199,325
-150,30,110,95,104,199,331
10,70,-170,101,99,200,351
0,-50,-80,98,102,200,355
-150,50,50,92,108,200,415
-150,0,110,97,103,200,410
-70,80,-90,96,104,200,368
10,-40,-140,104,96,200,371
20,-10,-140,98,102,200,407
-50,40,-100,98,102,200,428
140,-50,20,104,96,200,333
-40,50,-120,101,99,200,389
-140,-40,60,92,108,200,322
0,20,-160,109,92,201,413
-80,-60,150,100,101,201,371
160,-60,110,99,102,201,329
60,70,150,100,101,201,377
-60,-70,150,97,104,201,337
170,-40,130,100,101,201,373
-10,-40,-80,93,108,201,332
170,30,130,98,103,201,292
170,80,30,100,101,201,364
-50,-70,160,100,101,201,351
-80,-70,-130,97,104,201,404
-100,-70,110,99,102,201,322
40,-70,-70,94,107,201,312
-180,-60,30,95,106,201,388
180,-60,30,95,106,201,388
150,50,60,100,101,201,344
20,0,-140,97,104,201,416
0,-10,-160,104,98,202,440
180,-50,140,102,100,202,399
130,70,140,91,111,202,393
-20,20,-140,100,102,202,428
130,-50,50,104,98,202,310
-180,-50,140,102,100,202,399
-90,-80,120,96,106,202,377
-30,50,-130,103,99,202,387
180,-70,130,97,105,202,386
-70,60,-50,94,108,202,376
-90,-70,-140,102,100,202,427
-70,-60,-120,97,105,202,382
-160,60,30,97,105,202,412
-80,-70,130,99,103,202,352
-150,70,10,104,98,202,395
-180,-70,130,97,105,202,386
-10,10,-150,104,98,202,424
130,90,-180,92,111,203,359
20,10,-120,90,113,203,359
90,90,-140,92,111,203,359
10,90,-60,92,111,203,359
20,90,-70,92,111,203,359
80,90,-130,92,111,203,359
-180,-10,30,93,110,203,333
180,0,130,102,101,203,366
-20,40,-140,105,98,203,412
10,-10,-160,107,96,203,410
150,90,160,92,111,203,359
-80,90,30,92,111,203,359
-50,90,0,92,111,203,359
-130,-50,150,88,115,203,445
-120,90,70,92,111,203,359
50,90,-100,92,111,203,359
-160,90,110,92,111,203,359
130,90,180,92,111,203,359
-180,0,130,102,101,203,366
-180,90,130,92,111,203,359
60,90,-110,92,111,203,359
-180,80,20,103,100,203,373
170,90,140,92,111,203,359
10,-30,-120,103,100,203,400
20,10,-150,101,102,203,383
120,90,-170,92,111,203,359
180,-10,30,93,110,203,333
110,90,-160,92,111,203,359
-130,90,80,92,111,203,359
-10,90,-40,92,111,203,359
140,90,170,92,111,203,359
-170,90,120,92,111,203,359
-110,-70,100,101,102,203,291
70,90,-120,92,111,203,359
0,90,-50,92,111,203,359
-110,90,60,92,111,203,359
-70,90,20,92,111,203,359
-150,90,100,92,111,203,359
10,-70,-140,100,103,203,395
-30,90,-20,92,111,203,359
-10,40,-40,102,101,203,281
30,90,-80,92,111,203,359
180,90,130,92,111,203,359
-40,90,-10,92,111,203,359
160,90,150,92,111,203,359
100,90,-150,92,111,203,359
-20,90,-30,92,111,203,359
150,30,80,91,112,203,338
-90,90,40,92,111,203,359
40,90,-90,92,111,203,359
-60,90,10,92,111,203,359
10,80,-60,100,103,203,416
180,80,20,103,100,203,373
-100,90,50,92,111,203,359
10,-10,-80,98,105,203,325
30,80,170,106,97,203,327
-140,90,90,92,111,203,359
-150,60,30,101,103,204,412
160,80,40,99,105,204,365
-30,30,-130,105,99,204,410
-150,80,100,105,99,204,276
-180,80,130,93,111,204,292
-50,40,-50,90,114,204,352
-160,-70,50,91,113,204,335
-150,10,50,92,112,204,286
20,30,-140,99,105,204,425
30,70,-90,91,113,204,358
180,80,130,93,111,204,292
-170,80,10,104,100,204,382
-120,-70,-170,93,111,204,421
-70,-70,140,98,106,204,325
20,-50,-120,101,104,205,385
-100,-60,-170,93,112,205,420
-180,-60,140,101,104,205,424
-160,10,40,101,104,205,342
180,-60,140,101,104,205,424
160,50,130,100,105,205,363
150,60,130,96,109,205,388
150,-80,90,98,107,205,359
-60,60,-20,91,114,205,383
30,50,-110,96,109,205,414
-30,40,-130,106,100,206,413
110,80,-180,93,113,206,455
110,80,180,93,113,206,455
-100,-50,150,93,113,206,386
-50,20,-100,100,106,206,372
-30,20,-130,99,107,206,405
-160,-50,150,94,112,206,426
20,-10,-120,94,112,206,386
140,-40,70,101,105,206,365
-160,-40,150,99,107,206,395
-10,-20,-160,105,101,206,383
20,40,-150,104,102,206,422
-80,-50,-180,98,108,206,351
-50,50,-110,106,100,206,394
10,-30,-140,104,102,206,397
150,-40,20,101,105,206,370
-80,-50,180,98,108,206,351
0,30,-160,107,99,206,374
70,80,-140,95,112,207,432
180,0,30,96,111,207,355
120,-80,50,103,104,207,355
-70,-50,-140,99,108,207,387
-170,50,30,101,106,207,384
-180,60,120,98,109,207,388
0,-30,-160,103,104,207,431
180,60,120,98,109,207,388
170,-70,120,98,109,207,365
-30,70,-20,101,106,207,284
170,-40,20,99,108,207,359
-170,-70,140,97,110,207,430
-40,-20,-130,103,104,207,372
-90,-60,-150,103,104,207,452
-180,0,30,96,111,207,355
20,-60,-80,102,105,207,307
-150,-10,60,96,111,207,335
-110,-50,160,95,113,208,420
20,50,-160,110,98,208,394
20,-10,-130,100,108,208,415
-30,10,-130,103,105,208,399
-140,80,90,110,98,208,292
-130,-40,140,95,113,208,479
-160,-30,40,94,114,208,371
20,30,-150,106,102,208,398
140,60,120,94,114,208,426
60,70,-140,100,108,208,388
180,-30,140,100,108,208,398
-80,-80,130,98,110,208,374
150,20,80,104,104,208,338
20,20,-150,106,102,208,378
160,60,130,98,110,208,409
-180,-30,140,100,108,208,398
-50,50,-40,97,111,208,361
-120,70,-10,100,108,208,358
150,20,50,106,102,208,391
10,-40,-110,104,105,209,422
140,-50,80,105,104,209,309
20,-10,-110,96,113,209,371
20,20,-130,98,111,209,395
-40,-30,-160,97,112,209,334
20,40,-130,96,113,209,413
-160,70,10,103,106,209,411
20,10,-100,96,113,209,350
20,20,-140,95,114,209,407
-170,-50,150,104,105,209,420
-140,-50,150,94,115,209,468
-20,50,-150,111,98,209,395
10,60,-170,103,106,209,369
40,60,-110,85,124,209,345
-60,80,10,97,113,210,362
170,30,40,102,108,210,328
-100,-70,-150,99,111,210,431
10,30,-80,99,111,210,417
-160,-70,150,98,112,210,447
-80,80,-80,102,108,210,393
30,60,-90,90,120,210,334
110,-70,-10,94,116,210,347
-20,-20,-160,107,103,210,366
20,-50,-110,100,110,210,401
170,10,120,105,105,210,319
-80,-50,-170,101,109,210,409
130,80,170,94,116,210,391
-100,-80,110,102,109,211,384
160,-50,20,109,102,211,347
-50,-40,-160,103,108,211,363
20,-80,-120,104,107,211,364
-50,60,-20,98,113,211,372
0,-20,-160,102,109,211,463
-40,0,-60,101,110,211,324
170,80,140,99,112,211,305
20,40,-140,105,106,211,418
-110,-70,-160,99,112,211,432
20,-10,-100,95,116,211,377
160,-30,110,104,107,211,335
-40,30,-120,106,105,211,423
-110,-80,100,105,106,211,383
30,50,-120,90,121,211,397
-120,-80,-170,94,117,211,429
-160,50,40,104,107,211,412
150,30,110,104,107,211,341
-140,-20,120,98,113,211,417
-140,-80,170,96,115,211,438
-140,-60,60,109,102,211,310
-60,60,-100,112,100,212,385
-20,-50,-170,104,108,212,357
-20,20,-40,112,100,212,313
130,-40,40,102,110,212,428
-90,80,-70,101,111,212,397
-170,-30,30,102,110,212,373
20,-10,-150,109,103,212,405
160,60,40,100,112,212,354
30,-80,-110,105,107,212,371
10,-20,-100,101,111,212,437
-120,70,60,105,107,212,394
-170,-40,30,103,109,212,361
40,80,-100,97,115,212,428
160,70,40,106,106,212,381
-90,70,-60,100,112,212,399
150,50,120,99,113,212,448
-160,0,130,101,111,212,420
-70,-50,-180,99,113,212,340
-70,-50,180,99,113,212,340
-40,60,-130,106,107,213,390
160,-70,20,108,105,213,379
130,-50,20,104,109,213,384
120,70,140,98,115,213,409
140,40,70,109,104,213,404
-130,-60,170,96,117,213,446
-20,-70,-80,96,117,213,402
-50,-80,160,107,106,213,386
80,70,-170,98,115,213,415
30,-70,-110,100,113,213,365
-140,70,0,110,103,213,400
160,0,30,102,111,213,343
-160,-60,150,102,111,213,460
-30,-20,-70,106,107,213,382
10,-70,-70,107,106,213,338
-40,40,-120,110,103,213,418
160,-80,20,98,115,213,373
-60,-80,150,107,107,214,379
-170,-30,150,105,109,214,431
-30,-80,-90,107,107,214,394
30,70,170,115,99,214,361
130,60,100,101,113,214,380
-20,-70,180,104,110,214,396
-20,-70,-180,104,110,214,396
-10,-20,-60,107,107,214,375
-120,60,40,99,115,214,378
-70,60,-60,100,114,214,434
-120,-40,120,96,118,214,420
120,70,90,109,105,214,400
30,50,-130,91,123,214,419
170,70,30,105,109,214,396
-130,-30,120,107,107,214,433
100,70,160,103,111,214,403
160,-30,20,105,109,214,336
-30,60,-140,108,106,214,398
0,-40,-160,107,107,214,408
40,80,160,114,100,214,330
-180,10,30,104,111,215,373
50,60,-180,104,111,215,428
-130,-80,-180,101,114,215,434
50,60,180,104,111,215,428
160,-70,110,109,106,215,386
-20,30,-150,115,100,215,430
-10,-70,-170,109,106,215,391
-40,10,-120,109,106,215,426
50,80,150,114,101,215,347
-130,-80,180,101,114,215,434
180,10,30,104,111,215,373
170,-60,130,106,109,215,418
-60,-50,180,104,111,215,369
30,-80,-50,100,115,215,339
30,50,-150,98,117,215,412
20,-70,-130,105,110,215,420
20,-50,-100,108,107,215,391
-60,-50,-180,104,111,215,369
-40,70,-130,105,110,215,386
-80,-50,-160,106,109,215,430
-160,80,0,109,107,216,386
30,50,-160,104,112,216,406
-50,10,-90,107,109,216,333
-110,-50,110,101,115,216,360
-130,-40,80,96,120,216,385
140,-60,10,108,108,216,380
-100,80,-60,107,109,216,407
160,-60,20,114,102,216,374
150,-30,20,109,107,216,380
60,80,140,115,101,216,349
90,80,-160,99,117,216,481
-130,80,80,113,103,216,328
170,-30,130,105,111,216,385
160,70,140,102,114,216,377
140,60,70,107,110,217,357
-160,0,40,101,116,217,364
-150,-60,50,107,110,217,351
-20,60,-150,112,105,217,395
50,60,-130,94,123,217,437
150,80,50,107,110,217,360
-140,80,-20,106,111,217,412
160,20,40,103,114,217,350
-100,70,-40,97,120,217,360
120,-60,20,102,115,217,407
170,10,30,104,113,217,369
-100,-50,140,99,118,217,380
150,40,110,110,107,217,332
-40,20,-120,100,117,217,406
-50,-50,180,107,110,217,394
-50,-50,-180,107,110,217,394
80,80,-150,100,117,217,472
130,-70,0,99,118,217,344
170,60,30,102,116,218,369
-150,-20,140,102,116,218,380
40,60,170,108,110,218,423
-40,-50,180,112,106,218,389
-90,-60,130,102,116,218,388
20,20,-160,110,108,218,382
-40,-50,-180,112,106,218,389
-20,10,-140,110,108,218,440
150,10,40,114,104,218,395
-130,-30,110,103,115,218,430
-60,-60,160,105,113,218,357
-60,50,-50,105,113,218,373
30,-60,-90,101,117,218,328
150,70,50,112,107,219,374
110,70,150,109,110,219,435
-110,-80,-160,99,120,219,431
100,80,-170,98,121,219,468
150,40,50,114,105,219,394
170,-50,130,106,113,219,396
-140,-20,80,110,109,219,366
-140,-30,140,103,116,219,463
-100,-50,160,100,119,219,435
-150,80,-10,108,111,219,400
-150,-30,50,102,117,219,374
-170,-40,150,107,112,219,425
30,50,-100,101,119,220,451
-120,-80,90,109,111,220,376
-170,-10,140,101,119,220,408
-180,-30,20,111,109,220,400
180,-30,20,111,109,220,400
-40,-10,-130,103,117,220,359
0,-80,-70,109,111,220,346
150,20,90,104,116,220,354
-50,70,-120,109,111,220,390
-20,30,-40,115,105,220,328
-160,20,40,103,117,220,464
-70,80,20,102,118,220,357
10,-40,-100,110,110,220,464
-120,60,20,102,119,221,391
-50,-30,-130,106,115,221,388
-20,-30,-170,112,109,221,385
70,70,140,108,113,221,422
140,-40,20,114,107,221,379
10,10,-70,98,123,221,350
160,-10,100,103,118,221,408
110,70,100,110,111,221,424
-30,70,-140,110,111,221,398
-40,-80,170,110,111,221,402
150,-80,10,102,119,221,399
-30,-70,170,109,112,221,401
-100,-80,-150,102,119,221,435
-150,-80,160,106,115,221,459
-170,60,20,106,115,221,422
160,40,130,109,112,221,345
0,0,-160,111,110,221,459
-30,-80,-180,113,109,222,409
-160,60,20,113,109,222,445
-20,-20,-60,114,108,222,387
40,-80,-100,109,113,222,386
-30,-80,180,113,109,222,409
-160,70,110,107,115,222,361
180,-20,140,111,111,222,397
-180,-20,140,111,111,222,397
20,20,-100,106,116,222,399
70,80,130,116,106,222,365
-130,60,20,111,111,222,402
-10,-10,-160,106,116,222,442
-150,-10,130,112,110,222,367
150,-50,100,107,115,222,328
60,60,170,105,117,222,476
-180,70,20,110,112,222,416
180,70,20,110,112,222,416
-180,30,140,108,115,223,355
0,-70,-160,109,114,223,417
140,40,80,116,107,223,441
-160,-30,150,110,113,223,416
-80,70,-80,111,112,223,414
90,-80,10,109,114,223,378
160,-40,120,109,114,223,420
40,70,160,119,104,223,354
-130,-30,100,101,122,223,409
-170,0,30,105,118,223,420
-10,-60,-170,108,115,223,385
-170,-50,30,106,117,223,391
180,30,140,108,115,223,355
20,40,-120,106,117,223,413
-60,50,-90,110,113,223,435
40,-70,-90,101,122,223,351
-60,-40,-140,107,116,223,374
-110,70,-20,103,120,223,414
-10,60,-160,114,109,223,397
-150,20,50,104,119,223,414
-150,-50,150,106,118,224,499
-80,60,-10,111,113,224,488
20,50,-80,97,127,224,401
-130,-80,80,109,115,224,399
-110,80,-50,110,114,224,416
-120,80,-40,109,115,224,428
-170,-60,150,108,116,224,459
0,10,-160,115,109,224,448
-160,40,40,104,120,224,417
-20,0,-150,111,113,224,441
-130,-60,70,112,112,224,312
40,50,-130,107,118,225,457
60,60,-180,100,125,225,445
-130,80,-30,110,115,225,430
-50,-60,160,113,112,225,383
120,-60,30,104,121,225,424
10,10,-160,118,107,225,443
60,60,180,100,125,225,445
140,80,60,115,110,225,364
-20,70,-150,112,113,225,393
50,-70,-70,109,116,225,355
-20,-80,-170,114,111,225,416
100,70,110,109,116,225,421
-10,-10,-50,113,113,226,394
-10,70,-160,117,109,226,384
170,-50,20,108,118,226,432
130,-60,60,105,121,226,417
150,60,50,108,118,226,370
130,80,70,116,110,226,371
-130,70,-10,113,113,226,400
-140,30,80,109,117,226,341
110,-70,30,110,116,226,364
10,-60,-150,111,116,227,422
-150,50,40,107,120,227,493
-30,-10,-50,114,113,227,383
20,60,-180,114,113,227,394
140,60,130,102,125,227,445
130,-40,30,111,116,227,407
-150,0,120,112,115,227,438
-50,-30,-120,107,120,227,369
30,-60,-120,117,110,227,428
-170,-70,40,103,124,227,402
-130,-30,130,105,122,227,471
-10,-50,-170,110,117,227,404
-120,-60,-180,103,124,227,489
-120,-60,180,103,124,227,489
-30,50,-140,110,117,227,434
10,50,-170,115,112,227,412
20,60,180,114,113,227,394
-100,-60,110,109,119,228,396
50,70,-120,109,119,228,436
10,-50,-150,110,118,228,406
20,70,-70,106,122,228,424
10,0,-160,123,105,228,424
-120,-40,110,101,127,228,444
30,50,-140,100,128,228,449
120,-70,50,116,112,228,393
0,-50,-160,115,113,228,393
20,40,-100,102,126,228,477
100,-70,-10,109,119,228,346
-120,80,70,113,115,228,342
0,-60,-160,111,118,229,409
20,30,-160,116,113,229,382
30,-70,-120,114,115,229,446
-70,60,-80,113,116,229,421
-150,40,50,117,112,229,446
20,30,-100,106,123,229,471
-140,-80,70,112,117,229,410
-10,-80,-160,114,115,229,437
-50,-40,-100,114,115,229,448
-140,60,20,114,115,229,429
-10,0,-160,111,118,229,489
20,50,-170,113,116,229,435
-20,40,-150,119,110,229,445
130,60,110,105,124,229,416
10,-20,-90,109,120,229,521
-150,40,110,112,118,230,373
20,-50,-130,123,107,230,408
-20,-40,-170,111,119,230,357
-90,-80,-140,105,125,230,441
-170,50,130,109,121,230,416
130,60,90,114,116,230,393
160,50,40,109,121,230,403
-50,-30,-110,106,124,230,410
-90,80,40,107,123,230,337
-70,60,-70,105,125,230,434
-30,0,-140,117,113,230,433
30,50,-170,121,109,230,430
-160,30,130,114,117,231,377
20,40,-110,103,128,231,480
90,70,-180,110,121,231,478
-90,-50,170,108,123,231,450
-120,-50,160,100,131,231,475
120,-70,-10,105,126,231,402
50,-80,-90,111,120,231,390
-70,70,10,102,129,231,367
-120,-50,90,109,122,231,425
60,60,-170,103,128,231,434
150,-10,30,110,121,231,374
-150,70,100,111,120,231,369
90,70,180,110,121,231,478
10,-70,-150,113,119,232,459
-80,60,-20,109,123,232,467
150,50,50,112,120,232,412
-110,80,60,116,116,232,353
80,70,130,115,117,232,449
110,-80,40,115,117,232,409
-30,30,-140,123,109,232,468
20,80,-70,113,119,232,468
80,80,120,121,111,232,372
120,80,180,97,135,232,454
-30,20,-40,123,109,232,362
-30,-40,-70,111,121,232,427
-150,-60,160,110,122,232,512
50,80,-110,105,127,232,486
120,80,-180,97,135,232,454
140,50,90,118,115,233,447
-100,80,50,114,119,233,348
30,-60,-100,112,121,233,359
140,-80,80,110,123,233,416
10,40,-170,113,120,233,409
140,40,60,117,116,233,438
60,60,-160,107,126,233,431
-150,60,20,116,117,233,474
-160,-10,140,113,120,233,435
-130,60,60,106,127,233,405
-160,-80,150,113,120,233,478
-140,60,80,112,121,233,453
-170,40,30,116,117,233,429
20,40,-90,108,125,233,456
150,-70,10,111,122,233,433
-20,-40,-70,114,119,233,458
140,70,60,119,114,233,400
-30,10,-40,118,115,233,384
-30,40,-40,110,123,233,358
20,0,-90,100,133,233,365
10,-40,-150,120,113,233,435
140,50,100,115,119,234,460
20,-60,-140,116,118,234,433
-110,60,20,101,133,234,397
120,-80,-20,107,127,234,413
-100,70,-50,111,123,234,440
-30,-40,-170,118,116,234,397
-160,60,110,109,125,234,441
120,70,150,109,125,234,488
20,0,-150,117,117,234,446
-140,-20,130,103,131,234,455
-150,20,110,116,118,234,418
-130,-50,70,113,122,235,379
-40,50,-130,118,117,235,451
30,60,170,119,116,235,442
130,-80,-10,106,129,235,410
-40,-70,160,118,117,235,431
-100,60,10,103,132,235,453
10,-30,-150,124,111,235,465
-170,-20,30,114,121,235,421
-150,50,100,112,123,235,399
-50,-30,-140,108,127,235,451
-80,80,30,109,126,235,351
-180,40,30,115,120,235,421
150,-20,80,104,131,235,437
160,80,150,114,121,235,352
180,40,30,115,120,235,421
140,70,150,109,126,235,404
-20,0,-40,117,118,235,405
90,80,110,120,116,236,391
60,-80,-80,109,127,236,395
30,-60,-110,114,122,236,407
170,60,130,113,123,236,475
-130,-30,90,104,132,236,414
10,-50,-80,117,119,236,443
70,70,-150,114,122,236,472
-20,-30,-70,113,123,236,443
110,-80,-30,111,125,236,415
-40,-20,-140,117,119,236,396
140,-60,80,112,124,236,409
-60,40,-70,113,123,236,440
0,70,-170,121,115,236,406
0,-80,-150,115,121,236,469
100,-70,-20,111,126,237,398
140,-80,0,108,129,237,415
-50,80,-120,117,120,237,427
120,-60,10,109,128,237,427
-10,30,-40,122,115,237,372
-40,80,-130,117,120,237,417
-170,0,140,116,121,237,418
-80,60,-30,105,132,237,439
20,-70,-140,119,118,237,488
-30,-20,-160,117,120,237,390
130,60,120,106,131,237,489
10,-30,-110,120,117,237,482
140,-20,40,119,118,237,387
130,-70,70,118,120,238,408
-150,-40,150,110,128,238,479
-80,-50,170,118,120,238,401
-20,-20,-50,117,121,238,432
-100,-50,130,107,131,238,422
0,-40,-80,110,128,238,449
-160,50,120,109,129,238,432
170,-10,130,122,116,238,417
-170,20,140,118,120,238,381
120,80,80,121,117,238,386
-170,60,120,114,124,238,441
-80,70,20,108,130,238,395
110,80,-170,102,136,238,480
40,50,-180,119,120,239,471
-40,-20,-70,123,116,239,473
-60,-40,-150,114,125,239,417
-60,70,-110,120,119,239,407
-160,-60,40,114,125,239,425
-20,-60,180,117,122,239,410
0,30,-50,125,114,239,380
50,60,170,118,121,239,474
-20,-60,-180,117,122,239,410
-30,-20,-60,120,119,239,444
130,-50,60,117,122,239,380
0,-30,-80,113,126,239,493
-20,-50,-70,115,124,239,473
10,40,-60,111,128,239,418
-40,-40,-170,119,120,239,461
170,0,120,122,117,239,471
-110,-60,-170,117,122,239,508
40,50,180,119,120,239,471
-30,80,-140,120,119,239,424
20,40,-160,123,116,239,435
-60,-40,-130,111,128,239,430
-170,30,140,112,127,239,371
100,80,100,122,118,240,397
40,-70,-100,108,132,240,425
-150,70,0,121,119,240,449
-150,-80,60,115,125,240,430
-60,40,-80,117,123,240,472
170,-20,20,120,120,240,383
180,40,140,119,121,240,397
-180,40,140,119,121,240,397
-10,50,-160,124,116,240,416
170,-60,20,119,121,240,472
-90,-50,-180,115,125,240,431
160,10,30,118,122,240,420
-170,-10,30,113,127,240,444
-160,10,130,110,130,240,441
-50,10,-60,117,123,240,323
-90,-50,180,115,125,240,431
-130,-50,160,106,135,241,524
140,-30,20,115,126,241,420
90,70,120,119,122,241,446
160,30,40,114,127,241,424
-50,60,-120,120,121,241,433
-160,-10,40,114,127,241,412
140,-20,30,116,125,241,404
-120,-40,140,112,129,241,504
-180,-40,20,118,123,241,461
-150,0,50,111,130,241,413
180,-40,20,118,123,241,461
-70,-50,-130,112,129,241,479
160,40,40,115,126,241,425
170,50,30,116,125,241,415
180,60,20,119,123,242,422
-40,40,-130,126,116,242,455
-90,60,0,114,128,242,445
-30,30,-40,126,116,242,405
-80,-80,-130,111,131,242,439
10,-80,-140,116,126,242,479
180,0,140,119,123,242,424
-180,0,140,119,123,242,424
40,50,-120,114,128,242,480
-10,-40,-170,120,122,242,431
60,80,-120,111,131,242,513
50,70,150,125,117,242,390
-70,-80,-120,112,130,242,443
-180,60,20,119,123,242,422
100,-80,-40,110,132,242,408
100,80,-160,103,139,242,486
120,60,110,115,127,242,433
20,60,-70,114,128,242,354
100,-70,0,117,126,243,368
-30,-50,-180,123,120,243,403
-120,70,-20,121,122,243,463
-30,-70,-80,112,131,243,453
-150,10,110,120,123,243,470
30,80,-80,116,127,243,513
-170,70,120,119,124,243,407
-30,-50,180,123,120,243,403
-20,-80,-80,120,123,243,449
60,60,-150,111,132,243,488
-80,-60,140,119,124,243,461
-20,80,-150,123,120,243,420
-30,-10,-150,119,124,243,436
-110,70,-30,115,128,243,454
-160,-20,150,119,124,243,473
140,50,80,125,119,244,467
-10,40,-160,125,119,244,436
-70,80,-100,120,124,244,456
-140,-10,110,119,125,244,486
-140,50,60,116,128,244,460
-20,20,-150,123,121,244,470
-40,-30,-80,117,127,244,455
100,70,170,118,126,244,523
150,40,120,126,118,244,412
40,50,-170,116,128,244,472
-170,-80,140,120,124,244,506
150,-10,80,119,125,244,482
-160,50,30,119,125,244,479
-50,40,-110,125,119,244,473
-160,20,130,120,124,244,405
0,10,-50,124,120,244,376
130,-40,50,114,131,245,460
-10,80,-160,126,119,245,432
10,80,180,128,117,245,448
150,-70,100,125,120,245,450
-160,-60,160,116,129,245,533
110,80,90,125,120,245,399
150,-30,90,120,125,245,390
20,10,-90,116,129,245,399
160,0,100,117,128,245,458
40,-70,-60,115,130,245,392
-30,20,-140,122,123,245,471
10,80,-180,128,117,245,448
0,80,-170,127,118,245,442
10,-20,-160,121,124,245,481
180,-10,140,130,116,246,384
160,-20,20,125,121,246,414
20,-50,-90,116,130,246,448
-110,70,50,115,131,246,445
10,30,-70,117,129,246,458
20,40,-80,115,131,246,480
-40,30,-130,132,114,246,482
-140,50,50,115,131,246,480
0,-70,-70,122,124,246,425
30,-70,-130,124,122,246,518
10,70,-180,125,121,246,428
-60,50,-100,126,120,246,465
-160,30,40,112,134,246,454
10,70,180,125,121,246,428
150,0,30,121,125,246,438
10,-80,-60,125,121,246,416
-100,-60,-160,119,127,246,524
-10,10,-160,124,122,246,484
-180,-10,140,130,116,246,384
50,-70,-80,115,132,247,409
-30,-60,170,125,122,247,446
-10,20,-160,129,118,247,461
-20,10,-150,126,121,247,475
-50,-40,-170,122,125,247,462
150,60,140,120,127,247,516
110,70,160,116,131,247,548
140,60,60,115,132,247,412
60,60,160,118,129,247,507
140,-70,0,118,130,248,486
-60,40,-60,125,123,248,487
90,-80,-50,113,135,248,399
130,70,150,110,138,248,455
130,60,80,130,118,248,433
150,20,40,131,117,248,475
170,-40,140,126,122,248,483
-30,-30,-170,126,122,248,397
-170,10,30,116,132,248,468
-30,40,-140,129,119,248,459
-60,80,-110,122,126,248,444
-90,-50,160,115,133,248,455
-30,-30,-70,115,133,248,471
-50,-70,150,127,122,249,445
150,-60,10,127,122,249,476
40,70,-100,116,133,249,491
60,70,-130,121,128,249,531
10,30,-170,116,133,249,415
-160,-20,40,114,135,249,428
180,-70,30,117,132,249,451
-50,30,-110,123,126,249,487
20,-20,-150,125,124,249,472
140,50,110,112,137,249,497
-140,-10,100,123,126,249,510
-10,30,-160,130,119,249,467
-180,-70,30,117,132,249,451
-170,-20,150,115,134,249,485
-180,-90,30,121,129,250,491
-180,20,30,117,133,250,405
-20,-90,-170,121,129,250,491
-80,-90,130,121,129,250,491
90,80,-150,109,141,250,522
120,-90,-30,121,129,250,491
-100,-50,170,114,136,250,522
180,-90,30,121,129,250,491
140,-90,-10,121,129,250,491
-140,-40,150,119,131,250,557
-30,-90,-180,121,129,250,491
-10,-30,-170,126,124,250,489
-130,-90,80,121,129,250,491
-40,-90,170,121,129,250,491
100,-90,-50,121,129,250,491
-110,-90,100,121,129,250,491
170,20,30,119,131,250,411
110,-90,-40,121,129,250,491
20,-90,-130,121,129,250,491
130,-90,-20,121,129,250,491
-10,-90,-160,121,129,250,491
30,-90,-120,121,129,250,491
60,-90,-90,121,129,250,491
70,-90,-80,121,129,250,491
-100,-90,110,121,129,250,491
-60,-90,150,121,129,250,491
0,-90,-150,121,129,250,491
70,80,-130,111,139,250,535
170,-90,20,121,129,250,491
-30,-90,180,121,129,250,491
150,-90,0,121,129,250,491
-70,-90,140,121,129,250,491
80,-90,-70,121,129,250,491
-170,-90,40,121,129,250,491
50,-90,-100,121,129,250,491
10,-90,-140,121,129,250,491
-140,-90,70,121,129,250,491
-120,-90,90,121,129,250,491
-50,-90,160,121,129,250,491
-70,-60,150,121,129,250,456
100,-70,10,123,127,250,394
0,60,-170,127,123,250,409
-90,-90,120,121,129,250,491
160,-90,10,121,129,250,491
180,20,30,117,133,250,405
-150,-90,60,121,129,250,491
90,-90,-60,121,129,250,491
-10,10,-40,126,124,250,450
-160,-90,50,121,129,250,491
40,-90,-110,121,129,250,491
-160,-80,50,124,127,251,454
-140,30,70,128,123,251,399
-110,60,10,117,134,251,452
150,50,130,126,125,251,522
80,-80,0,121,130,251,454
-60,-80,-110,120,131,251,466
80,-80,-60,113,138,251,400
0,0,-50,119,132,251,398
160,-50,120,123,128,251,450
40,50,-140,116,135,251,486
140,-20,50,127,124,251,459
40,80,-90,123,128,251,531
-150,-50,160,121,130,251,542
180,-30,150,123,129,252,504
-180,-30,150,123,129,252,504
150,-40,100,121,131,252,412
40,-80,-40,109,143,252,402
-70,60,-10,122,130,252,492
150,30,40,124,128,252,482
70,-80,-70,113,139,252,403
-40,60,-20,122,130,252,408
-140,-30,60,125,127,252,470
70,60,170,120,132,252,483
-170,70,10,124,129,253,443
140,40,90,121,132,253,487
10,0,-70,119,134,253,381
-140,50,40,123,130,253,529
-120,60,10,125,128,253,471
20,80,170,130,123,253,467
160,-20,110,123,130,253,428
-140,50,70,117,137,254,469
-80,-60,-130,124,130,254,463
60,60,-140,110,144,254,610
-60,-50,-110,118,136,254,449
-140,-60,170,119,135,254,543
0,0,-170,134,120,254,488
0,20,-50,126,128,254,419
30,-60,-80,124,131,255,421
0,50,-170,124,131,255,449
160,50,140,127,128,255,431
-10,-30,-70,123,132,255,541
-160,-50,160,125,130,255,481
-70,-50,170,118,137,255,429
-40,-10,-60,128,127,255,460
120,-60,40,114,141,255,478
-140,40,80,120,135,255,476
-170,10,140,123,132,255,426
20,-80,-130,120,135,255,489
-150,30,50,121,135,256,523
-50,-60,-90,121,135,256,470
30,50,180,130,126,256,488
-40,-60,-80,126,130,256,458
-180,60,130,125,131,256,483
180,60,130,125,131,256,483
20,-20,-140,129,127,256,499
30,50,-180,130,126,256,488
30,-80,-120,121,135,256,504
-90,-50,-170,125,131,256,502
140,60,140,122,134,256,525
20,-10,-160,127,129,256,459
0,-10,-60,124,132,256,410
-90,70,30,120,136,256,404
70,60,160,120,136,256,516
80,80,-140,110,147,257,542
140,-30,70,126,131,257,406
150,10,80,126,131,257,435
-180,-50,150,126,131,257,465
-160,-70,160,122,135,257,527
80,60,150,121,136,257,514
10,20,-70,121,136,257,472
150,-60,100,126,131,257,451
170,-20,130,133,124,257,440
180,-50,150,126,131,257,465
-170,50,20,129,128,257,458
-140,30,90,134,123,257,390
110,-70,-20,118,139,257,451
-70,70,-100,127,131,258,433
-50,-80,-100,122,136,258,495
150,70,150,121,137,258,461
-10,0,-40,128,130,258,439
50,-70,-60,124,134,258,398
-50,-50,170,123,135,258,468
130,-30,30,129,130,259,411
-20,-10,-160,126,133,259,481
60,70,140,132,127,259,448
-40,0,-130,134,125,259,482
-30,10,-140,127,132,259,521
120,60,100,132,127,259,456
80,70,-160,120,139,259,575
10,-40,-90,122,137,259,518
-120,-60,80,127,132,259,385
-110,-40,130,119,140,259,522
150,90,40,135,125,260,494
10,90,-180,135,125,260,494
-40,90,-130,135,125,260,494
-40,40,-40,119,141,260,482
-170,90,0,135,125,260,494
10,90,180,135,125,260,494
100,90,90,135,125,260,494
120,90,70,135,125,260,494
0,90,-170,135,125,260,494
180,-50,20,129,131,260,520
-150,-70,170,117,143,260,531
-90,90,-80,135,125,260,494
180,90,10,135,125,260,494
-110,90,-60,135,125,260,494
110,90,80,135,125,260,494
-120,90,-50,135,125,260,494
-40,-40,-80,131,129,260,465
170,90,20,135,125,260,494
-80,80,-90,128,132,260,482
-60,90,-110,135,125,260,494
-100,90,-70,135,125,260,494
20,90,170,135,125,260,494
130,70,70,133,127,260,450
70,90,120,135,125,260,494
130,60,130,114,146,260,556
140,90,50,135,125,260,494
60,90,130,135,125,260,494
-180,90,10,135,125,260,494
80,90,110,135,125,260,494
130,-60,0,122,138,260,512
-160,90,-10,135,125,260,494
-130,90,-40,135,125,260,494
-50,90,-120,135,125,260,494
20,10,-160,131,129,260,465
50,90,140,135,125,260,494
-70,90,-100,135,125,260,494
-140,90,-30,135,125,260,494
160,90,30,135,125,260,494
40,90,150,135,125,260,494
-10,90,-160,135,125,260,494
-20,90,-150,135,125,260,494
-80,90,-90,135,125,260,494
50,60,160,130,130,260,491
-150,90,-20,135,125,260,494
-180,-50,20,129,131,260,520
130,90,60,135,125,260,494
-30,90,-140,135,125,260,494
30,90,160,135,125,260,494
90,90,100,135,125,260,494
-30,-50,-70,129,132,261,483
-50,30,-50,128,133,261,450
150,20,100,128,133,261,399
120,-50,20,130,131,261,482
180,50,20,132,129,261,463
20,50,180,127,134,261,444
-60,50,-40,130,131,261,471
30,70,-80,119,142,261,525
-50,10,-100,135,126,261,466
-150,40,40,132,129,261,538
-170,-80,40,129,132,261,502
140,-40,80,134,127,261,498
-180,50,20,132,129,261,463
20,50,-180,127,134,261,444
-60,-50,170,125,137,262,472
-180,30,30,126,136,262,455
-80,-50,160,120,142,262,499
-60,30,-70,126,136,262,445
180,-80,30,128,134,262,532
150,-20,20,131,131,262,486
20,-10,-90,125,137,262,503
-140,-10,120,128,134,262,498
30,80,160,140,122,262,467
-180,-80,30,128,134,262,532
180,30,30,126,136,262,455
150,-50,10,129,133,262,479
-160,40,130,125,137,262,417
-100,70,40,119,143,262,416
170,40,30,127,135,262,454
120,-50,30,130,133,263,506
120,70,160,120,143,263,547
10,20,-170,127,136,263,452
-150,50,30,128,135,263,571
-90,-50,150,115,148,263,477
70,60,180,122,141,263,488
180,-40,150,132,131,263,514
0,-40,-170,135,128,263,508
130,-40,20,134,129,263,467
70,60,-180,122,141,263,488
-180,-40,150,132,131,263,514
-140,-70,60,134,129,263,463
-80,60,0,119,145,264,497
-80,-50,-150,128,136,264,513
-40,-50,-80,132,132,264,448
-10,-50,-70,125,139,264,517
-110,70,-40,128,136,264,521
40,-80,-110,124,140,264,521
-10,-60,-70,121,143,264,500
-70,60,-90,136,128,264,454
140,-10,40,137,127,264,451
0,40,-170,126,138,264,445
40,-70,-110,125,139,264,511
140,50,70,131,133,264,479
90,70,-170,126,138,264,621
-140,-50,160,123,141,264,611
50,70,-110,128,136,264,604
-50,0,-80,127,137,264,419
-50,-70,-90,133,131,264,503
-170,-70,150,126,138,264,563
-10,20,-40,134,130,264,413
150,80,160,129,135,264,401
-60,-70,-100,134,131,265,502
-140,70,-10,137,128,265,472
-60,40,-90,131,134,265,549
-130,-40,150,124,141,265,587
-50,0,-90,126,139,265,437
30,40,-110,121,144,265,559
40,-90,-20,123,143,266,460
-40,-90,-100,123,143,266,460
10,-90,-50,123,143,266,460
-160,-90,140,123,143,266,460
-80,-90,-140,123,143,266,460
-60,-90,-120,123,143,266,460
170,-90,110,123,143,266,460
160,60,140,131,135,266,558
-180,-70,140,131,135,266,556
150,0,80,132,134,266,468
-140,50,30,128,138,266,564
160,-90,100,123,143,266,460
130,-90,70,123,143,266,460
-130,-90,170,123,143,266,460
70,-90,10,123,143,266,460
60,-90,0,123,143,266,460
-180,-90,120,123,143,266,460
-50,-90,-110,123,143,266,460
-10,-90,-70,123,143,266,460
-100,-90,-160,123,143,266,460
140,-90,80,123,143,266,460
-70,-90,-130,123,143,266,460
80,-90,20,123,143,266,460
50,-90,-10,123,143,266,460
-60,-40,-160,130,136,266,433
-90,-90,-150,123,143,266,460
-30,-90,-90,123,143,266,460
-20,-90,-80,123,143,266,460
110,-90,50,123,143,266,460
-120,-90,180,123,143,266,460
-110,-90,-170,123,143,266,460
180,-90,120,123,143,266,460
-140,-70,-180,124,142,266,520
180,-70,140,131,135,266,556
-120,-90,-180,123,143,266,460
0,-90,-60,123,143,266,460
-50,50,-120,135,131,266,489
20,-90,-40,123,143,266,460
90,-90,30,123,143,266,460
-140,-90,160,123,143,266,460
-160,70,0,127,139,266,476
-170,-90,130,123,143,266,460
100,-90,40,123,143,266,460
-150,-90,150,123,143,266,460
-140,-70,180,124,142,266,520
-20,-60,-70,126,140,266,500
30,-90,-30,123,143,266,460
-100,60,0,124,142,266,479
150,-90,90,123,143,266,460
120,-90,60,123,143,266,460
10,50,-180,123,144,267,465
10,50,180,123,144,267,465
-130,-20,110,125,142,267,527
20,-20,-130,127,140,267,499
90,-70,-20,127,140,267,428
140,-50,10,132,135,267,511
20,-20,-120,121,146,267,529
-90,80,-80,132,135,267,510
160,-40,10,131,136,267,478
-150,-30,150,128,139,267,519
-140,20,80,128,139,267,466
-20,70,-160,139,128,267,479
10,-30,-100,133,134,267,552
-180,10,140,132,135,267,501
90,60,140,130,137,267,496
40,50,-150,122,145,267,509
40,50,-160,125,142,267,520
-90,60,-10,132,135,267,514
180,10,140,132,135,267,501
160,-10,110,131,136,267,465
180,-20,20,137,131,268,460
-30,70,-150,137,131,268,494
160,-50,10,133,135,268,524
170,-10,20,132,136,268,444
-180,-80,130,128,140,268,542
-170,40,140,132,136,268,434
-110,-40,140,128,140,268,582
30,40,-100,126,142,268,499
180,-80,130,128,140,268,542
-180,-20,20,137,131,268,460
0,-20,-70,135,133,268,473
50,-70,-90,125,143,268,484
-100,80,-70,133,135,268,504
-160,0,140,129,140,269,522
30,-70,-60,130,139,269,416
-30,-80,170,134,135,269,509
160,20,30,129,140,269,489
-140,-10,90,133,136,269,538
170,-70,20,128,141,269,537
-130,-70,70,137,132,269,465
-20,-30,-60,127,142,269,554
-130,-70,-170,133,136,269,505
-160,40,30,125,144,269,524
-60,-60,150,134,135,269,494
130,-80,70,126,143,269,475
140,50,120,123,146,269,542
-130,-60,-180,125,144,269,542
70,-80,-10,126,143,269,488
70,60,-170,121,148,269,494
-130,-60,180,125,144,269,542
140,80,170,130,139,269,433
0,-60,-70,126,144,270,470
10,60,-180,130,140,270,428
50,50,-140,125,145,270,546
50,80,-100,128,142,270,548
-40,70,-10,128,142,270,377
-130,-30,140,116,154,270,576
50,-80,-30,116,154,270,454
-180,70,130,132,138,270,462
180,70,130,132,138,270,462
-90,70,-70,137,133,270,490
10,60,180,130,140,270,428
-160,-40,30,132,138,270,495
-170,30,30,128,142,270,529
0,-10,-170,131,139,270,492
-20,-80,-180,136,134,270,524
0,-30,-170,135,135,270,542
-10,-80,-170,137,133,270,542
120,-60,0,127,143,270,504
-20,-80,180,136,134,270,524
40,50,-110,129,141,270,540
-40,-50,170,137,134,271,492
-140,20,70,128,143,271,441
160,-80,10,131,140,271,575
-50,-30,-150,123,148,271,491
-180,-10,20,135,136,271,488
-120,-40,100,127,144,271,530
-170,20,30,132,139,271,539
-60,-70,140,134,137,271,474
70,70,130,139,132,271,509
180,-10,20,135,136,271,488
170,-80,20,134,137,271,556
70,70,-140,124,147,271,610
50,60,-120,113,158,271,568
90,-70,-30,135,137,272,449
-30,60,-150,139,133,272,512
40,60,160,133,139,272,476
-10,-40,-70,135,137,272,537
-140,50,80,130,142,272,498
-140,70,90,129,143,272,430
140,50,60,131,141,272,480
-110,80,-60,135,137,272,514
120,60,120,131,141,272,526
180,20,140,134,138,272,471
-180,20,140,134,138,272,471
-20,-10,-40,135,137,272,496
10,-40,-160,141,131,272,493
-30,-60,-70,137,135,272,516
0,30,-170,137,136,273,465
-120,-40,150,128,145,273,618
-80,60,-40,121,152,273,496
-20,-20,-170,134,139,273,512
170,-30,140,137,136,273,518
-40,-20,-150,131,142,273,441
40,-70,-120,135,138,273,568
100,-80,30,133,140,273,498
110,-60,10,129,144,273,529
-90,60,10,123,150,273,484
0,60,-40,126,147,273,438
30,40,-150,127,146,273,591
-130,-20,120,130,143,273,583
-110,60,30,117,157,274,449
130,-70,-10,127,147,274,505
130,-50,10,138,136,274,518
-120,-70,80,140,134,274,464
130,-30,40,134,140,274,422
20,20,-170,134,140,274,481
50,-80,-100,128,146,274,530
60,-80,-20,123,151,274,490
20,40,-170,139,135,274,496
20,30,-170,134,140,274,461
-40,-80,160,137,137,274,506
170,-80,120,133,142,275,549
160,-60,120,132,143,275,533
30,-60,-130,140,135,275,499
-10,0,-170,137,138,275,503
10,-60,-70,135,140,275,472
80,60,160,132,143,275,516
-10,-80,-70,132,143,275,503
-140,40,90,129,146,275,500
-150,60,100,128,147,275,489
-170,-60,30,125,150,275,509
170,0,20,129,147,276,492
-70,-70,130,135,141,276,485
-70,-70,-110,137,139,276,549
20,-40,-120,130,146,276,564
-140,-20,70,131,145,276,474
20,-50,-140,138,138,276,487
50,50,-150,132,144,276,554
-20,30,-160,142,134,276,543
-100,-50,120,129,147,276,483
-90,-60,120,125,151,276,484
20,-20,-110,126,150,276,565
-40,20,-130,134,142,276,547
110,-70,40,141,135,276,486
40,50,170,135,141,276,555
0,-80,-160,138,139,277,547
100,70,180,129,148,277,625
100,70,-180,129,148,277,625
20,-80,-50,139,138,277,499
-40,-60,160,136,141,277,482
-110,-50,170,128,149,277,576
110,60,120,128,149,277,521
90,60,150,134,143,277,518
-140,40,70,136,141,277,502
140,-40,10,141,136,277,523
80,60,140,134,143,277,539
150,40,40,138,139,277,492
160,-10,20,133,145,278,489
20,-40,-130,137,141,278,559
60,-70,-60,127,151,278,439
-80,60,-50,125,153,278,544
-30,50,-30,134,144,278,449
100,-80,-50,132,146,278,568
0,50,-40,129,149,278,406
-110,-60,90,133,145,278,449
-180,0,20,140,139,279,518
110,-80,-40,133,146,279,580
-20,-50,180,137,142,279,472
20,70,170,141,138,279,498
170,-50,140,143,136,279,531
120,70,80,142,137,279,490
-100,-50,180,128,151,279,596
180,0,20,140,139,279,518
-100,-50,-180,128,151,279,596
150,10,30,143,136,279,539
-150,-70,50,133,146,279,493
-60,60,-110,143,136,279,482
-20,-50,-180,137,142,279,472
140,30,60,136,143,279,512
60,-80,-90,129,150,279,535
10,-80,-150,141,139,280,566
20,0,-160,137,143,280,560
160,-80,110,134,146,280,556
-40,10,-130,134,146,280,562
40,-60,-110,142,138,280,512
-110,-70,90,142,138,280,485
170,30,30,133,147,280,488
-100,-70,100,143,137,280,489
170,20,130,139,141,280,458
-50,-80,150,138,142,280,498
150,-80,0,136,144,280,588
20,20,-90,138,142,280,536
140,-20,60,129,151,280,563
-50,-20,-100,141,139,280,505
160,10,110,132,148,280,538
160,-60,10,140,141,281,559
0,10,-170,149,132,281,559
-180,50,140,139,142,281,491
140,30,70,133,148,281,489
-150,-60,170,133,148,281,596
30,0,-130,131,150,281,531
-100,-60,100,133,148,281,523
-170,60,130,142,139,281,487
40,80,150,149,132,281,500
0,70,-40,135,146,281,481
-150,-40,40,134,147,281,482
180,50,140,139,142,281,491
-130,60,10,138,143,281,528
30,-50,-100,135,147,282,587
20,50,-70,128,154,282,549
40,60,-100,121,161,282,534
-10,-70,-70,133,149,282,546
-150,-10,140,141,141,282,495
160,30,30,137,145,282,528
20,30,-90,131,151,282,555
-170,-40,20,137,145,282,546
80,60,170,134,148,282,509
10,70,-50,137,145,282,502
110,70,170,126,156,282,618
160,-30,10,146,136,282,562
50,50,180,131,152,283,558
-20,60,-160,147,136,283,549
50,50,-180,131,152,283,558
110,60,110,136,147,283,523
110,70,90,144,139,283,541
-60,30,-80,136,147,283,508
10,60,-50,135,148,283,435
-60,-40,-170,130,153,283,495
30,30,-140,131,152,283,559
-110,-40,150,135,148,283,619
80,70,-150,132,151,283,676
-170,-30,20,141,142,283,522
-90,-70,110,143,140,283,517
-120,80,-50,140,143,283,533
-30,40,-150,153,130,283,592
140,-60,0,138,146,284,573
-30,30,-150,146,138,284,557
70,60,150,137,147,284,553
40,-60,-100,138,146,284,476
170,60,140,138,146,284,489
-40,70,-140,149,135,284,502
60,70,-120,136,148,284,679
20,-80,-140,140,144,284,586
-150,-20,50,140,144,284,507
-150,-50,40,137,147,284,455
170,50,140,148,136,284,417
180,-60,150,140,144,284,542
-180,-60,150,140,144,284,542
-80,60,-60,132,152,284,566
170,-70,130,138,146,284,554
10,-30,-160,143,141,284,537
-180,40,20,148,137,285,517
70,60,-160,133,152,285,618
-150,0,130,146,139,285,520
150,-40,10,144,141,285,494
100,-70,-30,130,155,285,498
140,-80,-10,137,148,285,584
180,40,20,148,137,285,517
120,-50,10,142,143,285,540
-140,-10,80,141,144,285,571
30,-50,-110,133,153,286,545
-50,-30,-100,141,145,286,542
50,-70,-100,134,152,286,572
-120,-50,170,123,163,286,608
170,-30,10,145,141,286,557
-120,-70,-160,148,138,286,547
-80,-70,120,148,139,287,507
20,40,180,142,145,287,524
100,70,100,149,138,287,546
50,80,140,152,135,287,508
-60,-80,140,144,143,287,519
-140,20,60,141,146,287,454
130,70,160,133,154,287,539
-160,50,20,139,148,287,548
150,50,140,141,146,287,580
30,40,-160,138,149,287,601
20,40,-180,142,145,287,524
0,-50,-70,135,153,288,569
-50,40,-120,148,140,288,566
-180,10,20,144,144,288,544
30,40,-120,129,159,288,652
10,0,-170,142,146,288,537
180,10,20,144,144,288,544
160,-70,10,140,148,288,594
80,60,-180,137,151,288,550
-40,60,-140,144,144,288,523
0,20,-170,154,134,288,564
140,30,80,138,150,288,502
100,60,130,141,147,288,573
120,60,90,143,145,288,524
80,60,180,137,151,288,550
160,-30,120,139,149,288,521
160,40,30,143,145,288,530
10,30,-60,148,140,288,528
-140,10,80,138,151,289,544
10,-10,-170,146,143,289,489
-20,50,-30,142,147,289,497
-80,-70,-120,146,143,289,567
-120,60,50,133,156,289,526
180,-20,150,141,148,289,579
-110,60,0,137,152,289,519
-110,-50,100,129,160,289,523
120,-80,-30,139,150,289,587
-140,-20,140,135,154,289,530
-180,-20,150,141,148,289,579
-50,20,-110,141,148,289,529
-10,-20,-50,141,148,289,485
-100,60,20,127,162,289,501
-170,-50,160,146,143,289,535
70,-80,-80,138,151,289,542
160,30,130,145,144,289,427
10,-20,-80,137,152,289,577
140,50,130,137,153,290,595
170,70,20,151,139,290,551
50,50,-160,138,152,290,565
-150,50,110,140,150,290,528
-150,30,120,142,148,290,478
-80,-60,130,134,156,290,510
170,10,20,136,154,290,518
30,70,160,147,143,290,502
90,60,130,136,154,290,531
170,70,140,140,150,290,550
80,-80,-70,136,154,290,560
120,-80,60,136,154,290,529
150,30,120,140,150,290,479
30,40,-140,135,155,290,625
90,-70,-10,142,148,290,478
150,60,40,149,141,290,473
-40,-80,-90,138,152,290,552
0,-50,-170,145,146,291,529
30,50,-90,128,163,291,595
-130,70,-20,148,143,291,547
-10,-20,-170,144,147,291,578
130,80,-180,145,146,291,475
10,-30,-90,143,148,291,643
50,50,-170,133,158,291,557
130,80,180,145,146,291,475
130,-80,-20,141,151,292,591
-60,60,-10,137,155,292,538
-40,-70,-80,149,143,292,560
-70,-80,130,147,145,292,525
90,60,160,136,156,292,563
-50,20,-50,147,145,292,425
80,70,120,153,139,292,533
0,40,-40,135,157,292,427
-60,-60,-100,139,153,292,544
-10,60,-170,151,141,292,564
20,-30,-140,149,143,292,598
20,-30,-130,147,145,292,596
80,-70,-40,142,150,292,518
-160,-40,160,145,147,292,575
-10,70,-170,153,139,292,525
100,60,140,140,152,292,579
50,50,-130,140,152,292,578
-70,-60,140,138,154,292,565
140,-10,60,146,146,292,530
110,80,-160,142,151,293,535
150,-50,110,144,149,293,516
160,70,30,150,143,293,520
30,50,170,143,150,293,543
10,-50,-160,147,146,293,520
160,20,20,149,144,293,539
180,-60,20,142,151,293,560
-180,-60,20,142,151,293,560
-20,-40,-60,140,153,293,607
120,80,-170,143,150,293,506
-90,-60,-140,142,151,293,585
170,-40,10,147,146,293,569
-60,20,-70,148,145,293,447
-160,60,10,149,145,294,568
-140,-80,180,137,157,294,594
10,10,-170,145,149,294,583
60,-70,-70,139,155,294,467
-30,20,-150,152,142,294,550
170,80,20,146,148,294,530
20,-40,-110,140,154,294,633
180,80,10,141,153,294,528
-90,-50,-160,135,159,294,586
-160,-30,30,141,153,294,555
-20,0,-160,142,152,294,550
140,-10,50,152,142,294,484
130,-60,70,144,150,294,517
-140,-80,-180,137,157,294,594
130,60,140,128,166,294,624
-180,80,10,141,153,294,528
110,-60,0,139,155,294,569
100,-70,20,139,156,295,463
150,-30,10,147,148,295,562
20,-70,-60,140,155,295,480
-40,50,-30,137,158,295,494
-170,60,10,148,147,295,511
-70,50,-60,142,153,295,596
90,-80,-60,139,156,295,574
-20,10,-160,148,147,295,553
-140,0,100,153,142,295,610
180,60,140,146,150,296,494
-10,-10,-170,150,146,296,592
-150,-20,150,138,158,296,552
20,60,170,145,151,296,509
60,80,130,159,137,296,523
-60,80,-120,149,147,296,547
-50,80,-130,150,146,296,541
30,30,-150,143,153,296,594
-50,-40,180,140,156,296,548
-20,-70,170,137,159,296,520
-180,60,140,146,150,296,494
40,70,150,158,138,296,524
90,70,110,158,138,296,537
-50,-40,-180,140,156,296,548
150,10,90,152,144,296,581
50,50,170,142,154,296,571
150,50,40,151,145,296,511
30,-80,-130,142,154,296,606
-160,-10,150,151,146,297,589
160,10,20,137,160,297,555
160,0,20,142,155,297,518
-40,80,-140,152,145,297,530
-130,-40,70,130,167,297,495
-90,-80,110,144,153,297,561
-150,70,-10,148,149,297,544
-140,0,90,149,148,297,625
-20,20,-160,155,142,297,568
30,20,-130,141,156,297,595
-150,60,10,147,150,297,619
60,80,-110,139,158,297,570
-10,60,-30,139,158,297,513
-110,-70,-150,145,152,297,580
30,-50,-120,147,150,297,581
150,20,30,150,148,298,570
-30,50,-150,150,148,298,582
-170,40,20,151,147,298,558
-100,-70,-140,147,151,298,585
-30,-20,-50,146,152,298,525
-130,80,-40,151,147,298,557
-10,-70,180,138,160,298,499
10,40,-180,143,155,298,503
10,40,180,143,155,298,503
-30,80,-150,155,143,298,554
140,-20,20,144,154,298,577
120,-70,-20,139,159,298,535
90,-80,20,144,154,298,583
110,60,130,144,154,298,613
-120,70,-30,148,150,298,585
-110,-40,120,136,162,298,578
-10,-70,-180,138,160,298,499
-130,-30,80,139,160,299,527
20,-20,-160,153,146,299,503
-50,-20,-110,146,153,299,546
20,-50,-80,137,162,299,587
-40,-10,-140,148,151,299,515
70,60,-150,141,158,299,674
0,80,-40,143,156,299,547
160,20,120,147,152,299,513
120,-50,40,143,156,299,544
60,60,150,148,151,299,570
170,10,130,139,160,299,516
30,30,-130,144,155,299,598
-120,-80,-160,139,161,300,605
-90,60,-20,142,158,300,586
-10,-60,-180,144,156,300,531
-160,0,30,151,149,300,563
170,30,140,155,145,300,518
-10,-60,180,144,156,300,531
170,40,140,148,152,300,450
-30,10,-150,150,150,300,618
130,-40,60,147,153,300,568
-90,-50,140,136,164,300,563
-170,80,0,144,156,300,530
-10,70,-30,141,160,301,504
70,80,-120,141,160,301,558
120,-70,60,150,151,301,534
150,-10,90,138,163,301,619
30,10,-120,142,159,301,648
160,80,30,151,150,301,550
150,-70,0,149,152,301,635
-140,40,60,157,144,301,555
30,0,-120,142,159,301,564
-30,60,-20,143,158,301,492
-20,40,-160,157,144,301,597
140,-50,90,140,162,302,486
-150,30,40,142,160,302,689
-130,-50,170,139,163,302,654
0,-70,-170,140,162,302,494
-100,-80,100,149,153,302,567
160,50,30,152,150,302,530
-140,-30,150,136,166,302,630
20,-60,-70,150,152,302,514
-70,80,-110,152,150,302,572
110,-60,20,141,161,302,567
-150,-80,170,148,154,302,586
70,80,120,162,140,302,536
-160,80,-10,149,154,303,549
150,70,40,155,148,303,522
-40,-40,180,148,155,303,601
30,40,-170,152,151,303,649
-80,60,-70,143,160,303,599
-90,-70,-130,152,151,303,589
-40,50,-140,150,153,303,559
170,50,20,156,147,303,560
100,80,-150,142,161,303,570
-40,-40,-180,148,155,303,601
-140,60,10,144,159,303,578
40,40,-120,140,163,303,632
150,80,40,152,151,303,540
-80,-80,120,149,154,303,549
-110,-80,90,152,151,303,573
40,70,-90,144,159,303,657
140,40,50,152,151,303,544
-130,-80,-170,141,162,303,597
-150,-40,160,147,156,303,619
100,60,150,145,158,303,615
-160,-50,30,153,151,304,528
40,-80,-120,147,157,304,620
-170,-60,160,149,155,304,566
80,80,110,165,139,304,553
-120,-60,-170,140,164,304,617
-150,-10,50,148,156,304,530
-110,-80,-150,146,158,304,599
-80,70,-90,151,153,304,496
-160,-70,40,142,162,304,545
140,60,50,153,151,304,533
-140,10,60,141,163,304,487
-50,70,-130,157,147,304,517
120,-60,-10,148,156,304,600
160,60,30,157,148,305,491
-60,70,-120,159,146,305,525
150,40,130,150,155,305,605
-20,80,-160,159,146,305,573
130,60,70,153,152,305,506
150,-20,90,138,167,305,570
-120,-80,80,151,154,305,594
90,70,-160,141,164,305,678
-20,50,-160,152,153,305,581
30,20,-120,148,158,306,608
-30,-70,160,148,158,306,549
170,0,130,148,158,306,569
150,-10,20,150,156,306,546
30,-10,-130,144,162,306,599
120,60,130,137,169,306,672
20,-40,-140,151,155,306,619
10,80,-50,144,162,306,553
-100,70,-60,149,157,306,584
120,-60,50,144,162,306,581
40,-60,-90,145,161,306,492
0,70,-180,160,147,307,560
130,50,90,154,153,307,601
0,70,180,160,147,307,560
160,-70,120,149,158,307,624
160,-40,130,152,155,307,542
-50,50,-30,150,157,307,535
170,-40,150,155,152,307,603
30,-50,-90,148,159,307,603
150,-80,100,145,162,307,590
20,-30,-150,162,145,307,633
-30,0,-40,152,155,307,533
150,30,30,151,156,307,575
10,50,-50,148,159,307,463
20,50,170,152,155,307,522
30,60,-80,145,163,308,544
60,60,-130,139,169,308,714
30,20,-150,150,158,308,633
130,50,80,155,153,308,619
70,-70,-50,149,159,308,518
-10,80,-30,148,160,308,545
-100,-80,-140,152,156,308,603
30,-10,-120,139,169,308,626
140,70,160,147,161,308,574
100,60,120,148,160,308,587
170,20,20,153,155,308,552
140,80,50,155,153,308,542
0,-60,-170,151,157,308,542
-70,-50,160,157,151,308,580
80,80,-130,144,164,308,572
140,-30,10,156,153,309,592
50,-70,-110,149,160,309,631
-130,70,80,147,162,309,522
130,-50,70,147,162,309,493
-10,10,-170,156,153,309,574
-150,10,40,146,163,309,487
100,80,90,162,147,309,553
140,30,50,152,157,309,556
60,-80,-100,151,158,309,647
-140,-50,50,160,149,309,486
50,-80,-110,150,159,309,634
-170,-10,150,147,162,309,576
-60,-40,-120,147,162,309,647
10,-20,-170,152,158,310,548
-140,-60,180,148,162,310,635
170,40,20,157,153,310,535
-130,-80,70,152,158,310,617
-140,-60,-180,148,162,310,635
140,40,100,147,163,310,564
-40,0,-50,156,154,310,506
-170,-70,30,146,164,310,609
150,-60,110,155,155,310,628
-140,0,70,148,162,310,554
90,-70,-40,147,163,310,539
60,-70,-50,142,168,310,514
50,-70,-50,141,169,310,541
-140,80,-30,159,152,311,575
-140,10,70,140,171,311,520
90,80,-140,146,165,311,578
130,50,110,150,161,311,647
-50,-20,-90,156,155,311,570
20,-40,-100,146,165,311,656
0,-40,-70,151,160,311,641
-50,60,-130,160,151,311,557
-60,20,-80,154,158,312,483
-40,40,-140,161,151,312,612
120,70,170,140,172,312,651
90,80,100,167,145,312,562
-20,-30,-180,154,158,312,574
30,10,-130,150,162,312,616
110,70,180,147,165,312,638
30,40,-130,137,175,312,683
-20,-30,180,154,158,312,574
110,70,-180,147,165,312,638
0,-20,-170,159,153,312,582
20,80,-60,148,164,312,561
60,-70,-80,144,168,312,539
-150,80,-20,155,157,312,558
140,-60,90,155,157,312,535
170,-20,10,157,155,312,578
-20,90,-20,150,163,313,462
-20,-50,-60,145,168,313,617
0,60,-180,158,155,313,578
40,-60,-120,158,155,313,589
130,90,-170,150,163,313,462
-120,90,80,150,163,313,462
20,90,-60,150,163,313,462
-40,90,0,150,163,313,462
-60,90,20,150,163,313,462
140,90,180,150,163,313,462
-130,90,90,150,163,313,462
-150,90,110,150,163,313,462
160,-50,130,157,156,313,577
-170,0,20,157,156,313,598
-50,90,10,150,163,313,462
-140,90,100,150,163,313,462
-100,90,60,150,163,313,462
100,90,-140,150,163,313,462
-10,90,-30,150,163,313,462
110,90,-150,150,163,313,462
10,90,-50,150,163,313,462
50,90,-90,150,163,313,462
-160,90,120,150,163,313,462
0,60,180,158,155,313,578
-100,-40,140,149,164,313,617
-180,90,140,150,163,313,462
140,90,-180,150,163,313,462
90,90,-130,150,163,313,462
160,90,160,150,163,313,462
40,90,-80,150,163,313,462
60,90,-100,150,163,313,462
170,90,150,150,163,313,462
150,90,170,150,163,313,462
-70,90,30,150,163,313,462
80,90,-120,150,163,313,462
-170,90,130,150,163,313,462
-110,90,70,150,163,313,462
-120,-40,90,139,174,313,622
-30,90,-10,150,163,313,462
70,90,-110,150,163,313,462
30,90,-70,150,163,313,462
120,90,-160,150,163,313,462
180,90,140,150,163,313,462
-100,-60,-150,158,155,313,677
-140,20,90,150,163,313,569
-80,90,40,150,163,313,462
0,90,-40,150,163,313,462
-90,90,50,150,163,313,462
110,80,80,163,150,313,558
-90,-80,-130,160,154,314,621
-70,-90,130,154,160,314,628
-20,-60,170,153,161,314,563
60,-90,-100,154,160,314,628
10,-90,-150,154,160,314,628
90,-90,-70,154,160,314,628
-160,-80,160,152,162,314,619
40,-90,-120,154,160,314,628
-80,-90,120,154,160,314,628
140,30,90,145,169,314,538
70,-90,-90,154,160,314,628
-160,-90,40,154,160,314,628
-90,-90,110,154,160,314,628
180,-90,20,154,160,314,628
110,-90,-50,154,160,314,628
-130,-20,100,141,173,314,576
-150,-90,50,154,160,314,628
-130,60,70,148,166,314,629
20,-90,-140,154,160,314,628
170,-90,10,154,160,314,628
-20,-90,-180,154,160,314,628
-140,40,50,160,154,314,621
30,-90,-130,154,160,314,628
-20,80,-20,143,171,314,553
-70,50,-70,151,163,314,591
-40,-90,160,154,160,314,628
-30,-90,170,154,160,314,628
130,-90,-30,154,160,314,628
-10,-90,-170,154,160,314,628
-140,30,60,160,154,314,543
-140,-90,60,154,160,314,628
160,-90,0,154,160,314,628
-180,-90,20,154,160,314,628
130,-60,-10,152,162,314,645
80,-90,-80,154,160,314,628
-50,-90,150,154,160,314,628
150,-90,-10,154,160,314,628
90,-70,0,157,157,314,529
120,80,70,163,151,314,549
100,-90,-60,154,160,314,628
50,-90,-110,154,160,314,628
-130,-90,70,154,160,314,628
120,-90,-40,154,160,314,628
-110,-90,90,154,160,314,628
-100,60,-10,152,162,314,587
-60,40,-50,152,162,314,546
-100,-90,100,154,160,314,628
20,70,-60,146,168,314,605
-20,-90,180,154,160,314,628
-170,-90,30,154,160,314,628
-20,-70,-70,145,169,314,600
-170,-40,160,157,157,314,619
0,-90,-160,154,160,314,628
-120,-90,80,154,160,314,628
140,-90,-20,154,160,314,628
-60,-90,140,154,160,314,628
-30,-30,-60,152,163,315,607
0,-30,-70,155,160,315,660
170,-50,10,154,161,315,649
-180,70,10,159,156,315,590
100,70,-170,148,167,315,679
-50,0,-100,156,159,315,542
70,70,-130,145,170,315,716
30,60,160,162,153,315,583
-130,-40,160,151,164,315,708
140,70,50,165,150,315,551
110,-80,50,147,168,315,596
20,-30,-120,156,159,315,626
180,70,10,159,156,315,590
-130,50,40,143,173,316,602
10,70,170,167,149,316,576
10,10,-60,142,174,316,538
50,50,160,159,157,316,581
-170,-10,20,158,158,316,623
130,-40,10,151,165,316,596
140,0,40,159,157,316,576
10,-50,-70,150,166,316,617
-170,-20,20,159,157,316,584
-50,-10,-90,149,167,316,578
-150,50,20,145,171,316,673
-10,50,-170,155,161,316,608
-50,-50,-90,154,162,316,623
-90,60,-30,145,171,316,613
50,70,140,172,144,316,566
80,60,-160,151,166,317,709
20,0,-80,147,170,317,518
-120,-50,80,142,175,317,587
-180,20,20,156,161,317,579
70,60,-140,154,163,317,728
-10,-50,-180,154,163,317,600
140,-10,30,157,160,317,515
-160,60,120,149,168,317,550
-140,0,80,159,158,317,614
140,-70,90,153,164,317,565
30,20,-140,149,168,317,636
-140,-10,130,143,174,317,600
180,20,20,156,161,317,579
150,0,20,160,157,317,599
-10,-50,180,154,163,317,600
0,-80,-60,158,159,317,596
-140,-40,50,158,159,317,515
30,30,-160,153,164,317,591
150,60,150,155,163,318,661
30,-80,-40,152,166,318,592
-180,-10,150,164,154,318,606
-170,-30,160,149,169,318,606
-120,-30,120,142,176,318,680
-150,10,120,152,166,318,619
-70,-60,-110,150,168,318,612
10,-60,-160,153,165,318,526
70,-70,-60,152,166,318,524
-50,10,-110,162,156,318,588
180,-10,150,164,154,318,606
90,60,170,144,174,318,657
20,-20,-100,152,166,318,630
-30,0,-150,163,155,318,663
40,-60,-80,154,164,318,547
20,40,-70,148,170,318,619
-120,60,0,150,168,318,590
130,80,60,167,151,318,550
-80,80,-100,158,160,318,590
170,-20,140,161,158,319,601
30,20,-110,159,160,319,657
-80,-50,150,141,178,319,610
160,-20,10,163,156,319,612
-10,30,-170,163,156,319,595
-40,-70,150,152,167,319,605
10,-70,-160,152,167,319,536
-50,70,0,148,171,319,500
10,-40,-80,139,180,319,659
20,-60,-150,161,158,319,540
130,50,100,156,163,319,600
80,70,-140,149,170,319,713
-60,20,-60,150,170,320,545
-10,-10,-40,158,162,320,555
80,60,-170,146,174,320,652
-10,-30,-60,161,159,320,665
80,-80,10,155,165,320,658
110,-70,-30,154,166,320,571
-130,50,30,155,165,320,596
-50,-10,-100,157,163,320,553
-60,50,-30,155,165,320,618
140,0,50,155,165,320,589
-30,-40,-60,148,172,320,583
-140,30,100,158,163,321,551
-170,50,140,155,166,321,570
10,-10,-70,157,164,321,574
-10,80,-170,167,154,321,611
-160,-70,170,163,158,321,586
-60,30,-90,152,169,321,595
-140,10,90,151,170,321,622
-90,-60,110,156,165,321,586
160,0,110,155,166,321,666
130,-30,20,162,159,321,559
-40,-30,-170,143,178,321,533
130,40,80,157,164,321,656
20,-50,-150,163,158,321,564
-30,-50,170,155,167,322,583
120,60,140,140,182,322,742
-40,30,-40,153,169,322,540
-100,-40,150,146,176,322,644
170,-60,140,161,161,322,585
170,-10,10,166,156,322,606
-50,40,-40,152,170,322,603
140,-70,-10,159,163,322,633
50,60,150,169,153,322,574
-50,30,-120,161,161,322,634
30,10,-110,155,167,322,651
160,60,150,158,164,322,584
110,60,100,153,169,322,590
-140,50,90,155,167,322,570
30,-10,-140,151,172,323,618
-60,-40,180,142,181,323,646
20,-10,-170,162,161,323,611
-110,-60,-160,157,166,323,680
-100,-50,-170,154,169,323,694
130,70,60,167,156,323,581
30,-70,-140,160,163,323,612
-60,-40,-180,142,181,323,646
-50,-10,-80,161,162,323,640
20,10,-170,166,157,323,571
160,-10,120,158,165,323,570
170,30,20,162,161,323,595
10,30,180,150,174,324,584
140,50,140,153,171,324,664
80,-70,-30,157,167,324,564
10,30,-180,150,174,324,584
30,80,-70,154,170,324,571
140,-50,0,164,160,324,652
-70,50,-80,160,165,325,585
-150,-80,50,162,163,325,654
130,-50,0,157,168,325,668
10,80,170,172,153,325,646
-170,-80,150,166,159,325,662
60,50,-160,147,178,325,671
40,40,-110,160,165,325,643
50,70,-100,148,177,325,731
170,60,20,167,158,325,547
-160,30,30,160,165,325,660
0,80,180,169,156,325,634
-120,-30,110,144,181,325,627
110,60,140,154,171,325,713
0,80,-180,169,156,325,634
30,40,-90,159,167,326,570
-140,-80,60,162,164,326,628
-150,-60,40,164,162,326,570
60,50,-170,153,173,326,690
-20,-60,-60,165,161,326,656
30,30,-120,152,174,326,651
-140,50,20,157,169,326,700
-70,60,0,152,174,326,602
-10,40,-170,164,162,326,614
30,0,-140,152,174,326,603
10,20,-180,165,161,326,614
10,20,180,165,161,326,614
-50,60,-10,151,176,327,597
60,-70,-90,154,173,327,613
-60,40,-100,166,161,327,653
-10,-30,180,167,160,327,633
-10,-30,-180,167,160,327,633
60,50,-180,157,171,328,704
70,-80,-90,158,170,328,682
150,20,110,166,162,328,578
80,-70,-50,155,173,328,557
-100,-50,110,147,181,328,599
-50,0,-70,161,167,328,535
150,-20,10,165,163,328,638
10,-40,-170,171,157,328,588
60,50,180,157,171,328,704
-30,80,-10,150,179,329,558
170,-30,150,170,159,329,610
-180,-30,10,168,161,329,631
-180,-80,140,165,164,329,691
20,-70,-150,162,167,329,578
180,-80,140,165,164,329,691
180,-30,10,168,161,329,631
170,60,150,161,168,329,543
-50,-60,150,164,165,329,603
-120,-30,130,142,187,329,701
-60,-50,160,168,161,329,642
-50,-30,-160,148,181,329,597
150,-60,0,157,173,330,678
-160,10,30,163,167,330,579
-170,-70,160,160,170,330,633
-30,-60,160,161,169,330,620
-20,-40,-180,163,167,330,545
150,10,20,168,162,330,617
40,50,160,167,163,330,616
20,-40,-90,156,174,330,721
130,-30,50,161,169,330,554
0,50,-180,163,167,330,614
-20,-40,180,163,167,330,545
-150,20,120,164,166,330,636
-50,-40,-90,161,169,330,612
-180,30,20,159,171,330,590
180,30,20,159,171,330,590
40,-70,-50,152,178,330,579
0,50,180,163,167,330,614
150,-30,100,163,167,330,563
130,40,70,165,165,330,628
40,80,-80,161,170,331,598
-30,-40,-180,161,170,331,588
-150,40,120,151,180,331,562
60,70,130,178,153,331,633
-90,80,-90,165,166,331,629
140,40,110,160,171,331,652
130,-70,-20,160,171,331,645
-30,-40,180,161,170,331,588
-60,50,-110,162,169,331,592
0,30,-40,166,166,332,577
70,60,140,163,169,332,599
-130,50,50,150,182,332,643
-20,-30,-50,162,170,332,656
-110,70,-50,164,168,332,640
-10,20,-170,174,158,332,622
-140,60,90,160,173,333,663
130,50,120,153,180,333,678
140,50,50,164,169,333,575
20,80,160,182,151,333,644
-110,-40,110,155,178,333,700
30,20,-160,156,177,333,621
-80,-80,-120,169,164,333,652
-40,30,-140,170,163,333,627
60,50,170,160,173,333,675
-140,-10,70,158,175,333,614
-160,-30,160,167,166,333,652
-170,50,10,171,163,334,608
30,40,180,159,175,334,634
100,60,160,159,175,334,696
-160,-80,40,164,170,334,675
30,40,-180,159,175,334,634
150,-50,0,171,163,334,642
10,-70,-60,161,173,334,604
30,0,-110,149,185,334,622
-170,-50,20,171,163,334,647
-140,-40,160,163,172,335,703
-160,50,130,156,179,335,580
-30,-10,-40,166,169,335,603
160,70,150,163,172,335,667
-130,-30,150,154,181,335,706
-130,-60,-170,170,165,335,663
-70,60,-100,171,164,335,576
60,50,-150,152,183,335,680
-150,40,30,166,169,335,659
-140,-60,50,173,162,335,576
-70,50,-50,162,174,336,656
150,-40,110,172,164,336,612
10,-30,-170,165,171,336,646
10,-30,-80,159,177,336,738
-10,-40,-180,167,169,336,591
-10,-50,-60,158,178,336,709
140,0,60,157,179,336,661
130,60,60,172,164,336,619
-10,-40,180,167,169,336,591
0,-10,-180,178,158,336,599
140,-80,90,158,178,336,623
60,-70,-100,168,168,336,657
90,70,-150,160,176,336,715
-130,-20,90,162,174,336,661
30,-50,-130,165,171,336,672
0,-10,180,178,158,336,599
-60,30,-60,164,172,336,576
30,80,150,182,154,336,646
-40,-30,-70,163,174,337,619
180,-70,20,169,168,337,688
20,30,180,159,178,337,567
120,70,70,170,167,337,634
120,-40,20,168,169,337,643
120,-40,30,160,177,337,626
140,-40,0,174,163,337,675
140,10,50,161,176,337,688
140,-10,70,160,177,337,642
20,30,-180,159,178,337,567
140,-20,70,158,179,337,699
-180,-70,20,169,168,337,688
-30,-50,-60,157,180,337,656
50,50,-120,161,176,337,689
130,50,70,167,170,337,659
-140,0,110,167,170,337,683
40,40,-130,156,181,337,742
10,40,-50,160,177,337,570
-60,20,-90,163,175,338,596
30,-10,-110,144,194,338,649
30,30,-110,154,184,338,714
-40,-20,-60,164,174,338,607
30,10,-140,159,179,338,629
-30,-20,-170,168,170,338,569
10,20,-60,169,169,338,647
-30,-80,-80,155,183,338,627
80,-80,-80,165,173,338,718
120,-60,60,157,181,338,656
-50,-10,-110,167,171,338,609
-80,-50,-140,165,174,339,695
-140,-50,170,161,178,339,732
-110,-50,180,158,181,339,721
-30,-70,-70,166,173,339,666
-180,-40,10,174,165,339,690
-120,-40,160,148,191,339,756
90,60,-160,160,179,339,745
-180,-70,150,162,177,339,680
30,-20,-140,169,170,339,679
-90,60,-40,151,188,339,679
-110,-50,-180,158,181,339,721
180,-70,150,162,177,339,680
-130,60,0,163,176,339,681
-160,-60,170,166,173,339,644
-110,-40,160,158,181,339,709
180,-40,10,174,165,339,690
10,0,-180,171,169,340,701
170,-10,140,169,171,340,635
20,-30,-110,167,173,340,696
-180,50,10,174,166,340,626
20,10,-80,161,179,340,611
180,50,10,174,166,340,626
10,0,180,171,169,340,701
70,-70,-70,159,181,340,586
30,-60,-140,168,172,340,591
-60,-70,130,172,169,341,695
0,-80,-170,167,174,341,605
10,0,-60,157,184,341,612
150,-40,0,178,163,341,609
70,-70,-40,158,183,341,582
10,60,170,179,162,341,627
90,60,-170,159,182,341,756
10,-80,-160,166,176,342,627
-150,-70,180,167,175,342,619
-80,60,-80,170,172,342,618
80,60,130,169,173,342,613
-20,-20,-40,170,172,342,633
-50,-70,140,173,169,342,665
-150,-70,-180,167,175,342,619
120,90,60,181,162,343,663
-180,90,0,181,162,343,663
-160,90,-20,181,162,343,663
10,90,170,181,162,343,663
-50,90,-130,181,162,343,663
150,90,30,181,162,343,663
100,90,80,181,162,343,663
50,90,130,181,162,343,663
20,90,160,181,162,343,663
-40,90,-140,181,162,343,663
130,60,150,165,178,343,719
110,90,70,181,162,343,663
-100,80,-80,169,174,343,653
20,70,160,183,160,343,622
90,90,90,181,162,343,663
-10,90,-170,181,162,343,663
-130,-20,130,161,182,343,694
-140,90,-40,181,162,343,663
-160,-20,160,170,173,343,709
-160,40,20,171,172,343,685
-80,90,-100,181,162,343,663
0,90,-180,181,162,343,663
40,90,140,181,162,343,663
-90,90,-90,181,162,343,663
0,90,180,181,162,343,663
170,90,10,181,162,343,663
-170,90,-10,181,162,343,663
60,90,120,181,162,343,663
130,90,50,181,162,343,663
-120,90,-60,181,162,343,663
80,90,100,181,162,343,663
-70,90,-110,181,162,343,663
140,90,40,181,162,343,663
-100,90,-80,181,162,343,663
-20,90,-160,181,162,343,663
-30,90,-150,181,162,343,663
180,90,0,181,162,343,663
160,90,20,181,162,343,663
40,80,140,189,154,343,667
70,90,110,181,162,343,663
-110,90,-70,181,162,343,663
-40,-80,150,163,180,343,652
-130,90,-50,181,162,343,663
-150,90,-30,181,162,343,663
30,90,150,181,162,343,663
50,60,-110,151,192,343,774
-60,90,-120,181,162,343,663
160,-10,10,175,169,344,639
30,10,-150,163,181,344,634
-70,-40,-160,153,191,344,656
120,60,80,164,180,344,626
0,0,-180,175,169,344,600
-140,-20,60,165,179,344,611
-50,-50,160,167,177,344,673
0,0,180,175,169,344,600
0,20,-40,176,169,345,658
120,-50,50,166,179,345,586
-150,20,40,166,179,345,602
100,70,90,175,170,345,682
-140,20,100,160,185,345,656
-170,80,130,170,175,345,567
-50,-80,140,165,180,345,667
180,0,150,173,172,345,576
-10,-80,-180,164,181,345,620
160,30,20,176,169,345,591
20,-40,-150,173,172,345,693
-160,80,120,169,176,345,574
-180,0,150,173,172,345,576
-160,-10,30,170,175,345,630
-40,20,-40,175,170,345,622
-10,-80,180,164,181,345,620
60,50,-140,157,188,345,754
-60,60,-120,172,173,345,616
90,60,180,163,183,346,746
-120,70,70,170,176,346,634
80,-70,-20,171,175,346,626
180,60,10,172,174,346,609
90,60,-180,163,183,346,746
0,-10,-50,168,178,346,636
-170,-80,30,170,176,346,713
-70,-50,-120,152,194,346,672
100,-70,-40,163,183,346,628
-40,20,-140,175,171,346,653
30,-50,-80,166,180,346,691
-170,0,150,167,179,346,604
170,-60,10,171,175,346,690
-180,60,10,172,174,346,609
-150,80,110,169,177,346,572
-70,50,-90,178,168,346,633
130,50,130,164,182,346,692
100,-70,30,175,171,346,617
-10,-40,-60,166,181,347,772
-160,-20,30,169,178,347,654
90,60,120,171,176,347,627
150,20,20,177,170,347,640
-90,60,-50,171,176,347,674
150,0,90,168,179,347,698
0,10,-40,175,172,347,610
170,-80,10,175,172,347,714
100,60,110,168,179,347,670
90,-70,10,163,185,348,592
0,-40,180,170,178,348,637
0,-40,-180,170,178,348,637
-180,40,10,181,167,348,644
-140,10,100,166,182,348,663
70,-80,0,167,181,348,741
-180,80,140,167,181,348,558
140,60,150,173,175,348,677
-70,-80,-110,173,175,348,667
-30,-80,160,165,183,348,646
180,40,10,181,167,348,644
180,80,140,167,181,348,558
-170,70,130,174,175,349,628
-180,-20,10,174,175,349,641
30,30,-170,172,177,349,668
180,-80,20,176,173,349,711
-50,50,-130,176,173,349,613
180,70,140,172,177,349,663
-180,-80,20,176,173,349,711
0,30,-180,170,179,349,662
-180,70,140,172,177,349,663
0,30,180,170,179,349,662
40,40,-170,176,173,349,719
180,-20,10,174,175,349,641
100,70,-160,176,174,350,700
90,-80,-70,170,180,350,753
-60,-60,140,175,175,350,675
0,-20,-60,171,179,350,593
-40,0,-140,163,187,350,729
40,40,-160,169,181,350,761
110,60,150,160,190,350,809
140,20,60,177,173,350,683
-160,30,140,167,183,350,560
20,30,-80,171,179,350,654
50,80,-90,166,184,350,615
20,-10,-80,168,182,350,695
120,-70,-30,174,177,351,669
-20,70,-20,162,189,351,618
-170,-20,160,173,178,351,656
120,-50,0,173,178,351,717
140,20,50,184,167,351,674
80,60,-150,170,181,351,716
-160,20,30,175,176,351,677
20,-80,-150,174,178,352,658
70,70,120,187,165,352,667
180,-30,160,176,176,352,690
110,-60,30,169,183,352,665
90,-70,-50,166,186,352,646
-140,0,60,169,183,352,629
-140,70,-20,173,179,352,650
150,50,150,169,183,352,667
40,50,-100,164,188,352,723
20,0,-170,179,173,352,664
40,60,150,177,175,352,652
-20,-80,170,166,186,352,638
30,-60,-70,168,184,352,618
160,-20,120,179,173,352,631
-180,-30,160,176,176,352,690
110,70,80,178,175,353,663
-30,60,-160,181,172,353,655
10,10,180,181,172,353,691
-10,0,180,183,170,353,641
160,-80,0,179,174,353,721
-150,-30,40,171,182,353,646
150,-10,100,166,187,353,703
10,10,-180,181,172,353,691
-100,-40,130,164,189,353,679
160,10,10,181,172,353,653
100,-80,40,158,195,353,678
-160,-60,30,167,186,353,633
40,-80,-30,160,193,353,688
-170,10,20,178,175,353,652
-40,-20,-160,168,185,353,600
110,-60,-10,162,191,353,713
-10,0,-180,183,170,353,641
60,70,-110,161,192,353,754
-130,50,20,167,186,353,724
170,-80,130,178,176,354,732
50,80,130,193,161,354,698
170,0,10,169,185,354,651
-20,-50,170,175,179,354,701
-120,-30,100,164,190,354,654
-110,60,40,166,188,354,669
60,50,160,174,180,354,700
130,70,170,169,185,354,707
-40,60,-150,182,172,354,638
120,-60,-20,172,183,355,678
-180,40,150,177,178,355,588
-150,60,0,182,173,355,755
180,40,150,177,178,355,588
110,-80,-50,175,180,355,759
160,80,160,167,188,355,634
-70,-60,130,174,181,355,670
140,30,100,170,185,355,621
-180,-40,160,174,181,355,705
120,60,150,159,196,355,832
180,-40,160,174,181,355,705
10,-10,-180,186,170,356,646
30,30,-100,168,188,356,733
-60,-80,130,173,183,356,695
30,70,-70,166,190,356,677
100,-80,-60,173,183,356,759
10,-10,180,186,170,356,646
130,-80,-30,177,179,356,749
30,0,-100,156,200,356,663
0,20,180,173,183,356,699
180,-50,10,177,179,356,718
140,-30,80,175,181,356,633
-10,-60,-60,165,191,356,710
80,70,110,189,167,356,685
0,20,-180,173,183,356,699
-180,-50,10,177,179,356,718
-40,80,0,164,193,357,586
180,30,150,176,181,357,571
-180,30,150,176,181,357,571
-10,-20,-180,181,176,357,709
100,60,170,166,191,357,755
-80,60,10,165,192,357,646
120,-80,-40,178,179,357,756
0,10,180,174,183,357,688
-80,-60,120,172,185,357,654
140,30,40,175,182,357,655
-70,70,-110,181,176,357,594
-10,-20,180,181,176,357,709
0,10,-180,174,183,357,688
170,20,10,185,172,357,649
130,-60,80,172,185,357,653
20,-90,-30,166,192,358,722
40,-90,-10,166,192,358,722
-60,-90,-110,166,192,358,722
60,-90,10,166,192,358,722
-140,-90,170,166,192,358,722
-20,-90,-70,166,192,358,722
30,50,160,179,179,358,670
-120,-90,-170,166,192,358,722
-40,-90,-90,166,192,358,722
-160,-90,150,166,192,358,722
160,0,10,176,182,358,684
-90,-90,-140,166,192,358,722
10,-80,-50,172,186,358,671
-100,-90,-150,166,192,358,722
-180,-90,130,166,192,358,722
-50,-90,-100,166,192,358,722
150,-90,100,166,192,358,722
180,-90,130,166,192,358,722
-80,-90,-130,166,192,358,722
120,-90,70,166,192,358,722
-70,-90,-120,166,192,358,722
-30,-90,-80,166,192,358,722
110,-90,60,166,192,358,722
10,-90,-40,166,192,358,722
80,-90,30,166,192,358,722
90,-90,40,166,192,358,722
-130,-90,180,166,192,358,722
130,-90,80,166,192,358,722
30,-90,-20,166,192,358,722
70,-90,20,166,192,358,722
10,-40,-70,167,191,358,774
50,-90,0,166,192,358,722
70,-70,-80,169,189,358,661
-150,-90,160,166,192,358,722
0,-90,-50,166,192,358,722
-130,-90,-180,166,192,358,722
100,-90,50,166,192,358,722
140,-90,90,166,192,358,722
160,-90,110,166,192,358,722
80,-70,-60,170,188,358,632
-10,-90,-60,166,192,358,722
-170,-90,140,166,192,358,722
160,50,20,188,170,358,632
-110,-90,-160,166,192,358,722
170,-90,120,166,192,358,722
-70,-40,-170,163,195,358,678
20,20,-180,171,188,359,672
20,20,180,171,188,359,672
-150,0,40,172,187,359,601
20,60,-60,174,185,359,593
40,-70,-130,176,183,359,678
-20,-40,-50,175,184,359,739
140,-80,-20,181,179,360,744
60,60,140,188,172,360,698
-110,60,-10,176,184,360,713
40,40,-150,171,189,360,809
170,80,150,174,186,360,609
-120,-50,180,170,190,360,721
-10,0,-30,178,182,360,680
170,10,10,182,178,360,660
-140,80,100,177,183,360,597
-60,-80,-100,180,180,360,687
20,40,170,180,180,360,623
-150,-10,150,176,184,360,674
-150,-30,160,174,186,360,741
-120,-50,-180,170,190,360,721
-50,-20,-120,169,192,361,718
0,-50,-60,179,182,361,798
90,70,100,192,169,361,670
150,-80,-10,180,181,361,731
150,-70,110,175,186,361,736
70,50,170,172,189,361,751
-140,40,40,181,180,361,753
70,70,-120,164,197,361,744
30,10,-160,177,184,361,628
-90,-50,-150,163,198,361,712
130,40,90,178,183,361,756
30,-10,-100,159,202,361,696
170,-70,10,182,179,361,763
10,50,170,189,172,361,686
-160,60,0,188,174,362,705
10,-50,-170,183,179,362,626
-140,0,120,173,189,362,755
180,0,10,179,183,362,674
-160,10,140,176,186,362,653
150,10,100,178,184,362,743
-70,-50,150,176,186,362,667
30,20,-100,182,180,362,775
-180,0,10,179,183,362,674
-30,50,-160,181,181,362,690
110,-60,40,177,186,363,706
110,60,90,173,190,363,713
-10,50,-30,177,186,363,628
0,-30,-180,179,184,363,672
140,-60,-10,176,187,363,764
70,50,-180,173,190,363,757
-50,20,-120,167,196,363,725
140,-60,100,180,183,363,697
0,-30,180,179,184,363,672
70,50,180,173,190,363,757
-90,-50,130,172,191,363,685
30,-80,-140,179,185,364,689
50,-80,-20,167,197,364,751
-170,60,140,173,191,364,646
0,-20,-180,180,184,364,695
-160,50,10,186,178,364,712
-140,40,100,178,186,364,666
-40,10,-140,171,193,364,720
0,-20,180,180,184,364,695
-70,50,-40,171,193,364,748
130,-80,80,166,198,364,684
-70,-80,120,176,188,364,702
110,-70,-40,177,187,364,702
20,-20,-90,176,188,364,735
150,40,30,179,185,364,641
-180,20,150,177,188,365,644
180,20,150,177,188,365,644
-100,60,-20,175,190,365,727
40,40,180,175,190,365,727
-30,-10,-160,178,187,365,694
-150,-50,170,189,176,365,702
40,40,-180,175,190,365,727
130,-70,80,174,191,365,675
30,-20,-130,172,193,365,762
140,-20,10,174,191,365,716
-140,-70,-170,178,188,366,669
0,-70,-60,176,190,366,756
170,40,10,194,172,366,648
-20,-10,-170,188,178,366,719
60,80,120,198,168,366,725
30,-70,-50,170,196,366,660
40,40,-140,167,199,366,823
-120,-30,140,166,201,367,719
40,-80,-130,179,188,367,695
-10,-10,-180,184,183,367,700
-60,30,-100,176,191,367,683
20,-50,-70,163,204,367,757
-10,-10,180,184,183,367,700
-130,80,90,179,188,367,626
-50,-30,-90,185,182,367,704
-170,70,0,184,184,368,684
170,20,140,179,189,368,720
120,-40,40,185,183,368,682
20,-30,-160,190,178,368,700
-160,70,120,181,187,368,644
160,40,20,189,179,368,638
-170,10,150,183,185,368,655
-70,-70,120,183,185,368,715
-140,60,0,183,186,369,745
20,60,160,196,173,369,654
-170,20,20,180,189,369,759
100,-60,0,180,189,369,709
-90,70,-80,181,188,369,612
-100,-50,-160,168,201,369,785
30,70,150,194,175,369,657
20,-20,-170,187,182,369,640
-20,60,-170,190,180,370,687
160,-60,130,181,189,370,716
180,-10,10,181,189,370,659
70,50,160,179,191,370,750
50,-80,-120,180,190,370,728
-130,-50,60,184,186,370,591
120,60,70,185,185,370,722
-180,-10,10,181,189,370,659
-80,-80,110,181,189,370,721
20,20,-80,185,185,370,777
170,0,140,187,183,370,659
130,-40,0,189,181,370,728
150,-10,10,186,184,370,760
170,30,10,189,182,371,638
180,30,10,178,193,371,706
-150,60,110,171,200,371,682
-180,30,10,178,193,371,706
60,-70,-40,167,204,371,695
140,10,40,188,183,371,708
60,-80,-10,170,201,371,756
140,-40,90,181,190,371,717
70,80,110,199,172,371,730
-120,70,-40,187,185,372,717
150,-30,0,190,182,372,715
50,-60,-100,189,183,372,668
160,-40,0,184,188,372,709
70,50,-170,175,197,372,752
-170,30,20,185,187,372,725
-110,80,-70,184,188,372,699
60,80,-100,179,193,372,660
-130,70,-30,180,192,372,710
-140,30,50,173,199,372,784
140,20,70,180,193,373,702
20,10,180,181,192,373,711
20,10,-180,181,192,373,711
20,-30,-100,181,192,373,771
140,-30,0,193,180,373,742
-50,-40,170,175,198,373,704
80,-70,-70,183,190,373,740
20,-40,-80,164,209,373,826
140,40,120,183,191,374,714
130,-20,30,184,190,374,674
-100,-40,160,165,209,374,731
170,-50,150,193,181,374,734
30,0,-150,180,194,374,752
110,60,160,175,200,375,804
-40,-10,-150,187,188,375,690
-50,0,-110,184,191,375,678
130,40,60,186,189,375,717
-120,-70,70,182,193,375,734
140,20,40,194,181,375,704
-130,-60,60,191,184,375,638
100,60,-170,174,201,375,795
20,-50,-160,202,173,375,661
-20,40,-170,189,186,375,731
-20,10,-170,185,190,375,707
-20,-80,-70,175,201,376,695
-50,-80,-90,184,192,376,716
70,80,-110,181,195,376,691
80,80,100,200,176,376,748
120,70,-180,176,200,376,773
110,-50,30,187,189,376,687
170,-70,140,183,193,376,741
-100,-40,120,178,198,376,771
120,70,180,176,200,376,773
30,40,170,188,188,376,645
0,40,180,183,194,377,676
80,80,-120,185,192,377,705
-130,-70,60,186,191,377,715
-30,-30,-180,186,191,377,597
30,50,-80,177,200,377,793
160,20,10,191,186,377,688
140,-10,20,190,187,377,727
110,-50,20,191,186,377,763
-30,-30,180,186,191,377,597
0,0,-40,191,186,377,614
70,-70,-30,176,201,377,720
0,40,-180,183,194,377,676
110,-70,50,192,185,377,690
-150,0,140,188,189,377,754
50,40,-140,186,192,378,805
-140,10,50,174,204,378,621
180,10,10,191,187,378,703
160,-80,120,189,189,378,794
140,0,30,192,186,378,720
90,80,90,197,181,378,761
-110,-40,100,174,204,378,783
-30,-30,-50,186,192,378,711
160,-30,0,197,181,378,719
-180,10,10,191,187,378,703
-170,30,150,180,198,378,604
80,70,-130,176,203,379,755
80,-70,-10,190,189,379,705
160,70,20,203,176,379,748
150,30,20,192,187,379,718
-170,40,10,191,188,379,710
0,-60,-60,185,194,379,752
-30,20,-160,202,177,379,677
40,-60,-70,184,196,380,746
140,40,40,187,193,380,729
-80,-50,140,174,206,380,739
-50,-10,-120,179,201,380,765
-30,-60,-60,193,187,380,761
40,30,-150,185,195,380,818
-110,-50,90,175,205,380,752
150,80,170,180,200,380,676
30,-10,-150,180,200,380,738
150,-20,100,190,190,380,732
150,60,30,197,183,380,705
-50,60,-140,196,184,380,667
110,-50,10,192,189,381,778
-50,80,10,178,203,381,620
-20,-20,180,185,196,381,739
0,-50,180,188,193,381,730
-60,70,10,181,200,381,637
0,-50,-180,188,193,381,730
-20,-20,-180,185,196,381,739
-20,50,-170,188,193,381,689
140,10,60,175,206,381,706
-80,-70,110,186,195,381,720
40,-60,-130,198,183,381,682
20,30,170,188,194,382,746
30,-20,-150,189,193,382,711
90,-80,30,178,204,382,751
-20,-50,-50,191,191,382,768
20,0,180,196,186,382,729
160,-20,0,195,187,382,766
160,50,150,198,184,382,671
20,0,-180,196,186,382,729
130,-60,-20,194,189,383,816
30,-20,-120,187,196,383,777
-10,-20,-40,189,194,383,706
160,-30,130,203,180,383,716
-120,80,80,189,194,383,656
20,-80,-40,180,203,383,748
-50,40,-130,200,183,383,771
140,20,80,183,200,383,696
-20,40,-30,185,198,383,703
160,60,20,198,186,384,719
100,60,180,179,205,384,779
30,10,-100,183,201,384,800
70,-70,-90,186,198,384,730
100,60,-180,179,205,384,779
-140,-10,140,183,201,384,753
30,-40,-100,186,198,384,807
30,60,150,198,186,384,727
-160,20,140,187,197,384,700
-180,60,150,198,187,385,644
120,-50,60,196,189,385,693
150,70,30,206,179,385,759
130,-30,10,187,198,385,711
90,80,-130,190,195,385,754
180,60,150,198,187,385,644
-170,-60,20,185,200,385,758
30,30,180,189,197,386,729
-70,-40,-150,167,219,386,776
60,-80,-110,190,196,386,758
90,-70,-60,191,195,386,753
170,70,150,189,197,386,747
-10,10,-30,192,194,386,720
140,60,40,199,187,386,717
30,30,-180,189,197,386,729
100,-60,10,183,203,386,744
-30,30,-160,200,186,386,758
-40,-50,-70,191,195,386,734
120,50,100,187,199,386,803
-40,-40,-70,180,207,387,692
130,-50,-10,197,190,387,822
50,-70,-120,193,194,387,756
50,40,-130,187,200,387,804
-90,-80,100,190,197,387,734
150,-70,-10,189,198,387,845
50,-60,-110,192,195,387,701
-150,70,110,189,198,387,706
10,-60,-60,183,204,387,770
-100,60,30,181,206,387,696
160,-50,0,196,192,388,749
30,-50,-140,191,197,388,722
-20,20,-170,198,190,388,713
60,60,-120,183,205,388,850
160,40,140,194,194,388,674
140,30,110,186,202,388,745
-40,-40,170,183,205,388,754
-180,10,150,192,196,388,684
120,50,120,179,209,388,850
150,70,160,187,201,388,798
100,-70,-50,192,196,388,754
-120,80,-60,187,201,388,723
-120,-60,-160,183,205,388,800
180,10,150,192,196,388,684
50,50,150,199,189,388,727
160,0,120,195,193,388,844
-180,-20,160,198,191,389,704
130,50,140,175,214,389,765
-140,-70,50,196,193,389,750
180,20,10,199,190,389,744
140,70,40,211,178,389,755
-120,-40,80,168,221,389,771
-90,60,20,175,214,389,693
-50,-20,-130,178,211,389,789
-180,20,10,199,190,389,744
180,-20,160,198,191,389,704
-110,-70,80,190,199,389,772
-110,70,60,196,194,390,761
-130,50,60,183,207,390,748
10,-20,180,191,199,390,698
-130,-10,110,181,209,390,799
-100,60,-30,185,205,390,811
-120,-30,150,183,207,390,868
140,-50,-10,200,190,390,762
140,20,90,185,205,390,735
150,-50,120,188,202,390,719
-90,80,50,192,198,390,659
10,-20,-180,191,199,390,698
-10,-30,-50,195,196,391,782
120,-40,10,190,201,391,772
140,40,130,190,201,391,765
120,50,110,180,211,391,825
-140,-20,150,193,199,392,742
-40,-60,-70,196,196,392,748
-30,40,-160,203,189,392,744
-50,10,-50,188,204,392,586
160,60,160,187,205,392,666
160,-70,0,192,200,392,795
-130,-70,-160,192,200,392,722
-10,10,180,205,187,392,730
-10,10,-180,205,187,392,730
150,80,30,207,185,392,777
170,50,10,204,188,392,753
80,60,-140,185,208,393,779
40,-50,-100,191,202,393,728
90,60,110,195,198,393,769
110,-50,40,191,202,393,695
70,50,-160,180,213,393,791
160,10,120,182,211,393,738
-90,-40,150,174,219,393,791
150,-20,0,199,194,393,778
20,-40,-160,206,187,393,769
160,-60,0,197,196,393,825
120,50,90,198,196,394,773
-40,-60,150,191,203,394,760
-80,80,40,191,203,394,661
20,30,-70,190,204,394,772
50,40,-150,191,203,394,849
-70,80,30,196,198,394,665
130,70,50,207,187,394,781
100,60,100,189,205,394,750
10,-20,-70,199,195,394,708
-50,-60,-80,193,201,394,781
150,50,30,203,191,394,661
-20,-30,-40,196,198,394,730
30,20,-170,183,211,394,731
170,-20,0,206,188,394,766
50,-60,-90,190,204,394,711
40,30,-140,187,207,394,866
160,-40,140,201,194,395,726
80,50,150,187,208,395,771
40,40,170,186,209,395,790
-40,50,-150,193,202,395,726
70,60,-130,191,204,395,838
90,60,-150,185,211,396,781
140,80,180,190,206,396,726
100,80,-140,191,205,396,738
0,-60,180,195,201,396,729
140,80,-180,190,206,396,726
0,-60,-180,195,201,396,729
140,80,40,212,184,396,779
-100,-80,90,196,200,396,767
130,50,60,196,200,396,748
110,70,-170,190,206,396,787
100,80,80,207,189,396,786
-120,-20,120,185,211,396,822
-60,40,-110,200,197,397,791
-110,80,70,198,199,397,683
-90,-70,100,192,205,397,756
130,-40,70,196,201,397,754
80,60,120,204,193,397,762
-140,40,30,197,200,397,826
140,-70,-20,205,192,397,857
-40,-10,-50,197,200,397,746
-90,60,-60,189,208,397,792
-40,-50,160,188,209,397,731
-10,-70,-60,184,213,397,826
70,-80,-100,194,203,397,791
60,50,-130,187,210,397,877
180,-50,160,202,196,398,781
-180,-50,160,202,196,398,781
90,-70,20,192,206,398,740
20,-60,-60,185,213,398,814
-150,-60,-180,196,202,398,774
150,10,10,198,200,398,741
-150,-60,180,196,202,398,774
-140,20,50,187,211,398,724
170,-30,0,208,190,398,797
-150,10,130,188,210,398,825
170,-40,0,208,191,399,851
-150,-80,-180,200,199,399,783
40,40,-100,192,207,399,781
150,30,130,194,205,399,756
10,40,170,204,195,399,780
30,10,-170,200,199,399,756
-120,-80,70,197,202,399,799
-60,-40,-110,190,209,399,872
-150,-80,180,200,199,399,783
20,50,-60,184,215,399,766
40,70,140,216,183,399,729
30,-40,-110,186,213,399,794
-170,20,150,197,202,399,690
-140,-30,160,186,213,399,874
70,60,130,212,188,400,767
-140,-30,50,201,199,400,748
-20,30,-170,209,191,400,771
30,-10,-90,182,218,400,748
-30,70,-160,203,197,400,731
40,60,-90,183,217,400,827
-160,-80,170,200,200,400,768
-60,-50,-100,194,206,400,794
170,-20,150,203,197,400,733
-120,60,-10,191,209,400,798
-90,-40,160,178,222,400,812
30,0,-160,192,208,400,814
70,50,-150,187,214,401,851
-30,80,-160,203,198,401,746
120,-80,70,181,220,401,757
40,50,150,208,193,401,767
-70,50,-30,187,214,401,809
-30,40,-30,196,205,401,763
-20,0,-30,206,195,401,735
-130,-10,100,188,213,401,900
-140,10,110,196,206,402,829
-80,-40,-170,182,220,402,827
-140,-80,-170,202,200,402,801
-10,80,180,208,194,402,760
20,-10,180,204,198,402,793
-110,-80,80,198,204,402,796
-10,80,-180,208,194,402,760
-20,60,-20,180,222,402,687
-100,80,60,202,200,402,691
20,-10,-180,204,198,402,793
-180,-60,10,203,199,402,833
180,-60,10,203,199,402,833
150,0,10,201,202,403,787
-130,-10,120,183,220,403,848
-120,60,60,190,213,403,787
-60,80,20,197,206,403,656
120,60,160,190,213,403,926
-60,-50,150,203,200,403,828
-160,70,-10,201,202,403,764
-10,60,180,209,194,403,776
170,-50,0,204,199,403,836
90,70,-140,189,214,403,813
130,-50,80,193,210,403,714
10,30,-50,199,204,403,727
100,-60,-10,193,210,403,784
-10,60,-180,209,194,403,776
-20,10,-30,198,205,403,745
30,-30,-140,202,201,403,809
50,40,-160,195,208,403,906
10,-60,-170,208,196,404,723
130,30,70,196,208,404,785
110,80,70,209,195,404,800
-20,0,-170,208,196,404,790
50,-70,-40,184,220,404,774
110,60,170,192,212,404,864
-40,10,-40,210,194,404,687
130,-30,60,202,202,404,773
130,40,100,195,209,404,893
-170,60,0,203,201,404,739
70,50,150,198,206,404,817
80,-80,20,190,215,405,815
-100,70,-70,200,205,405,716
150,-40,120,206,199,405,821
-130,80,-50,198,207,405,762
10,-50,-60,198,207,405,792
-50,-30,-170,187,218,405,826
-20,-40,170,198,208,406,812
-30,10,-160,197,209,406,763
150,-80,110,198,208,406,826
50,60,140,208,198,406,799
-160,-50,170,207,199,406,742
160,80,20,215,191,406,777
-170,-80,160,198,208,406,773
-20,80,-170,211,195,406,759
-40,80,-150,205,201,406,750
130,-70,-30,208,198,406,869
-140,-10,60,195,212,407,768
100,-90,-70,201,206,407,809
-80,-60,-120,199,208,407,758
-130,-90,60,201,206,407,809
120,-90,-50,201,206,407,809
-160,-90,30,201,206,407,809
140,-90,-30,201,206,407,809
-10,-90,180,201,206,407,809
-160,0,150,200,207,407,837
150,-90,-20,201,206,407,809
-60,-90,130,201,206,407,809
-10,50,-180,205,202,407,730
-120,-90,70,201,206,407,809
-150,-70,40,203,204,407,795
50,-90,-120,201,206,407,809
-40,-90,150,201,206,407,809
80,-90,-90,201,206,407,809
160,-90,-10,201,206,407,809
-10,50,180,205,202,407,730
0,-90,-170,201,206,407,809
10,-90,-160,201,206,407,809
20,-70,-50,191,216,407,764
-50,-90,140,201,206,407,809
-110,-90,80,201,206,407,809
-100,-90,90,201,206,407,809
170,-90,0,201,206,407,809
-180,-90,10,201,206,407,809
180,-90,10,201,206,407,809
90,-90,-80,201,206,407,809
-90,-90,100,201,206,407,809
40,-90,-130,201,206,407,809
110,-90,-60,201,206,407,809
-130,-80,60,198,209,407,825
-80,-90,110,201,206,407,809
-130,-20,80,197,210,407,820
30,-90,-140,201,206,407,809
130,-90,-40,201,206,407,809
-170,-90,20,201,206,407,809
-140,-90,50,201,206,407,809
-20,-90,170,201,206,407,809
-150,40,20,193,214,407,844
60,-90,-110,201,206,407,809
-30,-90,160,201,206,407,809
-70,-90,120,201,206,407,809
-150,-90,40,201,206,407,809
20,-90,-150,201,206,407,809
70,-90,-100,201,206,407,809
-10,-90,-180,201,206,407,809
120,70,60,208,200,408,811
-40,70,-150,206,202,408,715
-130,-80,-160,201,207,408,827
80,50,160,190,218,408,802
0,-40,-60,196,212,408,866
-10,-50,-50,191,217,408,881
-90,-50,120,186,222,408,787
-100,-70,90,199,209,408,779
-40,-80,-80,199,209,408,777
80,-70,0,183,225,408,746
170,70,10,208,200,408,818
40,70,-80,192,216,408,795
120,50,130,191,217,408,842
-150,50,10,194,215,409,864
40,20,-120,199,210,409,852
70,-70,-20,194,215,409,823
-10,70,180,204,205,409,745
110,60,80,196,213,409,812
-130,-20,140,194,215,409,838
0,-10,170,212,197,409,750
50,70,130,216,193,409,807
-110,-30,140,183,226,409,912
130,80,-170,198,211,409,738
-10,-80,-60,189,220,409,779
-50,10,-120,199,210,409,816
140,-20,80,197,212,409,830
60,40,-150,195,214,409,857
-10,70,-180,204,205,409,745
-70,-40,-180,188,222,410,770
140,0,70,208,202,410,789
150,40,140,195,215,410,818
120,50,80,203,207,410,817
140,50,150,187,223,410,779
120,-70,-40,209,201,410,895
-70,-40,180,188,222,410,770
50,40,-120,195,215,410,859
-100,60,-40,196,214,410,789
140,-40,-10,206,204,410,839
140,-50,100,203,207,410,710
30,-10,-160,203,207,410,798
-120,-60,70,207,203,410,681
120,80,60,215,195,410,797
80,50,-180,197,214,411,906
10,-10,-60,186,225,411,839
-70,-40,-140,178,233,411,839
80,50,180,197,214,411,906
20,-60,-160,211,200,411,699
-80,70,-100,207,204,411,717
110,-60,50,200,211,411,738
110,80,-150,193,218,411,766
0,80,170,215,196,411,775
-10,-70,170,198,214,412,735
150,-60,-10,212,200,412,885
-20,70,-170,204,208,412,744
130,-20,40,201,211,412,686
40,30,-160,208,204,412,866
-20,-10,-30,206,206,412,750
180,-80,150,202,210,412,796
-110,-30,130,188,224,412,866
60,-70,-110,199,213,412,798
-180,-80,150,202,210,412,796
-20,-70,-60,200,212,412,861
-140,80,-40,211,201,412,794
-130,-50,-180,196,217,413,855
30,-80,-30,195,218,413,821
20,50,160,218,195,413,791
-130,-50,180,196,217,413,855
130,40,110,196,217,413,895
-160,60,130,192,221,413,754
-10,30,-180,208,205,413,828
-10,30,180,208,205,413,828
130,80,50,221,192,413,796
150,0,100,199,214,413,916
-110,-50,-170,191,222,413,904
150,60,160,197,216,413,773
140,0,20,207,207,414,835
20,-30,-90,191,223,414,879
-140,-80,50,202,212,414,853
120,-40,50,210,204,414,818
110,-60,-20,211,203,414,805
60,50,150,213,201,414,804
120,-70,70,197,217,414,802
10,80,160,214,200,414,780
-130,-30,70,199,215,414,779
170,80,10,222,192,414,813
110,70,70,209,205,414,839
140,-70,100,197,218,415,834
120,80,-160,197,218,415,754
-30,-40,170,197,218,415,832
50,-60,-80,199,216,415,772
-50,80,-140,210,205,415,753
50,40,-170,202,213,415,888
40,-50,-110,200,215,415,784
-10,-60,170,205,211,416,778
140,10,70,190,226,416,765
140,10,30,204,212,416,778
-10,-40,-50,204,212,416,893
30,30,-90,199,217,416,838
20,80,150,212,204,416,807
0,-30,-60,210,206,416,853
160,-50,140,213,203,416,763
170,10,140,199,217,416,814
10,-30,-180,209,207,416,746
40,-80,-20,196,220,416,846
40,30,-130,190,226,416,911
80,-80,-90,207,209,416,841
10,-30,180,209,207,416,746
-150,30,30,203,213,416,874
170,50,150,218,198,416,795
110,-50,0,203,214,417,807
140,30,30,200,217,417,783
160,30,10,208,209,417,732
50,40,-180,197,220,417,847
20,-40,-70,189,228,417,929
-50,-20,-80,208,209,417,764
-50,70,-140,208,209,417,750
50,40,180,197,220,417,847
-100,-60,90,198,220,418,763
60,60,130,214,204,418,913
140,20,30,205,213,418,820
-170,40,150,205,213,418,689
110,-70,-50,212,206,418,886
150,-50,-10,215,203,418,855
30,-20,-160,217,201,418,762
-160,-70,30,207,211,418,802
-50,-20,-140,194,224,418,865
30,20,-90,213,205,418,883
30,40,-80,198,221,419,758
60,70,120,217,202,419,878
70,-80,10,195,224,419,872
30,-40,-120,192,227,419,845
40,-50,-90,201,218,419,788
140,-10,80,198,221,419,768
40,20,-130,206,213,419,857
-60,-40,170,202,217,419,893
-140,0,130,206,213,419,893
-60,50,-20,202,217,419,778
130,60,50,212,207,419,757
80,-70,-80,203,216,419,802
10,30,170,206,214,420,845
10,70,160,213,207,420,765
10,10,170,208,212,420,851
-150,30,130,190,230,420,736
120,50,140,197,223,420,892
-130,60,80,201,219,420,822
-160,-40,20,213,207,420,785
-130,-10,130,186,234,420,860
50,50,-110,196,225,421,933
160,-10,130,206,215,421,792
110,60,180,205,216,421,919
-70,-50,140,197,224,421,797
130,-20,20,203,218,421,768
-120,-20,110,201,220,421,842
-90,-60,100,206,215,421,769
-50,0,-120,202,219,421,778
10,-40,180,211,210,421,781
100,-60,20,201,220,421,833
10,-40,-180,211,210,421,781
110,60,-180,205,216,421,919
130,40,50,204,218,422,868
-70,60,-110,209,213,422,744
0,-70,-180,202,220,422,788
-10,-10,-30,211,211,422,806
-110,-60,80,206,216,422,732
0,-70,180,202,220,422,788
10,0,170,212,210,422,866
170,-10,0,212,210,422,802
70,70,110,221,201,422,894
-50,0,-60,200,222,422,720
-140,70,100,205,217,422,771
-110,-30,120,189,233,422,852
80,50,170,193,230,423,839
130,60,160,206,217,423,957
-150,-20,40,202,221,423,790
120,-60,-30,216,207,423,834
10,20,170,210,213,423,854
90,50,140,206,217,423,884
-150,-80,40,204,220,424,856
-110,60,-20,205,219,424,886
-100,-40,170,186,238,424,889
30,-40,-90,196,228,424,887
-160,40,140,197,227,424,695
150,20,120,206,218,424,853
90,-80,-80,211,213,424,860
140,60,160,208,216,424,874
140,50,40,211,213,424,773
40,20,-140,206,218,424,914
160,30,140,208,217,425,830
100,70,80,214,211,425,864
130,40,120,208,217,425,859
0,70,170,216,209,425,765
130,-40,-10,213,212,425,848
120,-50,-10,209,216,425,892
-160,-80,30,208,217,425,871
-150,80,-30,218,207,425,839
130,-30,0,217,208,425,887
20,0,-70,195,230,425,796
-60,20,-100,208,217,425,816
-20,-70,160,207,218,425,751
40,30,-120,191,234,425,889
-130,-10,90,206,220,426,902
170,-80,140,209,217,426,813
-120,-20,130,198,228,426,968
80,50,-170,202,224,426,924
-120,50,20,197,229,426,820
50,-80,-10,199,228,427,891
90,70,90,221,206,427,886
170,0,0,219,208,427,840
-50,-10,-70,205,222,427,805
-110,-30,110,193,234,427,870
-80,-40,-160,187,240,427,858
-60,40,-40,209,218,427,787
-10,40,-30,206,221,427,729
-170,-10,160,216,211,427,859
60,40,-140,205,222,427,862
30,-30,-150,214,214,428,835
-100,-50,100,183,245,428,822
150,-10,110,212,216,428,839
-130,50,70,203,225,428,851
-120,50,30,192,236,428,797
30,-40,-130,205,223,428,851
-10,-40,170,201,227,428,807
80,70,100,220,208,428,896
30,0,-90,192,237,429,834
170,-10,150,211,218,429,830
0,0,170,212,217,429,864
-170,0,10,222,207,429,832
120,-60,70,205,224,429,759
100,60,-160,204,225,429,906
-170,-80,20,213,216,429,899
40,30,-110,202,227,429,869
-150,-40,170,213,216,429,911
10,-30,-70,212,217,429,836
0,60,170,216,213,429,831
0,-80,-50,198,231,429,843
-70,40,-80,212,217,429,821
-60,-30,-150,196,233,429,832
170,30,150,204,225,429,762
130,30,60,209,221,430,826
30,-50,-70,204,226,430,915
60,-80,0,200,230,430,905
100,-70,40,214,216,430,817
-130,-30,160,209,221,430,934
-120,-80,-150,208,222,430,845
-20,-60,160,215,215,430,800
150,-60,120,211,219,430,797
-30,-20,-40,212,219,431,779
0,50,170,224,207,431,810
-100,70,50,214,217,431,814
140,70,170,206,225,431,929
-160,80,-20,224,207,431,833
170,60,10,225,206,431,817
130,30,80,210,221,431,821
170,60,160,225,206,431,745
-60,30,-50,207,224,431,841
-110,70,-60,212,219,431,789
-70,50,-20,207,224,431,853
-10,20,-180,218,214,432,828
40,20,-110,206,226,432,843
160,20,130,204,228,432,800
-60,80,-130,216,216,432,777
30,-60,-150,218,214,432,741
-10,20,180,218,214,432,828
20,-30,-170,219,213,432,784
-70,40,-70,213,220,433,833
150,40,20,230,203,433,791
-60,-30,-140,197,236,433,781
0,20,170,219,214,433,892
60,-70,-30,193,240,433,883
-70,70,20,210,223,433,710
40,-70,-40,199,234,433,838
40,60,140,225,208,433,840
-180,-80,10,213,220,433,917
-10,-50,170,208,225,433,861
-120,-30,90,205,228,433,843
-110,-40,170,194,239,433,890
40,-60,-60,204,229,433,938
180,-80,10,213,220,433,917
90,50,180,217,217,434,935
160,-70,130,204,230,434,887
140,-80,100,211,223,434,892
-170,30,10,224,210,434,931
-80,-40,160,198,236,434,886
-150,-10,40,203,231,434,839
90,50,-180,217,217,434,935
-110,-30,150,200,234,434,970
-180,50,150,213,222,435,790
180,50,150,213,222,435,790
110,50,120,211,224,435,928
-10,40,-180,219,216,435,802
20,70,150,217,218,435,816
-10,40,180,219,216,435,802
110,-80,60,196,239,435,822
-40,60,-10,208,227,435,788
-160,40,10,223,212,435,891
100,-80,-70,215,220,435,903
-50,50,-20,206,229,435,783
40,20,-150,205,230,435,895
-90,-40,170,206,229,435,956
50,70,-90,206,229,435,880
150,-80,-20,224,212,436,954
-30,-50,160,218,218,436,858
-130,-40,60,205,231,436,774
140,-10,10,216,220,436,886
-90,70,40,214,222,436,796
140,40,140,207,229,436,849
20,40,160,226,210,436,882
-60,-30,-130,207,229,436,839
-90,-40,140,208,228,436,838
-60,70,-130,216,220,436,790
110,-40,20,232,204,436,813
10,-70,-50,214,223,437,919
-80,60,-90,226,211,437,765
10,-10,170,218,219,437,881
150,-40,-10,226,211,437,881
160,-80,-10,219,218,437,950
-170,80,-10,231,206,437,853
110,50,130,203,234,437,972
30,-60,-60,202,235,437,877
-170,-40,10,227,210,437,842
140,-80,-30,220,218,438,952
-50,-60,140,218,220,438,885
-70,80,-120,217,221,438,800
90,-70,-70,216,222,438,867
140,-20,0,215,223,438,856
30,80,140,225,213,438,855
-140,30,110,206,232,438,798
30,-20,-110,205,233,438,842
-60,60,-130,223,215,438,761
-10,-60,-50,211,227,438,931
150,10,110,208,230,438,939
90,50,150,207,232,439,926
-110,90,-80,224,215,439,873
40,90,130,224,215,439,873
70,90,100,224,215,439,873
160,90,10,224,215,439,873
140,-60,-20,231,208,439,944
-20,90,-170,224,215,439,873
30,90,140,224,215,439,873
40,80,130,230,209,439,874
-170,90,-20,224,215,439,873
110,90,60,224,215,439,873
150,90,20,224,215,439,873
120,90,50,224,215,439,873
20,90,150,224,215,439,873
-70,90,-120,224,215,439,873
90,90,80,224,215,439,873
-120,90,-70,224,215,439,873
-50,90,-140,224,215,439,873
-180,90,-10,224,215,439,873
-40,90,-150,224,215,439,873
-170,-70,20,219,220,439,858
-10,90,180,224,215,439,873
80,90,90,224,215,439,873
-130,50,10,207,232,439,930
-100,90,-90,224,215,439,873
0,90,170,224,215,439,873
-80,90,-110,224,215,439,873
-160,90,-30,224,215,439,873
60,90,110,224,215,439,873
50,90,120,224,215,439,873
-150,90,-40,224,215,439,873
-60,90,-130,224,215,439,873
-30,90,-160,224,215,439,873
170,90,0,224,215,439,873
180,90,-10,224,215,439,873
-90,90,-100,224,215,439,873
130,-20,10,215,224,439,856
10,90,160,224,215,439,873
140,90,30,224,215,439,873
-40,-70,-70,215,224,439,884
-130,90,-60,224,215,439,873
130,90,40,224,215,439,873
100,90,70,224,215,439,873
-140,90,-50,224,215,439,873
-10,90,-180,224,215,439,873
-150,-20,160,213,227,440,895
140,-40,100,226,214,440,915
-180,-60,160,220,220,440,828
100,70,-150,210,230,440,901
20,-20,-80,223,217,440,874
30,60,-70,209,231,440,891
-60,50,-120,220,220,440,767
-180,80,0,236,204,440,860
-100,-80,-130,213,227,440,851
-60,60,0,205,235,440,779
180,80,0,236,204,440,860
180,-60,160,220,220,440,828
-60,-70,-90,219,221,440,812
150,-10,0,226,214,440,915
-30,-80,-70,210,230,440,855
-140,-60,-170,218,223,441,855
170,-60,0,229,212,441,951
20,-70,-160,224,217,441,813
160,70,160,219,222,441,873
-90,-80,-120,218,223,441,860
-150,70,-20,226,215,441,832
70,-70,-100,216,225,441,838
130,-60,90,221,220,441,828
10,-70,-170,218,223,441,799
-120,-50,70,203,238,441,814
-40,-30,180,208,233,441,881
50,-60,-120,223,218,441,795
-40,-30,-180,208,233,441,881
100,60,90,208,233,441,855
180,-70,10,222,220,442,898
-160,-10,160,213,229,442,873
160,0,0,230,212,442,849
110,-50,-10,218,224,442,920
-180,-70,10,222,220,442,898
170,-80,0,218,224,442,949
-170,-10,10,223,219,442,883
-20,-60,-50,216,226,442,875
170,-30,160,226,217,443,823
140,20,100,220,223,443,848
-160,30,20,216,227,443,907
-70,40,-60,216,227,443,796
-120,-40,170,205,238,443,947
10,10,-50,211,232,443,830
-110,-80,-140,210,233,443,859
10,20,-50,223,220,443,880
-140,0,50,204,239,443,788
10,70,-40,209,234,443,831
60,40,-160,212,232,444,935
-140,50,10,207,237,444,919
50,-60,-70,210,234,444,904
-40,-30,-60,214,230,444,813
160,-20,130,229,215,444,846
150,20,10,231,213,444,806
170,-70,0,225,220,445,964
80,-70,10,210,235,445,847
160,0,130,227,218,445,878
110,-50,50,213,232,445,843
-150,20,130,216,229,445,871
-80,70,30,216,229,445,779
-60,-60,130,211,234,445,931
30,-10,-170,231,214,445,885
130,50,150,203,242,445,939
160,-10,0,229,217,446,841
-160,-40,170,220,226,446,885
-180,-10,160,223,223,446,828
140,30,120,211,235,446,867
-50,30,-40,208,238,446,803
180,-10,160,223,223,446,828
140,10,20,224,222,446,830
-80,-40,170,203,243,446,949
120,60,170,214,232,446,1063
-80,-50,130,205,241,446,928
80,50,-160,214,232,446,925
30,20,180,215,232,447,808
30,20,-180,215,232,447,808
0,-10,-40,218,229,447,810
-30,-70,150,219,228,447,783
170,40,150,214,233,447,780
-40,30,-150,219,228,447,839
130,-80,-40,226,222,448,952
-80,-40,-180,211,237,448,928
10,40,-40,208,240,448,800
-80,-40,180,211,237,448,928
30,-70,-150,230,218,448,865
20,20,170,217,231,448,902
90,50,170,220,228,448,960
-50,-70,-80,220,228,448,826
-70,50,-100,225,223,448,818
-170,-20,10,223,226,449,824
-140,20,110,213,236,449,851
120,-40,0,211,238,449,891
-60,10,-70,213,236,449,786
-30,0,-160,221,228,449,927
20,40,-60,211,238,449,858
-40,40,-150,228,222,450,865
-30,70,-10,213,237,450,775
30,40,160,227,223,450,900
-170,-30,10,227,223,450,873
100,50,170,213,237,450,956
20,70,-50,218,232,450,871
90,50,-170,216,234,450,953
-80,-80,-110,218,232,450,855
-130,-40,170,220,230,450,1003
-70,40,-90,227,223,450,898
70,-70,-10,209,241,450,879
-150,60,-10,223,227,450,871
100,-60,-20,211,239,450,933
40,10,-130,218,233,451,908
120,60,60,227,224,451,884
140,-30,-10,229,222,451,959
20,-20,-180,231,220,451,824
50,80,120,235,216,451,901
-70,-70,-100,225,226,451,875
130,-50,-20,231,220,451,955
20,-20,180,231,220,451,824
130,-20,50,224,227,451,864
-50,30,-130,220,231,451,871
-40,10,-150,216,235,451,922
-60,10,-80,212,240,452,845
-160,-70,-180,223,229,452,810
160,40,10,232,220,452,814
-160,0,20,234,218,452,826
120,-30,20,214,238,452,799
-10,-30,170,220,232,452,841
-110,-40,90,196,256,452,880
-110,-60,-150,210,242,452,925
110,50,140,209,243,452,979
150,-30,110,224,228,452,845
-160,-70,180,223,229,452,810
130,40,130,215,237,452,832
80,50,140,219,233,452,870
0,-20,-50,222,231,453,837
40,40,160,220,233,453,871
-100,-40,110,207,246,453,924
120,50,150,219,234,453,991
60,70,-100,211,242,453,884
10,50,-40,220,233,453,785
-140,-40,170,220,233,453,998
30,0,-170,233,221,454,899
50,40,170,221,233,454,902
170,10,0,233,221,454,837
30,-50,-150,235,219,454,860
100,50,160,217,237,454,995
-130,60,-10,218,236,454,885
100,-60,30,221,233,454,915
-80,-60,110,217,237,454,880
-50,20,-130,217,237,454,905
130,-70,90,223,231,454,936
-60,-30,-120,216,239,455,884
30,50,150,240,215,455,878
30,-40,-80,211,244,455,1021
100,50,-180,221,234,455,953
-20,-30,170,224,231,455,887
100,50,180,221,234,455,953
-140,50,100,213,242,455,818
-140,30,40,223,232,455,1006
20,20,-70,222,233,455,991
160,-80,130,227,228,455,892
-140,-50,40,225,230,455,818
180,0,160,233,223,456,861
40,30,-170,237,219,456,953
40,-50,-120,217,239,456,887
110,-80,-60,232,224,456,941
-120,50,10,216,240,456,892
20,-40,-170,233,223,456,851
-60,-60,-90,224,232,456,923
20,-10,-70,202,254,456,927
110,-60,-30,225,231,456,874
140,10,80,218,238,456,859
-10,20,-30,224,232,456,841
40,50,-90,205,251,456,990
60,-60,-90,220,236,456,898
-20,20,-30,227,229,456,858
170,-40,160,222,234,456,864
-180,0,160,233,223,456,861
30,-30,-130,222,234,456,863
70,80,100,232,224,456,965
90,50,160,213,243,456,965
90,50,130,227,229,456,927
180,70,150,232,225,457,818
-150,-50,30,224,233,457,822
-170,-70,170,231,226,457,793
0,-80,-180,214,243,457,813
-70,-40,170,209,248,457,987
0,-80,180,214,243,457,813
-40,40,-30,221,236,457,860
0,10,170,228,229,457,964
-40,20,-150,232,225,457,881
120,40,90,224,233,457,979
100,-70,-60,233,224,457,920
90,-60,0,224,233,457,882
-20,-80,160,214,243,457,818
60,80,110,236,221,457,944
90,60,100,230,227,457,920
150,0,110,216,241,457,1006
30,30,170,237,220,457,872
110,-40,10,228,229,457,841
-180,70,150,232,225,457,818
110,50,170,218,240,458,1005
80,80,90,232,226,458,979
100,50,150,212,246,458,1034
-120,-20,100,219,240,459,928
140,0,80,237,222,459,912
-160,-50,20,228,231,459,874
100,50,140,212,247,459,1001
60,40,-130,210,249,459,960
-60,-50,140,222,237,459,964
-60,-30,-160,215,244,459,1006
-80,-50,-130,220,239,459,945
160,-70,-10,240,219,459,1005
-20,30,-30,231,228,459,855
-30,-80,150,213,246,459,840
-70,-40,-130,195,264,459,926
40,20,-100,216,243,459,859
120,40,80,226,234,460,964
-90,-50,110,202,258,460,848
-120,70,-50,230,230,460,880
-180,-70,160,230,230,460,834
180,-70,160,230,230,460,834
110,50,110,223,237,460,959
120,-80,-50,230,230,460,937
-90,-40,130,221,239,460,967
130,-60,-30,231,229,460,1005
150,-30,-10,234,226,460,970
90,80,80,235,226,461,996
70,60,120,233,228,461,954
30,30,-80,217,244,461,913
10,-40,-60,214,247,461,991
10,60,-40,221,240,461,836
110,50,150,222,239,461,1012
110,-70,60,227,234,461,937
-50,-10,-130,219,242,461,918
0,-20,170,228,233,461,802
-40,50,-20,227,234,461,788
-120,-50,-170,225,237,462,959
50,-90,10,216,246,462,952
-20,-90,-60,216,246,462,952
110,-90,70,216,246,462,952
-120,-70,-150,224,238,462,854
-140,-90,180,216,246,462,952
0,40,170,232,230,462,897
-30,-90,-70,216,246,462,952
-90,-90,-130,216,246,462,952
10,-90,-30,216,246,462,952
60,40,-170,208,254,462,1017
-50,-90,-90,216,246,462,952
-80,-90,-120,216,246,462,952
0,-90,-40,216,246,462,952
160,-90,120,216,246,462,952
-180,-90,140,216,246,462,952
10,-80,-170,220,242,462,856
-40,-90,-80,216,246,462,952
40,-90,0,216,246,462,952
20,-90,-20,216,246,462,952
-100,-90,-140,216,246,462,952
-80,80,-110,227,235,462,859
180,-90,140,216,246,462,952
40,-70,-140,228,234,462,893
-140,-90,-180,216,246,462,952
130,-90,90,216,246,462,952
170,-90,130,216,246,462,952
30,-90,-10,216,246,462,952
-150,-90,170,216,246,462,952
-50,-20,-150,216,246,462,865
150,-90,110,216,246,462,952
120,-90,80,216,246,462,952
-130,-90,-170,216,246,462,952
70,-90,30,216,246,462,952
100,-90,60,216,246,462,952
90,-90,50,216,246,462,952
80,-90,40,216,246,462,952
-60,-90,-100,216,246,462,952
-110,-90,-150,216,246,462,952
60,-90,20,216,246,462,952
-70,-90,-110,216,246,462,952
-120,-90,-160,216,246,462,952
-150,50,120,218,244,462,845
-170,-90,150,216,246,462,952
140,-90,100,216,246,462,952
-10,-90,-50,216,246,462,952
-160,-90,160,216,246,462,952
110,50,100,218,245,463,999
50,60,-100,218,245,463,986
10,-80,-40,212,251,463,922
100,80,70,237,226,463,990
-10,-80,170,217,247,464,834
30,-40,-140,231,233,464,923
160,-60,-10,245,219,464,1006
-50,-70,130,227,237,464,920
100,-50,20,225,239,464,918
120,-30,30,224,240,464,822
100,50,130,223,241,464,962
0,-50,-50,226,238,464,982
-90,60,-70,223,242,465,952
-120,50,40,222,243,465,903
120,-50,-20,234,231,465,996
-140,60,100,224,241,465,900
10,50,160,242,223,465,955
100,-80,50,210,255,465,904
90,-60,-10,222,243,465,893
0,-40,170,228,237,465,796
150,-70,-20,242,223,465,1030
110,50,160,228,237,465,1012
70,60,-120,224,242,466,986
30,10,180,225,241,466,928
30,-80,-150,231,235,466,892
-50,50,-140,227,239,466,857
60,50,-120,209,257,466,1039
110,70,-160,220,246,466,967
-140,10,120,223,243,466,1049
110,80,60,239,227,466,989
80,60,110,237,229,466,968
0,30,170,234,232,466,927
-140,60,-10,228,238,466,912
40,-50,-80,227,239,466,914
30,10,-180,225,241,466,928
20,10,-70,220,246,466,973
-140,70,-30,233,233,466,883
140,40,30,234,233,467,900
170,30,0,242,225,467,881
100,-50,30,224,243,467,893
20,-80,-160,223,244,467,876
10,0,-50,209,258,467,812
70,70,-110,219,248,467,912
160,10,0,246,221,467,866
120,-50,70,226,241,467,850
150,50,160,220,248,468,860
20,-50,-60,219,249,468,949
10,60,160,236,232,468,865
160,-40,-10,241,227,468,990
-90,70,-90,233,235,468,874
0,-60,-50,229,239,468,1014
120,50,70,233,235,468,915
150,30,10,238,230,468,872
30,10,-90,214,254,468,1016
170,20,0,248,220,468,820
120,50,160,230,238,468,1043
-100,-30,140,229,239,468,1011
-170,-50,10,241,227,468,934
-50,-50,150,226,243,469,980
-180,70,0,235,234,469,951
0,-30,170,226,243,469,887
-160,50,0,230,239,469,934
-90,-60,-130,226,243,469,980
170,0,150,233,236,469,857
160,-30,-10,241,228,469,965
20,0,170,239,230,469,962
-80,50,-70,225,244,469,932
180,70,0,235,234,469,951
160,50,10,241,228,469,885
100,70,70,238,231,469,987
30,70,140,243,226,469,883
0,-70,-50,217,252,469,1019
120,-30,10,238,231,469,884
140,20,110,229,241,470,987
130,30,50,240,230,470,908
50,60,130,239,231,470,999
-30,-50,-50,228,242,470,891
-60,10,-90,217,253,470,955
130,50,50,237,233,470,905
30,-10,-80,216,254,470,904
-40,-70,140,226,244,470,873
-60,30,-110,223,247,470,933
170,40,0,244,226,470,919
-180,-10,0,242,229,471,983
70,50,-140,227,244,471,1019
-40,-80,140,223,248,471,863
-170,50,0,236,235,471,890
-10,30,-30,230,241,471,829
-50,-50,-80,228,243,471,916
40,30,-100,222,249,471,973
-130,70,-40,227,244,471,925
180,-10,0,242,229,471,983
110,60,-170,228,244,472,1040
130,70,-180,232,240,472,1041
120,80,50,241,231,472,982
140,-50,-20,248,224,472,978
30,-20,-100,231,241,472,974
-150,10,30,229,243,472,866
-180,-30,0,241,231,472,952
160,-50,-10,246,226,472,978
20,-50,-170,238,234,472,828
130,70,180,232,240,472,1041
70,50,140,234,238,472,936
-50,0,-130,224,248,472,950
180,-30,0,241,231,472,952
80,60,-130,227,245,472,938
-180,40,0,232,241,473,884
-180,0,0,244,229,473,934
180,40,0,232,241,473,884
-70,-60,120,226,247,473,953
-150,20,30,236,237,473,900
180,0,0,244,229,473,934
-30,-20,-180,225,248,473,912
140,-10,90,233,240,473,920
-80,50,-60,225,248,473,958
-90,-40,-180,229,244,473,1066
-90,-40,180,229,244,473,1066
-80,50,-30,214,259,473,971
-130,0,100,232,241,473,1048
-30,-20,180,225,248,473,912
100,50,-170,234,240,474,1001
110,-40,30,246,228,474,931
-130,0,90,231,243,474,1055
110,50,180,229,245,474,1070
-170,70,140,244,230,474,875
-180,-40,0,247,227,474,1010
30,60,140,250,224,474,912
110,50,-180,229,245,474,1070
160,10,130,230,244,474,974
-50,-80,130,226,248,474,873
180,-40,0,247,227,474,1010
30,-30,-160,237,238,475,937
50,50,140,236,239,475,978
-140,-20,50,225,250,475,904
40,-80,-140,235,240,475,929
110,70,60,238,237,475,992
10,40,160,246,230,476,984
-170,-60,170,239,237,476,878
150,60,20,242,234,476,929
-30,-60,150,233,243,476,891
50,-70,-30,210,266,476,1011
140,10,90,228,248,476,936
-110,60,50,228,248,476,947
-160,-30,20,234,242,476,901
40,10,-140,226,250,476,956
-70,-80,-100,231,246,477,887
-140,-50,-180,233,244,477,1018
0,60,-30,229,248,477,867
-60,-80,120,233,244,477,913
-120,-30,160,219,258,477,1081
-50,-30,-80,230,247,477,934
130,-80,90,228,249,477,985
140,-70,-30,247,230,477,1063
50,40,-110,223,254,477,1031
-20,-40,-40,241,236,477,887
20,-80,-30,214,263,477,983
30,-30,-120,231,246,477,929
-140,-50,180,233,244,477,1018
60,60,-110,230,247,477,1050
70,40,-160,225,253,478,955
50,30,-130,230,248,478,1038
-20,-80,-60,230,248,478,951
-70,-80,110,235,244,479,926
90,70,80,244,235,479,1029
40,20,-160,231,248,479,930
-80,-70,-110,239,240,479,909
50,70,120,249,230,479,970
120,70,-170,229,250,479,1038
140,0,90,234,245,479,982
-70,40,-50,236,243,479,876
140,-60,110,237,242,479,914
40,-60,-140,250,229,479,817
-130,0,110,232,248,480,1064
140,-50,110,240,240,480,981
170,-60,150,231,249,480,907
30,-20,-170,252,228,480,921
170,70,160,246,234,480,861
-40,-20,-170,233,247,480,857
30,-70,-40,215,265,480,957
140,60,30,246,234,480,930
-170,-50,170,241,240,481,964
100,50,120,240,241,481,1004
-30,-70,-60,241,240,481,1010
60,-70,-20,226,255,481,1001
140,-30,90,230,251,481,935
80,-70,-90,235,246,481,938
60,-60,-100,234,247,481,911
20,30,160,234,247,481,987
-100,-30,150,220,261,481,1064
140,10,10,245,236,481,965
-60,-70,120,235,246,481,942
-130,0,80,233,249,482,968
-130,-20,70,233,249,482,966
70,40,-170,225,257,482,897
60,40,180,224,258,482,1031
180,-50,0,244,238,482,1042
-100,60,-50,228,254,482,923
-80,-40,150,217,265,482,978
120,70,50,248,234,482,971
130,70,40,249,233,482,971
70,40,-150,225,257,482,981
110,50,90,235,247,482,1017
60,40,-180,224,258,482,1031
20,50,-50,233,249,482,1000
-110,60,-30,239,243,482,988
-180,-50,0,244,238,482,1042
140,0,10,239,244,483,935
20,-30,-80,224,259,483,1020
-80,50,-20,225,258,483,999
-30,-40,-50,225,258,483,904
30,80,-60,227,256,483,850
10,-20,170,242,241,483,915
150,0,0,240,243,483,963
90,-80,40,220,263,483,961
150,50,20,247,236,483,849
50,-60,-60,221,263,484,1001
-90,-40,-170,219,265,484,1059
100,-60,40,240,244,484,949
-140,20,40,231,253,484,945
20,30,-60,221,263,484,961
50,30,-150,227,257,484,1057
40,70,130,253,232,485,932
10,-50,-180,240,245,485,875
-80,50,-50,230,255,485,1008
10,-50,180,240,245,485,875
-30,50,-170,241,244,485,919
130,-40,-20,244,241,485,1037
20,60,150,253,232,485,907
90,-70,30,241,245,486,935
120,-40,60,239,247,486,993
40,30,-180,245,241,486,1008
-150,-40,30,232,254,486,855
130,30,90,230,256,486,910
130,-30,70,230,256,486,1002
40,30,180,245,241,486,1008
10,30,160,236,250,486,1022
-170,20,10,244,242,486,997
140,-10,0,244,242,486,1028
80,70,90,244,242,486,1041
40,-50,-130,235,251,486,964
-70,60,10,236,251,487,861
130,30,100,235,252,487,922
-140,-60,40,246,241,487,907
-10,-30,-40,244,243,487,887
-80,-80,100,238,249,487,941
130,-70,-40,249,239,488,1079
40,80,-70,227,261,488,852
180,-20,0,250,238,488,939
60,50,140,249,239,488,1038
50,-80,-130,248,240,488,969
150,-20,110,240,248,488,973
110,-60,60,239,249,488,886
140,50,160,223,265,488,999
-180,-20,0,250,238,488,939
-110,-50,80,232,257,489,976
10,-10,-50,233,256,489,948
170,20,150,233,256,489,977
150,80,20,254,235,489,1073
150,-60,-20,260,229,489,1050
-110,50,10,230,259,489,972
50,-70,-130,239,250,489,947
130,-20,60,233,256,489,971
70,-70,0,238,251,489,980
140,0,100,240,250,490,1032
140,70,30,253,237,490,986
-130,70,90,232,258,490,908
20,80,-50,227,263,490,849
-60,-80,-90,229,261,490,925
-70,30,-80,240,251,491,856
130,30,110,237,254,491,921
-140,40,20,232,259,491,999
30,-60,-50,225,266,491,1069
120,50,170,236,255,491,1120
120,40,100,240,251,491,1075
-160,-20,20,248,243,491,972
-170,0,160,244,247,491,996
-170,-40,170,247,244,491,944
-50,-20,-70,240,252,492,946
70,40,-180,238,254,492,965
-120,-20,90,239,253,492,1032
-170,70,-10,248,244,492,1043
-80,50,-40,232,260,492,993
-70,-70,110,245,247,492,969
-130,-10,80,235,257,492,987
110,60,70,237,255,492,1010
-30,50,-20,242,250,492,844
30,-30,-110,233,259,492,958
-160,-30,170,248,244,492,992
20,10,170,236,256,492,1051
70,40,180,238,254,492,965
140,30,130,239,254,493,1007
70,70,100,246,247,493,1062
80,70,-120,234,259,493,976
-90,80,-100,241,252,493,902
120,-40,-10,240,253,493,983
80,-80,30,226,267,493,999
-100,-60,-140,233,260,493,1018
150,0,120,234,259,493,1072
-70,-40,160,233,260,493,971
140,80,30,255,238,493,1031
50,30,-120,238,255,493,1083
140,20,20,250,244,494,934
130,80,40,255,239,494,1016
130,-40,80,242,252,494,998
50,30,-140,240,254,494,1037
-100,-30,130,247,247,494,994
150,-70,120,237,257,494,1017
-130,40,60,238,256,494,972
130,-20,0,242,252,494,974
-160,60,-10,244,250,494,926
-160,10,20,243,251,494,899
-70,70,-120,250,245,495,890
130,40,140,242,253,495,955
150,-80,120,250,245,495,997
40,-10,-110,219,276,495,975
140,30,20,247,248,495,969
60,-60,-80,244,251,495,1004
-30,60,-170,257,238,495,934
40,-10,-100,225,270,495,974
130,-10,50,244,251,495,951
40,-60,-50,230,265,495,1058
130,-50,90,243,252,495,943
-140,-10,150,234,262,496,994
-20,-20,-30,245,251,496,949
-120,60,-20,246,250,496,1075
40,-10,-120,225,271,496,999
160,-30,140,247,249,496,936
60,40,170,238,258,496,1022
40,10,-120,239,257,496,1006
-160,-10,20,243,253,496,989
140,-20,90,236,261,497,1036
-120,-30,80,233,264,497,1075
100,50,110,242,255,497,1065
170,-70,150,256,241,497,932
120,-30,40,247,250,497,985
-10,-10,170,247,250,497,925
130,60,170,245,252,497,1136
-70,30,-70,242,255,497,911
30,70,-60,246,251,497,911
60,-80,-120,249,248,497,1012
120,40,120,240,257,497,1079
120,40,70,246,252,498,982
20,-60,-170,250,248,498,930
-40,-20,-50,248,250,498,896
-150,-60,30,249,249,498,950
-20,-10,-180,245,253,498,996
90,60,-140,229,269,498,998
-30,30,-30,249,249,498,966
-90,-50,-140,237,261,498,1026
-20,-10,180,245,253,498,996
-50,-80,-80,227,272,499,956
-10,0,170,247,252,499,903
-30,20,-30,245,254,499,956
0,10,-30,251,248,499,993
150,70,170,251,248,499,1050
90,60,90,244,255,499,1015
130,-30,-10,244,255,499,1031
90,-60,10,238,261,499,1026
50,40,160,250,249,499,939
160,-60,140,253,247,500,981
-110,-30,100,227,273,500,1031
-10,-70,-50,237,263,500,1087
-80,-40,-150,227,273,500,1014
70,-80,20,233,267,500,1057
40,0,-120,238,262,500,1010
0,-50,170,251,249,500,928
150,70,20,254,246,500,1017
30,50,-70,230,271,501,1037
130,-10,40,241,260,501,998
100,-50,10,246,255,501,1014
140,50,30,257,244,501,952
100,-60,-30,240,261,501,1006
30,0,-80,224,278,502,1067
-20,40,-180,251,251,502,991
40,40,-90,247,255,502,1038
-90,-80,90,251,251,502,977
160,80,10,263,239,502,1078
10,-20,-60,247,255,502,1008
90,-70,-80,250,252,502,977
40,30,-90,241,261,502,1043
50,80,-80,234,268,502,920
-20,40,180,251,251,502,991
20,60,-50,232,270,502,908
30,20,170,261,242,503,949
70,-80,-110,252,251,503,1047
60,40,-120,235,268,503,1027
120,-60,-40,250,253,503,1095
-70,-50,-110,239,264,503,1037
90,-60,-20,239,264,503,982
30,10,-80,244,259,503,1098
-80,-70,100,255,248,503,998
-40,0,-150,232,271,503,1027
-20,-50,160,256,247,503,1053
-60,-30,-110,235,268,503,1049
-130,40,40,248,255,503,1069
10,-30,170,251,252,503,945
90,50,-160,245,258,503,1042
40,50,140,261,242,503,947
140,10,100,240,264,504,1027
10,80,-40,239,265,504,873
-50,-40,-80,235,269,504,931
-10,-20,170,252,252,504,935
0,-40,-50,241,263,504,1081
20,-60,-50,237,267,504,1106
180,60,0,258,246,504,949
-20,60,-180,262,242,504,1008
-130,-70,50,249,255,504,1016
-20,60,180,262,242,504,1008
100,-50,0,251,253,504,1063
130,50,160,238,266,504,1097
-180,60,0,258,246,504,949
-130,40,70,237,267,504,987
120,-70,80,250,254,504,1025
110,-50,-20,248,257,505,1031
-140,-70,40,253,252,505,1018
-140,40,110,242,263,505,953
160,-20,-10,259,246,505,1005
-130,-20,150,247,258,505,1047
-10,-80,-50,238,267,505,997
-150,60,120,238,268,506,1002
0,70,-30,238,268,506,936
50,-80,0,241,265,506,1087
80,60,100,255,251,506,1112
-150,-70,-170,242,264,506,896
70,40,-140,227,279,506,980
-20,-50,-40,240,266,506,998
150,-20,-10,257,249,506,1018
-170,10,10,260,246,506,970
20,-90,-160,252,255,507,1018
0,-90,-180,252,255,507,1018
-60,-90,120,252,255,507,1018
-40,-90,140,252,255,507,1018
120,40,110,244,263,507,1060
0,-90,180,252,255,507,1018
60,-90,-120,252,255,507,1018
-20,-90,160,252,255,507,1018
-150,-90,30,252,255,507,1018
-170,-90,10,252,255,507,1018
180,-90,0,252,255,507,1018
130,-90,-50,252,255,507,1018
-80,-90,100,252,255,507,1018
150,-90,-30,252,255,507,1018
30,-90,-150,252,255,507,1018
-120,-90,60,252,255,507,1018
100,-90,-80,252,255,507,1018
10,-90,-170,252,255,507,1018
-40,0,-40,256,251,507,917
120,-60,80,254,253,507,955
120,-80,80,242,265,507,1077
-90,-90,90,252,255,507,1018
90,-90,-90,252,255,507,1018
-110,-90,70,252,255,507,1018
-160,-90,20,252,255,507,1018
50,-90,-130,252,255,507,1018
120,-90,-60,252,255,507,1018
-50,-90,130,252,255,507,1018
-50,-20,-160,231,276,507,973
160,-90,-20,252,255,507,1018
-130,-90,50,252,255,507,1018
140,-90,-40,252,255,507,1018
40,20,-90,239,268,507,931
80,-90,-100,252,255,507,1018
10,-60,-50,248,259,507,1088
110,-90,-70,252,255,507,1018
-180,-90,0,252,255,507,1018
70,-90,-110,252,255,507,1018
170,-90,-10,252,255,507,1018
-100,-90,80,252,255,507,1018
-70,-90,110,252,255,507,1018
-30,-90,150,252,255,507,1018
-100,-80,80,250,257,507,996
-140,-90,40,252,255,507,1018
-10,-90,170,252,255,507,1018
-30,-10,-170,246,261,507,983
40,-90,-140,252,255,507,1018
60,-80,10,243,265,508,1096
-160,-60,20,254,254,508,1010
0,0,-30,260,248,508,932
-20,50,-180,255,253,508,945
-20,50,180,255,253,508,945
30,80,130,268,240,508,1010
80,50,130,246,262,508,980
-30,-30,170,249,259,508,1035
40,10,-150,240,268,508,988
120,-70,-50,250,259,509,1103
-150,0,150,248,261,509,1090
-50,-30,-180,243,266,509,1010
-110,-70,-140,249,260,509,976
-80,-50,120,238,271,509,1037
100,-50,40,240,269,509,951
20,-70,-40,241,268,509,1079
-160,20,20,258,251,509,1017
-170,-30,170,258,251,509,1010
-50,-30,180,243,266,509,1010
100,60,80,245,264,509,1035
120,40,130,238,272,510,1148
-60,40,-120,260,250,510,1040
20,-30,-180,254,256,510,967
40,-80,-10,240,270,510,1096
30,-80,-20,227,283,510,1056
100,-70,50,259,251,510,1013
20,-30,180,254,256,510,967
50,20,-110,249,261,510,996
60,-60,-70,245,265,510,1048
-150,10,140,260,251,511,1198
60,70,110,263,248,511,1031
60,60,120,266,245,511,1112
40,20,-170,241,270,511,1059
150,60,170,247,264,511,943
110,-60,-40,266,245,511,1011
110,-70,-60,254,257,511,1085
30,0,180,253,258,511,1072
-160,70,130,258,253,511,964
30,-40,-150,264,247,511,1002
-130,0,120,245,266,511,1109
20,80,140,268,243,511,984
30,0,-180,253,258,511,1072
150,-50,-20,259,252,511,1063
-150,40,10,246,265,511,1078
80,-80,-100,256,256,512,1074
-180,50,0,261,251,512,947
30,20,-80,249,263,512,1051
-40,-80,-70,243,269,512,1031
40,0,-130,251,261,512,974
50,80,110,269,243,512,1016
0,80,160,263,249,512,990
-70,-50,130,244,268,512,1020
-170,-60,10,259,253,512,1094
160,20,0,261,251,512,954
180,50,0,261,251,512,947
60,-60,-60,237,275,512,1034
130,20,60,252,260,512,1090
-150,-80,30,250,263,513,1075
10,-50,-50,249,264,513,1116
140,-60,-30,267,246,513,1107
-110,-80,70,245,268,513,1008
-150,50,0,245,268,513,1080
20,-20,-70,253,260,513,1071
-90,-70,90,262,251,513,1029
0,80,-30,244,269,513,888
-130,-50,50,245,268,513,925
170,80,0,271,242,513,1123
10,80,150,263,250,513,968
180,30,0,253,261,514,975
170,-30,-10,262,252,514,1105
-180,30,0,253,261,514,975
-90,-70,-120,249,265,514,991
30,-10,-180,264,250,514,1049
-180,10,0,264,250,514,987
30,-10,180,264,250,514,1049
50,20,-120,258,256,514,987
30,-20,-90,242,272,514,1034
180,10,0,264,250,514,987
30,-30,-100,248,266,514,1066
140,-40,-20,259,255,514,1034
30,-50,-60,244,270,514,1128
170,-50,-10,264,251,515,1135
-60,10,-60,250,265,515,836
-60,10,-100,239,276,515,1073
40,10,-90,246,269,515,1008
-160,-70,20,250,265,515,1100
-100,-40,180,249,266,515,1144
-100,-40,100,233,282,515,989
180,30,160,253,262,515,955
-100,-40,-180,249,266,515,1144
50,30,-110,247,268,515,1135
-180,30,160,253,262,515,955
-50,40,-30,253,262,515,944
-150,-70,30,257,258,515,1075
60,-70,-120,259,257,516,1000
20,-10,170,258,258,516,1018
-50,-10,-140,246,270,516,1069
60,-70,-10,249,267,516,1110
-120,-20,140,246,270,516,1142
-110,60,-40,249,267,516,1066
-110,50,0,241,275,516,1026
-140,-80,40,248,268,516,1041
40,80,120,273,243,516,1000
40,-50,-70,248,268,516,1133
-100,50,0,245,271,516,1055
70,60,110,265,252,517,1160
50,30,-160,246,271,517,1137
30,-40,-70,238,279,517,1106
-120,-80,60,250,267,517,1034
-110,50,20,230,287,517,1051
30,30,-70,257,260,517,1083
-80,50,-80,247,270,517,982
-60,-30,-170,243,274,517,1021
120,-30,0,257,260,517,1035
-90,-40,120,240,278,518,1066
60,80,-90,244,274,518,973
10,-30,-60,257,261,518,1071
-130,50,80,234,284,518,984
40,60,-80,249,269,518,1106
40,-70,-30,237,281,518,1102
-60,-40,160,251,267,518,1175
50,20,-140,249,269,518,1070
0,-30,-50,268,250,518,1076
-130,-60,-160,248,270,518,959
170,-40,-10,266,252,518,1117
60,-60,-110,259,259,518,966
-110,-50,-160,236,282,518,1097
70,80,90,276,242,518,1035
-60,-40,-100,241,278,519,992
150,-50,130,262,257,519,991
20,-40,-60,238,281,519,1115
110,-40,40,260,259,519,1035
-110,-40,180,242,277,519,1134
160,60,10,260,259,519,1009
40,-40,-100,241,278,519,1094
-110,-40,-180,242,277,519,1134
-50,10,-130,246,273,519,1041
20,-30,-70,258,261,519,1179
-120,-10,110,251,268,519,1039
-120,-40,70,224,295,519,993
100,50,-160,254,266,520,1146
-130,-80,50,246,274,520,1026
-70,60,-120,262,258,520,934
-160,-80,20,254,266,520,1106
-180,40,160,249,271,520,874
-10,40,170,263,257,520,1052
-20,30,180,261,259,520,1046
180,40,160,249,271,520,874
130,60,40,265,255,520,1027
-20,30,-180,261,259,520,1046
-10,-50,-40,259,261,520,1129
-100,80,-90,253,268,521,977
-180,80,-10,270,251,521,1150
120,60,180,251,270,521,1154
180,80,-10,270,251,521,1150
-10,-20,-30,262,259,521,1007
-80,50,-10,255,266,521,1050
120,60,-180,251,270,521,1154
100,-70,-70,260,261,521,1072
10,-60,180,259,262,521,1000
0,50,-30,253,268,521,880
-130,-30,60,243,278,521,1029
10,-60,-180,259,262,521,1000
-10,80,170,265,257,522,1002
-10,30,170,269,253,522,1058
-80,60,-100,261,261,522,975
150,10,0,267,255,522,1001
140,-20,-10,260,262,522,1119
-100,-30,120,255,267,522,996
130,20,70,266,256,522,1082
-150,-10,160,251,271,522,1008
-150,-90,-180,250,273,523,1131
-20,10,180,261,262,523,982
-150,-90,180,250,273,523,1131
-140,-90,-170,250,273,523,1131
20,0,-60,240,283,523,1048
-70,-90,-100,250,273,523,1131
20,50,150,271,252,523,1102
-90,-90,-120,250,273,523,1131
-160,-90,170,250,273,523,1131
-130,-90,-160,250,273,523,1131
110,-90,80,250,273,523,1131
180,-90,150,250,273,523,1131
100,-90,70,250,273,523,1131
80,-70,20,259,264,523,1061
-130,-10,140,241,282,523,1101
70,40,170,247,276,523,1061
70,-90,40,250,273,523,1131
-50,-90,-80,250,273,523,1131
90,-90,60,250,273,523,1131
-140,-10,50,237,286,523,1038
120,-90,90,250,273,523,1131
160,-90,130,250,273,523,1131
130,-90,100,250,273,523,1131
-20,10,-180,261,262,523,982
-80,-90,-110,250,273,523,1131
-20,-90,-50,250,273,523,1131
80,-90,50,250,273,523,1131
-60,-90,-90,250,273,523,1131
0,-90,-30,250,273,523,1131
-10,-90,-40,250,273,523,1131
140,-90,110,250,273,523,1131
-170,-90,160,250,273,523,1131
50,50,-100,236,287,523,1179
50,-90,20,250,273,523,1131
170,-90,140,250,273,523,1131
-40,-90,-70,250,273,523,1131
150,-90,120,250,273,523,1131
10,30,-40,255,268,523,1054
40,-90,10,250,273,523,1131
60,-90,30,250,273,523,1131
-110,-90,-140,250,273,523,1131
-100,-90,-130,250,273,523,1131
-180,-90,150,250,273,523,1131
20,-90,-10,250,273,523,1131
10,-90,-20,250,273,523,1131
40,-10,-130,233,290,523,1004
-30,-90,-60,250,273,523,1131
30,-90,0,250,273,523,1131
-120,-90,-150,250,273,523,1131
160,60,170,253,271,524,998
-180,10,160,257,267,524,967
130,50,40,269,255,524,1086
40,0,-110,249,275,524,1033
50,20,-100,259,265,524,986
-100,-70,80,260,264,524,1039
-120,-10,120,247,277,524,1112
180,10,160,257,267,524,967
-40,60,-160,269,256,525,961
-100,-50,90,247,278,525,1124
140,40,150,242,283,525,1101
130,0,70,260,265,525,1020
20,20,-60,252,273,525,1094
130,40,40,254,272,526,1070
90,-60,20,256,270,526,1130
140,20,120,262,264,526,1072
-20,20,-180,273,253,526,1046
-20,20,180,273,253,526,1046
140,-70,110,251,275,526,1086
180,20,0,265,261,526,1029
40,40,150,265,261,526,1042
90,-80,-90,267,259,526,1109
50,20,-130,254,272,526,1071
-150,-30,30,257,269,526,1056
60,80,100,282,244,526,1036
-80,-40,140,251,275,526,1099
-180,20,0,265,261,526,1029
-170,40,0,267,259,526,1038
120,50,60,264,262,526,1101
90,50,120,255,271,526,1064
130,0,50,254,273,527,972
150,30,140,254,273,527,1058
160,-40,150,256,271,527,958
-170,-80,10,256,271,527,1140
170,10,150,263,264,527,1043
-50,40,-140,256,271,527,1106
40,60,130,271,256,527,1047
-140,0,140,241,286,527,1154
0,-20,-40,257,270,527,1053
40,-20,-130,247,280,527,1046
80,80,80,279,249,528,1064
90,70,-130,243,285,528,1073
40,-10,-90,243,285,528,1016
130,-10,60,260,268,528,1043
-150,-30,170,258,270,528,1117
80,50,-150,263,265,528,1111
70,50,-130,261,267,528,1172
150,10,120,253,275,528,1132
40,0,-140,247,281,528,1042
100,60,-150,248,280,528,1105
40,10,-160,248,280,528,1051
-60,20,-50,255,273,528,989
50,-50,-90,256,273,529,1086
160,70,170,270,259,529,1010
110,-40,0,263,266,529,1059
-120,50,0,249,280,529,1047
-180,20,160,263,266,529,933
160,70,10,267,262,529,1074
10,-70,-40,251,278,529,1139
-100,50,10,249,280,529,1015
180,20,160,263,266,529,933
-130,40,50,256,273,529,1058
-60,20,-110,244,285,529,1115
180,-80,0,259,271,530,1160
30,10,-70,244,286,530,1056
-50,20,-140,253,277,530,1070
30,-40,-160,278,252,530,1069
-180,-60,0,268,262,530,1127
-20,70,180,270,260,530,1094
-100,70,-80,257,273,530,1005
180,-60,0,268,262,530,1127
130,20,80,269,261,530,1145
150,20,130,251,279,530,1112
40,20,-80,250,280,530,974
-150,0,30,250,280,530,955
70,80,-100,250,280,530,1035
-20,70,-180,270,260,530,1094
30,-30,-170,272,258,530,1047
-180,-80,0,259,271,530,1160
-130,20,80,247,284,531,1039
-110,-70,70,255,276,531,1039
40,-40,-110,248,283,531,1107
110,-80,70,256,275,531,1145
140,0,110,259,272,531,1115
50,-50,-100,248,283,531,1050
-20,50,-20,250,281,531,943
120,40,140,252,279,531,1182
-30,0,-30,266,265,531,1048
-140,50,0,248,283,531,1189
-170,-80,170,256,275,531,965
-100,60,40,249,282,531,1052
-140,30,30,258,274,532,1129
130,0,40,258,274,532,1026
-30,-30,-40,269,263,532,983
-120,60,70,252,280,532,1092
-70,-40,150,253,279,532,1043
110,50,80,263,269,532,1118
40,0,-150,256,277,533,1099
-120,-70,60,269,264,533,1042
-20,0,-180,270,263,533,1056
40,0,-100,262,271,533,1118
-20,0,180,270,263,533,1056
-140,-20,160,270,263,533,1099
-130,10,80,250,283,533,1043
-140,-40,40,253,280,533,1009
-150,30,20,272,261,533,1098
0,-80,-40,245,288,533,1097
-160,-60,-180,272,262,534,1009
180,-20,170,272,262,534,1001
40,-20,-120,254,280,534,1050
-100,-70,-130,252,282,534,1041
-160,-60,180,272,262,534,1009
30,50,140,276,258,534,1126
-180,-20,170,272,262,534,1001
70,-70,-110,267,267,534,1080
70,-60,-60,257,277,534,1056
30,-10,-70,249,285,534,1087
50,-70,-20,246,288,534,1179
-50,20,-40,266,269,535,1054
20,-40,180,265,270,535,994
60,-60,-50,248,287,535,1079
160,20,140,250,285,535,1101
50,-60,-50,244,291,535,1079
180,-70,0,265,270,535,1142
20,-40,-180,265,270,535,994
-110,-30,160,241,294,535,1177
-180,-70,0,265,270,535,1142
120,-50,-30,270,265,535,1127
0,40,-30,257,278,535,901
-170,-70,10,264,272,536,1124
30,30,160,273,263,536,1094
40,70,-70,260,276,536,990
50,30,-100,254,282,536,1165
-110,80,-80,263,273,536,1039
100,-80,-80,270,266,536,1151
40,10,-110,255,281,536,1141
130,-50,-30,267,269,536,1164
150,-40,130,271,265,536,1066
-20,80,180,272,264,536,1019
-20,80,-180,272,264,536,1019
110,50,-170,262,275,537,1216
-20,-70,-50,266,271,537,1146
30,-30,-90,255,282,537,1176
150,40,150,261,276,537,1108
-130,-60,50,276,261,537,1020
120,50,-180,250,287,537,1187
120,50,180,250,287,537,1187
0,-60,170,269,268,537,1079
-150,40,130,256,281,537,950
110,-50,60,266,271,537,1000
130,30,120,256,281,537,1048
130,20,50,268,269,537,1113
50,20,-90,265,273,538,1066
40,-50,-60,253,285,538,1244
80,-60,-20,251,287,538,1100
80,40,170,252,286,538,1118
40,30,170,263,275,538,1117
-30,-60,-50,261,277,538,1129
90,-50,30,261,277,538,1062
40,10,-80,252,286,538,995
80,-60,-10,252,286,538,1070
130,-10,30,275,263,538,1083
-60,0,-90,253,286,539,1086
30,-60,-160,272,267,539,961
60,30,-140,274,265,539,1162
-170,-20,170,261,278,539,992
140,60,170,255,284,539,1110
-80,70,-110,265,274,539,989
110,-70,70,271,268,539,1091
170,-60,-10,279,260,539,1176
-70,50,-10,256,283,539,1039
-30,70,-170,265,274,539,1111
120,30,90,259,281,540,1179
-30,20,-170,269,271,540,1038
120,-30,50,259,281,540,1155
130,0,60,259,281,540,986
30,60,-60,257,283,540,1069
-120,-10,100,258,282,540,1102
140,40,20,272,268,540,1059
-130,10,90,251,289,540,1114
170,-20,160,277,263,540,1021
-70,-40,-120,247,293,540,1157
160,50,160,275,265,540,1087
-100,-50,-150,245,295,540,1087
100,-60,50,268,272,540,1062
140,-80,110,260,281,541,1106
-120,50,50,254,287,541,1049
170,50,0,267,274,541,1030
-90,50,-10,260,281,541,1153
-10,20,170,279,262,541,1097
-30,80,-170,272,269,541,1046
90,50,-150,262,279,541,1165
-70,30,-90,266,275,541,1047
-100,-30,160,244,297,541,1190
-30,-80,-60,255,287,542,1122
160,40,150,267,275,542,1089
100,-40,20,260,282,542,1025
60,40,160,263,279,542,1086
-10,70,170,277,265,542,1065
160,30,0,272,270,542,1058
20,40,150,275,267,542,1174
160,-10,-10,275,267,542,1088
80,40,-180,254,288,542,1112
120,40,60,269,273,542,1083
20,-10,-60,245,297,542,1100
80,40,180,254,288,542,1112
0,70,160,280,263,543,1042
-170,80,-20,282,261,543,1162
-130,20,90,244,299,543,979
170,-80,-10,268,275,543,1167
30,-70,-30,256,287,543,1210
-130,50,0,252,291,543,1136
0,20,-30,276,267,543,1037
160,-80,-20,275,269,544,1167
-40,70,0,256,288,544,976
-130,40,30,265,279,544,1131
50,-50,-110,262,282,544,1073
130,30,40,266,278,544,1098
30,-30,-80,261,283,544,1251
70,-60,-70,265,279,544,1176
-10,50,170,281,263,544,1019
-40,50,-160,272,272,544,1033
150,40,10,278,266,544,1062
70,-70,10,263,281,544,1141
140,0,0,273,272,545,1127
100,50,100,270,275,545,1104
-120,60,-30,264,281,545,1210
-10,60,170,280,265,545,1102
-100,60,-60,267,278,545,1142
150,-80,-30,280,265,545,1166
50,-60,-130,283,262,545,996
180,-80,160,261,285,546,998
80,-60,0,254,292,546,1131
150,-10,120,276,270,546,1067
110,-80,-70,274,272,546,1173
-140,10,40,256,290,546,961
60,30,-150,264,282,546,1175
90,80,70,288,258,546,1122
0,30,-30,263,283,546,931
-180,-80,160,261,285,546,998
-40,70,-160,261,285,546,1116
170,90,160,265,282,547,965
-70,90,-130,277,270,547,1047
-110,90,80,265,282,547,965
170,90,-10,277,270,547,1047
-140,90,-60,277,270,547,1047
160,90,0,277,270,547,1047
0,90,-30,265,282,547,965
-20,90,-10,265,282,547,965
-20,90,180,277,270,547,1047
130,-40,90,273,274,547,1162
-10,90,-20,265,282,547,965
-160,90,130,265,282,547,965
-10,90,170,277,270,547,1047
-170,90,-30,277,270,547,1047
60,90,-90,265,282,547,965
-140,-30,40,267,280,547,1083
130,40,150,268,279,547,1142
-40,90,-160,277,270,547,1047
-110,90,-90,277,270,547,1047
140,90,20,277,270,547,1047
-50,90,-150,277,270,547,1047
30,90,-60,265,282,547,965
140,90,-170,265,282,547,965
30,90,130,277,270,547,1047
10,90,-40,265,282,547,965
110,90,-140,265,282,547,965
180,90,150,265,282,547,965
50,20,-150,265,282,547,1119
-20,90,-180,277,270,547,1047
100,90,60,277,270,547,1047
-140,90,110,265,282,547,965
70,40,-130,257,290,547,1045
-100,90,70,265,282,547,965
-100,90,-100,277,270,547,1047
-30,90,-170,277,270,547,1047
60,90,100,277,270,547,1047
110,90,50,277,270,547,1047
100,90,-130,265,282,547,965
130,-10,70,270,277,547,1108
0,90,160,277,270,547,1047
-120,90,-80,277,270,547,1047
-80,90,50,265,282,547,965
180,90,-20,277,270,547,1047
-40,90,10,265,282,547,965
-120,90,90,265,282,547,965
50,90,110,277,270,547,1047
130,90,30,277,270,547,1047
140,-30,-20,280,267,547,1177
150,90,-180,265,282,547,965
-130,90,-70,277,270,547,1047
90,90,70,277,270,547,1047
120,90,-150,265,282,547,965
90,90,-120,265,282,547,965
-60,90,30,265,282,547,965
-50,90,20,265,282,547,965
-130,90,100,265,282,547,965
20,90,-50,265,282,547,965
40,90,-70,265,282,547,965
-180,90,150,265,282,547,965
20,90,140,277,270,547,1047
-170,90,140,265,282,547,965
-180,90,-20,277,270,547,1047
-160,90,-40,277,270,547,1047
50,90,-80,265,282,547,965
130,20,110,273,274,547,1119
40,10,-100,257,290,547,1100
10,90,150,277,270,547,1047
-60,90,-140,277,270,547,1047
70,90,90,277,270,547,1047
-90,90,-110,277,270,547,1047
110,-60,70,275,272,547,1055
-70,90,40,265,282,547,965
-90,90,60,265,282,547,965
150,90,180,265,282,547,965
-80,90,-120,277,270,547,1047
80,90,-110,265,282,547,965
70,90,-100,265,282,547,965
120,90,40,277,270,547,1047
40,90,120,277,270,547,1047
130,90,-160,265,282,547,965
150,90,10,277,270,547,1047
80,90,80,277,270,547,1047
-150,90,-50,277,270,547,1047
40,0,-90,264,283,547,1208
-30,90,0,265,282,547,965
160,90,170,265,282,547,965
-150,90,120,265,282,547,965
-10,10,170,277,271,548,1069
130,-60,100,269,279,548,1077
140,-40,110,272,276,548,1114
170,-70,-10,268,280,548,1172
-20,-30,-30,270,278,548,992
50,30,-170,267,281,548,1194
-10,-40,-40,280,268,548,1116
40,30,-80,268,280,548,1148
-40,-10,-160,266,283,549,1019
-10,80,-20,267,282,549,966
70,70,90,279,270,549,1158
-70,40,-100,274,275,549,1122
-90,50,0,257,292,549,1079
-120,70,80,269,280,549,1065
140,70,180,277,272,549,1240
-120,-40,-180,270,279,549,1229
-120,-40,180,270,279,549,1229
30,-50,-160,282,267,549,985
140,70,-180,277,272,549,1240
140,-80,-40,285,265,550,1176
-130,60,-20,263,287,550,1174
0,-70,170,278,272,550,1085
60,30,-130,265,285,550,1214
60,30,-120,267,283,550,1205
120,-80,-60,277,273,550,1161
120,40,150,260,290,550,1192
-170,10,160,274,276,550,1059
-50,-40,160,261,289,550,1159
-160,-80,-180,268,283,551,1024
50,40,-100,257,294,551,1226
70,-60,-50,261,290,551,1095
-160,-80,180,268,283,551,1024
-90,-40,-160,247,304,551,1112
-40,80,-160,275,276,551,1080
-30,10,-30,274,277,551,1001
-20,-40,160,271,280,551,1119
-40,-50,150,265,287,552,1159
50,40,150,269,283,552,1100
160,-70,-20,282,270,552,1221
-30,40,-170,282,270,552,1071
-140,30,120,246,306,552,1068
-180,80,150,276,276,552,1050
30,40,150,275,277,552,1197
70,40,160,267,285,552,1173
180,80,150,276,276,552,1050
-120,80,-70,269,283,552,1079
50,30,180,264,289,553,1210
180,-30,170,280,273,553,1091
120,40,160,267,286,553,1124
-150,-50,-180,283,270,553,1127
-130,-50,-170,277,276,553,1203
160,-70,140,281,272,553,1113
120,-40,70,271,282,553,1173
160,10,140,272,281,553,1182
50,30,-180,264,289,553,1210
-180,-30,170,280,273,553,1091
20,70,140,285,268,553,1076
120,-50,80,280,273,553,1070
30,70,130,287,266,553,1090
120,30,100,258,295,553,1144
-150,-50,180,283,270,553,1127
60,20,-130,279,274,553,1163
-130,0,70,264,289,553,962
150,-40,-20,280,273,553,1147
80,80,-110,259,295,554,1091
150,-30,120,273,281,554,1153
130,-80,-50,281,273,554,1153
-90,50,-20,255,299,554,1162
10,0,160,280,274,554,1152
-130,30,70,267,287,554,1035
170,-20,-10,282,272,554,1079
170,80,160,274,281,555,1076
50,60,-90,267,288,555,1207
80,50,-140,281,274,555,1279
0,40,160,272,283,555,1123
40,-50,-140,282,273,555,1097
-160,30,10,280,275,555,1174
30,40,-70,260,295,555,1123
-130,20,70,252,303,555,1116
150,50,10,279,276,555,1142
100,80,60,286,269,555,1155
10,20,-40,275,280,555,1140
140,10,110,257,298,555,1186
-130,-10,70,253,303,556,1131
10,-70,-180,278,278,556,1099
10,-40,170,273,283,556,1000
130,-60,-40,281,275,556,1191
30,10,170,279,277,556,1120
140,-10,100,274,282,556,1164
-130,30,80,252,304,556,1054
-140,-30,170,272,284,556,1221
10,-70,180,278,278,556,1099
120,-40,-20,283,273,556,1166
-50,-10,-60,264,293,557,1028
40,70,120,284,273,557,1115
-60,50,-130,274,283,557,1078
-40,-60,140,269,288,557,1075
10,70,150,289,268,557,1044
-140,20,120,267,290,557,1083
-60,30,-120,274,283,557,1109
-170,80,140,281,276,557,1060
60,50,-110,254,303,557,1217
100,-40,10,268,289,557,1014
130,20,100,282,275,557,1181
-10,-60,-40,266,291,557,1121
40,50,-80,255,302,557,1242
100,-60,-40,272,285,557,1069
110,60,-160,260,297,557,1198
40,-60,-40,258,300,558,1216
150,-60,130,277,281,558,1027
160,80,170,283,275,558,1138
20,-20,170,281,277,558,1116
50,-50,-80,274,284,558,1211
70,-60,-80,275,283,558,1213
60,50,130,285,273,558,1182
160,40,0,287,271,558,1131
90,-70,40,275,283,558,1145
-130,10,70,262,296,558,1078
90,-60,-30,266,292,558,1116
100,-80,60,262,296,558,1207
140,-50,-30,280,278,558,1203
10,10,160,287,272,559,1195
-160,70,-20,273,286,559,1144
110,40,150,259,300,559,1245
170,-10,-10,285,275,560,1114
130,0,80,270,290,560,1146
60,30,-160,272,288,560,1185
170,40,160,268,292,560,1036
170,50,160,274,286,560,1107
30,-20,-80,271,289,560,1241
-60,-30,-180,267,293,560,1155
80,70,80,285,275,560,1173
-60,-30,180,267,293,560,1155
20,40,-50,267,293,560,1097
-40,-40,160,278,282,560,1117
-80,60,20,271,290,561,1071
120,60,50,283,278,561,1139
-150,80,-40,287,274,561,1139
100,70,-140,262,299,561,1175
80,-60,10,264,297,561,1228
-130,40,80,263,298,561,1039
-10,-60,160,276,285,561,1092
80,60,90,280,281,561,1139
0,-60,-40,274,287,561,1253
40,-10,-140,257,304,561,1072
160,-50,-20,282,279,561,1236
-90,60,-80,282,279,561,1063
160,0,140,287,275,562,1031
40,-40,-90,257,305,562,1195
20,20,160,273,289,562,1164
-10,-70,160,282,280,562,1057
90,70,70,281,281,562,1179
20,10,-60,270,292,562,1253
110,40,160,261,301,562,1209
130,20,90,281,281,562,1209
80,-70,-100,277,286,563,1167
-130,30,60,273,290,563,1093
170,30,160,271,292,563,1112
80,-60,-60,272,291,563,1154
120,30,110,270,293,563,1161
30,-20,180,292,271,563,1107
30,-20,-180,292,271,563,1107
130,-10,20,280,283,563,1175
130,10,50,271,292,563,1145
90,80,-120,262,301,563,1122
140,50,20,284,279,563,1147
40,-70,-20,272,292,564,1301
50,60,120,291,273,564,1155
90,-50,10,289,275,564,1181
-110,-20,120,260,304,564,1155
50,-50,-120,269,295,564,1124
-160,40,0,284,280,564,1216
-160,10,150,284,280,564,1117
10,-80,-30,261,303,564,1172
0,50,160,294,271,565,1112
-170,50,150,270,295,565,1003
80,-60,-30,270,295,565,1184
130,50,170,255,310,565,1239
130,-70,100,281,284,565,1162
-160,80,-30,292,273,565,1157
-40,-60,-60,276,289,565,1120
-50,70,-150,277,288,565,1160
-50,80,-150,280,285,565,1125
-160,-20,170,268,297,565,1097
90,-50,20,284,282,566,1125
70,-60,-40,269,297,566,1159
90,40,-180,280,286,566,1215
40,-20,-140,272,294,566,1087
-60,-50,-90,271,295,566,1187
-90,60,30,266,300,566,1054
90,40,180,280,286,566,1215
110,40,170,275,291,566,1203
-60,40,-30,278,288,566,1122
30,20,-70,257,309,566,1151
90,-60,30,277,289,566,1165
-130,0,130,262,304,566,1229
70,50,130,279,287,566,1146
-160,30,150,257,310,567,1019
-70,-60,-100,273,294,567,1149
130,-30,80,269,298,567,1163
60,40,-110,282,285,567,1183
130,-20,70,271,296,567,1162
110,80,-140,275,292,567,1161
120,-30,-10,279,288,567,1213
-140,80,-50,283,284,567,1138
130,-10,10,284,283,567,1152
130,-80,100,275,292,567,1184
130,10,60,275,292,567,1185
-40,-30,170,266,302,568,1217
-140,60,-20,273,295,568,1119
110,40,100,273,295,568,1242
160,-60,-20,294,274,568,1215
60,70,100,295,273,568,1108
10,20,160,281,287,568,1224
170,-50,160,280,288,568,1113
110,80,50,290,278,568,1193
50,-60,-40,266,302,568,1151
130,0,30,274,294,568,1152
170,0,-10,291,278,569,1143
-110,-20,130,268,301,569,1152
-130,-30,170,279,290,569,1296
80,40,-170,276,293,569,1195
-70,50,-110,287,282,569,1075
100,70,60,284,285,569,1190
50,50,130,287,282,569,1175
30,0,-70,258,311,569,1182
20,-50,-50,261,308,569,1251
100,40,170,287,282,569,1227
160,30,150,265,304,569,1128
130,-40,-30,290,279,569,1231
0,-70,-40,270,300,570,1222
90,-60,-40,273,297,570,1165
40,20,-180,265,305,570,1191
180,-40,170,288,282,570,1097
70,-60,-20,265,305,570,1254
-150,70,120,281,289,570,1071
40,0,-160,276,294,570,1144
40,20,180,265,305,570,1191
-180,-40,170,288,282,570,1097
0,-10,-30,285,286,571,1105
150,80,180,293,278,571,1145
-20,80,-10,276,295,571,1032
-130,80,-60,285,286,571,1120
150,80,-180,293,278,571,1145
-140,10,130,277,294,571,1275
120,40,170,268,304,572,1156
110,-40,50,284,288,572,1193
-30,10,-170,288,284,572,1121
100,80,-130,272,300,572,1139
100,-50,-10,276,296,572,1160
40,50,130,293,279,572,1213
130,-50,100,291,281,572,1136
80,-60,-50,277,295,572,1152
100,-50,50,286,286,572,1048
130,10,80,278,294,572,1188
40,10,-170,268,304,572,1246
160,-10,140,274,298,572,1169
-130,30,90,265,308,573,1160
-70,-40,140,269,304,573,1172
150,20,0,293,280,573,1148
80,50,120,278,295,573,1157
160,0,-10,300,273,573,1112
140,20,10,292,281,573,1107
-20,-80,-50,269,304,573,1175
170,-80,150,271,302,573,1046
110,40,140,269,304,573,1275
60,-60,-30,277,297,574,1293
60,20,-140,279,295,574,1165
20,-70,-170,291,283,574,1134
40,20,-70,278,296,574,1136
0,60,160,304,270,574,1183
20,-80,-20,270,304,574,1247
-50,-60,130,276,298,574,1174
30,50,-60,274,301,575,1216
50,70,110,293,282,575,1126
150,-70,-30,292,283,575,1250
40,30,-70,281,294,575,1230
50,-70,-10,276,299,575,1343
100,-40,30,280,295,575,1089
-130,60,90,267,308,575,1157
-160,80,130,288,287,575,1094
40,-40,-80,268,307,575,1299
0,30,160,292,283,575,1164
30,-30,-70,280,296,576,1295
-30,-40,160,285,291,576,1165
160,-20,140,291,285,576,1173
-160,20,150,290,286,576,1123
-10,-10,-20,285,291,576,1094
30,-50,-50,266,310,576,1267
10,-60,-40,283,293,576,1280
90,40,170,292,284,576,1254
120,30,80,284,292,576,1187
140,20,130,275,302,577,1189
110,-50,-30,293,284,577,1167
130,30,130,274,303,577,1198
130,70,-170,292,285,577,1317
130,10,70,277,300,577,1202
110,70,-150,273,304,577,1276
140,-30,100,277,300,577,1207
-100,50,-10,271,306,577,1254
100,40,150,281,296,577,1280
100,40,160,278,299,577,1252
130,-30,-20,282,296,578,1207
-110,-20,110,273,305,578,1193
0,20,160,300,278,578,1252
150,0,130,284,294,578,1222
-70,40,-40,280,298,578,1164
150,-10,-10,289,289,578,1153
-130,30,50,285,293,578,1154
70,-60,-100,285,293,578,1157
-60,-50,130,273,305,578,1137
-10,-50,160,301,278,579,1129
-50,60,-150,299,280,579,1066
80,40,160,271,308,579,1255
-40,-40,-60,269,310,579,1102
150,-60,-30,292,287,579,1273
70,-60,-90,283,296,579,1167
60,60,-100,283,296,579,1282
50,70,-80,281,298,579,1048
0,-50,-40,284,295,579,1183
-100,-30,110,272,307,579,1126
90,-70,-90,286,293,579,1195
20,-70,-30,273,306,579,1313
-120,-20,80,288,291,579,1193
140,30,140,274,306,580,1216
150,-30,-20,298,282,580,1203
-170,30,0,286,294,580,1247
-130,40,20,271,309,580,1231
40,-40,-120,281,299,580,1170
120,80,40,295,285,580,1224
60,-60,-40,270,310,580,1182
-110,70,-70,281,299,580,1089
120,60,-170,274,306,580,1274
110,-60,-50,289,291,580,1220
90,-80,50,273,307,580,1241
-50,30,-140,283,297,580,1164
40,10,-70,283,297,580,1081
-50,0,-50,270,311,581,966
10,-40,-50,281,300,581,1223
90,40,160,292,289,581,1296
40,-20,-110,271,310,581,1138
10,-10,160,287,294,581,1116
-140,-70,-160,277,304,581,1036
-40,30,-30,291,290,581,1180
140,80,-170,292,290,582,1184
-90,-30,140,285,297,582,1304
-50,0,-140,269,313,582,1164
160,-30,150,294,288,582,1154
90,50,110,274,308,582,1207
-80,-40,130,279,303,582,1200
-70,20,-70,286,296,582,1022
-150,-20,30,279,303,582,1176
60,30,-110,274,308,582,1254
70,60,100,289,293,582,1219
130,40,160,272,311,583,1249
50,30,-90,280,303,583,1212
140,-20,100,285,298,583,1231
160,-40,-20,294,289,583,1223
130,10,40,285,298,583,1163
-60,10,-110,287,296,583,1215
-20,-20,170,275,308,583,1180
0,0,160,284,299,583,1158
-80,50,-90,291,292,583,1156
20,-30,-60,295,289,584,1292
-60,0,-80,286,298,584,1174
40,-50,-50,273,311,584,1276
120,-60,90,281,303,584,1120
130,0,90,277,307,584,1236
70,-60,-30,276,308,584,1227
-90,50,-30,272,312,584,1158
60,-70,0,275,309,584,1280
-100,-40,-170,277,307,584,1291
-30,0,-170,282,302,584,1258
-160,50,140,284,301,585,1094
120,40,50,285,300,585,1234
-120,-10,130,267,318,585,1263
-120,-20,150,277,308,585,1328
10,-10,-40,285,300,585,1115
-50,60,0,282,303,585,1078
40,-10,-150,279,306,585,1126
-130,-40,-180,283,302,585,1341
-130,-40,180,283,302,585,1341
40,30,160,287,299,586,1257
-120,-60,60,300,286,586,1187
-120,50,60,269,317,586,1161
-40,-50,-60,282,304,586,1062
30,-70,-160,295,291,586,1143
90,60,80,292,294,586,1155
110,70,50,295,291,586,1189
-110,-30,90,277,309,586,1297
100,-60,60,284,302,586,1178
170,-10,160,298,289,587,1149
160,-50,150,303,284,587,1085
60,20,-110,293,294,587,1198
20,10,160,291,296,587,1248
120,80,-150,281,306,587,1163
110,40,90,284,304,588,1217
-130,10,100,287,301,588,1250
130,60,180,284,304,588,1313
130,60,-180,284,304,588,1313
130,60,30,287,301,588,1168
130,-10,80,287,301,588,1314
30,10,-60,268,320,588,1149
110,40,130,282,306,588,1335
150,-20,120,281,307,588,1283
150,70,-180,299,290,589,1255
80,-60,-40,283,306,589,1197
150,70,180,299,290,589,1255
10,60,150,300,289,589,1226
60,20,-120,281,308,589,1198
-120,-50,60,275,314,589,1158
30,-80,-10,271,318,589,1304
140,-10,-10,289,300,589,1240
130,-70,-50,295,295,590,1370
80,60,-120,281,309,590,1278
110,60,60,289,301,590,1210
30,-60,-40,268,323,591,1255
30,-40,-60,277,314,591,1321
130,20,120,292,299,591,1218
140,50,170,273,318,591,1286
140,60,20,295,296,591,1147
100,-40,40,293,298,591,1169
100,-60,-50,297,294,591,1173
-30,60,-10,282,309,591,1086
120,50,50,299,292,591,1282
70,60,-110,287,304,591,1248
20,-20,-60,292,300,592,1310
120,70,-160,286,306,592,1313
10,50,150,303,289,592,1275
-30,30,-170,291,301,592,1136
170,60,0,308,284,592,1209
30,20,-60,272,320,592,1213
120,-80,90,288,305,593,1291
-10,0,-20,307,286,593,1091
-10,60,-20,280,313,593,1051
40,0,-80,281,312,593,1248
-120,-30,70,285,308,593,1196
-110,-20,140,279,314,593,1326
120,-70,-60,294,299,593,1347
-60,-60,120,284,309,593,1241
130,80,-160,288,305,593,1176
20,-60,-40,282,312,594,1264
70,30,-170,290,304,594,1244
160,-80,140,286,308,594,1124
180,-50,170,283,311,594,1199
-110,-40,80,270,324,594,1122
-10,70,-20,286,308,594,1132
-90,-50,100,272,322,594,1185
10,-50,170,289,305,594,1094
-180,-50,170,283,311,594,1199
90,-50,0,300,295,595,1263
-150,20,140,295,300,595,1253
-50,-50,140,282,313,595,1230
20,60,140,304,291,595,1236
40,-20,-150,291,304,595,1181
-10,-30,-30,310,285,595,1158
30,60,130,311,284,595,1263
80,40,-150,288,308,596,1244
130,80,30,306,290,596,1251
130,-20,-10,292,304,596,1244
170,10,-10,314,282,596,1109
-130,-20,60,286,310,596,1210
130,-50,-40,299,297,596,1265
30,20,160,293,303,596,1219
100,-40,0,300,296,596,1193
-110,70,70,295,302,597,1173
10,-20,-50,280,317,597,1251
100,50,90,286,311,597,1277
170,0,160,301,296,597,1145
90,-60,-50,277,320,597,1207
100,-70,60,298,299,597,1222
-20,-60,150,289,308,597,1182
140,10,120,286,311,597,1303
0,-80,170,294,303,597,1121
170,70,0,302,295,597,1236
-120,70,-60,291,307,598,1110
150,10,130,281,317,598,1278
50,10,-110,289,309,598,1239
40,40,140,298,300,598,1219
120,70,40,303,295,598,1190
130,20,40,294,304,598,1169
120,-60,-50,299,299,598,1254
-20,-60,-40,291,307,598,1220
130,10,90,284,314,598,1244
-170,-10,170,290,308,598,1173
110,40,110,289,309,598,1299
-150,80,120,297,301,598,1116
-90,-30,150,282,317,599,1229
80,-60,-70,294,305,599,1226
150,30,0,307,292,599,1208
60,60,110,307,292,599,1288
160,50,0,306,293,599,1212
80,-60,20,289,310,599,1248
110,40,120,282,317,599,1351
-150,-80,-170,284,315,599,1090
-120,-30,170,285,315,600,1368
160,-30,-20,304,296,600,1223
10,10,-40,297,303,600,1166
50,10,-100,284,316,600,1173
140,-70,-40,296,304,600,1315
70,50,-120,290,310,600,1323
-10,-70,-40,286,314,600,1300
70,-60,-10,275,325,600,1315
180,-30,-10,311,290,601,1284
80,-70,30,282,319,601,1268
60,30,-170,302,299,601,1311
-10,-40,160,301,300,601,1129
140,30,10,300,301,601,1194
-170,20,160,306,295,601,1165
-130,70,-50,291,310,601,1135
-180,-30,-10,311,290,601,1284
-90,70,-100,287,314,601,1118
40,40,-80,293,308,601,1265
80,-80,40,284,317,601,1309
70,40,-120,288,313,601,1171
60,40,150,297,304,601,1307
130,50,30,306,296,602,1222
100,-50,-20,302,300,602,1228
40,-10,-80,283,319,602,1231
70,30,-160,289,313,602,1285
-130,10,60,275,327,602,1116
130,70,30,308,294,602,1222
140,-50,120,308,294,602,1222
-20,-70,150,294,308,602,1079
100,60,70,293,309,602,1207
-70,-50,120,288,314,602,1336
-170,60,-10,299,304,603,1162
-60,80,-140,295,308,603,1162
10,-80,-180,301,302,603,1139
10,-80,180,301,302,603,1139
20,-50,-180,305,298,603,1129
140,-40,-30,299,304,603,1306
-60,0,-100,282,321,603,1207
20,-50,180,305,298,603,1129
150,-70,130,296,307,603,1264
160,10,-10,317,286,603,1201
140,10,0,307,297,604,1173
20,-10,-50,274,330,604,1263
-110,50,30,279,325,604,1140
90,-60,40,292,312,604,1188
-170,60,150,299,305,604,1099
0,10,160,302,302,604,1262
20,20,-50,288,316,604,1253
50,-60,-30,281,323,604,1302
80,40,-160,301,303,604,1243
120,-20,40,293,311,604,1249
-140,80,110,298,306,604,1146
60,-60,-20,288,316,604,1358
100,-70,-80,300,305,605,1242
50,30,170,297,308,605,1273
50,-50,-70,289,316,605,1306
70,30,-150,298,307,605,1271
-90,-40,110,287,318,605,1242
90,-40,20,296,309,605,1165
100,40,-180,303,302,605,1301
100,40,180,303,302,605,1301
-170,30,160,287,318,605,1099
130,40,30,299,306,605,1235
-130,30,40,295,311,606,1262
-150,-10,30,289,317,606,1252
150,-80,130,296,310,606,1238
50,10,-90,292,314,606,1158
-60,-40,150,297,309,606,1209
180,-10,170,312,294,606,1187
-70,-30,-170,268,338,606,1304
-180,-10,170,312,294,606,1187
110,50,-160,286,320,606,1395
140,-60,-40,303,303,606,1322
60,20,-100,308,299,607,1243
-60,30,-40,295,312,607,1230
-150,70,-30,292,315,607,1203
140,70,20,307,300,607,1254
140,80,20,309,298,607,1275
-70,30,-60,294,313,607,1183
-160,0,160,296,311,607,1293
40,-80,0,280,327,607,1373
150,0,-10,311,296,607,1208
10,0,-40,292,315,607,1094
-150,30,140,287,321,608,1158
120,-30,60,282,326,608,1267
-30,-10,-30,299,309,608,1138
-110,50,-10,281,327,608,1301
100,40,140,295,313,608,1341
120,30,70,297,311,608,1228
-60,50,-10,280,328,608,1138
-10,-80,160,301,307,608,1111
40,-40,-130,309,299,608,1281
30,-80,-160,298,310,608,1196
40,-60,-150,315,293,608,1072
-150,-60,-170,291,317,608,1185
-110,-20,100,291,317,608,1268
-100,-60,80,298,310,608,1253
-90,-30,160,293,316,609,1267
-30,80,0,301,308,609,1105
60,70,-90,292,317,609,1176
-50,-60,-70,306,303,609,1196
-20,-80,150,296,313,609,1117
120,-70,90,303,306,609,1262
-90,50,-40,288,321,609,1285
30,30,-60,292,317,609,1336
-80,-40,-140,275,334,609,1285
-110,60,60,292,317,609,1222
90,40,-170,305,304,609,1326
150,50,170,294,316,610,1273
0,-10,160,295,315,610,1176
110,50,70,302,308,610,1255
-160,-50,-180,302,308,610,1195
110,-40,60,302,308,610,1317
-120,-10,90,305,305,610,1243
30,30,150,304,306,610,1300
-160,-50,180,302,308,610,1195
10,-30,-50,302,308,610,1356
40,-60,-30,288,322,610,1356
-130,10,110,290,321,611,1326
20,30,150,310,301,611,1246
40,-40,-70,289,322,611,1360
120,30,130,302,309,611,1351
0,-20,160,318,294,612,1102
110,-50,70,296,316,612,1231
130,10,30,293,319,612,1170
40,-80,-150,299,313,612,1235
-130,80,100,306,306,612,1175
-90,-30,130,308,304,612,1315
120,30,120,290,322,612,1317
20,-80,-170,303,310,613,1175
-140,40,10,282,331,613,1197
-30,-50,150,304,309,613,1276
40,-20,-100,294,320,614,1303
10,-50,-40,301,313,614,1292
-110,-60,70,305,309,614,1249
120,-20,30,301,313,614,1250
120,-20,10,305,309,614,1186
-120,-50,-160,298,316,614,1317
140,40,160,292,322,614,1372
30,-40,-170,305,309,614,1220
130,-10,0,299,315,614,1312
130,0,20,308,306,614,1223
-110,-40,-170,291,323,614,1333
-120,-80,50,300,315,615,1288
-130,20,60,289,326,615,1203
-160,-70,10,318,297,615,1258
40,60,-70,297,319,616,1285
-60,70,-140,307,309,616,1234
90,60,-130,282,334,616,1348
-140,0,40,285,331,616,1156
-130,0,60,294,322,616,1097
90,40,150,300,316,616,1294
20,0,160,315,302,617,1251
50,-80,-140,301,316,617,1288
70,-60,0,285,332,617,1314
-70,-30,-160,286,331,617,1342
40,-70,-150,303,314,617,1193
50,20,-80,296,321,617,1220
20,30,-50,290,327,617,1262
90,-50,40,304,313,617,1231
120,20,100,304,313,617,1329
50,-80,10,287,330,617,1375
70,-80,30,285,332,617,1357
30,40,140,310,308,618,1352
70,40,150,304,314,618,1287
-10,-20,-20,312,306,618,1248
40,-10,-160,308,310,618,1239
-150,50,-10,292,326,618,1256
50,20,-160,289,329,618,1296
-80,50,0,297,321,618,1200
80,40,150,304,314,618,1280
90,-60,-60,301,317,618,1197
-70,-30,-180,286,333,619,1265
-140,70,-40,296,323,619,1202
-70,-30,180,286,333,619,1265
-170,-70,0,316,303,619,1268
-120,0,110,296,323,619,1316
150,60,10,305,314,619,1268
120,-40,80,295,324,619,1271
130,-20,80,302,317,619,1329
20,0,-50,283,336,619,1271
70,50,120,308,311,619,1315
-110,60,-50,303,316,619,1209
-10,-80,-40,292,328,620,1292
-170,0,0,313,307,620,1205
120,50,-170,288,332,620,1351
10,-60,170,307,313,620,1214
-30,-80,140,300,320,620,1136
160,10,150,310,310,620,1333
170,20,160,296,324,620,1213
50,30,-80,302,318,620,1226
130,10,20,314,307,621,1224
170,-60,160,317,304,621,1296
-80,-50,110,293,328,621,1248
110,-60,80,306,315,621,1189
60,20,-150,302,319,621,1266
20,-40,-50,295,326,621,1379
100,50,-150,293,328,621,1371
150,-20,-20,324,297,621,1306
-40,20,-30,304,317,621,1233
-90,-60,90,302,320,622,1246
50,40,140,306,316,622,1276
110,-70,-70,306,316,622,1287
-110,-80,60,303,319,622,1301
-110,-30,170,294,328,622,1416
50,10,-120,292,330,622,1368
120,30,140,299,323,622,1318
160,20,150,300,322,622,1287
120,60,40,310,313,623,1265
140,-60,120,311,312,623,1208
-140,-40,-180,314,309,623,1401
110,30,90,300,323,623,1279
-100,-80,70,309,314,623,1313
60,-60,-10,293,330,623,1322
-90,60,-90,304,319,623,1177
130,0,100,299,324,623,1278
-140,-40,180,314,309,623,1401
60,30,-180,306,318,624,1359
-120,-60,-150,290,334,624,1173
60,30,180,306,318,624,1359
-130,-10,150,303,321,624,1340
40,20,-60,308,316,624,1182
130,30,30,306,318,624,1296
30,-10,-60,288,336,624,1329
30,-70,-20,299,325,624,1394
-140,50,110,294,331,625,1221
-180,0,170,310,315,625,1280
60,-80,-130,310,315,625,1308
130,30,140,306,319,625,1397
180,0,170,310,315,625,1280
150,-50,-30,313,312,625,1306
-140,-80,-160,300,325,625,1190
-120,80,90,316,309,625,1205
90,-40,30,303,322,625,1168
50,-60,-20,303,322,625,1370
20,-10,160,320,305,625,1226
-160,50,-10,317,308,625,1223
120,-20,20,300,325,625,1215
10,40,150,319,306,625,1247
-140,-80,30,311,315,626,1296
120,-20,0,312,314,626,1209
60,-80,20,291,335,626,1373
-40,-20,180,290,336,626,1272
-40,-20,-180,290,336,626,1272
30,0,-60,304,322,626,1264
50,10,-150,304,323,627,1317
0,-20,-30,312,315,627,1252
-70,80,-130,304,323,627,1230
20,-30,170,315,312,627,1252
-50,-30,-70,295,332,627,1205
-50,10,-140,293,334,627,1286
110,40,80,305,322,627,1333
-140,20,30,304,323,627,1295
50,-10,-110,301,326,627,1174
50,10,-140,300,328,628,1315
40,10,-180,295,333,628,1325
40,-50,-40,302,326,628,1297
130,10,110,310,318,628,1305
50,20,-170,299,329,628,1343
40,10,180,295,333,628,1325
-100,-40,90,277,351,628,1164
140,-10,110,313,315,628,1400
-50,-10,-150,288,340,628,1264
80,50,-130,302,326,628,1342
130,10,100,304,324,628,1310
-150,20,20,318,310,628,1295
120,30,60,312,316,628,1258
130,20,130,306,322,628,1341
10,-20,160,318,311,629,1245
-40,-10,-40,313,316,629,1229
160,-20,-20,317,312,629,1324
180,70,-10,317,312,629,1373
50,40,-90,311,318,629,1375
30,-30,180,319,310,629,1247
150,20,140,298,331,629,1327
-50,-30,170,290,339,629,1277
110,-80,80,298,331,629,1399
-150,60,-20,313,316,629,1200
-150,-20,170,309,320,629,1287
-180,70,-10,317,312,629,1373
70,70,-100,295,334,629,1288
50,50,-90,295,334,629,1376
30,-30,-180,319,310,629,1247
-60,-20,-130,285,345,630,1293
90,-40,10,306,324,630,1263
-80,60,-110,312,318,630,1162
90,50,100,303,327,630,1337
80,50,110,305,325,630,1349
140,60,-180,307,323,630,1303
0,-30,160,313,317,630,1156
140,60,180,307,323,630,1303
-40,-80,130,306,324,630,1185
140,70,-170,325,305,630,1409
-40,80,10,305,326,631,1118
70,30,-140,299,332,631,1319
50,-10,-100,305,326,631,1227
180,50,160,306,325,631,1156
50,-50,-60,295,336,631,1365
110,-40,-10,306,325,631,1297
-180,50,160,306,325,631,1156
170,-40,-20,318,313,631,1366
-130,-80,40,313,318,631,1291
-70,-60,110,301,330,631,1315
40,-30,-130,308,324,632,1337
40,20,170,301,331,632,1317
30,0,170,322,310,632,1273
-50,-80,120,307,325,632,1232
60,30,-100,303,329,632,1204
180,-40,-10,320,313,633,1395
-180,-40,-10,320,313,633,1395
-50,-20,-170,300,333,633,1288
90,50,-140,311,322,633,1330
60,-60,-120,322,311,633,1158
140,0,120,301,332,633,1253
130,20,30,306,328,634,1299
-30,-70,140,302,332,634,1185
-60,-30,170,299,335,634,1337
-150,-80,20,317,317,634,1292
-150,-70,20,326,308,634,1279
150,30,150,292,342,634,1304
-40,10,-160,308,326,634,1280
140,20,140,300,334,634,1330
-80,-30,180,295,339,634,1259
120,20,110,317,317,634,1311
-80,-30,-180,295,339,634,1259
-90,-80,80,314,320,634,1314
100,-50,60,305,329,634,1231
80,40,-140,302,333,635,1271
-170,-40,0,331,304,635,1352
-180,-60,170,312,323,635,1232
180,-60,170,312,323,635,1232
150,80,10,324,311,635,1308
-170,20,0,322,313,635,1328
20,-60,180,314,321,635,1223
150,60,180,304,331,635,1254
150,60,-180,304,331,635,1254
20,-60,-180,314,321,635,1223
-130,-70,-150,308,327,635,1195
30,20,-50,300,335,635,1339
-80,-80,90,303,332,635,1300
110,40,-180,309,327,636,1347
-60,-80,110,307,329,636,1239
70,-80,-120,317,319,636,1321
-60,-10,-90,306,330,636,1257
110,40,180,309,327,636,1347
-160,-80,10,318,318,636,1270
-40,-30,-50,309,327,636,1198
-130,-20,160,311,325,636,1398
130,40,170,289,348,637,1325
180,60,160,328,309,637,1145
-130,40,90,304,333,637,1265
-170,-80,0,323,314,637,1282
40,60,120,331,306,637,1351
-60,40,-130,304,333,637,1393
-10,-30,160,310,327,637,1224
-180,60,160,328,309,637,1145
40,30,150,316,321,637,1387
180,-80,-10,320,318,638,1255
130,50,180,291,347,638,1320
-180,-80,-10,320,318,638,1255
80,-60,30,317,321,638,1318
130,50,-180,291,347,638,1320
110,-30,40,307,331,638,1369
-80,-60,100,302,336,638,1270
20,10,-50,310,328,638,1435
100,60,-140,288,350,638,1415
110,60,-150,292,346,638,1433
-160,10,10,321,317,638,1309
-130,50,90,307,331,638,1295
90,40,140,311,328,639,1376
180,-50,-10,326,313,639,1352
-180,-50,-10,326,313,639,1352
140,-80,120,310,329,639,1322
140,-20,-20,330,309,639,1363
50,10,-130,294,345,639,1405
120,30,150,319,320,639,1273
-90,50,-50,299,340,639,1384
-60,20,-120,303,336,639,1369
-160,60,140,309,330,639,1294
50,80,100,332,307,639,1294
170,10,160,313,326,639,1188
80,-60,-80,325,314,639,1355
-110,80,80,317,323,640,1197
-70,20,-60,314,326,640,1129
90,-50,-10,302,338,640,1331
30,-20,-70,303,337,640,1375
-110,-10,110,310,330,640,1314
60,50,120,321,319,640,1350
80,-50,10,326,314,640,1328
110,30,100,315,325,640,1322
-80,80,-120,312,329,641,1260
-120,0,120,306,335,641,1351
150,40,0,312,329,641,1362
30,-50,-40,303,338,641,1395
180,-70,-10,317,324,641,1306
40,-20,-160,315,326,641,1277
-180,-70,-10,317,324,641,1306
-10,-40,-30,333,308,641,1357
-140,30,20,319,322,641,1314
40,50,-70,299,342,641,1402
-130,-40,50,305,336,641,1268
70,-70,20,302,339,641,1372
-120,50,-10,289,353,642,1348
120,40,-180,305,337,642,1287
-130,20,100,310,332,642,1174
120,40,180,305,337,642,1287
-140,50,-10,290,352,642,1328
110,-30,20,312,330,642,1301
110,30,140,317,326,643,1395
30,50,130,328,315,643,1381
120,60,-160,307,336,643,1392
40,-30,-150,316,327,643,1262
-50,80,20,321,322,643,1148
170,-70,-20,316,327,643,1331
-180,-70,170,327,316,643,1200
-170,-60,0,326,317,643,1354
40,-20,-90,310,333,643,1343
100,40,130,308,335,643,1427
170,-30,-20,327,316,643,1394
180,-70,170,327,316,643,1200
110,-30,30,317,326,643,1337
40,-30,-140,306,337,643,1230
130,-60,110,312,332,644,1303
-120,60,-40,317,327,644,1297
60,50,-100,306,338,644,1377
-60,-20,-120,291,353,644,1340
150,-40,140,323,321,644,1297
-90,-40,-150,304,340,644,1304
-10,10,-20,304,340,644,1201
30,-10,170,338,306,644,1321
-70,-80,100,309,335,644,1267
130,-60,-50,321,323,644,1414
150,-40,-30,318,326,644,1374
-110,-20,90,306,338,644,1343
-70,80,40,326,319,645,1191
-100,70,60,317,328,645,1247
60,-70,10,309,336,645,1380
40,30,-60,301,344,645,1292
50,-70,-140,320,325,645,1279
120,-20,50,309,336,645,1246
-150,-40,180,316,329,645,1371
10,-70,-30,298,347,645,1321
130,-30,90,306,339,645,1356
120,-40,-30,319,326,645,1379
70,30,180,316,329,645,1421
-170,10,0,331,314,645,1339
20,50,140,334,311,645,1399
70,30,-180,316,329,645,1421
50,0,-110,312,333,645,1372
-60,-10,-100,306,339,645,1220
-150,-40,-180,316,329,645,1371
-160,0,10,325,320,645,1232
170,-80,-20,322,324,646,1289
-130,-30,50,319,327,646,1269
70,30,-120,320,326,646,1201
60,80,90,329,317,646,1271
110,60,50,324,322,646,1376
60,-50,-90,310,336,646,1387
140,-70,120,321,325,646,1361
150,40,160,308,338,646,1403
-110,-50,70,316,330,646,1282
30,-60,-170,321,325,646,1293
130,-40,100,312,334,646,1299
-100,80,70,323,323,646,1198
-60,-90,110,319,328,647,1235
50,-90,-140,319,328,647,1235
-50,-90,120,319,328,647,1235
90,-90,-100,319,328,647,1235
100,-90,-90,319,328,647,1235
-160,-90,10,319,328,647,1235
-40,30,-160,317,330,647,1272
150,-90,-40,319,328,647,1235
-170,-90,0,319,328,647,1235
-180,-90,-10,319,328,647,1235
160,-90,-30,319,328,647,1235
-140,-90,30,319,328,647,1235
-120,-90,50,319,328,647,1235
-20,-90,150,319,328,647,1235
0,-90,170,319,328,647,1235
-80,-90,90,319,328,647,1235
120,-90,-70,319,328,647,1235
-70,-40,130,314,333,647,1361
-90,80,60,322,325,647,1155
50,-60,-140,329,318,647,1191
140,10,130,313,334,647,1347
100,-60,-60,321,326,647,1330
-90,-90,80,319,328,647,1235
20,-90,-170,319,328,647,1235
-110,-90,60,319,328,647,1235
70,-90,-120,319,328,647,1235
-70,-90,100,319,328,647,1235
-10,-90,160,319,328,647,1235
80,-90,-110,319,328,647,1235
130,-90,-60,319,328,647,1235
140,-90,-50,319,328,647,1235
30,-90,-160,319,328,647,1235
170,-90,-20,319,328,647,1235
110,-70,80,322,325,647,1284
-100,-90,70,319,328,647,1235
180,-90,-10,319,328,647,1235
-70,30,-100,311,336,647,1333
80,-80,-110,322,325,647,1346
-150,-90,20,319,328,647,1235
-30,-90,140,319,328,647,1235
-80,40,-80,321,326,647,1278
10,-90,180,319,328,647,1235
60,-90,-130,319,328,647,1235
-40,-90,130,319,328,647,1235
10,-90,-180,319,328,647,1235
40,-90,-150,319,328,647,1235
-130,-90,40,319,328,647,1235
110,-90,-80,319,328,647,1235
60,30,-90,322,325,647,1219
-100,-30,170,318,330,648,1352
40,0,-170,315,333,648,1339
-100,60,-70,320,328,648,1294
40,-10,-170,318,330,648,1455
20,-20,-50,309,339,648,1397
-80,40,-70,306,342,648,1354
90,40,-160,321,327,648,1380
100,40,-170,323,325,648,1412
-40,40,-160,324,325,649,1314
40,10,-60,314,335,649,1231
-60,-20,-110,298,351,649,1288
110,-30,10,313,336,649,1284
-110,-20,150,295,354,649,1449
0,-80,-30,308,341,649,1367
-160,-10,170,313,336,649,1256
-50,10,-40,320,329,649,1181
-160,20,10,328,321,649,1324
120,50,40,331,318,649,1360
30,-50,-170,325,324,649,1242
20,-50,-40,315,335,650,1434
40,80,110,334,316,650,1324
-140,0,150,311,339,650,1519
-70,20,-80,316,334,650,1233
160,-60,150,320,330,650,1304
70,30,-130,314,336,650,1265
50,-50,-50,304,346,650,1371
-70,-30,-150,291,359,650,1370
120,-50,-40,327,323,650,1346
100,-60,70,324,326,650,1231
60,40,140,329,321,650,1451
30,40,-60,310,340,650,1455
-100,50,-20,307,343,650,1405
-160,-60,10,331,319,650,1352
90,-60,-70,325,325,650,1301
160,20,-10,330,320,650,1338
-180,0,-10,333,318,651,1323
50,0,-100,315,336,651,1385
60,40,-100,318,333,651,1313
-60,60,-140,328,323,651,1180
0,-40,-40,323,328,651,1431
-60,-30,-100,306,345,651,1401
180,0,-10,333,318,651,1323
110,-60,-60,322,330,652,1348
110,40,-170,317,335,652,1476
50,20,-180,300,352,652,1369
50,20,180,300,352,652,1369
-60,-40,140,310,342,652,1280
0,-30,-40,320,332,652,1333
-50,50,-150,326,326,652,1223
140,-50,-40,326,326,652,1387
50,60,-80,311,341,652,1430
-130,50,-10,297,355,652,1349
160,-80,-30,328,324,652,1317
40,-30,-120,321,332,653,1381
30,-60,-30,312,341,653,1405
40,-40,-60,304,349,653,1416
-10,50,-20,319,334,653,1201
-70,-30,-140,305,348,653,1395
-80,-50,-120,306,347,653,1358
40,0,-70,317,336,653,1297
-170,50,-10,328,326,654,1285
-40,20,-160,318,336,654,1260
-160,-40,180,318,336,654,1424
-50,50,-10,319,335,654,1208
180,-10,-10,330,324,654,1356
-160,-40,-180,318,336,654,1424
120,20,90,313,341,654,1494
40,-70,-10,315,339,654,1439
60,30,170,311,343,654,1427
-80,80,50,326,328,654,1184
-180,-10,-10,330,324,654,1356
40,-50,-150,338,316,654,1237
-100,70,-90,307,347,654,1304
-130,60,-30,303,352,655,1422
20,-30,-50,323,332,655,1437
160,80,0,323,332,655,1359
40,-40,-140,330,325,655,1369
150,10,-10,337,318,655,1317
60,-50,-80,319,336,655,1434
-140,70,110,315,340,655,1287
-40,-70,130,308,347,655,1252
90,-60,50,316,339,655,1317
170,-20,-20,339,317,656,1383
180,-20,-10,343,313,656,1361
170,-70,160,328,328,656,1257
110,30,150,320,336,656,1411
60,-50,-100,327,329,656,1338
30,-40,-50,306,350,656,1438
120,30,160,313,343,656,1379
-60,0,-110,313,343,656,1344
-180,-20,-10,343,313,656,1361
-100,50,20,314,342,656,1244
-80,-30,-170,301,355,656,1342
170,-50,-20,334,323,657,1395
10,-20,-40,315,342,657,1378
100,-40,50,332,325,657,1344
-90,80,-110,320,337,657,1332
-90,50,10,313,344,657,1253
150,70,10,329,328,657,1355
70,80,80,338,319,657,1288
150,10,140,317,341,658,1391
-150,40,0,312,346,658,1406
-120,0,100,320,338,658,1414
150,-30,130,323,335,658,1431
30,10,-50,309,349,658,1330
-50,70,10,320,338,658,1179
-70,-30,170,306,352,658,1280
120,20,120,329,329,658,1342
-170,-10,0,324,334,658,1377
50,-70,0,318,340,658,1455
90,70,-120,306,352,658,1424
140,-30,110,320,338,658,1440
50,10,-80,327,332,659,1243
-150,30,10,328,331,659,1348
80,-50,0,329,330,659,1368
110,-30,0,316,343,659,1258
50,50,120,339,320,659,1381
40,-30,-160,333,326,659,1272
90,-80,-100,324,335,659,1337
90,-70,50,322,337,659,1368
-130,-80,-150,322,338,660,1262
50,-50,-130,325,335,660,1398
80,70,-110,301,359,660,1373
120,-30,-20,323,337,660,1454
110,30,80,329,331,660,1404
30,80,120,343,317,660,1352
-140,-20,40,309,351,660,1321
-60,-20,-100,310,351,661,1303
-80,-30,170,307,354,661,1402
-50,-20,-60,320,341,661,1331
-130,0,140,315,346,661,1477
70,-60,10,313,348,661,1365
80,-50,-10,327,334,661,1408
140,30,150,314,347,661,1475
0,-50,160,332,329,661,1243
140,40,10,324,337,661,1345
-140,-10,160,316,346,662,1404
-80,50,-100,334,328,662,1270
120,-50,90,331,331,662,1365
170,70,170,331,331,662,1174
-130,-10,60,306,356,662,1279
20,20,150,331,331,662,1334
30,10,160,327,335,662,1357
100,-80,70,314,348,662,1466
160,-70,-30,334,328,662,1415
-30,-10,-180,316,347,663,1420
-130,10,120,322,341,663,1482
-140,-70,30,344,319,663,1307
30,-30,-60,315,348,663,1420
-90,50,-60,315,348,663,1361
-30,-10,180,316,347,663,1420
-140,60,110,310,353,663,1357
20,80,130,342,321,663,1393
110,30,110,331,333,664,1539
-130,40,10,308,356,664,1366
70,50,110,326,338,664,1414
130,20,140,322,342,664,1400
80,40,140,324,340,664,1374
-90,-30,170,319,346,665,1526
140,-40,120,316,349,665,1374
-70,70,-130,334,331,665,1312
100,-50,-30,329,336,665,1376
-120,50,70,312,354,666,1322
-120,-80,-140,324,342,666,1292
120,-30,70,314,352,666,1392
-70,30,-50,334,332,666,1362
-20,-30,160,329,337,666,1330
100,70,-130,310,356,666,1422
80,-50,20,330,336,666,1378
-90,-30,120,335,331,666,1351
180,-60,-10,336,331,667,1353
-180,-60,-10,336,331,667,1353
-130,10,50,314,353,667,1273
-60,-20,-140,308,359,667,1380
-70,40,-30,318,349,667,1366
150,-10,130,327,341,668,1394
70,20,-130,326,342,668,1333
120,-20,60,321,347,668,1400
-170,-30,0,340,328,668,1363
170,-60,-20,333,335,668,1390
150,-50,140,338,330,668,1307
160,-20,150,337,331,668,1476
110,30,130,329,339,668,1496
-30,-40,-40,330,339,669,1275
-10,-50,-30,332,337,669,1410
50,-10,-120,317,352,669,1383
140,20,0,341,328,669,1404
10,30,150,333,336,669,1332
130,30,150,314,355,669,1497
20,-60,-30,316,353,669,1424
-120,-10,140,319,350,669,1435
50,30,160,328,341,669,1357
120,30,50,328,341,669,1354
-60,80,30,337,332,669,1205
130,60,-170,318,352,670,1464
130,-70,110,326,344,670,1428
10,-80,-20,318,352,670,1467
120,10,100,342,328,670,1478
150,-80,-40,336,334,670,1346
-110,-10,120,319,351,670,1377
130,-30,-30,332,338,670,1440
-110,-10,100,334,336,670,1322
130,10,120,324,346,670,1404
-40,0,-160,313,357,670,1389
0,-40,160,324,346,670,1248
80,30,-170,313,357,670,1393
40,-30,-80,309,362,671,1457
50,0,-90,312,359,671,1355
130,30,160,312,359,671,1426
-80,-60,-110,323,348,671,1375
120,50,-160,317,354,671,1436
70,30,-110,330,341,671,1210
100,-80,-90,323,348,671,1369
50,-50,-40,312,359,671,1398
-70,-70,100,332,340,672,1375
-80,-80,-100,322,350,672,1290
80,50,100,321,351,672,1434
100,-40,-10,327,345,672,1456
80,80,70,344,328,672,1320
50,-50,-30,322,350,672,1512
180,70,160,340,332,672,1203
-100,-30,100,322,350,672,1365
-130,20,50,320,352,672,1281
-180,70,160,340,332,672,1203
70,40,-110,321,352,673,1290
170,20,-10,341,332,673,1282
10,-30,160,339,334,673,1324
70,50,-110,317,356,673,1392
0,-70,-30,325,348,673,1446
60,-70,-130,334,339,673,1349
-170,-20,0,344,329,673,1417
-130,-70,40,341,332,673,1369
-90,-80,-110,334,339,673,1299
-70,-40,-110,307,366,673,1340
160,0,150,338,335,673,1334
10,80,140,349,324,673,1417
-100,80,-100,327,347,674,1353
-150,-60,20,345,329,674,1402
40,-30,-110,326,348,674,1442
90,-40,0,330,344,674,1428
140,0,-10,337,337,674,1386
-80,40,-60,318,356,674,1373
110,30,160,322,352,674,1440
70,-70,-120,333,341,674,1394
10,-40,-40,328,347,675,1505
130,-80,110,324,351,675,1425
-150,10,20,330,345,675,1380
-50,-70,120,316,359,675,1327
-170,-50,0,340,335,675,1375
50,-60,-10,326,350,676,1481
-140,40,120,314,362,676,1360
-90,70,50,336,340,676,1286
-140,20,130,342,334,676,1450
60,-50,-70,322,354,676,1459
60,-50,-60,327,349,676,1453
-160,-40,10,340,336,676,1335
170,80,-10,328,349,677,1432
180,60,-10,342,335,677,1465
-180,60,-10,342,335,677,1465
-80,-30,140,326,351,677,1408
-10,50,160,342,335,677,1402
140,50,10,345,332,677,1383
130,-10,90,324,353,677,1514
70,30,170,326,351,677,1457
-60,0,-70,321,357,678,1341
-80,-40,120,324,354,678,1422
120,10,90,340,338,678,1410
100,40,120,329,349,678,1514
0,-60,160,341,337,678,1298
-60,-70,110,330,348,678,1362
-120,-20,70,321,357,678,1419
0,0,-20,332,346,678,1371
20,70,130,351,327,678,1452
30,70,120,343,335,678,1462
-170,70,-20,334,344,678,1425
170,-30,170,331,347,678,1263
-170,-50,-180,328,351,679,1386
-170,-50,180,328,351,679,1386
-30,-60,140,333,346,679,1355
50,60,110,349,330,679,1407
40,-60,-20,326,353,679,1499
-70,50,-120,343,336,679,1268
50,30,-70,330,349,679,1308
-120,60,80,317,362,679,1336
-10,40,160,344,335,679,1358
-170,70,150,348,331,679,1256
70,40,140,325,354,679,1443
-100,-20,130,331,349,680,1512
90,-80,60,325,355,680,1542
30,0,-50,323,357,680,1320
120,-60,100,331,349,680,1302
110,-40,-20,346,334,680,1380
-140,-50,-170,341,340,681,1465
160,-70,150,338,343,681,1398
-130,30,100,305,376,681,1392
-20,-40,-30,346,335,681,1274
90,80,60,343,338,681,1346
30,-20,-60,319,362,681,1482
130,-80,-60,333,349,682,1397
-80,-30,160,328,354,682,1384
10,20,150,342,340,682,1468
140,-80,-50,340,342,682,1397
40,-30,-90,321,361,682,1526
40,-40,-150,346,336,682,1378
90,60,70,342,340,682,1368
130,-70,-60,336,346,682,1512
60,-60,0,324,358,682,1351
110,-40,70,335,347,682,1446
130,70,-160,341,341,682,1510
120,20,130,334,348,682,1358
-70,-80,-90,330,353,683,1319
110,-80,-80,328,355,683,1390
140,-20,110,345,338,683,1479
40,-40,-50,315,368,683,1452
-160,-50,10,344,339,683,1383
-20,40,-20,334,349,683,1394
-120,-70,50,348,335,683,1432
140,-30,-30,344,339,683,1440
-110,50,40,325,358,683,1274
-150,50,130,337,346,683,1377
-20,-10,170,336,347,683,1360
110,50,-150,317,367,684,1570
-100,-50,80,331,353,684,1354
120,-70,-70,338,346,684,1515
90,40,130,335,349,684,1504
-170,80,-30,337,347,684,1467
-30,-70,-50,333,351,684,1448
100,-70,70,334,350,684,1402
-160,-10,10,340,345,685,1450
180,80,-20,332,353,685,1455
-100,-80,-120,335,350,685,1290
110,70,-140,327,358,685,1449
-180,80,-20,332,353,685,1455
-140,-10,40,314,371,685,1391
110,30,120,339,346,685,1543
50,10,-160,327,358,685,1469
-80,-30,150,323,362,685,1413
160,40,160,330,355,685,1458
-60,10,-50,333,352,685,1219
40,-30,-100,327,358,685,1540
-70,40,-110,340,346,686,1391
10,-60,-30,329,357,686,1465
40,-20,-170,338,348,686,1388
-50,-70,-70,335,351,686,1405
90,-40,40,336,350,686,1367
30,-20,170,350,336,686,1378
70,-50,0,325,361,686,1376
160,-10,-20,357,329,686,1365
-110,-30,80,330,356,686,1493
40,40,-70,331,355,686,1504
-100,50,-30,319,367,686,1409
-60,10,-120,324,362,686,1444
-80,-70,90,341,346,687,1438
-170,-70,180,356,331,687,1266
-170,-70,-180,356,331,687,1266
90,50,90,337,350,687,1528
-60,-60,-80,341,346,687,1340
100,60,60,342,345,687,1423
20,-70,-20,329,358,687,1459
60,60,-90,329,358,687,1512
130,40,180,324,364,688,1361
130,40,-180,324,364,688,1361
160,-60,-30,338,350,688,1479
120,20,70,342,346,688,1503
-100,-20,140,328,360,688,1480
-70,-30,-130,317,371,688,1525
160,30,160,327,361,688,1354
130,10,130,329,359,688,1519
110,50,60,340,348,688,1405
60,20,-160,325,363,688,1441
110,-30,50,323,366,689,1460
120,-80,-70,331,358,689,1407
80,30,-160,324,365,689,1360
70,60,90,352,337,689,1413
120,20,60,348,341,689,1454
100,50,80,339,350,689,1503
-150,-50,20,337,352,689,1370
140,40,170,334,355,689,1498
100,40,110,337,352,689,1576
100,-50,70,347,342,689,1384
140,50,180,336,353,689,1489
140,50,-180,336,353,689,1489
50,0,-120,330,359,689,1339
60,-50,-110,334,356,690,1377
40,0,-60,339,351,690,1407
70,20,-120,336,354,690,1334
100,40,-160,345,345,690,1505
-40,-70,-60,335,355,690,1412
20,-20,160,356,334,690,1377
60,30,-80,343,347,690,1290
110,40,70,341,350,691,1474
130,0,10,337,354,691,1372
120,10,70,333,358,691,1504
-120,-20,160,332,359,691,1591
-20,-10,-20,330,361,691,1300
130,0,110,343,348,691,1348
50,-40,-110,333,358,691,1506
130,30,170,330,361,691,1453
160,-40,-30,352,339,691,1414
-100,-40,-160,316,375,691,1444
-120,-10,80,334,358,692,1492
150,-70,-40,347,345,692,1456
-110,-80,-130,335,357,692,1304
90,-50,-20,327,365,692,1448
100,40,-150,338,354,692,1550
90,-50,50,335,357,692,1410
120,70,-150,341,351,692,1503
120,40,40,338,354,692,1456
-80,70,40,333,359,692,1299
60,60,100,346,346,692,1440
20,40,140,356,336,692,1496
90,-90,70,330,363,693,1442
-140,-90,-160,330,363,693,1442
-70,-90,-90,330,363,693,1442
20,10,150,348,345,693,1432
120,-90,100,330,363,693,1442
100,-90,80,330,363,693,1442
-20,-90,-40,330,363,693,1442
-90,-90,-110,330,363,693,1442
-60,-90,-80,330,363,693,1442
-110,-90,-130,330,363,693,1442
60,20,-90,346,347,693,1323
-50,-90,-70,330,363,693,1442
-120,-40,-170,329,364,693,1534
-170,-90,170,330,363,693,1442
-160,-90,180,330,363,693,1442
150,-90,130,330,363,693,1442
-160,-90,-180,330,363,693,1442
-120,-90,-140,330,363,693,1442
0,-90,-20,330,363,693,1442
-180,-90,160,330,363,693,1442
50,-90,30,330,363,693,1442
110,-90,90,330,363,693,1442
-40,-90,-60,330,363,693,1442
30,-90,10,330,363,693,1442
130,-90,110,330,363,693,1442
-50,-40,150,332,361,693,1499
10,-90,-10,330,363,693,1442
80,-60,-90,338,355,693,1444
80,-90,60,330,363,693,1442
60,-90,40,330,363,693,1442
150,0,140,346,347,693,1468
40,-50,-30,327,366,693,1437
160,-90,140,330,363,693,1442
-150,-90,-170,330,363,693,1442
-130,-90,-150,330,363,693,1442
80,60,80,356,337,693,1371
-100,-90,-120,330,363,693,1442
-80,-90,-100,330,363,693,1442
180,-90,160,330,363,693,1442
40,-90,20,330,363,693,1442
-30,-20,170,324,369,693,1431
20,-90,0,330,363,693,1442
-10,-90,-30,330,363,693,1442
140,-90,120,330,363,693,1442
-30,-90,-50,330,363,693,1442
170,-90,150,330,363,693,1442
70,-90,50,330,363,693,1442
120,-20,-10,339,355,694,1376
140,10,140,338,356,694,1505
40,-30,-70,330,364,694,1482
40,40,130,350,344,694,1393
-20,-70,-40,343,351,694,1495
20,-80,-10,326,368,694,1535
-70,-50,-100,331,363,694,1411
-20,70,-10,334,360,694,1431
150,-30,-30,350,344,694,1431
-20,50,170,348,347,695,1364
110,20,90,351,344,695,1479
90,40,-150,338,357,695,1397
-60,-10,-110,325,370,695,1298
130,50,-170,332,363,695,1414
-20,10,170,348,347,695,1310
120,20,140,353,342,695,1393
-140,-20,170,346,350,696,1560
130,-20,90,328,368,696,1501
-110,80,-90,340,356,696,1395
160,70,180,341,355,696,1264
50,50,-80,315,381,696,1544
-60,-10,-80,327,369,696,1301
50,20,-70,341,355,696,1322
130,-20,-20,337,359,696,1481
160,70,-180,341,355,696,1264
110,20,130,359,338,697,1413
160,-50,-30,355,342,697,1453
130,20,20,347,350,697,1454
30,60,120,359,338,697,1554
-60,60,10,329,368,697,1306
120,0,80,350,347,697,1488
-160,-20,10,347,351,698,1473
130,10,10,348,350,698,1357
120,-40,90,346,352,698,1399
120,40,-170,335,363,698,1499
0,-10,-20,348,350,698,1402
50,-40,-90,334,364,698,1544
170,30,-10,352,346,698,1356
140,-70,-50,342,356,698,1511
-30,40,-20,338,360,698,1454
120,20,80,338,360,698,1517
20,-40,-40,330,368,698,1573
110,-50,80,347,351,698,1399
130,-50,110,343,355,698,1434
20,20,-40,329,370,699,1485
80,-80,50,337,362,699,1542
170,60,170,348,351,699,1334
110,-50,-40,354,345,699,1448
120,-70,100,341,358,699,1444
30,20,150,342,357,699,1523
40,70,110,357,342,699,1470
40,-20,-80,336,363,699,1533
180,10,170,359,341,700,1376
0,80,150,359,341,700,1435
100,30,160,350,350,700,1550
-150,10,150,348,352,700,1581
120,10,80,339,361,700,1467
150,20,150,339,361,700,1523
-60,-40,-90,321,379,700,1372
-100,-20,150,317,383,700,1496
-180,10,170,359,341,700,1376
120,60,-150,333,367,700,1470
-30,-30,160,328,372,700,1462
70,-50,-10,339,362,701,1372
160,50,170,342,359,701,1513
-110,-70,60,351,350,701,1475
120,0,70,338,363,701,1526
20,50,-40,340,361,701,1351
120,-60,-60,346,355,701,1426
-120,-70,-140,351,350,701,1375
180,10,-10,362,339,701,1381
110,-30,-10,336,365,701,1391
30,30,-50,330,371,701,1512
170,-20,170,362,339,701,1343
0,-60,-30,340,361,701,1492
-180,10,-10,362,339,701,1381
-60,-80,-80,346,356,702,1366
60,10,-110,348,354,702,1513
-50,-40,-70,326,376,702,1437
130,20,150,328,374,702,1522
-20,0,170,337,365,702,1372
-130,-20,50,320,382,702,1454
120,10,120,347,355,702,1549
110,30,170,343,360,703,1501
40,-10,-70,327,376,703,1506
-90,-70,80,347,356,703,1472
70,30,-100,345,358,703,1339
-10,10,160,350,353,703,1405
120,30,170,348,355,703,1467
70,-60,-110,357,346,703,1344
70,20,-140,331,372,703,1406
160,-10,150,347,356,703,1542
-120,-30,60,336,367,703,1456
30,-80,0,331,372,703,1596
80,70,70,356,347,703,1443
20,60,130,368,335,703,1541
40,50,120,359,344,703,1463
-120,0,90,341,363,704,1514
170,40,-10,360,344,704,1378
-10,-20,160,353,351,704,1386
-160,-30,10,355,349,704,1437
50,-40,-80,335,369,704,1570
-10,80,160,356,348,704,1428
-140,40,0,328,376,704,1489
80,-70,40,333,371,704,1495
130,60,-160,348,356,704,1492
50,-40,-100,335,369,704,1509
0,10,-20,357,348,705,1444
-70,-30,160,331,374,705,1486
80,50,-120,336,369,705,1449
-20,-50,150,357,348,705,1424
10,70,140,371,334,705,1490
100,50,-140,334,371,705,1576
70,70,80,359,347,706,1427
-10,-60,-30,355,351,706,1436
160,-40,160,343,363,706,1346
130,50,20,358,348,706,1485
150,10,150,345,361,706,1515
60,10,-100,349,357,706,1496
120,10,110,355,351,706,1514
10,10,150,362,344,706,1551
-90,50,-70,343,363,706,1410
140,20,150,338,369,707,1511
120,10,60,351,356,707,1539
70,60,-100,339,368,707,1526
20,40,-40,340,367,707,1394
-60,-20,-150,324,383,707,1555
30,50,-50,339,368,707,1499
80,40,-130,331,376,707,1428
150,-60,140,348,359,707,1371
-170,-60,-180,359,349,708,1406
180,40,-10,353,355,708,1406
-170,-60,180,359,349,708,1406
50,-20,-120,336,372,708,1389
40,0,-180,356,352,708,1443
-180,40,-10,353,355,708,1406
80,30,180,344,364,708,1525
40,0,180,356,352,708,1443
80,-70,-110,353,355,708,1493
20,60,-40,337,371,708,1419
130,-10,-10,346,362,708,1471
-80,40,-50,339,369,708,1406
80,30,-180,344,364,708,1525
90,30,160,349,359,708,1542
100,80,50,359,349,708,1419
90,-70,-100,344,364,708,1529
100,30,150,346,362,708,1597
-40,-50,140,338,370,708,1587
150,-20,130,346,362,708,1586
-90,-30,-180,328,381,709,1513
-100,-20,120,346,363,709,1505
120,0,60,347,362,709,1512
-60,-20,-90,326,383,709,1393
60,-50,-20,337,372,709,1461
-90,-30,180,328,381,709,1513
-50,-50,-70,329,380,709,1342
140,-40,-40,360,349,709,1438
-110,-30,-180,345,364,709,1625
-110,-60,-140,340,369,709,1467
80,-50,-20,347,362,709,1530
-110,-30,180,345,364,709,1625
-170,40,160,336,374,710,1279
20,-20,-40,342,368,710,1477
-90,-40,100,333,377,710,1379
50,-10,-90,352,358,710,1468
-100,-30,180,342,368,710,1550
50,-50,-20,339,371,710,1530
160,30,-10,352,358,710,1445
-70,20,-90,340,370,710,1320
-100,-30,-180,342,368,710,1550
60,-50,-30,340,371,711,1546
110,-60,90,349,362,711,1326
100,-40,60,357,354,711,1484
90,70,60,355,356,711,1473
-10,0,160,349,362,711,1352
-60,-10,-120,332,379,711,1359
-70,50,0,340,371,711,1387
-160,30,0,364,347,711,1501
60,40,-90,349,362,711,1403
130,-40,-40,363,349,712,1465
40,-80,10,334,378,712,1596
110,20,80,360,352,712,1489
-100,60,50,341,371,712,1382
-50,-80,-70,349,363,712,1426
160,60,0,351,361,712,1480
40,30,140,353,359,712,1499
-130,30,30,353,359,712,1489
-140,-60,30,366,346,712,1437
10,-30,-40,346,366,712,1626
70,-60,20,341,372,713,1414
70,-50,-20,344,369,713,1423
110,20,100,363,350,713,1454
110,60,-140,332,381,713,1554
60,50,-90,339,374,713,1530
-60,70,20,345,368,713,1389
40,-40,-40,341,372,713,1521
20,-40,170,352,361,713,1416
120,-80,100,339,374,713,1517
-180,50,-10,352,362,714,1483
100,-60,-70,350,364,714,1456
-80,-30,-160,321,393,714,1496
30,-40,-40,330,384,714,1593
150,-10,-20,377,337,714,1449
180,50,-10,352,362,714,1483
40,20,-50,350,364,714,1382
0,-30,-30,353,361,714,1514
110,-70,-80,352,362,714,1522
-110,-20,80,348,366,714,1521
70,20,-110,351,364,715,1339
40,-60,-160,366,349,715,1431
-40,-10,-170,343,372,715,1441
50,70,100,366,349,715,1469
120,-40,-40,355,361,716,1461
-110,60,-60,348,368,716,1426
-100,-70,70,358,358,716,1478
-160,80,-40,346,370,716,1488
-120,80,-80,353,363,716,1459
60,-50,-50,339,377,716,1490
50,40,-80,344,372,716,1505
-80,70,-120,349,367,716,1397
50,30,150,347,369,716,1531
70,-80,40,343,373,716,1578
-60,30,-130,352,365,717,1371
140,60,-170,358,359,717,1560
130,-30,100,345,372,717,1513
-110,50,-20,337,380,717,1594
0,-50,-30,349,368,717,1545
80,60,-110,337,380,717,1581
-150,0,160,356,361,717,1513
110,20,110,368,349,717,1467
60,-80,30,341,376,717,1588
60,10,-120,350,367,717,1617
-50,-50,130,344,373,717,1502
-20,60,170,365,353,718,1494
100,-70,-90,350,368,718,1492
0,70,150,358,360,718,1496
-20,40,170,372,346,718,1405
100,-30,10,356,362,718,1467
100,40,100,355,363,718,1583
110,20,120,355,363,718,1441
0,40,150,359,359,718,1438
-130,0,50,331,387,718,1308
170,-10,-20,381,337,718,1536
10,-20,-30,353,365,718,1464
-170,0,170,356,362,718,1505
10,10,-30,348,370,718,1522
60,-50,-40,342,377,719,1537
150,-60,-40,349,370,719,1587
60,50,110,354,365,719,1522
10,-70,170,356,363,719,1499
-100,50,-40,339,380,719,1498
20,-10,-40,336,383,719,1453
80,30,-150,339,380,719,1489
50,-80,20,341,378,719,1589
110,80,40,368,351,719,1448
-150,-10,170,347,372,719,1462
-90,-30,110,346,374,720,1393
-70,70,30,356,364,720,1387
-20,80,170,367,353,720,1458
50,-20,-130,336,384,720,1443
-150,80,-50,355,365,720,1531
80,-50,30,353,367,720,1492
160,70,0,369,351,720,1507
30,-10,-50,335,385,720,1550
-140,10,30,340,381,721,1468
100,-30,20,352,369,721,1530
40,20,160,355,366,721,1584
-100,-60,-130,342,379,721,1535
160,-30,160,354,367,721,1384
50,-40,-120,353,369,722,1633
-120,-30,180,361,361,722,1586
80,40,130,357,365,722,1521
-120,-30,-180,361,361,722,1586
-30,-20,-30,353,369,722,1313
90,-60,-80,355,367,722,1505
170,-40,170,351,372,723,1409
10,-10,-30,335,388,723,1456
120,-20,70,340,383,723,1620
120,-10,50,343,380,723,1442
50,-40,-60,338,385,723,1543
-30,50,-180,363,360,723,1371
-30,50,180,363,360,723,1371
40,10,170,346,377,723,1501
60,10,-130,357,367,724,1614
-140,10,140,358,366,724,1596
50,-40,-70,336,388,724,1599
-140,-30,180,352,372,724,1692
-110,70,-80,354,370,724,1492
-120,-40,60,336,388,724,1584
110,20,140,372,352,724,1522
-140,-30,-180,352,372,724,1692
30,40,130,366,358,724,1550
-50,0,-150,339,385,724,1453
50,0,-130,336,388,724,1440
160,20,160,351,373,724,1514
-130,20,40,338,386,724,1435
-60,-70,-80,347,377,724,1453
60,40,130,363,361,724,1625
90,-50,-30,348,376,724,1548
-20,70,170,359,365,724,1528
130,10,140,348,377,725,1578
120,-30,80,345,381,726,1535
20,-70,180,356,370,726,1506
10,60,140,375,351,726,1580
20,-70,-180,356,370,726,1506
-10,60,160,367,359,726,1549
50,40,130,361,365,726,1517
70,20,-150,339,387,726,1527
-120,40,30,346,380,726,1481
110,20,150,370,356,726,1594
-140,-60,-160,349,377,726,1474
70,-70,30,341,385,726,1578
30,30,140,368,358,726,1565
-90,-60,-120,350,377,727,1490
50,20,170,346,381,727,1604
-40,-60,130,348,379,727,1533
80,-40,0,350,377,727,1524
60,20,-170,348,379,727,1529
-60,-20,-160,342,385,727,1526
-80,-30,130,350,377,727,1637
-160,40,150,335,392,727,1331
90,-40,-10,361,366,727,1565
60,70,90,372,355,727,1442
120,10,130,360,367,727,1567
160,60,180,335,393,728,1476
-10,70,160,362,366,728,1522
100,70,50,357,371,728,1486
0,-40,-30,363,365,728,1597
-120,40,20,343,385,728,1541
160,60,-180,335,393,728,1476
80,30,170,361,367,728,1617
130,40,20,358,371,729,1523
0,-20,-20,366,363,729,1535
-130,-30,-180,352,377,729,1694
-80,40,-90,363,366,729,1369
100,60,-130,333,396,729,1620
60,-60,-130,364,365,729,1378
-90,-50,-130,346,383,729,1489
100,-30,0,346,383,729,1466
150,20,-10,381,348,729,1538
140,-10,120,353,376,729,1657
50,-20,-110,339,390,729,1525
90,-40,50,364,365,729,1549
-130,-30,180,352,377,729,1694
-10,-30,-20,368,362,730,1509
40,-30,-60,356,374,730,1661
-120,0,130,356,374,730,1555
40,-20,-70,351,379,730,1581
40,-30,-170,368,362,730,1434
140,-50,130,368,362,730,1534
-90,50,-80,354,376,730,1518
70,-50,-30,354,376,730,1563
-80,-40,-130,339,392,731,1554
-10,-10,160,365,366,731,1358
50,0,-140,339,392,731,1530
40,10,-50,361,370,731,1450
100,30,140,360,371,731,1590
150,50,0,371,361,732,1454
140,-10,-20,374,358,732,1562
60,-50,-10,336,396,732,1517
70,20,-160,368,364,732,1596
-50,40,-150,350,382,732,1506
120,0,90,361,372,733,1473
-140,-50,30,358,375,733,1398
130,-10,100,351,382,733,1698
10,20,-30,353,380,733,1532
120,20,50,373,360,733,1520
-50,30,-30,367,366,733,1602
30,-70,-10,342,391,733,1558
-140,80,-60,362,371,733,1548
130,20,160,357,376,733,1548
90,40,-140,359,374,733,1482
-10,30,160,369,365,734,1519
110,30,70,359,375,734,1567
160,-30,-30,376,358,734,1469
-30,70,-180,364,370,734,1548
80,-60,40,355,379,734,1576
70,50,100,367,367,734,1518
-30,70,180,364,370,734,1548
130,60,20,368,366,734,1461
90,-60,60,363,371,734,1436
160,10,160,361,373,734,1459
110,-80,90,353,381,734,1604
100,30,130,360,374,734,1661
90,-40,60,367,367,734,1572
150,-30,140,363,371,734,1613
-60,-40,130,347,387,734,1507
120,30,180,363,372,735,1551
40,-60,-10,357,378,735,1603
120,30,-180,363,372,735,1551
50,0,-80,339,396,735,1442
90,40,120,364,371,735,1571
10,-70,-20,347,388,735,1585
-40,50,-10,349,386,735,1406
90,60,-120,340,395,735,1642
90,30,170,359,376,735,1650
30,-60,-20,347,388,735,1592
-110,-70,-130,379,356,735,1542
70,40,130,357,378,735,1621
-10,20,-20,358,378,736,1436
140,30,160,344,392,736,1626
20,0,-40,339,397,736,1488
90,50,-130,355,381,736,1522
130,30,20,375,361,736,1493
-130,80,-70,362,375,737,1507
-160,60,-20,363,374,737,1463
80,-40,10,365,372,737,1549
140,60,10,365,372,737,1492
-110,-50,-150,338,399,737,1533
20,-30,-40,351,386,737,1626
170,30,170,354,384,738,1495
20,10,-40,358,380,738,1564
130,30,-180,364,374,738,1605
110,70,40,366,372,738,1510
-140,60,-30,364,374,738,1584
-130,20,110,358,380,738,1491
80,-50,-30,353,385,738,1605
-60,-50,120,353,385,738,1583
10,60,-30,352,386,738,1374
-110,-10,90,359,379,738,1539
130,30,180,364,374,738,1605
120,0,50,363,375,738,1517
90,-70,60,361,377,738,1560
120,20,150,361,377,738,1554
-150,0,20,352,387,739,1454
180,20,-10,381,358,739,1476
100,-40,-20,369,370,739,1644
-40,40,-20,371,368,739,1459
80,-40,20,369,370,739,1528
150,-70,140,370,369,739,1514
40,-40,-160,371,368,739,1402
-180,20,-10,381,358,739,1476
70,-50,-70,358,381,739,1636
0,50,150,368,372,740,1520
120,70,30,369,371,740,1511
50,-40,-50,351,389,740,1529
-90,60,-100,361,379,740,1415
90,30,150,358,382,740,1606
-10,20,160,366,374,740,1485
-20,0,-20,379,361,740,1432
30,10,-40,354,386,740,1494
-30,80,-180,375,366,741,1483
70,40,-100,370,371,741,1478
120,-10,40,356,385,741,1519
-160,70,-30,363,378,741,1545
-120,40,40,366,375,741,1534
40,-70,0,352,389,741,1572
-30,80,180,375,366,741,1483
100,30,170,370,371,741,1654
-110,-20,160,351,390,741,1642
30,-70,-170,376,366,742,1555
-100,60,-80,354,388,742,1433
180,30,-10,367,375,742,1471
-150,-30,-180,357,385,742,1587
-150,-30,180,357,385,742,1587
120,20,160,368,374,742,1606
80,30,-140,366,376,742,1557
160,0,-20,391,351,742,1489
-30,10,-180,359,383,742,1493
-30,10,180,359,383,742,1493
-180,30,-10,367,375,742,1471
10,40,-30,357,385,742,1359
-10,40,-20,366,377,743,1450
140,0,130,355,388,743,1502
70,20,-170,367,376,743,1567
30,-50,-30,352,391,743,1609
-130,70,100,356,387,743,1493
140,-60,-50,361,382,743,1627
150,70,-170,372,371,743,1526
100,40,90,366,377,743,1654
-60,-30,-90,343,400,743,1508
120,80,30,371,372,743,1510
100,-40,70,366,377,743,1578
120,60,30,365,378,743,1487
140,10,-10,380,364,744,1497
50,-20,-100,355,389,744,1580
150,40,170,359,385,744,1675
70,-50,-40,359,385,744,1672
130,-40,110,358,386,744,1550
-40,-40,150,363,381,744,1629
110,40,-160,362,382,744,1659
30,-30,-50,350,394,744,1629
150,30,160,351,393,744,1597
140,10,150,363,381,744,1624
60,30,160,366,378,744,1577
130,40,-170,360,384,744,1566
-90,-30,-170,345,400,745,1493
140,20,160,362,383,745,1602
120,10,140,373,372,745,1663
150,-50,-40,374,371,745,1573
50,10,-70,362,383,745,1460
100,30,180,363,382,745,1733
100,30,-180,363,382,745,1733
60,-70,20,352,393,745,1584
-150,-30,20,365,380,745,1527
-120,0,80,350,395,745,1562
60,10,-140,353,392,745,1611
-150,-40,20,378,368,746,1465
120,50,-150,359,387,746,1506
0,60,150,382,364,746,1625
-70,60,-130,371,375,746,1372
20,30,140,369,377,746,1561
70,-50,-60,355,391,746,1623
100,-30,30,367,379,746,1631
-50,10,-150,364,382,746,1544
110,-40,80,375,372,747,1545
-40,-80,-60,361,386,747,1525
110,40,60,365,382,747,1589
110,-40,-30,372,375,747,1533
10,-50,-30,350,397,747,1616
20,30,-40,354,393,747,1592
170,-10,170,387,360,747,1529
0,-70,160,373,374,747,1508
50,0,-150,360,387,747,1549
120,-50,100,361,386,747,1579
120,30,40,374,374,748,1626
30,-40,180,383,365,748,1500
50,10,-170,363,385,748,1624
140,-40,130,365,383,748,1578
30,-40,-180,383,365,748,1500
-170,-40,-180,373,375,748,1587
-170,-40,180,373,375,748,1587
110,50,50,377,371,748,1560
100,50,70,367,382,749,1689
40,60,110,389,360,749,1600
120,10,50,374,375,749,1583
-130,10,130,359,390,749,1652
70,50,-100,360,389,749,1570
90,-50,60,379,370,749,1592
-170,40,-10,370,379,749,1496
170,20,170,368,381,749,1511
-130,-60,40,383,366,749,1530
70,-50,-50,362,388,750,1616
30,20,-40,349,401,750,1610
60,20,180,350,401,751,1561
-10,-60,150,383,368,751,1474
80,30,160,370,381,751,1636
60,20,-180,350,401,751,1561
140,-60,130,378,373,751,1501
100,-50,-40,367,385,752,1605
-50,40,-20,373,379,752,1559
-120,40,50,364,388,752,1473
-30,60,-180,377,375,752,1497
120,-10,60,359,393,752,1573
-30,60,180,377,375,752,1497
-50,-10,-160,353,399,752,1655
40,-50,-160,388,364,752,1466
50,-70,10,355,397,752,1591
30,40,-50,356,396,752,1591
-70,-30,150,364,388,752,1540
-50,-10,-50,376,376,752,1429
-120,-10,150,374,378,752,1653
70,20,180,362,391,753,1632
130,0,120,364,389,753,1542
150,50,-180,357,396,753,1654
-80,30,-80,355,398,753,1472
70,20,-180,362,391,753,1632
-90,-20,140,366,387,753,1679
60,10,-150,354,399,753,1550
110,-60,-70,362,391,753,1512
-30,-80,-50,363,390,753,1558
120,-30,90,377,376,753,1608
-70,30,-110,371,382,753,1540
80,-40,-10,369,384,753,1597
-110,-10,130,378,375,753,1617
110,20,160,379,374,753,1679
-130,-40,-170,370,383,753,1710
150,50,180,357,396,753,1654
170,0,170,380,373,753,1476
-80,40,-40,379,374,753,1568
-40,10,-30,375,379,754,1470
10,50,-30,367,387,754,1423
-60,0,-120,356,398,754,1557
30,60,-50,358,396,754,1492
40,-70,-160,381,373,754,1617
130,0,0,362,393,755,1575
-50,-20,-180,361,394,755,1604
120,50,30,379,376,755,1557
150,20,160,367,388,755,1660
-50,-20,180,361,394,755,1604
-90,70,-110,366,389,755,1454
50,-40,-40,354,402,756,1610
-160,-30,180,377,379,756,1567
-160,-30,-180,377,379,756,1567
50,-10,-130,351,405,756,1602
70,-50,-80,366,390,756,1646
40,50,-60,355,401,756,1555
130,70,20,378,378,756,1537
10,-40,160,367,389,756,1471
-70,-30,-120,353,403,756,1533
110,-70,90,361,395,756,1534
140,-30,120,355,402,757,1634
130,50,-160,358,399,757,1516
-20,20,170,382,375,757,1495
120,0,100,369,388,757,1561
100,-80,80,368,389,757,1660
-120,40,10,353,404,757,1590
140,30,0,381,377,758,1617
10,0,-30,372,386,758,1600
100,40,-140,369,389,758,1634
70,30,160,371,388,759,1619
170,40,170,367,392,759,1452
-40,-30,160,364,395,759,1612
140,40,-180,359,400,759,1651
140,40,180,359,400,759,1651
90,30,180,374,385,759,1641
-60,0,-60,358,401,759,1430
90,30,-180,374,385,759,1641
20,50,130,387,372,759,1639
80,-60,-100,366,393,759,1578
60,0,-110,363,397,760,1538
130,-20,100,365,395,760,1634
-20,30,170,375,385,760,1528
-110,-40,70,354,406,760,1665
150,-20,-30,385,375,760,1606
30,70,-50,373,387,760,1482
-150,-50,-170,362,398,760,1645
150,-40,-40,381,379,760,1563
40,-50,-20,361,399,760,1570
100,-30,40,368,393,761,1644
-130,-10,50,346,415,761,1537
20,0,150,387,374,761,1610
-50,20,-150,368,393,761,1513
-30,0,-180,363,398,761,1623
-30,0,180,363,398,761,1623
160,40,-10,386,376,762,1575
30,50,120,392,370,762,1632
-130,40,0,351,411,762,1604
-160,70,140,382,380,762,1482
130,80,20,377,385,762,1548
130,-50,-50,378,384,762,1526
110,-30,60,360,402,762,1545
40,-10,-180,380,382,762,1677
40,-10,180,380,382,762,1677
140,-20,-30,395,368,763,1624
-20,-20,-20,380,383,763,1416
-140,90,-70,375,388,763,1513
10,90,140,375,388,763,1513
140,90,10,375,388,763,1513
110,90,40,375,388,763,1513
-60,20,-40,370,393,763,1476
60,90,90,375,388,763,1513
-160,90,-50,375,388,763,1513
-100,90,-110,375,388,763,1513
-130,90,-80,375,388,763,1513
-20,90,170,375,388,763,1513
20,90,130,375,388,763,1513
170,50,-10,380,383,763,1580
-110,90,-100,375,388,763,1513
-70,90,-140,375,388,763,1513
100,90,50,375,388,763,1513
-40,90,-170,375,388,763,1513
-120,90,-90,375,388,763,1513
-30,90,-180,375,388,763,1513
-30,90,180,375,388,763,1513
30,-20,-50,352,411,763,1651
170,90,-20,375,388,763,1513
-110,60,70,364,399,763,1418
50,90,100,375,388,763,1513
-60,90,-150,375,388,763,1513
120,90,30,375,388,763,1513
-170,90,-40,375,388,763,1513
40,90,110,375,388,763,1513
180,90,-30,375,388,763,1513
-120,-60,50,384,379,763,1640
-180,90,-30,375,388,763,1513
-50,90,-160,375,388,763,1513
0,90,150,375,388,763,1513
90,90,60,375,388,763,1513
130,90,20,375,388,763,1513
-80,90,-130,375,388,763,1513
70,90,80,375,388,763,1513
160,90,-10,375,388,763,1513
-150,90,-60,375,388,763,1513
80,90,70,375,388,763,1513
-10,90,160,375,388,763,1513
150,90,0,375,388,763,1513
80,40,120,374,389,763,1649
-90,90,-120,375,388,763,1513
30,90,120,375,388,763,1513
20,-80,-180,379,385,764,1616
-80,30,-70,374,390,764,1520
30,0,160,383,381,764,1600
170,50,170,368,396,764,1535
-80,40,-30,369,395,764,1605
20,-80,180,379,385,764,1616
-70,-70,-90,374,390,764,1490
100,20,130,380,384,764,1676
150,0,-20,396,369,765,1545
-130,-10,160,375,390,765,1712
-130,40,100,362,403,765,1598
-120,50,-20,349,416,765,1692
50,40,-70,370,395,765,1570
-110,50,-30,368,397,765,1603
-100,-20,110,374,392,766,1480
100,-30,-10,369,397,766,1537
10,50,140,390,376,766,1680
90,40,-130,370,396,766,1579
-120,60,-50,367,399,766,1443
40,70,-60,365,401,766,1540
110,10,90,375,391,766,1642
20,-50,-30,362,404,766,1705
110,-50,90,376,390,766,1515
70,20,-100,384,382,766,1495
110,20,70,378,388,766,1617
50,-30,-140,368,398,766,1613
120,-50,-50,377,389,766,1578
170,10,170,388,379,767,1493
100,20,120,378,389,767,1634
-100,-50,-140,361,406,767,1616
-10,-70,150,382,385,767,1557
-20,-50,-30,373,394,767,1454
40,40,-60,369,399,768,1617
-20,10,-20,375,393,768,1471
60,-60,10,368,400,768,1543
-60,-10,-130,360,408,768,1593
50,-60,0,365,403,768,1657
80,40,-120,365,403,768,1604
-130,-20,170,385,383,768,1760
50,-30,-120,377,392,769,1592
170,70,-10,384,385,769,1647
110,10,110,396,373,769,1640
-140,30,130,366,403,769,1522
-10,-70,-30,373,396,769,1661
40,-10,-60,371,398,769,1766
10,0,150,387,383,770,1616
-180,20,170,380,390,770,1519
40,-40,-30,367,403,770,1699
180,20,170,380,390,770,1519
40,60,-60,367,403,770,1611
80,-40,30,373,397,770,1573
110,60,40,382,389,771,1624
100,30,120,385,386,771,1758
-20,30,-20,375,396,771,1570
120,-10,30,371,400,771,1635
-120,-20,60,372,399,771,1693
60,-50,0,372,400,772,1598
100,40,80,380,392,772,1689
-70,-40,120,372,400,772,1712
90,30,-170,378,394,772,1657
100,-30,60,394,378,772,1598
-60,20,-130,370,402,772,1624
10,30,-30,366,406,772,1500
110,-20,30,377,396,773,1633
130,-60,120,386,387,773,1532
110,10,120,402,371,773,1598
-30,-40,150,378,395,773,1651
-70,-30,140,370,403,773,1516
-160,10,160,395,378,773,1794
160,-50,160,392,381,773,1482
20,-50,170,382,391,773,1503
50,0,-160,365,408,773,1652
80,-50,-40,374,399,773,1688
-140,-40,30,381,392,773,1609
-130,-50,-160,370,403,773,1663
-70,20,-100,375,399,774,1545
60,10,-160,367,407,774,1668
50,-30,-130,375,399,774,1545
120,0,40,393,381,774,1555
110,-20,40,377,397,774,1577
-30,-50,-40,369,405,774,1467
50,-40,-130,377,397,774,1725
60,40,-80,381,393,774,1541
30,-80,-170,386,389,775,1638
30,10,150,384,391,775,1594
100,20,110,371,404,775,1589
-20,-80,-40,373,402,775,1619
80,30,150,375,400,775,1653
80,50,90,381,394,775,1631
90,30,-160,370,405,775,1583
120,40,-160,375,400,775,1610
120,-40,100,395,380,775,1633
-70,10,-80,364,411,775,1487
50,0,-70,374,401,775,1615
-60,-30,160,369,406,775,1532
110,10,80,388,387,775,1637
50,-70,-150,391,385,776,1665
110,-30,-20,386,390,776,1582
40,-20,180,388,388,776,1580
100,-60,80,381,395,776,1496
40,-20,-180,388,388,776,1580
-100,-20,160,376,400,776,1724
70,-50,10,366,410,776,1563
100,-30,50,374,402,776,1627
40,0,-50,384,392,776,1588
-160,40,-10,382,394,776,1602
-10,-50,150,382,395,777,1531
50,-50,-140,388,389,777,1629
30,-30,170,387,390,777,1648
50,-20,-140,370,407,777,1615
-140,-30,30,365,412,777,1524
90,50,-120,363,414,777,1636
110,10,70,388,389,777,1727
20,-70,-10,368,409,777,1636
80,-50,40,378,400,778,1683
80,-70,50,369,409,778,1683
0,-30,-20,377,401,778,1684
110,-40,90,397,381,778,1660
130,-30,110,375,403,778,1699
10,-10,150,389,389,778,1568
120,-10,20,382,396,778,1593
-110,-10,140,379,400,779,1746
60,-40,-30,384,395,779,1680
-40,80,-170,392,387,779,1550
50,50,110,400,379,779,1617
120,-10,70,365,414,779,1707
-20,20,-20,368,411,779,1597
110,-30,80,388,391,779,1636
170,-50,170,381,398,779,1544
140,-70,130,391,388,779,1617
120,-30,-30,380,399,779,1562
80,20,-130,391,388,779,1577
20,-60,-20,367,412,779,1635
50,-50,-10,371,409,780,1716
-120,70,-70,381,399,780,1565
90,40,110,388,392,780,1730
50,-40,-30,376,404,780,1673
-50,30,-150,378,402,780,1563
140,30,170,380,400,780,1678
-30,40,180,388,392,780,1577
0,-80,160,382,398,780,1613
-30,40,-180,388,392,780,1577
-170,-30,180,386,395,781,1652
-170,-30,-180,386,395,781,1652
-60,40,-20,378,403,781,1594
110,10,100,391,390,781,1648
60,0,-100,370,411,781,1620
40,-80,-160,385,396,781,1699
150,30,-10,404,377,781,1641
110,70,-130,381,400,781,1650
110,50,-140,372,410,782,1701
-10,-80,-30,377,405,782,1631
10,-80,170,388,394,782,1626
-60,50,-140,397,385,782,1509
100,-40,80,392,390,782,1592
50,-20,-90,379,403,782,1711
-120,-10,70,362,420,782,1671
0,30,150,399,384,783,1647
-40,-40,-50,363,420,783,1526
-80,-30,-150,372,411,783,1701
-110,50,50,367,416,783,1527
130,-50,120,390,393,783,1708
60,-50,-120,382,401,783,1617
60,10,-170,369,415,784,1679
160,-20,160,400,384,784,1653
180,-30,-180,383,401,784,1640
-180,-30,-180,383,401,784,1640
-180,-30,180,383,401,784,1640
110,-30,70,382,402,784,1591
180,-30,180,383,401,784,1640
120,-30,100,391,393,784,1711
-50,-30,160,376,409,785,1674
-90,-20,130,398,387,785,1714
40,30,-50,374,411,785,1627
-40,70,-170,387,398,785,1617
50,70,-70,379,406,785,1649
-90,-40,-140,371,414,785,1683
-60,-20,-170,377,408,785,1710
150,60,-170,374,411,785,1696
90,30,140,379,406,785,1735
20,-30,160,391,394,785,1718
-40,60,0,378,407,785,1519
120,0,30,394,391,785,1687
160,40,170,375,410,785,1695
100,-50,80,403,382,785,1556
-160,-70,-170,393,392,785,1473
160,-20,-30,407,379,786,1631
90,50,80,382,404,786,1789
100,20,150,384,402,786,1770
-100,-30,-170,373,413,786,1648
110,10,130,401,385,786,1660
70,-60,30,376,410,786,1642
60,0,-120,366,420,786,1613
-130,50,-20,369,417,786,1702
80,30,-130,380,406,786,1568
80,-40,40,390,396,786,1652
140,50,-170,378,408,786,1634
-110,-60,60,413,373,786,1735
50,30,140,380,406,786,1753
-150,20,150,376,410,786,1703
60,10,-90,384,403,787,1601
10,-30,-30,372,415,787,1733
80,50,-110,371,416,787,1582
-180,30,170,383,404,787,1510
180,30,170,383,404,787,1510
-150,70,-40,383,404,787,1625
-50,-60,120,371,417,788,1654
150,-40,150,390,398,788,1594
90,-80,70,377,411,788,1687
20,-40,-30,368,420,788,1800
-130,30,110,360,428,788,1618
50,20,-60,378,410,788,1579
-120,10,100,383,405,788,1566
40,20,150,386,402,788,1723
100,20,140,381,407,788,1791
-80,-40,110,380,408,788,1789
120,-10,10,390,398,788,1585
-120,10,110,392,396,788,1671
-120,40,60,371,417,788,1574
50,60,100,406,382,788,1649
10,40,140,410,379,789,1682
100,20,160,385,404,789,1820
60,-70,-140,400,389,789,1699
90,-50,-40,382,407,789,1730
-130,0,150,382,407,789,1790
-90,60,40,380,409,789,1570
60,-40,-20,374,415,789,1656
30,80,-50,381,408,789,1551
80,-40,50,395,394,789,1677
-70,60,20,384,406,790,1637
40,-30,-50,365,425,790,1737
80,-50,-50,375,415,790,1722
50,-60,-150,406,384,790,1580
110,30,180,383,407,790,1726
10,-40,-30,375,415,790,1664
-40,50,-170,397,393,790,1528
70,-40,-20,392,398,790,1600
-110,-40,-160,379,411,790,1667
110,30,-180,383,407,790,1726
-40,-20,170,382,408,790,1693
-30,-60,-40,385,405,790,1582
-110,-30,70,366,424,790,1754
130,10,150,376,414,790,1706
50,30,-60,385,406,791,1530
-120,70,90,373,418,791,1603
60,30,150,381,410,791,1754
120,70,-140,387,404,791,1708
140,70,-160,392,399,791,1691
80,-30,20,387,404,791,1673
120,10,40,387,404,791,1562
70,10,-140,374,418,792,1629
30,0,-40,373,419,792,1548
-130,60,-40,378,414,792,1632
80,70,-100,371,422,793,1725
110,60,-130,387,406,793,1682
70,-50,-90,401,392,793,1651
120,30,-170,394,399,793,1632
20,70,-40,383,410,793,1467
170,0,-20,417,376,793,1623
-90,-50,90,384,409,793,1604
50,60,-70,371,422,793,1726
0,-80,-20,378,416,794,1649
20,-20,-30,382,412,794,1600
80,-80,-120,391,403,794,1684
-170,-80,-10,392,402,794,1642
-50,-40,140,366,428,794,1731
-100,50,30,382,412,794,1573
80,30,-120,388,406,794,1641
50,50,-70,370,424,794,1727
140,-30,-40,404,390,794,1651
70,10,-160,378,416,794,1755
-80,50,10,386,408,794,1612
-70,10,-70,376,418,794,1506
150,-10,140,382,413,795,1797
70,10,-130,391,404,795,1627
60,20,170,378,417,795,1626
40,-20,-60,375,420,795,1826
-100,-70,-120,390,405,795,1675
100,30,90,384,411,795,1634
130,-60,-60,391,404,795,1655
50,-30,-110,373,423,796,1716
-140,50,-20,370,426,796,1714
100,60,50,393,403,796,1675
-80,-70,-100,385,411,796,1607
-10,-80,150,387,409,796,1579
40,80,-60,386,410,796,1573
140,-20,120,386,410,796,1709
100,30,-170,384,412,796,1785
100,30,110,395,401,796,1745
-20,-40,150,391,406,797,1622
30,-30,-40,364,433,797,1798
100,-30,-20,396,401,797,1641
40,-30,-40,378,419,797,1762
120,0,110,394,403,797,1815
60,-80,-140,400,397,797,1706
-140,20,140,398,399,797,1830
50,20,160,384,413,797,1676
110,40,-150,393,404,797,1675
0,20,150,407,390,797,1692
70,-80,50,387,410,797,1738
80,-40,-20,393,404,797,1627
100,30,80,386,411,797,1652
100,50,-130,373,424,797,1718
160,-80,-40,398,399,797,1725
70,-70,40,377,421,798,1738
70,70,-90,375,423,798,1747
100,30,100,382,416,798,1701
120,-20,80,367,431,798,1757
70,-80,-130,401,397,798,1702
70,80,-90,395,403,798,1623
90,70,-110,381,417,798,1697
-10,30,-20,401,397,798,1548
-80,50,-110,398,400,798,1529
70,40,120,382,416,798,1765
150,60,0,400,398,798,1647
-160,20,160,392,406,798,1668
90,60,60,412,386,798,1645
50,-80,-150,398,400,798,1729
140,40,0,397,402,799,1682
-170,-20,-180,376,423,799,1617
170,-80,-30,394,405,799,1730
50,-10,-80,384,415,799,1644
-20,60,-10,393,406,799,1501
0,10,150,401,398,799,1669
180,80,160,419,380,799,1626
120,60,-140,384,415,799,1659
-170,-20,180,376,423,799,1617
-180,80,160,419,380,799,1626
70,10,-150,378,422,800,1679
180,-80,-20,397,403,800,1687
-140,-40,-170,385,415,800,1875
-20,-20,160,393,407,800,1669
-160,20,0,399,401,800,1759
-120,-20,170,388,412,800,1862
-180,-80,-20,397,403,800,1687
120,20,40,398,402,800,1730
90,-30,0,383,417,800,1641
-70,-60,-90,394,406,800,1608
50,-30,-90,370,430,800,1805
160,80,-180,413,388,801,1710
160,20,170,391,410,801,1683
-150,40,140,377,424,801,1563
80,80,-100,394,407,801,1656
-80,60,30,390,411,801,1584
120,-10,80,383,418,801,1815
60,-40,-70,389,412,801,1634
20,-80,0,380,421,801,1695
60,80,-80,394,407,801,1600
-150,60,130,388,413,801,1725
-140,30,10,380,421,801,1717
100,20,90,395,406,801,1620
160,80,180,413,388,801,1710
10,-80,-10,379,422,801,1680
-60,-10,-140,372,429,801,1788
40,10,160,387,415,802,1743
140,80,10,398,404,802,1595
150,-80,-50,398,404,802,1695
90,-50,70,404,398,802,1675
80,-50,-60,382,420,802,1668
-170,80,150,412,390,802,1628
-120,40,0,374,428,802,1706
20,-30,-30,371,431,802,1673
40,40,120,402,400,802,1693
80,-80,60,387,415,802,1736
50,-10,-140,374,428,802,1717
150,-20,140,393,409,802,1800
30,-40,-30,380,422,802,1814
140,70,10,406,396,802,1626
160,30,170,390,412,802,1642
110,-50,-50,390,413,803,1728
60,50,100,406,397,803,1668
-100,-30,90,392,411,803,1690
-120,10,90,382,421,803,1705
90,-30,10,397,406,803,1628
60,70,-80,376,427,803,1743
-10,-40,-20,407,396,803,1730
-30,-50,140,393,410,803,1775
-50,80,-160,397,406,803,1622
100,70,-120,387,416,803,1675
10,-60,-20,382,422,804,1773
100,-70,80,391,413,804,1678
130,60,-150,389,415,804,1674
120,20,170,397,407,804,1710
-150,20,10,403,401,804,1742
170,80,170,418,386,804,1667
-70,30,-40,402,403,805,1659
40,-40,-170,402,403,805,1607
60,20,-80,391,414,805,1548
120,40,30,405,400,805,1709
-150,-20,20,394,411,805,1717
50,-30,-40,390,415,805,1840
-150,-10,20,379,426,805,1711
-170,60,-20,405,400,805,1697
30,-70,0,383,422,805,1756
80,60,70,421,384,805,1662
100,20,100,393,412,805,1600
110,-20,50,388,418,806,1699
-120,0,70,389,417,806,1561
60,-10,-110,391,415,806,1639
120,-50,110,400,406,806,1709
60,-40,-60,379,427,806,1654
-30,70,0,392,414,806,1739
110,10,140,402,404,806,1723
20,20,140,400,407,807,1632
-50,-30,-60,387,420,807,1610
120,10,30,406,401,807,1617
90,40,-120,398,409,807,1647
130,-10,110,386,421,807,1865
-140,20,20,404,403,807,1714
90,-40,-20,388,419,807,1765
70,30,150,384,423,807,1788
50,80,-70,393,415,808,1592
50,-70,20,386,422,808,1850
-20,-80,140,397,411,808,1566
60,0,-130,386,422,808,1731
20,80,-40,394,414,808,1566
50,40,120,415,393,808,1726
-130,70,-60,386,422,808,1598
160,10,-20,413,395,808,1697
50,-30,-150,393,415,808,1708
70,-40,-10,388,420,808,1679
130,-70,120,395,414,809,1653
100,-60,-80,394,415,809,1665
120,10,150,408,401,809,1747
30,-50,180,408,401,809,1561
60,-40,-50,385,424,809,1717
-170,30,-10,397,412,809,1754
30,-50,-180,408,401,809,1561
-120,0,140,386,423,809,1719
50,-40,-20,391,418,809,1817
-180,-70,-20,412,397,809,1631
60,-80,40,391,418,809,1756
170,-60,-30,395,414,809,1632
180,-70,-20,412,397,809,1631
90,-30,20,405,404,809,1685
-160,-70,0,413,396,809,1674
80,-40,-30,406,404,810,1708
120,-60,110,404,406,810,1554
50,-30,-80,367,443,810,1773
140,-50,-50,395,415,810,1679
30,-10,-40,379,431,810,1717
90,80,-110,402,408,810,1674
150,80,0,400,410,810,1634
-170,10,170,410,400,810,1785
70,40,-90,396,415,811,1598
-130,-50,40,400,411,811,1558
30,90,-50,409,402,811,1525
40,90,-60,409,402,811,1525
170,60,-10,398,413,811,1718
120,-20,-20,396,415,811,1678
20,90,-40,409,402,811,1525
-100,90,80,409,402,811,1525
0,90,-20,409,402,811,1525
-140,0,30,376,435,811,1655
140,90,-160,409,402,811,1525
-170,90,150,409,402,811,1525
60,90,-80,409,402,811,1525
90,90,-110,409,402,811,1525
-80,90,60,409,402,811,1525
-40,90,20,409,402,811,1525
-160,-50,-170,403,408,811,1661
-20,90,0,409,402,811,1525
-50,70,-160,408,403,811,1677
150,90,-170,409,402,811,1525
50,90,-70,409,402,811,1525
180,90,160,409,402,811,1525
130,90,-150,409,402,811,1525
-180,90,160,409,402,811,1525
-60,90,40,409,402,811,1525
-110,90,90,409,402,811,1525
-150,90,130,409,402,811,1525
60,-40,-40,393,418,811,1761
-140,90,120,409,402,811,1525
-30,90,10,409,402,811,1525
80,90,-100,409,402,811,1525
100,90,-120,409,402,811,1525
120,90,-140,409,402,811,1525
70,-40,0,391,420,811,1756
10,90,-30,409,402,811,1525
-50,90,30,409,402,811,1525
-90,90,70,409,402,811,1525
-130,90,110,409,402,811,1525
170,90,170,409,402,811,1525
160,90,-180,409,402,811,1525
160,90,180,409,402,811,1525
-70,90,50,409,402,811,1525
70,90,-90,409,402,811,1525
110,90,-130,409,402,811,1525
-120,90,100,409,402,811,1525
-10,90,-10,409,402,811,1525
-160,90,140,409,402,811,1525
110,-20,20,387,424,811,1713
50,0,-170,389,422,811,1793
-160,80,140,410,401,811,1630
-70,40,-20,393,418,811,1657
130,10,0,403,409,812,1612
60,40,120,405,407,812,1788
-30,-80,130,404,408,812,1594
170,-80,160,399,413,812,1565
50,-30,-70,385,427,812,1710
70,-60,-120,405,407,812,1628
70,-40,-30,405,407,812,1652
160,80,-10,405,408,813,1692
150,30,170,392,421,813,1786
-180,-20,-180,400,413,813,1646
130,-30,-40,403,410,813,1734
80,-30,10,401,412,813,1656
-120,10,70,386,427,813,1629
80,-50,-70,386,427,813,1695
40,-30,-30,385,428,813,1802
-180,-20,180,400,413,813,1646
180,-20,180,400,413,813,1646
-80,-30,120,405,408,813,1839
180,-20,-180,400,413,813,1646
110,20,170,409,404,813,1779
-70,-50,110,392,421,813,1811
90,30,130,405,408,813,1808
-60,10,-130,393,421,814,1742
-130,60,100,382,432,814,1751
-40,0,-170,395,419,814,1791
-140,70,-50,400,414,814,1635
-110,-20,170,388,426,814,1799
120,-10,90,392,423,815,1752
-100,70,-100,398,417,815,1648
20,-60,170,399,416,815,1610
180,40,170,386,429,815,1526
90,-50,-50,399,416,815,1847
130,70,-150,410,405,815,1736
130,20,10,401,414,815,1654
-180,40,170,386,429,815,1526
30,-20,-40,387,428,815,1803
130,20,170,396,419,815,1728
-70,40,-120,388,427,815,1794
-40,10,-170,384,432,816,1695
60,10,180,390,426,816,1752
50,-80,30,390,426,816,1747
-40,-20,-40,401,415,816,1599
-100,-20,100,407,409,816,1655
60,10,-180,390,426,816,1752
50,-30,-100,381,435,816,1844
-60,0,-130,391,425,816,1689
150,10,-20,428,388,816,1777
150,40,180,384,433,817,1792
110,-30,90,414,403,817,1773
-130,50,100,394,423,817,1673
-110,40,10,389,428,817,1723
170,-70,-30,410,407,817,1722
110,-40,-40,403,414,817,1712
30,-60,-10,385,432,817,1745
30,-80,10,385,432,817,1725
150,40,-180,384,433,817,1792
40,-70,10,387,430,817,1812
-170,-70,-10,413,404,817,1640
140,20,-10,411,407,818,1719
50,10,180,398,420,818,1720
-50,0,-40,400,418,818,1642
-60,-20,-80,388,430,818,1588
110,-20,10,398,420,818,1716
90,-30,-10,395,423,818,1674
-30,30,-20,393,425,818,1726
150,-30,150,414,404,818,1741
50,10,-180,398,420,818,1720
120,80,-140,411,407,818,1695
140,-80,-60,408,410,818,1717
-140,0,160,386,432,818,1844
-130,20,120,387,432,819,1812
110,-40,100,422,397,819,1705
70,30,-90,409,410,819,1554
80,20,-140,395,424,819,1662
150,80,-170,424,395,819,1753
20,-10,150,417,402,819,1812
-40,60,-170,406,413,819,1611
170,-30,-30,420,399,819,1663
70,-50,20,391,429,820,1843
80,40,-110,396,424,820,1669
130,-40,120,391,429,820,1756
10,-50,160,402,418,820,1583
180,70,-20,402,418,820,1713
110,50,40,416,404,820,1763
-90,-20,150,401,419,820,1753
110,-20,60,390,430,820,1782
120,-10,0,402,418,820,1715
130,-30,120,400,420,820,1756
50,-20,-80,392,428,820,1802
-180,70,-20,402,418,820,1713
-20,-70,140,405,415,820,1658
130,-90,-70,408,413,821,1630
20,-90,-180,408,413,821,1630
60,-70,30,389,432,821,1788
-110,-90,50,408,413,821,1630
-160,-90,0,408,413,821,1630
60,-40,-90,391,430,821,1785
-70,-90,90,408,413,821,1630
0,-90,160,408,413,821,1630
30,-60,-180,404,417,821,1639
140,-90,-60,408,413,821,1630
90,-90,-110,408,413,821,1630
160,-90,-40,408,413,821,1630
10,-90,170,408,413,821,1630
-180,-90,-20,408,413,821,1630
-80,-90,80,408,413,821,1630
100,-90,-100,408,413,821,1630
30,-90,-170,408,413,821,1630
150,-90,-50,408,413,821,1630
-150,-90,10,408,413,821,1630
110,80,-130,410,411,821,1668
120,-30,110,401,420,821,1756
-10,-90,150,408,413,821,1630
110,-90,-90,408,413,821,1630
-140,-90,20,408,413,821,1630
170,-90,-30,408,413,821,1630
-160,-80,0,401,420,821,1652
-130,-90,30,408,413,821,1630
40,-90,-160,408,413,821,1630
-170,-90,-10,408,413,821,1630
-180,-30,-20,422,399,821,1719
20,-90,180,408,413,821,1630
-50,-90,110,408,413,821,1630
80,-90,-120,408,413,821,1630
180,-90,-20,408,413,821,1630
-100,-90,60,408,413,821,1630
60,-90,-140,408,413,821,1630
-120,0,60,393,428,821,1664
180,-30,-20,422,399,821,1719
-150,-70,10,417,404,821,1719
-60,-90,100,408,413,821,1630
70,-90,-130,408,413,821,1630
120,-90,-80,408,413,821,1630
110,30,60,411,410,821,1754
-120,-90,40,408,413,821,1630
-20,-90,140,408,413,821,1630
-40,-90,120,408,413,821,1630
-10,-10,-10,408,413,821,1567
140,80,-160,427,394,821,1721
-30,-90,130,408,413,821,1630
30,-60,180,404,417,821,1639
50,-90,-150,408,413,821,1630
40,-60,0,386,435,821,1798
-90,-90,70,408,413,821,1630
-60,80,-150,399,423,822,1680
150,-80,140,405,417,822,1690
-110,0,120,398,424,822,1750
160,-80,150,401,421,822,1630
100,80,-120,408,414,822,1688
-110,-10,80,403,419,822,1727
80,50,-100,401,421,822,1615
80,40,-100,405,417,822,1613
100,-80,-100,406,416,822,1707
150,-50,150,406,416,822,1672
120,-20,90,388,434,822,1775
90,30,-150,390,432,822,1675
-100,-60,70,414,408,822,1804
50,10,-60,403,419,822,1630
60,60,-80,389,433,822,1788
-60,-60,110,398,425,823,1762
10,-20,-20,400,423,823,1737
-100,-40,80,383,440,823,1676
60,-40,-110,402,421,823,1806
80,40,110,406,417,823,1803
-120,20,70,379,444,823,1789
50,-10,-70,388,435,823,1847
-30,-30,-30,403,420,823,1643
130,80,-150,424,400,824,1713
-30,50,-10,401,423,824,1649
-150,-80,10,407,417,824,1663
80,20,-170,396,428,824,1747
60,50,-80,398,426,824,1765
-110,-30,-170,403,421,824,1763
90,60,-110,405,419,824,1809
60,-40,-100,401,423,824,1824
70,10,-120,396,429,825,1737
70,50,-90,396,429,825,1726
150,-30,-40,414,411,825,1772
30,30,130,418,407,825,1728
90,-80,-110,398,427,825,1702
-160,10,0,424,401,825,1686
-150,40,-10,392,433,825,1759
90,-30,40,428,397,825,1680
-80,-50,-110,406,420,826,1700
-180,-40,-20,429,397,826,1720
-90,50,-90,411,415,826,1669
180,-40,-20,429,397,826,1720
60,-60,20,387,439,826,1707
-110,40,0,381,445,826,1756
110,-80,-90,408,418,826,1719
130,-10,-20,416,410,826,1749
100,20,80,412,414,826,1717
-100,50,-50,390,436,826,1775
140,0,-20,420,407,827,1723
-130,-30,40,399,428,827,1673
70,60,-90,398,429,827,1830
50,-30,-60,392,435,827,1728
-160,-20,-180,398,429,827,1666
-140,40,-10,379,448,827,1750
-160,-20,180,398,429,827,1666
90,-30,30,410,417,827,1712
-90,-70,-110,413,414,827,1690
170,-50,-30,419,408,827,1674
130,-20,-30,420,407,827,1770
140,-30,130,405,422,827,1785
90,30,-140,400,428,828,1722
60,30,-70,413,415,828,1620
60,-40,-80,395,433,828,1743
70,-50,-100,404,424,828,1710
70,60,80,421,407,828,1673
150,0,150,404,424,828,1833
-110,0,110,416,412,828,1641
40,-40,-20,395,433,828,1840
40,-80,20,387,441,828,1754
-100,-20,170,407,421,828,1804
20,40,130,410,418,828,1832
50,-30,-50,390,438,828,1786
-130,10,40,388,441,829,1626
-140,-10,170,396,433,829,1754
130,-80,-70,417,412,829,1731
90,-40,70,402,427,829,1687
70,40,-80,410,419,829,1563
-160,-60,-170,414,416,830,1707
-80,-50,100,402,428,830,1788
-90,-60,80,414,416,830,1845
110,20,60,406,424,830,1703
120,-40,110,419,411,830,1767
-160,0,170,409,421,830,1856
80,20,180,399,431,830,1732
-70,-30,130,387,443,830,1723
30,40,120,423,407,830,1775
130,-40,-50,416,414,830,1709
80,20,-180,399,431,830,1732
80,-30,30,412,418,830,1739
100,-40,-30,408,422,830,1789
140,60,-160,403,428,831,1781
-80,40,-100,412,419,831,1667
160,-60,-40,423,408,831,1769
-130,30,20,393,438,831,1820
-120,10,80,393,438,831,1742
60,-10,-100,402,429,831,1772
-60,50,0,396,435,831,1644
160,-70,-40,414,417,831,1749
-60,-30,150,407,424,831,1722
40,-20,-50,393,439,832,1914
30,20,140,413,419,832,1794
-110,0,100,403,429,832,1714
10,80,-30,411,421,832,1647
130,-70,-70,407,425,832,1801
0,0,150,411,421,832,1709
140,-70,-60,408,424,832,1770
-120,50,80,405,427,832,1715
-90,-30,100,391,442,833,1616
-180,-20,-20,437,396,833,1812
180,-20,-20,437,396,833,1812
0,-60,-20,393,440,833,1812
100,50,60,410,423,833,1851
-140,50,120,396,437,833,1737
110,-60,100,412,421,833,1664
40,-50,-10,409,424,833,1800
70,20,170,410,423,833,1786
30,-30,-30,389,444,833,1856
-80,30,-60,407,426,833,1725
-40,-80,120,408,426,834,1620
80,60,-100,396,438,834,1805
-140,-70,20,416,418,834,1775
-90,-30,-160,387,447,834,1673
160,0,160,405,429,834,1793
70,-70,-130,416,418,834,1739
-90,50,20,401,433,834,1639
-70,20,-50,402,432,834,1617
140,40,-170,400,434,834,1814
-20,-60,-30,410,424,834,1771
90,-60,-90,403,431,834,1791
-120,10,60,388,446,834,1579
120,-80,-80,414,420,834,1729
-30,20,-180,413,421,834,1634
-110,-20,70,414,420,834,1745
-30,20,180,413,421,834,1634
100,10,110,411,424,835,1771
30,-50,-20,392,443,835,1892
100,60,-120,410,425,835,1823
50,-40,-140,411,424,835,1797
130,50,10,415,421,836,1694
0,-70,-20,403,433,836,1793
100,10,120,414,422,836,1830
90,20,120,412,424,836,1841
100,-30,70,414,422,836,1707
50,-10,-150,392,444,836,1760
-120,20,80,375,461,836,1627
140,20,170,404,432,836,1797
50,-20,-50,395,442,837,1923
130,40,-160,397,440,837,1723
90,20,130,418,419,837,1772
-120,-30,-170,405,432,837,1827
80,-60,50,401,436,837,1793
10,70,-30,393,444,837,1617
120,0,120,411,426,837,1976
-10,-40,150,418,419,837,1666
-50,20,-30,412,425,837,1711
-160,30,160,403,434,837,1668
-150,80,130,418,419,837,1681
160,-60,160,423,414,837,1832
60,60,90,429,408,837,1665
140,-80,130,407,430,837,1768
180,-80,170,399,438,837,1556
-180,-80,170,399,438,837,1556
50,-20,-70,393,444,837,1902
150,-70,-50,423,415,838,1761
100,30,-160,401,437,838,1815
70,10,-170,407,431,838,1780
-170,-60,-10,431,407,838,1673
-80,-20,-180,395,443,838,1652
80,-50,50,410,428,838,1783
-80,-20,180,395,443,838,1652
-90,-20,160,404,435,839,1845
120,50,-140,394,445,839,1698
180,-60,-20,423,416,839,1636
-40,-60,-50,405,434,839,1652
-180,-60,-20,423,416,839,1636
140,-10,130,399,440,839,1912
-60,-30,-80,392,447,839,1669
-140,-20,30,388,451,839,1793
-110,70,80,391,448,839,1695
30,30,-40,391,449,840,1727
-140,-80,20,414,426,840,1669
40,50,110,428,412,840,1773
40,-10,-50,395,445,840,1851
-120,50,-30,400,440,840,1882
50,-20,-60,397,443,840,1950
100,10,100,424,416,840,1809
-50,-80,110,403,437,840,1658
130,0,-10,413,428,841,1765
-170,0,-10,425,416,841,1764
80,20,-120,421,420,841,1676
170,-40,-30,431,411,842,1659
-70,10,-90,398,444,842,1741
140,-40,-50,413,429,842,1779
110,-20,0,412,430,842,1714
50,0,-60,415,427,842,1816
110,-20,70,402,440,842,1820
0,80,-20,422,421,843,1690
60,-40,-10,406,437,843,1798
40,0,170,416,427,843,1713
110,30,-170,405,438,843,1857
-20,-30,-20,420,423,843,1627
-60,-50,-80,398,445,843,1686
60,30,140,411,432,843,1940
40,10,-40,415,428,843,1723
40,30,130,413,430,843,1737
130,0,130,405,438,843,1813
20,-50,-20,396,447,843,1944
-70,-40,-100,401,442,843,1658
110,40,50,407,437,844,1742
100,20,170,409,435,844,1920
10,-30,-20,409,435,844,1818
-130,-20,40,403,441,844,1702
80,20,-150,407,437,844,1799
-130,20,30,401,443,844,1772
-80,60,-120,424,420,844,1639
20,10,-30,398,447,845,1833
90,-40,-30,415,430,845,1857
140,0,140,405,440,845,1803
20,20,-30,399,446,845,1863
-90,40,-60,411,434,845,1748
70,-40,-40,413,432,845,1780
-130,-40,40,409,436,845,1837
-20,-60,140,437,408,845,1693
-60,-80,100,407,439,846,1678
120,-60,-70,414,432,846,1752
90,50,-110,409,437,846,1797
80,-70,-120,427,419,846,1821
-150,-40,-170,411,435,846,1870
-70,80,-140,412,434,846,1721
0,-40,-20,406,440,846,1880
-150,50,-20,406,441,847,1694
-150,70,130,419,428,847,1648
90,20,160,416,431,847,1902
-80,-20,170,412,435,847,1656
90,30,120,418,429,847,1923
130,30,-170,412,435,847,1782
-180,-50,-20,424,424,848,1779
130,50,-150,397,451,848,1736
180,-50,-20,424,424,848,1779
100,10,130,416,432,848,1860
-170,20,170,418,430,848,1704
30,-10,160,430,418,848,1814
90,40,100,422,426,848,1904
-10,-20,-10,410,438,848,1620
30,10,-30,411,437,848,1703
50,-20,-150,407,441,848,1806
-120,-50,50,406,442,848,1750
150,10,160,407,441,848,1786
80,20,170,410,439,849,1805
0,20,-20,423,426,849,1701
60,-10,-120,409,440,849,1750
110,-20,80,416,433,849,1823
100,-50,-50,404,445,849,1849
80,20,-160,416,433,849,1771
100,10,140,424,425,849,1872
10,-60,160,422,427,849,1670
-70,-80,90,414,435,849,1670
120,40,-150,415,434,849,1780
90,-70,70,400,449,849,1793
-60,30,-30,420,429,849,1885
140,30,-180,416,433,849,1858
-60,-10,-70,407,442,849,1649
140,30,180,416,433,849,1858
80,30,140,413,436,849,1828
100,40,70,416,433,849,1880
0,-20,-10,404,445,849,1791
40,-30,180,429,420,849,1698
-140,80,120,429,420,849,1720
90,-60,70,414,435,849,1775
-120,-40,-160,406,443,849,1904
40,-30,-180,429,420,849,1698
-60,-20,-180,398,452,850,1885
20,-10,-30,413,437,850,1818
-170,10,-10,425,425,850,1740
60,0,-90,400,450,850,1835
-60,-20,180,398,452,850,1885
-120,-80,40,418,432,850,1700
20,-60,-10,406,444,850,1890
50,-50,0,407,443,850,1816
40,-20,-40,403,448,851,1969
-80,30,-90,410,441,851,1724
170,80,-20,421,430,851,1763
50,-30,-30,406,445,851,1935
70,50,90,429,422,851,1761
60,-50,10,416,435,851,1776
160,50,-10,426,425,851,1803
110,-50,100,430,421,851,1678
-130,-80,30,420,431,851,1697
90,-30,50,435,417,852,1749
100,40,-130,416,436,852,1738
110,20,50,425,427,852,1788
90,20,140,421,431,852,1885
70,10,-110,425,427,852,1804
170,-60,170,419,434,853,1792
-110,50,-40,401,452,853,1749
-120,-10,60,383,470,853,1735
40,20,-40,418,435,853,1722
-120,10,120,415,438,853,1883
-110,-10,150,414,439,853,1935
110,-20,-10,422,431,853,1822
30,70,110,434,419,853,1812
110,-70,-90,422,431,853,1870
160,-10,160,417,436,853,1879
140,-40,140,420,433,853,1855
50,-60,10,402,452,854,1808
140,-20,130,423,431,854,1894
-30,30,180,408,446,854,1698
-150,10,10,426,428,854,1850
120,-70,-80,419,435,854,1817
110,10,60,427,427,854,1865
50,-50,-150,435,419,854,1808
-30,30,-180,408,446,854,1698
-130,40,-10,399,455,854,1788
110,0,80,419,435,854,1850
-120,-10,160,425,430,855,1976
10,20,140,433,422,855,1778
130,-10,120,409,446,855,1961
70,10,180,413,442,855,1828
100,-50,90,434,421,855,1758
70,10,-180,413,442,855,1828
30,-40,-20,406,449,855,1892
-90,-80,70,426,429,855,1680
-110,-80,50,424,432,856,1708
100,20,70,424,432,856,1856
-90,-40,90,406,450,856,1700
-80,40,-20,403,453,856,1819
180,-40,180,437,420,857,1812
180,-40,-180,437,420,857,1812
130,-20,110,417,440,857,1844
-100,-20,-180,409,448,857,1833
-120,40,70,397,460,857,1816
-180,-40,-180,437,420,857,1812
120,-10,100,410,447,857,1911
-100,-80,60,428,429,857,1701
-100,-20,180,409,448,857,1833
10,30,140,428,429,857,1724
-180,-40,180,437,420,857,1812
-170,-80,-180,407,451,858,1570
90,-30,-20,431,427,858,1763
-130,-60,-150,413,445,858,1744
10,-50,-20,399,459,858,1905
-170,-80,180,407,451,858,1570
-40,-50,-50,411,447,858,1695
70,20,-90,418,440,858,1756
-50,60,-160,433,426,859,1696
120,20,30,421,438,859,1930
60,0,-140,414,445,859,1821
-130,0,40,398,461,859,1711
-150,30,0,417,442,859,1821
0,60,-20,410,449,859,1636
-110,0,90,419,440,859,1846
-170,20,-10,439,420,859,1825
-160,0,0,420,440,860,1676
-40,-10,-180,400,460,860,1797
-40,-10,180,400,460,860,1797
70,40,110,414,446,860,1880
60,40,-70,432,428,860,1638
40,40,-50,414,446,860,1759
-90,40,-70,428,433,861,1810
50,-30,-160,417,444,861,1854
120,-70,110,417,444,861,1776
40,-60,10,404,457,861,1907
-140,-10,30,410,451,861,1850
-160,-80,-170,413,448,861,1645
80,50,80,433,428,861,1930
-120,0,150,427,434,861,1833
60,-40,-120,417,444,861,1859
60,-10,-90,402,459,861,1893
-80,-60,90,423,438,861,1837
20,10,140,436,425,861,1772
-130,-70,30,429,432,861,1834
-70,-20,170,413,449,862,1778
0,-10,-10,414,448,862,1757
-90,-20,170,416,446,862,1900
110,50,-130,415,447,862,1844
50,40,-60,416,446,862,1775
120,30,30,425,437,862,1842
-150,30,150,403,460,863,1784
180,-10,180,433,430,863,1799
-180,-10,-180,433,430,863,1799
-80,-80,80,428,435,863,1698
-180,-10,180,433,430,863,1799
-100,-20,90,419,444,863,1845
150,20,170,427,436,863,1862
70,-30,-30,423,440,863,1878
60,-60,-140,446,417,863,1713
180,-10,-180,433,430,863,1799
180,-50,-180,420,444,864,1784
100,30,-150,415,449,864,1846
-180,-50,180,420,444,864,1784
-110,-20,-180,422,442,864,1802
60,-30,-40,413,451,864,1936
-180,-50,-180,420,444,864,1784
0,-50,-20,415,449,864,1878
70,-40,-50,420,444,864,1864
180,-50,180,420,444,864,1784
-110,-20,180,422,442,864,1802
160,-50,-40,441,424,865,1807
-100,-10,130,419,446,865,1865
100,-40,90,440,425,865,1783
140,50,0,435,430,865,1716
20,60,120,438,427,865,1851
160,50,-180,418,447,865,1908
160,50,180,418,447,865,1908
130,40,10,436,429,865,1877
80,-60,-110,423,442,865,1809
110,0,90,427,438,865,1878
90,-70,-110,433,432,865,1877
120,0,20,424,441,865,1894
60,-20,-100,414,451,865,1868
140,10,160,433,433,866,1837
100,10,150,428,438,866,1902
-170,-20,-10,436,430,866,1939
-80,-40,-120,415,451,866,1857
130,10,160,429,437,866,1856
90,50,70,426,441,867,1973
-60,40,-140,414,453,867,1849
110,0,110,432,435,867,1913
-30,-70,130,416,451,867,1744
50,-40,-10,423,445,868,1848
-80,-20,140,406,462,868,1789
30,-20,-30,410,458,868,1961
-130,80,110,427,441,868,1725
80,40,-90,435,433,868,1687
-60,70,-150,437,432,869,1784
100,30,70,426,443,869,1795
-170,50,160,427,442,869,1760
10,-10,-20,413,456,869,1843
-160,50,-20,433,436,869,1725
130,-80,120,430,439,869,1850
150,70,0,437,432,869,1816
-110,60,-70,428,441,869,1736
10,10,-20,423,447,870,1763
20,70,120,431,439,870,1842
-150,60,-30,412,458,870,1843
-50,-10,-170,404,466,870,1921
170,10,-20,443,427,870,1789
100,-70,-100,424,446,870,1884
-170,-30,-10,449,421,870,1845
150,-60,150,437,433,870,1770
50,-20,-40,414,456,870,1969
10,-70,-10,414,456,870,1885
-110,0,130,437,433,870,1813
80,-40,60,423,448,871,1817
90,40,-110,442,429,871,1750
60,-30,-50,427,444,871,1931
110,10,150,438,433,871,1842
0,-10,150,428,443,871,1733
90,20,150,424,447,871,1939
-100,60,60,419,452,871,1759
-70,-60,100,421,450,871,1831
60,10,-80,422,449,871,1748
50,10,170,419,453,872,1845
100,-60,90,436,436,872,1821
-90,-20,120,428,444,872,1866
80,20,160,433,439,872,1916
50,-10,-160,412,460,872,1861
-160,-60,0,454,418,872,1795
-110,40,-10,402,471,873,1880
-130,10,140,426,447,873,1913
90,-50,-60,422,451,873,1836
-100,-10,140,420,453,873,1940
110,0,100,425,448,873,1934
-40,0,-30,425,448,873,1679
-140,10,150,427,446,873,1941
120,50,20,441,433,874,1823
10,-20,150,436,438,874,1846
40,0,-40,429,445,874,1853
10,-40,-20,408,466,874,1980
70,30,140,416,458,874,1936
150,-10,-30,450,424,874,1864
-120,-70,40,441,433,874,1863
80,-50,-80,423,451,874,1868
0,-30,-10,420,454,874,1830
-100,60,-90,419,456,875,1723
70,-40,-60,424,451,875,1846
110,0,70,423,452,875,1839
-90,-20,180,416,459,875,1767
50,-30,-20,429,446,875,1979
50,-40,-150,429,446,875,1785
-90,-20,-180,416,459,875,1767
120,-30,120,437,438,875,1933
-80,80,-130,427,448,875,1777
-110,50,60,418,457,875,1691
60,-30,-30,424,451,875,1953
110,-30,-30,438,437,875,1834
80,-40,-40,435,440,875,1851
-70,10,-60,413,463,876,1734
130,-40,130,439,437,876,1915
20,-30,-20,421,455,876,1890
30,-60,0,416,461,877,1915
60,20,-70,428,449,877,1777
60,-20,-110,404,473,877,1865
-180,-10,-20,446,431,877,1857
100,10,90,438,439,877,1851
180,-10,-20,446,431,877,1857
40,-10,-40,407,470,877,1908
30,60,110,442,435,877,1809
-180,80,-30,433,445,878,1809
90,40,90,431,447,878,2052
180,80,-30,433,445,878,1809
-150,-20,-180,434,444,878,1809
-150,-20,180,434,444,878,1809
30,80,110,446,432,878,1821
40,70,100,445,433,878,1842
80,-70,60,421,457,878,1896
150,-60,-50,436,442,878,1891
30,-70,-180,435,444,879,1853
30,-70,180,435,444,879,1853
-120,40,-10,403,476,879,1878
-100,50,-60,429,450,879,1798
120,-20,100,424,456,880,1866
120,-40,-50,440,440,880,1747
70,-40,10,413,467,880,1910
-50,-40,130,413,467,880,1892
-10,-50,-20,437,443,880,1825
110,60,30,437,443,880,1742
20,-40,-20,412,468,880,1967
150,-20,150,438,443,881,1975
140,-50,140,430,451,881,1840
40,80,100,446,435,881,1831
70,-60,40,419,462,881,1905
50,-10,-60,412,469,881,2007
110,30,-160,415,466,881,1966
80,30,-110,430,451,881,1761
60,0,-80,430,452,882,1967
0,70,-20,425,457,882,1772
170,-20,-30,460,422,882,1781
10,70,130,448,434,882,1895
50,70,90,442,440,882,1852
-130,-30,-170,421,461,882,1939
100,-40,-40,429,454,883,1939
-80,-30,-140,420,463,883,1870
-70,10,-100,413,470,883,1812
-130,-20,-180,433,451,884,2038
10,0,-20,419,465,884,1949
50,80,90,451,433,884,1828
-130,-20,180,433,451,884,2038
-170,70,-30,432,452,884,1825
40,-40,-10,432,452,884,1869
70,30,-80,440,444,884,1690
70,-50,-110,435,449,884,1885
110,-10,60,415,470,885,1989
90,30,-130,434,451,885,1834
50,20,-50,418,467,885,1782
50,20,150,429,456,885,1936
50,30,130,433,452,885,1960
30,-50,-10,422,463,885,1970
60,20,160,428,457,885,1884
20,-70,170,443,442,885,1821
130,-20,120,429,456,885,1937
-150,-80,-160,425,460,885,1730
130,30,10,438,447,885,1793
80,-30,0,433,452,885,1821
-80,20,-70,415,470,885,1750
80,10,-160,429,456,885,1899
-60,-30,140,430,455,885,1891
60,10,170,416,469,885,1899
140,50,-160,422,463,885,1842
20,80,120,448,438,886,1861
140,-60,140,445,441,886,1761
30,0,-30,436,450,886,1883
-40,40,-170,438,448,886,1864
150,40,-10,442,444,886,1860
90,20,180,431,455,886,1894
-100,-10,110,438,448,886,1812
-60,-20,-70,416,470,886,1739
120,-20,110,438,448,886,1964
100,10,80,435,451,886,1904
90,20,-180,431,455,886,1894
110,-40,110,457,429,886,1835
80,10,-150,423,463,886,1931
120,0,130,448,439,887,1892
120,60,20,439,448,887,1726
150,-50,-50,437,450,887,1885
90,10,120,433,454,887,1874
-170,-50,-10,442,445,887,1929
140,-30,140,433,454,887,1903
-150,-70,-160,437,451,888,1725
80,-50,60,432,456,888,1868
60,40,110,442,446,888,1933
80,-30,40,439,449,888,1900
30,-10,-30,426,462,888,1892
60,0,-160,427,461,888,1959
-10,80,-10,433,456,889,1740
80,-30,-10,440,449,889,1903
90,20,170,435,454,889,1944
40,-70,-170,447,442,889,1907
20,-70,0,428,461,889,1943
110,-70,100,431,458,889,1874
100,50,-120,434,455,889,1907
100,20,180,430,459,889,1962
100,20,-180,430,459,889,1962
30,40,-40,426,463,889,1863
70,0,-170,420,470,890,1909
-160,50,150,438,452,890,1823
30,10,140,443,447,890,1877
-60,-40,120,433,457,890,1956
120,-40,120,457,433,890,1871
40,-60,-170,452,438,890,1821
-170,-10,-10,437,453,890,1987
40,-30,-20,421,469,890,1863
-100,40,-10,423,467,890,1878
60,-20,-90,432,458,890,1962
70,-50,30,436,455,891,2026
70,20,160,445,446,891,2066
-120,80,100,431,460,891,1750
60,0,-150,429,462,891,1979
30,-70,10,432,459,891,1923
110,40,-140,437,454,891,1807
80,50,-90,436,455,891,1837
60,70,80,460,431,891,1813
110,-60,-80,445,446,891,1852
90,20,110,434,457,891,1912
-100,70,70,418,474,892,1818
60,-20,-120,427,465,892,1824
100,-20,40,441,451,892,1901
160,40,180,438,454,892,1926
20,0,-30,418,474,892,1883
10,80,130,450,442,892,1898
-170,50,-20,442,450,892,1881
160,-10,-30,457,435,892,1868
130,-30,130,441,451,892,1946
160,40,-180,438,454,892,1926
-120,-30,50,433,459,892,1900
60,-20,-50,424,468,892,2022
-70,-30,-110,425,467,892,1901
60,-30,-70,427,466,893,1923
110,20,180,440,453,893,1914
-110,0,140,448,445,893,1853
110,20,-180,440,453,893,1914
60,-20,-70,417,477,894,1979
110,0,120,453,441,894,1884
-40,-50,130,427,467,894,1915
-140,-20,-180,441,453,894,1990
140,-10,-30,448,446,894,1942
70,50,-80,436,458,894,1806
30,20,-30,427,467,894,1853
-140,-20,180,441,453,894,1990
60,-20,-60,427,467,894,1988
140,-60,-60,448,447,895,1894
110,-30,100,439,456,895,1979
90,10,110,437,458,895,1924
40,20,140,442,453,895,1954
70,-40,-70,433,463,896,1811
-80,-20,150,420,476,896,1823
60,-50,-130,434,462,896,1898
150,50,-170,428,468,896,1911
-120,-20,180,430,466,896,1953
-110,40,20,428,468,896,1873
90,-30,-30,440,456,896,1836
-120,-20,-180,430,466,896,1953
-30,20,-20,434,463,897,1889
-110,70,-90,437,460,897,1861
-150,10,160,448,449,897,2113
160,20,-20,447,450,897,1847
-140,-30,-170,439,458,897,2077
120,-50,120,447,450,897,1890
-90,80,-120,439,458,897,1794
80,30,-100,440,457,897,1796
160,60,-10,449,448,897,1985
90,20,100,432,466,898,1959
-100,40,0,422,476,898,1876
0,-20,150,444,454,898,1838
60,-10,-130,423,475,898,1949
-120,-50,-150,435,463,898,1957
-70,20,-110,423,475,898,1843
120,-10,110,429,470,899,2014
40,-50,-170,459,440,899,1822
80,20,-110,431,468,899,1777
60,-20,-80,428,471,899,1994
-70,-20,-160,415,484,899,2014
-70,-20,-170,412,487,899,1922
60,-30,-120,435,464,899,1842
100,-50,-60,437,462,899,1940
120,-10,-10,453,446,899,1896
40,10,150,434,466,900,1997
-120,-20,50,425,475,900,1930
80,-30,-20,451,449,900,1893
-30,-10,170,418,482,900,1905
70,-30,-20,450,450,900,1889
100,-30,-30,441,459,900,1835
-100,-10,120,451,449,900,1835
110,-20,90,437,463,900,1898
60,-30,-100,432,469,901,2074
160,-40,-40,458,443,901,1821
-130,40,110,420,481,901,1926
-100,-40,-150,421,480,901,1915
90,30,110,437,464,901,2065
-50,-50,120,435,466,901,1892
150,30,180,436,466,902,2013
60,-30,-60,440,462,902,1965
30,-20,160,458,444,902,1881
-120,20,90,417,485,902,1887
50,-60,20,429,473,902,1953
60,-30,-110,431,471,902,1921
150,30,-180,436,466,902,2013
60,30,130,439,463,902,2102
180,50,170,444,459,903,1873
-50,-20,170,423,480,903,1915
120,10,20,443,460,903,1911
-180,50,170,444,459,903,1873
-130,-10,170,454,449,903,2066
40,-70,20,434,469,903,1925
50,-70,-160,457,446,903,1913
-80,-60,-100,443,461,904,1905
90,10,130,451,453,904,1934
50,0,180,430,474,904,2015
0,70,140,463,441,904,1949
120,-80,110,440,464,904,1906
70,-40,30,445,459,904,2052
50,0,-180,430,474,904,2015
-170,80,-40,456,449,905,1886
-180,0,-180,467,438,905,1977
-180,0,180,467,438,905,1977
180,0,180,467,438,905,1977
60,-40,0,439,466,905,1920
180,0,-180,467,438,905,1977
-70,-20,-180,434,471,905,1934
-70,-20,180,434,471,905,1934
80,40,100,447,458,905,2015
90,-40,-40,436,470,906,2056
-170,-40,-10,462,444,906,1935
130,-50,130,439,467,906,1883
150,-10,150,438,468,906,2135
-140,-80,-150,440,466,906,1795
70,70,70,462,444,906,1812
50,50,100,461,445,906,1911
-40,20,-170,441,465,906,1929
-40,70,10,444,462,906,1969
100,-30,80,446,460,906,1948
130,-60,130,451,456,907,1810
80,30,130,431,476,907,1969
-130,-10,40,429,478,907,1853
60,80,80,465,442,907,1824
90,10,100,450,457,907,1958
60,-30,-80,433,474,907,2025
80,70,60,453,454,907,1813
30,0,150,449,459,908,1954
110,10,160,451,457,908,1958
160,10,170,449,459,908,1906
110,-10,80,440,468,908,1960
120,20,-180,445,463,908,1916
-110,-10,70,443,465,908,1955
70,-70,50,428,480,908,1971
-110,-70,50,446,462,908,1989
-110,-50,60,443,465,908,1853
120,20,180,445,463,908,1916
-50,0,-160,438,470,908,1866
100,20,60,464,445,909,1902
130,20,0,448,461,909,1883
0,-30,150,443,466,909,1729
-120,30,80,424,485,909,1945
50,-10,-50,438,471,909,2087
10,-70,160,450,459,909,1848
-110,80,90,441,468,909,1772
-70,-20,-150,415,494,909,2007
-20,80,0,442,467,909,1807
20,-20,150,453,456,909,1866
30,-40,170,448,461,909,1948
60,-20,-130,429,481,910,1940
60,-20,-40,448,462,910,2018
0,80,140,462,448,910,1930
110,30,50,452,458,910,1982
150,20,-20,469,441,910,2002
-40,-70,120,431,479,910,1873
110,-10,50,434,476,910,2022
-100,-50,70,436,474,910,1851
-60,-10,-150,424,486,910,1991
-60,-20,170,437,473,910,1993
-80,-20,130,448,463,911,1901
180,-60,-180,436,475,911,1857
180,-60,180,436,475,911,1857
-180,-60,180,436,475,911,1857
90,-30,-40,450,461,911,1886
120,-50,-60,452,459,911,1857
160,-30,-40,475,436,911,1904
-180,-60,-180,436,475,911,1857
110,-10,70,436,475,911,1959
80,-50,-90,448,463,911,1926
60,-10,-80,424,487,911,2015
70,-30,10,444,468,912,1914
0,30,-20,444,468,912,1833
130,60,10,451,461,912,1781
120,10,160,453,459,912,1909
20,-20,-20,440,472,912,1908
140,10,-20,456,456,912,1918
130,0,140,446,466,912,2084
70,-60,-130,460,452,912,1887
70,10,-100,444,468,912,1905
80,-30,-30,449,463,912,1934
0,50,-20,439,473,912,1769
-160,-40,-170,450,462,912,2077
40,-20,-30,432,480,912,1974
60,-30,-130,446,466,912,1852
50,-70,30,439,473,912,1955
-170,30,170,446,466,912,1824
-90,40,-30,445,468,913,1917
90,-50,-70,438,475,913,1848
40,10,-30,443,470,913,1864
70,-30,-40,445,468,913,1962
100,-20,20,450,463,913,1951
100,-20,30,443,470,913,1851
-50,-60,-60,433,481,914,1844
100,30,-140,444,470,914,1976
120,-30,-40,450,464,914,1895
-50,50,-160,455,459,914,1797
-70,50,-130,454,460,914,1738
80,-30,-40,450,464,914,1976
50,-20,-160,439,475,914,1976
-80,-20,-170,438,476,914,1912
70,-40,20,429,485,914,2022
50,10,-50,437,477,914,1943
-80,-20,160,446,468,914,1906
100,10,160,458,457,915,1969
100,-20,50,436,479,915,1971
60,-60,30,438,477,915,1922
80,-40,-50,442,473,915,1986
20,30,130,461,454,915,2017
90,-50,80,463,452,915,1897
140,-20,140,461,454,915,2062
90,20,90,451,464,915,1901
-60,-40,-80,426,489,915,1956
-120,30,70,425,491,916,1927
0,-50,150,452,464,916,1808
70,-40,-80,441,475,916,1876
60,-30,-90,439,477,916,2040
10,-30,150,460,456,916,2038
70,80,70,458,458,916,1828
-90,-20,110,447,469,916,1942
70,-20,-90,440,477,917,2106
-30,-20,160,435,482,917,1963
-170,-10,180,449,468,917,1947
-170,-10,-180,449,468,917,1947
50,-50,10,442,475,917,1977
0,-40,-10,442,475,917,2053
90,70,50,456,462,918,1845
-120,30,40,443,475,918,2002
80,20,140,449,469,918,2101
140,-20,-40,463,455,918,1979
130,-60,-70,449,469,918,1914
-140,70,120,443,475,918,1878
-70,-50,-90,435,483,918,1915
-180,0,-20,462,456,918,1932
180,0,-20,462,456,918,1932
-140,60,120,432,486,918,2015
-40,30,-20,452,466,918,2017
-120,-60,-140,440,478,918,1937
-100,-10,100,462,457,919,1945
-40,-40,140,451,468,919,2064
110,-50,-60,449,470,919,1884
-100,50,-70,452,467,919,1850
60,-30,-140,437,482,919,1885
70,30,130,436,483,919,2028
110,-40,-50,450,469,919,1928
130,-20,130,461,458,919,2073
110,-50,110,466,453,919,1923
40,-50,0,437,483,920,1954
60,-70,40,440,480,920,1991
-120,60,90,442,478,920,1871
-110,-10,160,450,470,920,2074
70,10,170,442,478,920,1980
40,-10,170,454,466,920,2005
-120,30,60,426,494,920,1965
-150,-60,10,470,450,920,1875
170,-20,180,463,458,921,1937
120,30,-160,442,479,921,1831
40,50,-50,449,472,921,1900
-130,0,160,442,479,921,1968
40,30,-40,449,472,921,1932
50,0,-50,445,476,921,1947
30,30,120,460,461,921,2004
70,-40,40,448,473,921,2051
-40,-30,-40,464,457,921,1843
60,0,-170,427,494,921,1954
170,-20,-180,463,458,921,1937
80,10,-170,451,471,922,1918
-70,30,-120,446,476,922,1784
30,-30,-20,435,487,922,2009
80,20,150,449,473,922,2035
80,30,120,444,478,922,2085
80,10,-140,429,493,922,1947
-10,-30,150,451,471,922,1819
90,20,80,449,473,922,1979
-80,-40,100,454,468,922,2038
-120,20,60,440,482,922,2008
180,60,-20,468,455,923,1929
-50,-30,150,441,482,923,2033
-180,60,-20,468,455,923,1929
100,10,70,460,463,923,1952
-160,-10,0,451,472,923,2024
110,0,60,444,479,923,2030
70,0,-160,430,494,924,1960
100,20,-170,434,490,924,2033
90,20,-170,437,487,924,1989
150,-20,-40,463,461,924,1947
-140,-50,-160,439,486,925,1971
-100,-30,80,457,468,925,2045
-120,10,130,444,481,925,2035
40,60,100,478,447,925,1891
100,70,40,462,464,926,1879
110,-20,-20,463,463,926,1909
-70,10,-110,446,480,926,1948
-90,40,-20,441,485,926,2005
-100,50,40,449,477,926,1854
50,30,-50,447,479,926,1877
60,-10,-70,441,486,927,2065
30,-40,-10,444,483,927,2015
70,-30,20,451,476,927,2002
-160,30,-10,460,467,927,1993
50,-10,-170,446,481,927,1978
100,-20,60,456,471,927,2030
-140,40,130,435,492,927,1943
50,-40,-160,439,488,927,1888
30,-50,0,441,486,927,1999
-160,80,-50,458,469,927,1938
70,0,-150,439,488,927,1978
-120,30,50,441,487,928,2036
110,10,50,462,466,928,2053
-130,20,130,444,484,928,2035
50,40,110,468,460,928,2005
20,30,-30,446,482,928,2001
60,-30,-20,453,475,928,1969
-70,-20,-130,440,489,929,1990
-80,-30,110,470,459,929,1961
-90,40,-10,431,498,929,1942
-50,-70,110,438,491,929,1865
50,-20,-30,438,491,929,2062
-170,-30,-170,449,480,929,2034
60,-70,-150,467,462,929,2003
100,10,60,471,458,929,2060
100,-70,90,445,484,929,2020
90,10,90,468,462,930,2050
90,-30,60,462,468,930,1965
160,30,-180,451,479,930,1978
100,-20,70,447,483,930,2037
160,30,180,451,479,930,1978
10,-30,-10,445,485,930,1896
20,-40,160,455,476,931,1947
-70,70,-140,463,468,931,1912
-100,80,-110,462,469,931,1885
20,-50,-10,428,503,931,2115
-110,0,80,442,489,931,1853
90,30,100,458,473,931,2090
70,-40,-90,459,473,932,1985
-140,30,0,459,473,932,2055
130,20,-180,453,479,932,1991
60,-50,20,452,480,932,2023
130,20,180,453,479,932,1991
70,0,-140,451,481,932,1972
-120,60,-60,461,471,932,1856
-20,-30,150,448,484,932,1902
110,-10,40,442,491,933,2057
-90,40,-50,460,473,933,1970
160,70,-10,459,474,933,2007
110,-80,100,451,482,933,1967
40,-20,170,468,465,933,1981
110,70,30,462,471,933,1897
-160,-10,-180,456,477,933,1975
-160,-10,180,456,477,933,1975
-50,-40,-60,429,505,934,1839
90,20,-150,464,470,934,2038
110,40,40,456,478,934,2089
-80,30,-50,463,471,934,1871
-160,-50,0,463,471,934,2001
0,-60,150,462,472,934,1934
10,-60,-10,434,500,934,2062
-60,0,-140,444,490,934,1927
10,60,130,474,460,934,1965
-10,70,150,478,457,935,2016
120,-60,120,462,473,935,1878
70,0,-130,451,484,935,2016
-50,10,-160,453,482,935,1925
120,0,140,461,474,935,1957
-10,80,150,467,469,936,1977
60,-40,-130,455,481,936,2008
70,-20,-100,450,486,936,2110
-60,10,-40,448,488,936,1844
-110,40,30,451,485,936,1962
-150,0,170,445,492,937,2085
140,0,150,449,488,937,2030
100,50,50,465,472,937,2037
-90,-30,-150,463,474,937,2096
-90,60,-110,459,478,937,1903
-100,-10,150,457,480,937,2095
90,-60,80,461,476,937,2036
30,50,110,471,467,938,1952
0,-70,150,468,470,938,1899
100,60,40,463,475,938,1886
140,-30,-50,470,469,939,2010
-120,40,80,433,506,939,2035
60,-20,-140,440,499,939,2017
20,50,120,471,468,939,1992
70,-30,30,460,479,939,1989
80,10,-130,452,487,939,2006
40,30,120,471,468,939,1994
70,30,120,443,496,939,2139
-70,-20,160,473,467,940,1994
-60,60,-150,476,464,940,1854
50,-60,-160,471,469,940,1988
-20,-50,140,464,476,940,1968
100,-20,10,472,468,940,2100
-10,-60,-20,459,481,940,1914
50,-30,-10,456,484,940,2114
50,10,160,441,499,940,2051
-40,30,-170,464,477,941,1849
-80,40,-110,464,477,941,1978
50,-40,0,462,479,941,2014
-50,-20,-50,463,478,941,1866
80,-60,60,444,498,942,2049
-130,-80,-140,457,485,942,1874
70,-30,0,461,481,942,2064
-90,40,-40,468,474,942,2025
90,-80,80,455,487,942,1999
90,-40,80,461,481,942,1932
-70,-30,120,462,481,943,2098
160,-30,170,462,481,943,1940
-80,20,-80,454,489,943,1748
50,-80,-160,471,472,943,2047
-70,-20,-140,450,493,943,2104
70,-50,40,456,487,943,2105
-110,10,90,448,495,943,1932
70,0,180,454,489,943,2045
70,0,-180,454,489,943,2045
100,-80,90,453,490,943,1986
90,50,-100,468,475,943,2074
120,-20,-30,471,473,944,2015
-120,0,50,446,498,944,1907
-60,30,-140,451,493,944,1897
60,-80,-150,471,473,944,2068
-130,50,-30,435,509,944,2022
130,-30,140,480,464,944,2034
100,-60,-90,479,465,944,2012
90,40,80,454,490,944,2102
60,10,-70,455,489,944,1984
70,-40,-100,458,486,944,2036
-160,60,-30,471,473,944,1997
120,-20,120,466,479,945,2125
90,10,140,483,462,945,2026
70,20,-80,451,494,945,1939
-130,30,120,452,493,945,2073
40,-80,-170,468,477,945,2021
-150,0,10,462,483,945,1964
10,10,140,466,479,945,2039
70,-50,-120,464,481,945,2090
-120,-40,50,451,495,946,2173
90,10,150,467,479,946,2111
30,-20,-20,444,502,946,2066
-90,70,60,460,486,946,1950
-140,-60,20,473,473,946,2014
-60,-70,100,458,488,946,1938
90,-50,-80,454,493,947,1960
-100,-10,160,466,481,947,2106
40,0,160,460,487,947,2083
150,-40,-50,462,486,948,2022
130,-10,130,458,490,948,2152
170,-30,180,455,493,948,1953
100,40,60,451,497,948,2135
-90,-20,-170,455,493,948,2133
140,30,-170,454,494,948,2103
130,-40,140,480,468,948,2057
80,10,-180,468,480,948,2023
170,-30,-180,455,493,948,1953
80,10,180,468,480,948,2023
90,30,90,453,495,948,2133
60,-40,10,475,474,949,2017
130,40,-150,455,494,949,2049
170,20,-180,453,496,949,1991
70,-30,-50,457,492,949,2061
-180,10,-180,480,469,949,2071
180,10,-180,480,469,949,2071
180,10,180,480,469,949,2071
10,-40,-10,456,493,949,2088
170,20,180,453,496,949,1991
-180,10,180,480,469,949,2071
100,40,-120,466,483,949,1988
100,20,50,469,480,949,1949
-110,10,100,453,496,949,1976
140,40,-160,457,492,949,2072
80,80,60,475,475,950,1911
100,0,100,472,478,950,2009
-100,-70,60,470,480,950,2076
110,-10,30,450,500,950,2018
10,-20,-10,454,496,950,2082
160,-20,170,471,480,951,2112
110,50,30,464,487,951,2014
-110,-30,60,462,489,951,2057
100,-30,-40,476,475,951,1973
150,-30,160,471,480,951,2005
0,-40,150,473,478,951,1886
-100,40,10,464,487,951,1967
70,0,-120,452,499,951,2057
-100,80,80,461,490,951,1851
-70,-70,90,465,486,951,2010
120,0,10,466,485,951,2117
-80,30,-100,464,487,951,1956
110,-10,20,458,494,952,1992
80,-40,-60,467,485,952,2047
80,20,120,474,478,952,2041
90,-60,-100,465,487,952,2024
40,-50,10,460,492,952,2023
-80,40,-10,444,508,952,2035
-130,30,10,453,500,953,2040
150,40,-170,451,502,953,2010
80,20,130,470,483,953,2098
120,40,20,475,478,953,2075
50,50,-60,453,501,954,1987
-130,-40,-160,451,503,954,2090
-120,-10,50,423,531,954,1899
-90,40,-80,464,490,954,2016
130,-20,-40,479,475,954,2144
80,-30,-50,466,488,954,2050
-30,-60,130,459,495,954,1961
90,20,-140,476,478,954,2045
-140,10,20,462,492,954,2046
60,10,160,443,511,954,2086
60,0,180,457,498,955,2101
-140,-70,-150,458,497,955,1903
-140,20,10,463,492,955,2168
60,0,-180,457,498,955,2101
50,-10,-40,458,497,955,2092
70,40,100,467,488,955,2106
140,-10,140,464,491,955,2157
90,30,-120,473,483,956,2060
-20,-10,160,472,484,956,1934
80,30,-90,477,479,956,1929
100,0,90,473,483,956,2152
-130,60,-50,461,495,956,1916
110,10,40,475,481,956,2133
-150,80,-60,462,494,956,2060
150,50,-10,480,476,956,1982
60,50,-70,467,489,956,1983
90,-70,80,460,496,956,2082
140,-30,150,476,480,956,2118
130,0,-20,486,471,957,2028
120,-10,-20,473,484,957,2093
-50,50,0,465,492,957,1939
-80,-70,80,466,491,957,2104
70,-30,-10,460,497,957,2057
120,-10,120,463,494,957,2050
110,30,-150,463,494,957,2007
120,-40,130,481,477,958,1967
-150,-60,-160,477,481,958,2025
-20,50,-10,467,491,958,1919
-90,-10,140,472,486,958,2020
-160,70,-40,469,489,958,1974
-110,80,-100,475,483,958,1977
170,10,180,483,475,958,1974
0,40,-20,470,488,958,1888
20,-10,-20,460,498,958,2114
-160,-20,0,483,475,958,2049
170,10,-180,483,475,958,1974
-160,-30,0,484,474,958,2004
70,-10,-80,463,496,959,2110
-10,50,150,482,477,959,1921
90,20,-160,460,499,959,2083
110,-10,90,454,505,959,2074
30,10,-20,464,495,959,2039
60,0,-70,472,487,959,2054
100,-40,-50,473,486,959,2159
130,-50,-60,462,497,959,1980
90,-40,-50,459,500,959,2206
160,20,180,467,492,959,2112
160,20,-180,467,492,959,2112
-120,70,-80,471,488,959,1986
150,0,-30,491,468,959,2020
170,20,-20,475,484,959,1974
70,-20,0,479,481,960,2072
90,40,-100,488,472,960,1948
110,-40,120,481,479,960,1996
0,0,-10,480,480,960,1905
80,-30,50,469,492,961,2067
170,-10,-180,472,489,961,2147
80,-80,70,470,491,961,2006
-50,60,10,466,495,961,1988
-90,-50,-120,470,491,961,2067
80,-80,-130,472,489,961,2131
110,20,40,471,490,961,2011
-150,-30,-170,468,493,961,2130
170,-10,180,472,489,961,2147
-90,-70,70,469,492,961,2138
70,-40,50,475,486,961,2122
100,-50,-70,459,502,961,1931
-140,60,-40,456,505,961,1985
90,10,80,478,484,962,2095
30,-80,-180,477,485,962,2044
-110,40,40,477,485,962,2077
-120,30,90,441,521,962,2029
-90,50,-100,477,485,962,1909
10,-50,-10,437,525,962,2178
50,60,90,491,471,962,2030
30,-80,180,477,485,962,2044
40,-60,20,463,499,962,2034
70,-10,-100,461,502,963,2131
70,-80,-140,478,485,963,2127
120,70,20,472,491,963,1950
30,50,-40,454,509,963,1945
130,10,-10,479,484,963,1929
130,-20,140,490,473,963,2222
120,50,-130,466,498,964,2055
40,40,110,486,478,964,2107
-110,-20,60,470,494,964,2027
70,-10,-110,455,509,964,2113
-30,-70,-40,454,510,964,2079
-20,0,160,462,502,964,1885
-160,-40,0,479,485,964,2036
70,-70,-140,485,479,964,2095
30,-60,10,464,500,964,2060
60,-10,-60,463,501,964,2115
100,60,-110,482,482,964,2036
90,60,-100,470,495,965,2056
-70,-40,110,469,496,965,2116
100,-20,-20,465,500,965,1958
60,-10,-160,455,510,965,2077
90,30,80,459,506,965,2099
100,80,40,460,506,966,1959
-80,-90,-90,461,505,966,1943
170,-90,160,461,505,966,1943
20,-90,10,461,505,966,1943
110,-90,100,461,505,966,1943
-150,-90,-160,461,505,966,1943
100,-20,0,479,487,966,2097
-160,-90,-170,461,505,966,1943
-50,-90,-60,461,505,966,1943
-30,-90,-40,461,505,966,1943
150,-90,140,461,505,966,1943
-40,-90,-50,461,505,966,1943
80,-90,70,461,505,966,1943
-120,-90,-130,461,505,966,1943
180,-90,170,461,505,966,1943
-180,-90,170,461,505,966,1943
0,-90,-10,461,505,966,1943
-70,-90,-80,461,505,966,1943
60,-10,-140,442,524,966,2061
-110,-90,-120,461,505,966,1943
50,-90,40,461,505,966,1943
-10,-90,-20,461,505,966,1943
-170,-90,180,461,505,966,1943
120,-90,110,461,505,966,1943
60,-90,50,461,505,966,1943
-100,-20,-170,473,493,966,2118
70,-90,60,461,505,966,1943
30,-90,20,461,505,966,1943
-60,-10,-160,446,520,966,2085
40,-90,30,461,505,966,1943
-20,-90,-30,461,505,966,1943
-100,-90,-110,461,505,966,1943
140,-90,130,461,505,966,1943
90,-90,80,461,505,966,1943
-140,-90,-150,461,505,966,1943
100,-90,90,461,505,966,1943
-60,-90,-70,461,505,966,1943
-90,-90,-100,461,505,966,1943
-130,-90,-140,461,505,966,1943
140,-40,150,475,491,966,2072
100,-40,100,487,479,966,1995
160,-90,150,461,505,966,1943
130,-90,120,461,505,966,1943
-170,-90,-180,461,505,966,1943
10,-90,0,461,505,966,1943
-20,80,160,485,481,966,2067
-30,80,10,474,493,967,1859
60,-10,-50,458,509,967,2170
-100,-20,80,479,488,967,2073
20,10,-20,452,515,967,2082
-100,-30,-160,469,498,967,2033
60,40,-60,481,486,967,1937
-30,10,-20,468,500,968,2025
130,-10,-30,480,488,968,2137
90,10,160,475,493,968,2131
60,20,150,458,510,968,2225
80,30,110,473,495,968,2191
-10,0,-10,491,477,968,1963
130,30,-160,475,493,968,2152
110,60,-120,478,491,969,2042
140,30,-10,493,476,969,2075
140,60,0,490,479,969,1982
-150,20,0,471,498,969,2092
80,20,-100,463,506,969,2021
20,0,-20,467,502,969,2119
-110,60,-80,464,506,970,1988
-70,0,-100,445,525,970,2096
110,0,130,491,479,970,2040
60,-10,-150,448,522,970,2059
70,10,-90,473,497,970,2077
90,80,50,479,491,970,1952
90,-20,20,483,487,970,2111
110,0,50,462,508,970,2171
110,-20,100,468,502,970,2112
100,0,80,484,486,970,2122
-110,-30,-160,478,493,971,2147
50,-60,30,470,501,971,2080
70,60,-80,461,510,971,2126
-120,10,50,463,508,971,1922
80,-20,-10,479,492,971,2118
20,-40,-10,467,504,971,2140
-90,-60,-110,474,497,971,2162
70,40,-70,480,491,971,1833
-40,80,20,473,499,972,1966
80,20,110,479,493,972,2090
30,-30,160,486,486,972,2053
130,0,150,476,496,972,2145
100,10,50,489,483,972,2202
-80,70,50,462,510,972,1945
130,-30,-50,480,492,972,2034
80,-50,70,476,497,973,2026
-40,-70,-50,459,514,973,2098
110,30,40,477,496,973,2100
-80,20,-60,464,509,973,2013
100,-20,-10,475,498,973,2014
120,40,-140,467,506,973,2002
70,-10,-90,466,507,973,2132
-60,0,-50,459,514,973,2025
60,-30,0,469,504,973,2117
150,-20,160,482,491,973,2081
60,50,90,483,491,974,2046
120,-30,130,487,487,974,2044
110,-60,110,485,489,974,2028
80,60,-90,472,502,974,2070
-120,50,-40,467,507,974,2011
-140,30,140,470,504,974,2052
-110,-50,-140,457,517,974,2168
40,-40,0,469,505,974,2057
70,-30,-60,468,507,975,2178
20,-30,-10,470,505,975,2157
70,-50,50,476,499,975,2105
90,-80,-120,478,497,975,2150
-60,10,-140,466,509,975,2016
30,20,130,490,485,975,2172
100,-50,100,490,485,975,2030
-10,70,-10,475,500,975,2022
-150,-50,10,486,489,975,2074
60,30,-60,497,478,975,1926
60,20,-60,471,504,975,1951
-90,-10,150,479,497,976,2191
160,0,-30,497,479,976,2083
70,10,160,467,509,976,2136
-60,-30,130,476,500,976,2073
30,30,-30,482,494,976,2051
-50,40,-160,474,502,976,2114
20,-80,170,491,485,976,2037
70,-30,-90,468,508,976,2170
20,0,140,497,479,976,2057
-120,20,50,460,516,976,2063
20,-60,0,457,520,977,2161
70,0,-110,459,518,977,2118
60,-20,-30,471,506,977,2116
100,-80,-110,477,500,977,2184
-10,-30,-10,471,506,977,2004
100,30,60,478,499,977,2086
-80,-20,-160,485,492,977,2147
0,60,140,495,482,977,2088
70,-80,60,475,502,977,2050
10,50,130,489,488,977,2105
-70,40,-10,478,500,978,2041
70,-20,-110,460,518,978,2200
70,-10,-130,463,515,978,2159
100,10,170,473,505,978,2087
80,-70,70,471,507,978,2164
60,-50,-140,480,498,978,2114
170,0,180,501,478,979,1962
70,20,150,471,508,979,2271
-120,30,30,467,512,979,2194
-100,40,-20,479,500,979,2130
170,-10,-30,508,471,979,2059
40,-10,-30,455,524,979,2154
-40,-30,150,481,498,979,2205
150,10,170,474,505,979,2169
-110,50,-50,478,501,979,2103
170,0,-180,501,478,979,1962
-160,10,170,497,482,979,2244
80,-20,0,475,505,980,2102
60,-30,-10,469,511,980,2134
140,-80,-70,495,485,980,2121
140,-50,-60,493,487,980,2081
-120,-80,-130,482,498,980,1909
40,0,-30,477,503,980,2089
-150,-30,10,481,499,980,2020
120,20,20,473,507,980,2124
150,0,160,458,523,981,2260
120,10,10,487,494,981,2113
-30,0,-20,473,508,981,2017
-60,20,-140,461,520,981,2048
80,0,-160,481,500,981,2110
-120,0,160,488,493,981,2134
70,0,-100,469,513,982,2126
70,-20,-10,491,491,982,2100
-70,-20,-120,470,512,982,2081
-90,-50,80,473,509,982,2094
-70,-20,-100,455,527,982,2013
60,-30,-150,476,506,982,2098
120,60,-130,484,498,982,2068
140,-70,140,483,499,982,2101
80,-20,-20,483,499,982,2127
-180,50,-20,477,505,982,2075
90,20,70,482,500,982,2080
80,20,100,482,500,982,2158
50,30,120,484,498,982,2205
-30,-30,150,468,514,982,2095
110,20,-170,476,506,982,2185
90,50,60,481,501,982,2207
180,50,-20,477,505,982,2075
-140,80,-70,483,500,983,2077
-120,20,110,457,526,983,2157
50,-20,-170,472,511,983,2183
-130,-60,30,473,510,983,2179
20,40,120,488,495,983,2101
90,-20,-20,480,503,983,2037
-30,0,170,473,511,984,2123
-150,-40,10,489,495,984,2175
30,0,-20,482,502,984,2134
110,0,40,473,511,984,2166
-130,70,-70,490,494,984,2071
-120,80,-90,487,497,984,2049
-110,-10,170,489,495,984,2129
60,60,-70,456,528,984,2149
-120,20,100,478,506,984,2198
70,-10,-120,465,519,984,2132
-20,-70,-30,472,512,984,2063
80,10,100,488,496,984,2090
110,-80,-100,486,499,985,2187
60,-40,20,479,506,985,2131
140,-20,150,489,496,985,2232
100,20,-160,470,515,985,2166
70,-20,-20,486,499,985,2102
0,50,140,489,496,985,1995
-140,-30,20,479,506,985,2024
-180,10,-20,496,490,986,1990
90,-30,-50,492,494,986,2041
100,0,110,496,490,986,2062
180,10,-20,496,490,986,1990
140,0,-30,502,484,986,2117
70,-20,-40,469,517,986,2082
-90,60,50,470,516,986,2028
90,-20,30,485,501,986,2026
-110,-20,-170,476,510,986,2058
90,40,70,476,510,986,2262
120,-80,-90,487,499,986,2170
80,-60,-120,490,496,986,2054
-90,40,0,458,528,986,2052
110,-10,10,466,520,986,2082
80,-40,70,478,508,986,2144
90,-20,10,485,502,987,2174
-70,0,-90,458,529,987,2043
-130,50,110,472,515,987,2152
90,-20,-10,480,507,987,2088
-90,80,70,473,514,987,1942
-100,50,-80,485,502,987,1999
60,-40,-140,482,505,987,2056
80,-40,-70,475,513,988,2036
70,-20,-50,470,518,988,2144
130,-70,130,486,502,988,2110
70,-30,-80,472,516,988,2188
60,-60,40,475,513,988,2098
50,20,140,479,509,988,2142
-70,50,10,483,505,988,2053
80,40,90,484,504,988,2239
-160,-30,-170,457,531,988,2090
-40,-20,160,471,517,988,2118
-50,-30,140,479,510,989,2300
50,-20,-20,459,530,989,2187
-150,-10,-180,478,511,989,2146
-20,10,160,504,485,989,1953
-150,-10,180,478,511,989,2146
-110,-40,-150,493,496,989,2216
-30,-40,-30,498,491,989,1918
80,-70,-130,502,487,989,2187
40,-30,-10,475,514,989,2184
150,-40,160,488,501,989,2066
100,0,130,501,488,989,2187
-120,-10,170,509,481,990,2181
20,40,-30,485,505,990,2037
70,-20,-80,473,517,990,2132
-60,-10,-60,482,508,990,2029
70,-20,-30,477,513,990,2149
80,0,-150,482,508,990,2201
70,-30,-100,469,521,990,2171
-80,70,-130,505,486,991,2042
70,50,80,483,508,991,2126
-40,0,-180,484,507,991,2121
-40,-10,-30,498,493,991,1951
-70,20,-40,479,512,991,2041
-60,40,-10,470,521,991,2081
150,-10,160,481,510,991,2242
130,-80,-80,500,491,991,2154
-10,-20,150,497,494,991,2020
130,50,-140,485,506,991,2058
-20,70,160,500,491,991,2088
70,-60,50,475,516,991,2132
-40,0,180,484,507,991,2121
-30,-40,140,490,502,992,2259
-170,-40,-170,490,502,992,2168
-50,80,30,477,515,992,1979
60,-80,50,486,506,992,2080
70,-20,10,495,497,992,2118
50,60,-60,472,520,992,2246
80,10,90,491,501,992,2100
60,-60,-150,504,488,992,2131
160,30,-20,485,507,992,1985
-80,20,-90,488,504,992,1881
90,60,50,502,490,992,2009
110,10,170,487,505,992,2201
-170,60,160,469,523,992,2139
-90,-30,90,491,501,992,2057
110,-30,-40,503,490,993,2158
90,10,170,483,510,993,2179
100,0,60,510,483,993,2205
110,-10,100,483,510,993,2155
-10,-70,140,486,507,993,1985
90,-20,-30,484,510,994,2049
80,10,170,484,510,994,2142
-110,0,150,490,504,994,2042
70,-20,-60,473,521,994,2204
-80,-20,120,494,500,994,2141
80,0,-170,482,512,994,2024
-90,-10,130,481,513,994,2139
110,-20,-30,491,504,995,2087
-20,-40,-20,486,509,995,2052
120,0,0,490,505,995,2154
-30,60,0,474,521,995,2077
80,-20,-40,489,506,995,2104
50,-80,40,484,511,995,2077
70,-10,-20,491,504,995,2181
80,10,160,478,517,995,2125
100,-20,-30,485,510,995,2017
80,-50,-100,492,503,995,2149
50,-50,20,477,518,995,2077
-100,-10,90,495,501,996,2194
80,-20,10,489,507,996,2105
50,-30,-170,488,508,996,2111
-60,-60,-70,491,505,996,1981
-90,-40,-130,479,517,996,2088
60,-20,-20,475,521,996,2163
0,40,140,494,502,996,2067
60,30,120,481,515,996,2231
-120,40,-20,468,528,996,2257
50,-40,10,484,512,996,2228
80,10,-120,483,513,996,2009
100,50,-110,492,504,996,2122
40,-20,-20,477,519,996,2189
110,-30,110,483,514,997,2121
50,20,-40,480,517,997,2123
50,-10,180,477,520,997,2115
-80,50,-120,492,505,997,1944
50,-10,-180,477,520,997,2115
-70,70,40,486,511,997,2057
70,30,110,480,517,997,2298
110,50,-120,483,514,997,2013
-150,50,140,468,530,998,2062
110,80,30,473,525,998,2023
170,40,-180,496,502,998,2073
-100,-10,170,482,516,998,2163
80,40,-80,498,500,998,2018
170,40,180,496,502,998,2073
160,-20,-40,507,491,998,2110
160,-10,170,500,498,998,2111
-180,60,170,483,516,999,2107
-50,30,-20,499,500,999,2214
70,-30,-70,474,525,999,2188
-90,40,-90,488,511,999,2049
90,-20,-40,493,506,999,2116
170,30,-180,470,529,999,2030
170,30,180,470,529,999,2030
160,-40,170,494,505,999,2015
-30,-10,-20,485,514,999,1862
150,-80,-60,509,490,999,2154
180,60,170,483,516,999,2107
90,-30,70,489,510,999,2194
140,10,170,487,513,1000,2199
-130,80,-80,488,512,1000,2115
80,10,150,486,514,1000,2169
30,-10,-20,488,512,1000,2134
60,60,80,501,499,1000,2096
80,-20,-30,496,504,1000,2198
-50,-70,-60,486,515,1001,2131
130,-50,140,490,511,1001,2175
-70,20,-120,475,526,1001,2138
40,20,-30,495,506,1001,2080
-120,10,140,476,525,1001,2162
-70,-20,140,475,526,1001,2096
30,-50,10,476,525,1001,2128
10,40,130,506,495,1001,2117
-50,70,20,491,511,1002,2081
70,-40,-110,491,511,1002,2091
10,-80,160,507,495,1002,2095
40,-40,-180,496,506,1002,2056
40,-40,180,496,506,1002,2056
-80,-20,-150,474,528,1002,2110
90,-70,-120,499,504,1003,2205
-80,-30,-130,481,522,1003,2195
-110,-80,-120,490,513,1003,1981
-60,80,40,477,526,1003,2005
60,-50,30,478,525,1003,2195
170,-80,-40,498,505,1003,2132
120,30,20,508,496,1004,2086
150,20,180,502,502,1004,2209
130,10,170,488,516,1004,2167
150,20,-180,502,502,1004,2209
-120,30,100,470,534,1004,2227
90,0,130,493,512,1005,2148
90,-20,40,491,514,1005,2103
70,0,-90,493,512,1005,2195
160,0,170,485,520,1005,2305
-110,10,80,478,527,1005,2223
0,-50,-10,482,523,1005,2205
-160,40,160,492,513,1005,2124
160,-80,-50,508,497,1005,2131
-80,-50,90,487,518,1005,2277
-130,10,150,488,517,1005,2179
120,80,20,486,519,1005,2028
-80,-30,100,490,516,1006,2136
-80,80,60,481,525,1006,1957
-70,30,-30,502,504,1006,2170
60,-40,30,482,524,1006,2173
-30,80,170,504,502,1006,2156
-130,70,110,495,511,1006,2038
10,-40,0,482,524,1006,2174
60,40,100,497,509,1006,2224
-110,40,-20,480,526,1006,2127
60,0,170,478,529,1007,2215
-140,10,160,498,509,1007,2209
20,20,130,499,508,1007,2147
130,60,-140,487,521,1008,2115
100,0,120,509,499,1008,2096
-110,-40,60,484,524,1008,2272
50,0,170,475,533,1008,2281
50,0,-40,479,529,1008,2195
70,-10,-140,473,535,1008,2297
-120,30,20,477,531,1008,2172
-170,-50,-170,495,513,1008,2157
100,0,70,499,509,1008,2155
-150,20,160,492,516,1008,2233
-160,20,-10,504,504,1008,2154
170,70,-20,495,513,1008,2149
40,60,-50,493,516,1009,2153
100,-10,60,498,511,1009,2154
-70,0,-80,466,543,1009,2152
80,-40,-80,488,521,1009,2064
130,30,0,509,500,1009,2172
-10,0,150,495,514,1009,2040
90,10,70,511,498,1009,2098
20,-50,0,472,537,1009,2236
-80,-40,-110,488,521,1009,2065
140,-70,-70,505,504,1009,2147
140,20,-180,482,528,1010,2245
140,20,180,482,528,1010,2245
30,-30,-10,493,517,1010,2227
-10,60,150,507,503,1010,2086
120,20,-170,493,518,1011,2239
100,-30,90,490,521,1011,2218
-30,10,170,495,517,1012,2059
40,-80,30,495,517,1012,2104
70,50,-70,500,512,1012,2160
40,20,130,496,516,1012,2266
10,-30,0,494,518,1012,2075
130,-70,-80,503,509,1012,2153
80,-60,70,488,524,1012,2202
-140,20,150,496,516,1012,2192
60,-30,20,496,516,1012,2190
30,40,110,505,507,1012,2250
130,70,10,499,513,1012,2098
-110,0,70,493,519,1012,2126
-40,-60,120,488,525,1013,2191
100,-20,80,492,521,1013,2173
-140,-50,20,504,509,1013,2182
-20,50,160,502,511,1013,2038
30,-50,170,504,509,1013,2141
90,-20,0,506,507,1013,2172
-70,-20,-110,456,557,1013,2078
50,10,-40,476,537,1013,2131
-130,-70,-140,484,529,1013,2008
80,60,60,516,497,1013,2074
-90,50,30,489,524,1013,2113
-80,-50,-100,495,518,1013,2040
50,-50,-160,510,503,1013,2113
100,20,40,499,515,1014,2191
70,60,70,511,503,1014,2126
-60,-20,160,488,526,1014,2110
70,-10,-70,495,519,1014,2192
80,30,100,495,519,1014,2311
60,-20,-150,481,533,1014,2272
70,30,-70,504,511,1015,2021
-140,70,-60,497,518,1015,2177
-140,0,20,493,522,1015,2183
70,20,140,495,520,1015,2350
90,30,70,489,526,1015,2186
80,20,90,493,522,1015,2231
10,20,-20,493,522,1015,2204
140,40,-10,500,515,1015,2167
20,-50,160,496,520,1016,2093
40,-50,20,486,530,1016,2170
10,-10,-10,487,529,1016,2243
-170,-60,-170,484,532,1016,2064
40,50,100,516,500,1016,2190
120,-60,-80,492,524,1016,2096
90,0,120,498,518,1016,2190
70,-70,60,480,536,1016,2285
120,-70,120,504,512,1016,2170
130,-30,150,495,521,1016,2152
90,-40,90,504,512,1016,2149
80,-20,-50,488,529,1017,2187
-70,80,50,487,530,1017,2020
-90,-30,-140,484,533,1017,2131
-170,-80,-20,505,512,1017,2149
-130,10,30,485,532,1017,2172
30,-80,20,500,517,1017,2099
150,-50,160,503,514,1017,2144
-10,10,150,509,508,1017,2076
130,-40,-60,503,514,1017,2122
-50,40,-10,492,525,1017,2212
140,20,-20,514,503,1017,2197
80,-30,-60,489,529,1018,2239
-180,-80,-30,505,513,1018,2138
50,10,150,470,548,1018,2290
-140,-40,-160,494,524,1018,2231
180,-80,-30,505,513,1018,2138
-60,20,-30,497,521,1018,2211
-70,40,-130,480,538,1018,2150
-50,10,-30,505,513,1018,2050
90,-50,90,507,511,1018,2151
90,20,-130,500,518,1018,2101
80,50,70,505,513,1018,2236
110,0,30,485,533,1018,2229
170,50,-180,496,522,1018,2173
170,50,180,496,522,1018,2173
60,-10,-40,491,527,1018,2231
-50,-50,-60,488,530,1018,2054
70,-30,40,498,521,1019,2161
0,-60,-10,483,536,1019,2188
-120,-60,40,496,523,1019,2272
20,-80,10,493,526,1019,2081
-110,10,110,489,530,1019,2196
140,50,-150,490,529,1019,2207
50,40,-50,497,522,1019,2112
90,-40,-60,492,527,1019,2273
100,-30,-50,505,514,1019,2202
-90,-10,160,511,509,1020,2283
-150,-20,10,492,528,1020,2278
60,-30,10,501,519,1020,2147
20,-10,-10,494,526,1020,2343
60,10,-60,483,537,1020,2203
-150,70,-50,496,524,1020,2167
150,-70,-60,518,502,1020,2191
80,10,110,500,520,1020,2153
-120,-30,-160,493,527,1020,2240
-70,-20,150,503,517,1020,2285
90,10,-160,487,534,1021,2235
90,-50,-90,486,535,1021,2166
40,-30,170,510,511,1021,2115
-150,-10,10,494,527,1021,2233
70,-10,-30,491,530,1021,2184
-110,-60,-130,476,545,1021,2179
-70,-10,-110,482,539,1021,2032
110,40,-130,493,528,1021,2069
70,-20,-70,496,525,1021,2269
60,-10,-170,478,544,1022,2262
150,-70,150,510,512,1022,2160
-110,-10,60,491,531,1022,2129
70,-50,60,497,525,1022,2149
-100,-50,-130,484,538,1022,2166
60,-20,-10,500,522,1022,2127
-160,-80,-10,505,517,1022,2196
-120,50,90,488,535,1023,2155
-70,-50,100,496,527,1023,2337
100,-10,50,496,527,1023,2257
110,-50,-70,495,528,1023,2134
-90,-20,100,513,510,1023,2170
100,30,50,513,511,1024,2255
140,-50,150,498,526,1024,2162
-100,-40,-140,481,543,1024,2225
130,80,10,498,526,1024,2032
-60,-50,110,500,524,1024,2192
-160,20,170,511,513,1024,2248
10,0,140,520,504,1024,2229
-140,50,-30,485,540,1025,2172
30,-40,0,489,536,1025,2188
170,30,-20,513,512,1025,2134
120,-20,130,510,515,1025,2353
80,-20,-90,501,524,1025,2272
90,30,-110,501,524,1025,2152
50,-10,-30,486,540,1026,2225
80,-20,20,509,517,1026,2200
150,30,-20,528,498,1026,2151
-60,-70,-70,509,517,1026,2153
-140,-40,20,505,521,1026,2201
90,10,-170,502,524,1026,2276
-170,0,-180,506,520,1026,2323
-170,0,180,506,520,1026,2323
80,0,-140,506,521,1027,2266
-140,-10,-180,492,535,1027,2211
60,20,140,492,535,1027,2437
-140,-10,180,492,535,1027,2211
90,0,110,504,524,1028,2256
-120,-20,-170,507,521,1028,2160
-100,50,50,503,525,1028,2125
60,-40,-150,499,530,1029,2146
110,-10,0,491,538,1029,2239
-140,0,170,492,537,1029,2349
100,50,40,498,531,1029,2240
120,-50,130,505,524,1029,2238
-40,20,-20,502,527,1029,2205
120,-10,130,490,539,1029,2306
50,-70,40,511,518,1029,2239
-10,-70,-20,498,532,1030,2213
100,20,-150,495,535,1030,2257
170,-70,-40,509,521,1030,2203
80,50,-80,508,522,1030,2174
0,-80,150,520,510,1030,2131
40,40,-40,501,529,1030,2152
110,-20,110,495,536,1031,2352
100,-70,-110,507,524,1031,2245
70,0,-80,492,539,1031,2186
130,-10,140,497,534,1031,2331
120,10,170,510,521,1031,2254
-120,20,120,482,550,1032,2167
-150,-50,-160,492,540,1032,2200
-130,20,20,512,520,1032,2276
130,-20,150,503,529,1032,2290
-140,40,-20,481,552,1033,2243
-140,-20,20,485,548,1033,2226
140,-10,150,499,534,1033,2338
70,-10,-60,499,534,1033,2105
70,10,150,482,551,1033,2259
10,-80,0,492,541,1033,2091
160,-70,160,516,517,1033,2147
-70,-30,-100,497,536,1033,2276
-60,70,30,493,540,1033,2135
80,20,80,509,524,1033,2206
60,10,150,482,552,1034,2293
-100,-80,-110,501,533,1034,2059
70,-60,-140,518,516,1034,2197
150,-30,-50,516,518,1034,2193
-130,-20,-170,511,523,1034,2241
-70,-20,130,481,554,1035,2205
120,-70,-90,504,531,1035,2221
110,10,30,503,532,1035,2281
-110,40,50,488,547,1035,2262
60,-50,40,495,540,1035,2168
90,10,-150,485,550,1035,2234
170,-40,-180,504,532,1036,2137
30,0,140,517,519,1036,2193
-110,-60,50,505,531,1036,2284
170,40,-20,518,518,1036,2163
170,-40,180,504,532,1036,2137
20,-20,-10,501,535,1036,2193
30,-10,150,515,521,1036,2237
70,-10,-160,482,555,1037,2304
-160,60,150,491,546,1037,2220
40,10,140,496,541,1037,2358
140,60,-150,497,540,1037,2160
120,30,-150,503,534,1037,2195
-70,-10,-90,486,551,1037,2140
-100,40,-30,484,554,1038,2262
20,50,-30,488,550,1038,2122
-170,40,-20,507,531,1038,2112
140,-40,-60,507,531,1038,2216
90,10,60,516,522,1038,2147
90,0,90,532,506,1038,2246
-100,0,110,517,521,1038,2217
80,30,90,507,531,1038,2357
-50,-10,180,487,552,1039,2348
110,-70,110,514,525,1039,2229
-50,-10,-180,487,552,1039,2348
60,0,-60,507,532,1039,2208
80,10,-110,493,546,1039,2137
-70,0,-110,490,549,1039,2267
100,-10,70,498,541,1039,2199
20,-30,150,519,520,1039,2206
120,-40,140,523,517,1040,2213
60,-70,50,504,536,1040,2271
10,-40,150,510,530,1040,2115
70,-40,-120,505,535,1040,2158
110,40,30,514,527,1041,2419
-10,-60,140,509,532,1041,2136
90,-40,-70,498,543,1041,2273
-70,0,-70,486,555,1041,2119
110,-10,110,499,542,1041,2302
-90,-80,-100,501,540,1041,2137
90,10,-180,511,531,1042,2289
90,10,180,511,531,1042,2289
160,-70,-50,519,523,1042,2185
70,-30,-110,490,552,1042,2257
50,-50,30,504,538,1042,2220
-110,60,80,494,549,1043,2076
-150,-80,0,507,536,1043,2212
170,-70,170,512,531,1043,2186
-40,-40,130,497,546,1043,2368
-100,60,-100,515,528,1043,2098
150,60,-160,495,548,1043,2166
100,30,-130,508,536,1044,2278
120,0,150,509,535,1044,2190
-60,60,20,498,546,1044,2214
60,-10,-30,506,538,1044,2292
100,10,180,507,537,1044,2300
80,10,120,510,534,1044,2250
-60,-80,-70,509,535,1044,2211
100,10,-180,507,537,1044,2300
-40,-90,110,526,519,1045,2242
-30,-90,120,526,519,1045,2242
80,10,80,523,522,1045,2316
-120,-90,30,526,519,1045,2242
-130,-90,20,526,519,1045,2242
130,-90,-80,526,519,1045,2242
100,-10,40,506,539,1045,2368
-110,-10,180,506,539,1045,2228
-50,-90,100,526,519,1045,2242
140,-90,-70,526,519,1045,2242
-110,-10,-180,506,539,1045,2228
160,-90,-50,526,519,1045,2242
90,-90,-120,526,519,1045,2242
-60,-90,90,526,519,1045,2242
180,-90,-30,526,519,1045,2242
150,-90,-60,526,519,1045,2242
110,-90,-100,526,519,1045,2242
-20,-90,130,526,519,1045,2242
-80,-90,70,526,519,1045,2242
100,-90,-110,526,519,1045,2242
-100,-90,50,526,519,1045,2242
80,0,180,504,541,1045,2222
-160,-90,-10,526,519,1045,2242
-70,-80,-80,510,535,1045,2181
120,-90,-90,526,519,1045,2242
10,-90,160,526,519,1045,2242
80,-30,-70,497,548,1045,2444
-70,-90,80,526,519,1045,2242
60,-90,-150,526,519,1045,2242
-180,-90,-30,526,519,1045,2242
-90,-90,60,526,519,1045,2242
40,-90,-170,526,519,1045,2242
80,0,-180,504,541,1045,2222
70,-10,-150,497,548,1045,2321
-10,-90,140,526,519,1045,2242
170,-90,-40,526,519,1045,2242
70,-90,-140,526,519,1045,2242
-110,-90,40,526,519,1045,2242
140,-10,-40,512,533,1045,2325
180,20,180,516,529,1045,2081
-150,-90,0,526,519,1045,2242
30,-90,-180,526,519,1045,2242
-140,-90,10,526,519,1045,2242
-180,20,180,516,529,1045,2081
0,-90,150,526,519,1045,2242
180,40,-20,509,536,1045,2206
-180,40,-20,509,536,1045,2206
180,20,-180,516,529,1045,2081
30,-90,180,526,519,1045,2242
80,-90,-130,526,519,1045,2242
-180,20,-180,516,529,1045,2081
20,-90,170,526,519,1045,2242
-170,-90,-20,526,519,1045,2242
50,-90,-160,526,519,1045,2242
140,0,160,501,544,1045,2291
30,-20,-10,494,552,1046,2203
130,40,0,521,525,1046,2233
110,20,-160,498,548,1046,2353
90,20,60,522,524,1046,2263
-90,70,-120,534,512,1046,2109
40,-40,10,501,545,1046,2257
100,-10,20,506,540,1046,2255
-90,-10,120,506,540,1046,2296
-10,40,150,521,526,1047,2081
80,-40,-90,509,538,1047,2220
70,-10,-10,513,534,1047,2223
110,20,30,519,528,1047,2313
-130,-20,30,504,543,1047,2046
70,-10,-40,505,542,1047,2238
150,-10,-40,527,520,1047,2319
80,-50,-110,509,539,1048,2293
70,0,170,504,544,1048,2288
-180,-30,-170,505,543,1048,2162
180,-30,-170,505,543,1048,2162
110,-30,120,520,528,1048,2303
40,10,-20,503,545,1048,2167
-130,30,0,490,558,1048,2283
60,-40,40,495,553,1048,2393
-70,10,-50,503,545,1048,2090
-10,30,150,531,517,1048,2220
-130,-30,30,505,543,1048,2211
-110,50,70,496,553,1049,2147
60,-10,-20,506,543,1049,2275
120,-40,-60,520,529,1049,2228
-130,40,120,505,544,1049,2267
80,10,140,519,530,1049,2241
100,0,140,527,522,1049,2290
-120,-20,40,497,552,1049,2147
100,-60,100,516,533,1049,2246
70,-20,-120,500,549,1049,2349
40,-70,30,514,535,1049,2216
-70,-70,-80,514,536,1050,2219
-40,-10,170,497,553,1050,2259
80,-20,-80,500,550,1050,2421
90,0,100,516,534,1050,2253
10,0,-10,497,553,1050,2116
80,-10,-40,507,543,1050,2278
50,-30,0,506,544,1050,2261
-130,-10,-180,527,524,1051,2358
90,-20,50,514,537,1051,2218
-40,80,-180,519,532,1051,2255
-140,-80,10,505,546,1051,2237
50,10,-30,510,541,1051,2270
60,70,-70,512,539,1051,2374
100,-20,90,505,546,1051,2348
-130,-10,180,527,524,1051,2358
100,70,-110,527,524,1051,2213
-40,80,180,519,532,1051,2255
-50,-80,-60,513,538,1051,2223
-100,0,140,527,524,1051,2133
20,-40,0,510,541,1051,2332
110,30,30,523,529,1052,2253
70,-60,60,498,554,1052,2261
-50,0,-170,501,551,1052,2285
180,-70,-30,516,536,1052,2265
-180,-70,-30,516,536,1052,2265
-40,40,-10,506,546,1052,2337
100,-10,30,513,539,1052,2364
110,-70,-100,517,535,1052,2281
80,-20,-100,507,546,1053,2328
-30,40,-10,515,538,1053,2326
70,-20,20,524,529,1053,2268
-90,-10,170,511,542,1053,2258
150,30,-170,517,536,1053,2304
-80,50,20,515,538,1053,2226
60,30,-50,525,528,1053,2196
60,-30,30,505,549,1054,2349
100,-70,100,518,536,1054,2347
70,-10,180,496,558,1054,2203
-130,-30,-160,522,532,1054,2326
70,-10,-180,496,558,1054,2203
-10,-10,150,508,547,1055,2233
100,-50,-80,503,552,1055,2201
90,70,-100,527,528,1055,2188
-170,40,170,505,550,1055,2211
-60,-30,-70,493,563,1056,2293
50,-40,20,512,544,1056,2422
120,0,-10,525,531,1056,2272
110,0,140,519,537,1056,2269
0,-80,-10,500,556,1056,2147
100,-10,80,514,542,1056,2283
0,-70,-10,511,545,1056,2316
140,-20,160,516,540,1056,2333
90,-60,-110,526,530,1056,2253
-30,-50,130,507,549,1056,2324
110,30,-140,511,546,1057,2204
-50,-10,-40,541,516,1057,2106
70,-20,-130,496,561,1057,2273
-170,-20,-170,515,542,1057,2395
-60,0,-150,489,568,1057,2193
-70,-30,110,523,534,1057,2305
100,-20,-40,508,549,1057,2277
110,0,20,509,549,1058,2279
90,-10,10,513,545,1058,2187
-100,-10,-180,512,546,1058,2270
150,-60,-60,524,534,1058,2319
60,-60,50,507,551,1058,2313
-160,40,-20,514,544,1058,2232
-120,-40,-150,492,566,1058,2410
-150,40,-20,500,558,1058,2262
-70,-10,-100,494,564,1058,2152
-100,-10,180,512,546,1058,2270
-70,-60,-80,522,537,1059,2098
20,-10,140,539,520,1059,2387
-10,-80,140,531,528,1059,2171
100,-10,10,509,550,1059,2237
-150,30,-10,507,552,1059,2338
-110,10,130,522,537,1059,2188
90,10,50,521,538,1059,2244
-140,-20,-170,521,538,1059,2313
80,-10,-90,509,550,1059,2292
180,20,-20,535,525,1060,2184
100,-10,90,526,534,1060,2399
80,20,70,533,527,1060,2273
140,80,0,521,539,1060,2093
-180,20,-20,535,525,1060,2184
-120,60,-70,516,544,1060,2176
-100,-60,-120,522,538,1060,2278
-80,-80,-90,511,549,1060,2163
130,-40,150,530,530,1060,2302
-100,-30,70,517,543,1060,2352
-130,40,-20,497,563,1060,2191
120,-30,140,530,531,1061,2234
120,20,10,521,540,1061,2296
70,20,130,517,544,1061,2426
50,-20,-10,502,559,1061,2368
80,-10,-20,512,549,1061,2288
120,50,10,522,539,1061,2325
-130,-80,20,519,543,1062,2301
60,-20,0,510,552,1062,2268
100,40,50,509,553,1062,2419
-80,-10,120,515,547,1062,2404
-80,-20,110,514,548,1062,2364
-60,50,-150,527,535,1062,2144
40,-60,30,505,557,1062,2251
20,-60,160,520,542,1062,2175
80,40,80,527,535,1062,2484
50,-20,180,506,556,1062,2393
-130,20,140,514,548,1062,2260
50,-20,-180,506,556,1062,2393
100,-40,110,530,533,1063,2286
-70,60,-140,534,529,1063,2085
70,-10,-50,514,549,1063,2190
80,-30,60,529,534,1063,2201
80,10,130,529,534,1063,2257
-20,60,160,526,537,1063,2198
30,30,110,527,537,1064,2337
-60,-10,-170,505,559,1064,2321
50,0,160,512,552,1064,2530
80,70,-90,529,535,1064,2283
-130,0,170,533,531,1064,2229
-40,-80,-50,515,549,1064,2202
150,50,-160,505,560,1065,2370
100,0,50,532,533,1065,2225
-160,-70,-10,519,546,1065,2255
30,60,-40,523,542,1065,2155
-50,-20,160,518,547,1065,2288
20,10,130,530,535,1065,2255
70,-10,-170,502,563,1065,2259
60,10,-50,510,555,1065,2334
90,10,-140,516,549,1065,2301
-30,70,170,546,519,1065,2252
60,30,110,512,553,1065,2375
90,-10,0,518,547,1065,2202
90,20,50,521,544,1065,2256
160,40,-20,542,524,1066,2205
40,30,110,520,546,1066,2303
-50,20,-160,519,547,1066,2200
120,-20,-40,529,537,1066,2319
180,-40,-170,514,552,1066,2230
-100,-40,70,494,572,1066,2377
-180,-40,-170,514,552,1066,2230
110,0,10,526,541,1067,2322
90,-20,-50,527,540,1067,2201
70,-40,-130,517,550,1067,2321
70,-40,60,528,539,1067,2291
170,60,-20,530,537,1067,2310
-80,30,-40,525,542,1067,2258
90,-30,-60,514,553,1067,2309
110,-10,-10,522,546,1068,2299
70,-30,50,525,543,1068,2338
-10,-50,140,514,554,1068,2300
40,-10,-20,513,555,1068,2325
170,-50,-40,534,534,1068,2279
130,20,-10,531,537,1068,2205
20,-30,0,523,546,1069,2287
60,-20,-160,510,559,1069,2411
-100,-10,80,513,556,1069,2243
-110,50,-60,521,548,1069,2231
-50,-40,120,502,567,1069,2323
180,-70,-180,517,553,1070,2239
50,70,-60,524,546,1070,2381
-180,-70,180,517,553,1070,2239
180,-70,180,517,553,1070,2239
10,-10,140,528,542,1070,2345
170,60,-180,517,553,1070,2264
-30,-80,-40,508,562,1070,2207
170,60,180,517,553,1070,2264
-100,0,130,530,540,1070,2300
160,-50,170,522,548,1070,2161
0,30,140,538,532,1070,2234
80,-30,-80,512,558,1070,2417
170,0,-30,535,535,1070,2319
-180,-70,-180,517,553,1070,2239
80,20,-90,508,562,1070,2183
60,20,-50,517,554,1071,2254
70,-50,-130,518,553,1071,2336
130,50,0,527,544,1071,2209
-20,40,-10,526,545,1071,2347
-130,60,110,507,564,1071,2294
-90,-10,-180,512,559,1071,2358
-50,-60,110,526,545,1071,2291
-90,-10,180,512,559,1071,2358
110,10,20,515,557,1072,2390
-120,40,90,500,572,1072,2233
-20,-70,130,535,537,1072,2124
110,70,-120,539,533,1072,2274
160,-60,-50,529,543,1072,2309
80,0,100,532,541,1073,2392
30,-70,20,530,543,1073,2207
40,-30,0,513,560,1073,2474
-150,60,-40,524,549,1073,2316
-120,70,100,508,565,1073,2234
-120,-80,30,531,542,1073,2341
30,-60,170,533,541,1074,2248
70,20,110,509,565,1074,2405
60,0,-50,524,550,1074,2278
70,-30,-120,513,561,1074,2263
110,-50,120,534,540,1074,2326
120,-50,-70,525,549,1074,2232
10,-50,0,514,560,1074,2328
-110,10,70,516,558,1074,2422
0,-20,0,530,544,1074,2113
60,-50,-150,533,541,1074,2322
-70,-10,-120,492,582,1074,2220
100,-40,-60,519,555,1074,2355
70,20,-70,521,553,1074,2172
150,10,-30,543,532,1075,2355
-120,20,40,504,571,1075,2279
-20,-40,140,515,560,1075,2349
60,-10,-180,515,560,1075,2374
60,-10,180,515,560,1075,2374
80,-20,-110,519,556,1075,2476
-10,-80,-20,512,563,1075,2179
-20,-80,130,542,533,1075,2243
50,-40,-170,530,545,1075,2232
-90,-20,-160,525,551,1076,2399
-70,10,-120,507,569,1076,2399
130,-10,150,516,560,1076,2473
80,-30,-90,520,556,1076,2316
20,30,120,527,549,1076,2229
40,70,90,539,537,1076,2257
120,-30,-50,535,541,1076,2310
-90,30,-60,505,571,1076,2216
160,60,-170,502,574,1076,2213
-100,0,120,546,531,1077,2258
110,-10,120,526,551,1077,2368
140,-30,160,529,548,1077,2391
80,-20,30,541,536,1077,2315
30,20,-20,513,564,1077,2177
70,10,-80,505,572,1077,2246
-150,40,150,526,551,1077,2253
70,30,100,505,572,1077,2441
-90,-60,70,527,551,1078,2475
-90,30,-70,510,568,1078,2301
-140,50,130,525,553,1078,2249
50,-60,40,525,553,1078,2280
40,-10,160,534,544,1078,2385
80,-30,-100,524,555,1079,2320
160,-50,-50,540,539,1079,2333
150,-20,170,527,552,1079,2400
-40,10,-180,521,559,1080,2280
50,-10,170,522,558,1080,2366
0,20,140,537,543,1080,2343
110,10,-180,536,544,1080,2460
80,-20,-60,520,560,1080,2284
80,-50,80,530,550,1080,2303
90,30,-100,533,547,1080,2330
110,10,180,536,544,1080,2460
-40,10,180,521,559,1080,2280
90,0,140,545,535,1080,2256
60,0,-40,525,555,1080,2360
80,-10,-30,528,553,1081,2278
100,40,-110,532,549,1081,2294
50,0,-30,515,566,1081,2400
-20,-80,-30,511,570,1081,2216
-100,-60,60,527,554,1081,2438
120,-10,-30,533,548,1081,2385
-160,-20,-170,524,557,1081,2474
-130,-50,-150,517,564,1081,2385
50,40,100,531,550,1081,2356
-130,0,30,529,552,1081,2309
60,-10,-10,524,557,1081,2412
50,30,-40,529,552,1081,2311
-180,30,-20,531,551,1082,2233
70,-30,-130,527,555,1082,2333
180,30,-20,531,551,1082,2233
-110,-80,40,537,545,1082,2314
-50,80,-170,538,544,1082,2328
-120,30,10,515,567,1082,2342
-170,60,-30,534,548,1082,2310
-80,40,0,509,573,1082,2365
140,70,0,531,551,1082,2277
70,20,120,513,569,1082,2428
70,70,-80,534,548,1082,2364
-120,-70,-130,520,562,1082,2191
100,10,40,540,543,1083,2403
130,20,-170,535,548,1083,2320
50,20,130,531,552,1083,2398
-70,60,30,527,556,1083,2253
150,60,-10,541,542,1083,2242
20,-70,10,528,555,1083,2269
-120,30,110,525,558,1083,2437
90,0,-160,529,555,1084,2346
30,20,120,532,552,1084,2396
-80,-70,-90,544,540,1084,2384
50,50,90,539,545,1084,2345
-110,0,60,518,566,1084,2391
120,-20,140,536,548,1084,2457
90,20,-120,520,564,1084,2220
-110,0,160,541,543,1084,2298
-100,0,90,528,556,1084,2365
10,-60,0,520,564,1084,2409
30,-60,20,531,554,1085,2297
-50,-30,-50,515,570,1085,2204
170,50,-20,539,546,1085,2283
70,40,-60,538,547,1085,2152
120,-10,140,525,560,1085,2491
90,-70,90,524,561,1085,2371
-110,10,120,533,552,1085,2215
120,10,0,530,555,1085,2319
70,40,90,537,549,1086,2413
180,-60,-30,540,546,1086,2373
-60,-20,150,528,558,1086,2467
90,20,40,530,556,1086,2344
-180,-60,-30,540,546,1086,2373
50,30,110,522,564,1086,2492
90,0,80,529,557,1086,2358
-170,-70,-20,532,554,1086,2273
20,20,-20,514,573,1087,2308
80,0,90,542,545,1087,2399
40,0,-20,534,553,1087,2377
90,50,-90,531,556,1087,2361
-150,-20,-170,525,562,1087,2328
-80,-10,150,532,555,1087,2368
-80,-10,140,518,569,1087,2285
80,-10,-10,528,559,1087,2406
150,80,-10,536,551,1087,2211
140,-20,-50,537,550,1087,2406
40,-50,180,542,546,1088,2257
-150,10,0,530,558,1088,2318
40,-50,-180,542,546,1088,2257
-80,-30,-120,520,568,1088,2306
70,0,160,531,557,1088,2394
170,70,-180,532,557,1089,2078
150,-10,170,544,545,1089,2378
80,30,-80,534,555,1089,2170
-10,60,-10,521,568,1089,2144
30,10,130,539,550,1089,2451
-170,10,180,540,549,1089,2365
170,70,180,532,557,1089,2078
-80,-60,80,547,542,1089,2486
-170,10,-180,540,549,1089,2365
90,-30,80,529,561,1090,2374
-130,30,130,523,567,1090,2452
-150,-40,-160,538,552,1090,2452
-170,70,160,528,563,1091,2175
-120,10,150,546,545,1091,2298
-60,30,-20,540,551,1091,2411
110,-20,-40,531,560,1091,2300
80,-10,-80,532,559,1091,2315
80,0,-130,521,570,1091,2323
-50,30,-160,521,570,1091,2276
80,-10,-100,512,580,1092,2320
100,-30,100,535,557,1092,2357
60,20,130,534,558,1092,2590
-80,60,40,523,570,1093,2233
160,40,-170,533,560,1093,2367
40,-20,-10,517,576,1093,2435
80,0,-90,523,570,1093,2293
10,-20,0,528,565,1093,2326
80,-10,-110,519,574,1093,2420
-130,-40,30,541,552,1093,2391
-180,70,-30,543,551,1094,2338
30,70,100,556,538,1094,2278
110,-60,-90,550,544,1094,2305
110,-20,120,537,557,1094,2582
160,-40,-50,546,548,1094,2350
70,-20,-140,512,582,1094,2442
-20,30,160,555,539,1094,2305
180,70,-30,543,551,1094,2338
60,0,160,522,572,1094,2411
30,0,-10,524,571,1095,2388
10,30,130,537,558,1095,2386
110,-40,-60,545,550,1095,2292
-120,-10,180,545,550,1095,2323
160,10,-30,556,539,1095,2439
70,10,140,530,565,1095,2442
-120,-10,-180,545,550,1095,2323
-20,70,0,540,556,1096,2302
160,80,-170,555,541,1096,2220
50,-30,10,523,573,1096,2417
170,80,-180,550,546,1096,2200
80,10,-100,524,572,1096,2253
-20,40,160,551,545,1096,2296
170,80,180,550,546,1096,2200
60,90,80,555,542,1097,2318
-150,-70,0,539,558,1097,2340
-30,90,170,555,542,1097,2318
-160,90,-60,555,542,1097,2318
20,90,120,555,542,1097,2318
110,90,30,555,542,1097,2318
90,90,50,555,542,1097,2318
-150,90,-70,555,542,1097,2318
140,90,0,555,542,1097,2318
-140,90,-80,555,542,1097,2318
120,70,-130,552,545,1097,2369
-100,0,150,543,554,1097,2433
-60,90,-160,555,542,1097,2318
-90,90,-130,555,542,1097,2318
-10,90,150,555,542,1097,2318
10,90,130,555,542,1097,2318
40,90,100,555,542,1097,2318
160,90,-20,555,542,1097,2318
180,90,-40,555,542,1097,2318
-180,90,-40,555,542,1097,2318
170,-60,-40,548,549,1097,2329
30,90,110,555,542,1097,2318
-120,90,-100,555,542,1097,2318
50,90,90,555,542,1097,2318
70,90,70,555,542,1097,2318
100,90,40,555,542,1097,2318
-40,90,180,555,542,1097,2318
-100,90,-120,555,542,1097,2318
-50,90,-170,555,542,1097,2318
-130,90,-90,555,542,1097,2318
-20,-20,150,519,578,1097,2320
-70,90,-150,555,542,1097,2318
120,90,20,555,542,1097,2318
-170,90,-50,555,542,1097,2318
130,90,10,555,542,1097,2318
-40,90,-180,555,542,1097,2318
-20,90,160,555,542,1097,2318
0,90,140,555,542,1097,2318
-110,90,-110,555,542,1097,2318
-80,90,-140,555,542,1097,2318
150,90,-10,555,542,1097,2318
160,50,-170,528,569,1097,2453
170,90,-30,555,542,1097,2318
80,90,60,555,542,1097,2318
100,-10,0,529,569,1098,2452
10,-70,0,535,563,1098,2305
130,0,160,529,569,1098,2369
110,-30,-50,550,548,1098,2470
100,10,-170,535,563,1098,2406
80,0,110,538,560,1098,2450
0,10,-10,551,547,1098,2226
60,0,-30,534,564,1098,2437
50,-10,-20,524,574,1098,2489
-130,-50,30,551,548,1099,2411
150,80,-160,565,534,1099,2288
-30,-80,120,552,547,1099,2287
-140,-60,-150,538,561,1099,2436
90,-60,90,530,569,1099,2310
90,10,-130,530,570,1100,2400
80,30,80,531,569,1100,2346
-90,40,-100,532,568,1100,2303
-10,20,150,550,550,1100,2280
90,-40,-80,524,576,1100,2301
80,-10,-50,536,564,1100,2420
80,-20,-70,526,574,1100,2472
40,-20,160,539,562,1101,2494
90,-20,60,532,569,1101,2321
80,-10,-60,540,561,1101,2437
100,-10,100,532,569,1101,2416
-180,-50,-30,571,530,1101,2265
60,-20,10,535,566,1101,2387
-70,-20,120,536,565,1101,2392
180,-50,-30,571,530,1101,2265
80,-40,80,537,564,1101,2400
80,-60,-130,556,545,1101,2371
-80,-10,130,521,581,1102,2347
-90,-40,80,522,580,1102,2304
20,-50,10,532,570,1102,2394
-80,-40,90,528,574,1102,2485
30,-10,-10,547,555,1102,2422
-150,60,140,520,582,1102,2336
130,-20,-50,550,552,1102,2381
140,-60,-70,535,567,1102,2344
80,0,170,550,553,1103,2386
80,-10,-70,536,567,1103,2352
-20,-10,-10,544,559,1103,2076
0,-30,0,521,582,1103,2161
160,10,-180,538,565,1103,2457
130,-10,-40,541,562,1103,2475
-60,-80,90,548,555,1103,2390
-150,10,170,537,566,1103,2431
160,10,180,538,565,1103,2457
90,-10,-10,543,561,1104,2302
90,30,60,534,570,1104,2380
100,-60,-100,547,557,1104,2392
90,0,70,541,563,1104,2493
-70,0,-120,525,579,1104,2295
140,80,-150,572,533,1105,2299
30,-30,0,525,580,1105,2419
20,-60,10,520,585,1105,2424
70,0,-70,543,562,1105,2335
-170,-60,-20,563,542,1105,2402
170,-40,-40,571,534,1105,2312
-110,10,60,536,569,1105,2248
160,70,-170,543,562,1105,2146
100,30,40,537,569,1106,2288
180,70,170,539,567,1106,2114
-180,80,170,548,558,1106,2199
-60,80,-160,545,561,1106,2367
80,-10,-160,529,577,1106,2288
180,80,170,548,558,1106,2199
-180,70,170,539,567,1106,2114
-100,-20,70,526,581,1107,2380
80,-40,-100,543,564,1107,2360
-10,-40,-10,540,567,1107,2343
-70,-10,-160,532,575,1107,2352
80,-20,40,550,557,1107,2444
40,0,150,525,582,1107,2361
-70,-10,-130,525,582,1107,2358
140,30,-160,544,564,1108,2475
20,-20,0,540,568,1108,2423
-120,0,170,537,571,1108,2418
90,0,-170,536,572,1108,2417
-40,-80,110,558,550,1108,2348
60,-20,-170,523,585,1108,2351
40,70,-50,541,567,1108,2428
70,-10,170,532,576,1108,2350
70,20,100,534,575,1109,2480
50,70,80,562,547,1109,2418
110,60,20,547,562,1109,2235
90,0,-150,532,577,1109,2408
-100,-30,-150,533,576,1109,2437
130,70,-140,557,552,1109,2400
140,-60,150,544,565,1109,2281
-90,-20,-150,526,583,1109,2304
20,0,-10,548,561,1109,2413
150,70,-160,544,566,1110,2330
90,40,60,520,590,1110,2391
-20,20,160,565,545,1110,2326
-100,-80,50,539,571,1110,2384
-160,10,-10,553,558,1111,2313
100,0,40,539,572,1111,2483
-100,-20,-160,545,566,1111,2574
-130,50,-40,522,589,1111,2392
-140,-10,20,532,579,1111,2431
-30,-50,-30,551,560,1111,2335
-80,-10,170,532,580,1112,2365
100,-20,100,531,581,1112,2566
130,-20,160,558,554,1112,2389
-110,40,-30,531,581,1112,2377
60,40,-50,543,570,1113,2203
-70,-40,-90,533,580,1113,2295
100,20,-140,536,577,1113,2414
70,0,150,554,559,1113,2405
-120,-50,40,544,570,1114,2524
80,-30,70,552,562,1114,2407
60,50,-60,553,561,1114,2278
100,-20,-50,543,571,1114,2434
70,30,-60,546,568,1114,2271
40,30,-30,556,558,1114,2375
140,40,-150,553,561,1114,2490
-50,-30,130,539,575,1114,2550
120,40,10,552,562,1114,2482
-50,-80,100,554,560,1114,2387
60,10,140,535,579,1114,2514
-100,0,80,531,583,1114,2290
90,80,-100,542,573,1115,2341
160,-10,-180,557,558,1115,2481
80,0,130,542,573,1115,2397
160,-10,180,557,558,1115,2481
60,-30,-160,532,584,1116,2334
90,-10,20,535,581,1116,2278
-100,0,100,551,565,1116,2390
-70,-80,80,548,568,1116,2407
-120,10,40,528,588,1116,2350
80,10,-90,529,587,1116,2398
150,-50,-60,550,567,1117,2379
-90,40,10,535,582,1117,2427
80,-50,-120,543,574,1117,2483
-30,50,170,556,561,1117,2258
80,-10,-170,537,580,1117,2426
80,-60,80,543,574,1117,2364
30,-40,160,557,561,1118,2451
110,50,20,541,577,1118,2428
110,-40,130,557,561,1118,2308
50,80,-60,565,553,1118,2401
-90,30,-80,536,582,1118,2304
-80,-10,180,540,579,1119,2461
150,0,170,532,587,1119,2606
-80,-10,-180,540,579,1119,2461
160,-10,-40,574,545,1119,2445
70,-60,70,545,574,1119,2395
140,-30,-60,550,569,1119,2425
-80,10,-70,535,584,1119,2318
80,0,-80,544,576,1120,2405
40,20,120,542,578,1120,2440
90,0,150,559,561,1120,2420
110,0,150,545,575,1120,2471
-180,-20,-170,540,580,1120,2426
90,0,60,560,560,1120,2501
100,0,150,565,555,1120,2438
180,-20,-170,540,580,1120,2426
-120,-30,40,544,576,1120,2424
-100,50,-90,544,576,1120,2245
60,-50,50,532,588,1120,2407
-90,-80,60,542,578,1120,2425
-80,-20,-140,545,576,1121,2442
120,40,-130,552,569,1121,2423
-40,-50,120,541,580,1121,2415
-60,-40,110,546,575,1121,2513
50,10,140,532,589,1121,2508
-100,70,-110,561,561,1122,2191
40,-60,-180,571,551,1122,2380
-90,-20,90,552,570,1122,2379
50,-40,30,548,574,1122,2477
40,-60,180,571,551,1122,2380
-60,-50,-70,535,587,1122,2377
-60,-30,120,558,564,1122,2424
-100,-10,70,537,585,1122,2272
30,-20,150,546,576,1122,2475
-120,0,40,546,576,1122,2333
-90,-70,-100,565,558,1123,2496
-100,40,20,533,590,1123,2412
80,-20,-120,539,584,1123,2487
80,-10,-150,548,575,1123,2368
-70,-10,-80,536,587,1123,2326
80,0,120,555,569,1124,2339
90,-10,-20,545,579,1124,2381
40,40,100,567,557,1124,2516
-80,-80,70,551,573,1124,2414
60,80,-70,559,565,1124,2414
140,-10,160,544,580,1124,2577
120,30,10,567,557,1124,2450
30,-40,10,542,582,1124,2464
140,70,-150,553,571,1124,2447
110,-10,-20,548,577,1125,2402
-100,40,-40,537,588,1125,2379
100,10,-160,553,572,1125,2459
90,-20,70,552,573,1125,2476
120,20,-160,544,581,1125,2458
-80,20,-50,554,571,1125,2403
-40,50,0,535,591,1126,2312
100,50,-100,554,572,1126,2353
50,20,-30,549,577,1126,2378
10,-50,150,545,582,1127,2355
-140,-30,-160,553,574,1127,2421
70,-20,30,555,572,1127,2520
40,-40,170,552,575,1127,2445
120,0,160,539,588,1127,2443
-90,50,-110,554,573,1127,2227
70,-10,0,559,568,1127,2475
-100,40,-60,551,576,1127,2322
40,60,90,554,573,1127,2448
130,80,-140,585,542,1127,2281
150,-30,170,552,575,1127,2506
120,60,10,548,579,1127,2211
90,-50,-100,554,573,1127,2492
80,0,-110,532,596,1128,2447
150,-40,-60,561,567,1128,2415
140,-40,160,546,582,1128,2477
70,-30,-140,540,588,1128,2428
40,-40,20,550,578,1128,2482
80,-70,80,543,585,1128,2485
130,-30,-60,559,569,1128,2452
170,-50,180,545,583,1128,2490
170,-50,-180,545,583,1128,2490
80,80,-90,552,577,1129,2381
-70,-10,-150,545,584,1129,2465
-70,-60,90,554,575,1129,2530
-110,60,-90,547,582,1129,2275
0,10,140,565,565,1130,2333
90,-10,-30,544,586,1130,2381
100,20,30,559,571,1130,2478
100,-50,110,557,573,1130,2418
80,0,-120,533,597,1130,2456
-90,-40,-120,536,594,1130,2279
70,80,-80,559,572,1131,2394
110,-30,130,567,564,1131,2476
10,20,130,568,563,1131,2344
60,10,-40,551,580,1131,2432
90,-30,-70,550,581,1131,2563
-60,-40,-70,538,593,1131,2367
130,-30,160,566,565,1131,2387
90,50,50,553,578,1131,2457
60,20,120,544,588,1132,2706
-140,40,140,557,575,1132,2417
80,0,-100,530,602,1132,2393
90,10,40,568,564,1132,2524
100,80,-110,566,566,1132,2321
80,-10,0,544,588,1132,2535
-120,-10,40,542,590,1132,2349
70,-20,-150,528,604,1132,2476
110,40,-120,566,566,1132,2404
60,-10,170,536,596,1132,2402
70,-40,-140,543,589,1132,2424
80,-10,-120,550,582,1132,2479
-110,-30,-150,542,591,1133,2534
-140,20,0,545,588,1133,2447
-110,-50,50,557,576,1133,2555
-70,-10,170,532,601,1133,2438
50,-50,40,545,588,1133,2423
50,10,-20,549,584,1133,2476
30,60,100,566,567,1133,2426
20,-40,10,547,587,1134,2414
-20,0,-10,557,577,1134,2199
-110,20,100,528,606,1134,2339
-170,80,160,561,573,1134,2258
-140,30,-10,536,598,1134,2389
130,-60,-80,555,579,1134,2413
100,30,-120,552,582,1134,2493
-160,-60,-160,547,587,1134,2348
-110,-20,-160,556,579,1135,2500
70,-50,70,544,591,1135,2435
50,-20,0,555,580,1135,2495
110,80,-120,579,556,1135,2332
-150,50,-30,546,589,1135,2341
90,-40,-90,552,583,1135,2474
180,-10,-170,563,573,1136,2485
-180,-10,-170,563,573,1136,2485
90,-10,-40,566,570,1136,2465
-70,-40,100,562,574,1136,2460
130,40,-140,556,580,1136,2511
0,-10,0,548,588,1136,2360
-170,30,-20,564,572,1136,2327
80,-10,-130,549,587,1136,2470
-40,-30,140,561,575,1136,2621
110,0,0,558,578,1136,2418
130,-50,-70,558,579,1137,2401
-160,70,150,549,588,1137,2334
110,20,-150,544,593,1137,2502
30,-70,170,564,573,1137,2436
130,-60,140,563,575,1138,2303
160,-20,180,569,569,1138,2621
160,-20,-180,569,569,1138,2621
30,-50,20,550,588,1138,2395
-70,-20,-90,539,599,1138,2381
140,10,-30,583,555,1138,2403
-40,-40,-40,558,581,1139,2349
150,40,-160,548,591,1139,2503
180,-40,-30,583,556,1139,2369
120,-60,130,558,581,1139,2420
-180,-40,-30,583,556,1139,2369
-140,60,-50,551,588,1139,2444
-130,60,-60,557,582,1139,2432
90,-10,30,561,579,1140,2449
160,30,-170,559,581,1140,2474
-60,-60,100,561,579,1140,2475
-170,20,-180,548,592,1140,2422
-170,20,180,548,592,1140,2422
50,-30,20,556,584,1140,2490
90,-20,-60,556,584,1140,2432
-120,40,100,537,603,1140,2486
110,20,20,560,581,1141,2598
-120,-40,40,552,589,1141,2561
-50,-20,150,554,587,1141,2454
40,80,-50,569,572,1141,2453
-70,-10,-140,524,617,1141,2382
-80,10,-80,540,601,1141,2341
20,-10,0,558,583,1141,2515
150,-20,-50,564,577,1141,2516
-70,-30,-90,520,622,1142,2408
80,-10,-140,568,574,1142,2417
90,40,-90,564,578,1142,2382
10,-60,150,574,568,1142,2386
-130,-10,30,540,602,1142,2407
-110,-30,50,542,600,1142,2468
-160,50,-30,568,575,1143,2451
90,30,50,559,584,1143,2493
110,-50,-80,552,591,1143,2360
20,70,110,577,566,1143,2375
80,0,140,555,588,1143,2454
130,0,-30,568,575,1143,2538
40,-50,30,554,590,1144,2400
-120,20,130,562,582,1144,2534
90,0,180,563,581,1144,2473
90,0,-180,563,581,1144,2473
80,-40,-110,550,595,1145,2460
110,50,-110,553,592,1145,2348
-90,-10,100,558,587,1145,2464
40,-70,180,579,566,1145,2460
-70,80,-150,568,577,1145,2423
-110,10,140,573,572,1145,2386
40,-70,-180,579,566,1145,2460
160,0,180,561,585,1146,2616
-100,-10,-170,551,595,1146,2631
-110,50,-70,549,597,1146,2299
130,10,-20,580,566,1146,2373
100,-40,-70,546,600,1146,2474
-90,-10,110,554,592,1146,2548
80,0,150,568,578,1146,2484
160,0,-180,561,585,1146,2616
70,0,140,565,581,1146,2560
-80,30,-110,549,598,1147,2330
140,10,-180,556,591,1147,2541
-140,-70,10,552,595,1147,2478
80,0,160,575,572,1147,2435
-100,40,-70,550,597,1147,2414
140,10,180,556,591,1147,2541
-170,20,-20,574,574,1148,2423
100,-10,110,568,580,1148,2491
70,20,90,564,584,1148,2519
50,-70,-170,570,578,1148,2512
120,10,-180,555,593,1148,2561
120,10,180,555,593,1148,2561
110,-10,130,556,593,1149,2522
60,50,80,565,584,1149,2526
30,-20,0,546,603,1149,2483
150,-60,160,560,589,1149,2274
70,10,-70,552,597,1149,2475
90,0,170,571,578,1149,2526
20,-40,150,570,579,1149,2516
60,-40,50,547,603,1150,2531
80,30,70,557,593,1150,2421
90,-20,80,555,595,1150,2581
80,40,70,553,597,1150,2637
150,10,-180,551,599,1150,2602
150,10,180,551,599,1150,2602
70,0,-60,558,593,1151,2495
70,0,-30,564,587,1151,2472
80,40,-70,580,571,1151,2448
50,-30,180,552,599,1151,2498
100,-20,-60,569,582,1151,2541
60,0,150,553,598,1151,2525
50,-30,-180,552,599,1151,2498
-170,-70,-170,548,603,1151,2378
-120,-20,-160,560,591,1151,2474
60,0,-20,565,586,1151,2498
60,70,70,579,573,1152,2490
-120,50,-50,557,595,1152,2377
-180,30,-180,558,594,1152,2308
90,-20,-70,564,588,1152,2546
180,30,180,558,594,1152,2308
90,-10,50,566,586,1152,2527
100,-50,-90,561,591,1152,2454
-180,30,180,558,594,1152,2308
180,30,-180,558,594,1152,2308
120,80,-130,601,552,1153,2314
-100,0,160,567,586,1153,2496
20,-70,160,568,585,1153,2449
-30,-10,160,549,604,1153,2498
90,-10,40,561,592,1153,2527
-60,-20,-60,553,600,1153,2387
70,30,90,554,599,1153,2589
-110,-70,-120,563,590,1153,2468
-110,40,60,540,613,1153,2479
90,20,-110,551,603,1154,2404
-110,20,110,556,598,1154,2513
140,50,-10,579,575,1154,2319
-30,-70,120,569,585,1154,2331
40,-30,10,558,596,1154,2645
-60,-10,180,543,612,1155,2548
-150,-30,-160,551,604,1155,2400
80,-30,-110,545,610,1155,2492
-130,10,160,566,589,1155,2520
-70,-10,-180,549,606,1155,2582
30,80,-40,578,577,1155,2493
160,80,-20,571,584,1155,2326
60,-30,40,563,592,1155,2466
80,10,70,584,571,1155,2621
-60,-10,-180,543,612,1155,2548
-80,-10,160,574,581,1155,2550
-80,40,-120,557,598,1155,2451
-80,20,-100,557,598,1155,2331
-70,-10,180,549,606,1155,2582
-40,70,180,586,570,1156,2444
-100,-70,-110,569,587,1156,2505
60,30,100,551,605,1156,2643
-40,70,-180,586,570,1156,2444
60,-40,-160,561,595,1156,2457
130,30,-150,565,591,1156,2511
70,10,90,577,579,1156,2590
-110,-20,50,571,585,1156,2379
80,-20,50,570,586,1156,2547
-10,10,-10,576,580,1156,2323
-80,10,-60,559,597,1156,2321
-150,20,-10,570,587,1157,2511
110,-10,-30,579,578,1157,2560
-120,30,0,548,609,1157,2510
70,-50,-140,550,607,1157,2531
100,-20,110,558,599,1157,2643
-100,60,70,553,604,1157,2425
-90,-30,80,577,580,1157,2436
30,10,-10,566,592,1158,2388
-20,-60,130,558,600,1158,2423
-110,40,70,550,608,1158,2547
-100,-50,60,570,588,1158,2490
100,-30,-60,558,600,1158,2538
20,60,-30,565,593,1158,2304
0,-40,0,568,590,1158,2418
-20,30,-10,575,583,1158,2372
-90,-30,-130,546,613,1159,2491
140,30,-20,595,564,1159,2432
140,0,-40,590,569,1159,2562
30,70,-40,567,592,1159,2493
-120,20,30,548,611,1159,2531
-170,10,-20,583,577,1160,2433
100,-30,110,572,588,1160,2533
50,0,-20,560,600,1160,2585
90,0,160,563,597,1160,2525
100,0,160,570,590,1160,2548
10,30,-20,561,599,1160,2494
10,-10,0,551,609,1160,2482
60,-20,-180,558,602,1160,2490
50,-10,-10,556,604,1160,2643
90,-10,90,563,597,1160,2667
100,40,40,564,596,1160,2695
60,-20,180,558,602,1160,2490
120,-10,150,573,588,1161,2649
20,-30,10,562,599,1161,2416
-120,40,-30,552,609,1161,2545
70,10,110,574,588,1162,2565
-160,-40,-160,565,597,1162,2449
-120,50,100,551,611,1162,2572
-30,60,170,568,594,1162,2469
90,0,-80,554,609,1163,2576
-30,-20,-20,562,601,1163,2325
-120,-50,-140,555,608,1163,2563
10,10,-10,551,612,1163,2390
50,-10,160,575,588,1163,2606
150,0,-40,591,572,1163,2575
10,40,-20,553,610,1163,2429
90,-20,-80,573,591,1164,2622
40,-10,-10,561,603,1164,2610
90,0,50,587,577,1164,2615
100,0,30,560,604,1164,2648
90,-30,90,564,600,1164,2525
120,-30,150,584,580,1164,2411
120,-20,150,574,590,1164,2628
50,60,80,578,586,1164,2602
80,70,50,583,582,1165,2536
110,10,10,565,600,1165,2595
150,70,-10,564,601,1165,2483
-160,0,-180,579,586,1165,2626
-70,-10,-170,555,610,1165,2603
-160,0,180,579,586,1165,2626
130,10,180,556,610,1166,2648
80,50,60,562,604,1166,2590
110,-80,110,566,600,1166,2460
60,-60,60,561,605,1166,2557
90,70,40,583,583,1166,2434
90,-10,-50,575,591,1166,2491
-180,-30,-30,606,560,1166,2426
30,40,-30,567,599,1166,2450
180,-30,-30,606,560,1166,2426
130,10,-180,556,610,1166,2648
-130,20,10,582,585,1167,2530
-60,-20,140,575,592,1167,2709
40,0,-10,571,596,1167,2600
60,0,140,570,597,1167,2554
-30,40,170,572,595,1167,2497
60,-80,-160,589,579,1168,2526
80,60,-80,575,593,1168,2488
-90,30,-50,564,604,1168,2416
70,70,60,584,584,1168,2542
70,-20,-160,550,618,1168,2537
70,0,-50,567,601,1168,2520
40,10,130,574,595,1169,2716
110,10,-170,563,606,1169,2640
100,10,-150,563,606,1169,2472
70,20,-60,559,610,1169,2477
140,0,170,565,604,1169,2622
-40,-20,-30,572,597,1169,2394
-70,-20,110,570,600,1170,2536
20,-20,140,592,578,1170,2519
140,-80,140,568,602,1170,2510
60,30,-40,581,590,1171,2477
-60,50,10,557,614,1171,2501
-140,10,10,570,601,1171,2575
70,10,100,595,576,1171,2614
-170,-40,-20,586,585,1171,2514
-160,-30,-160,576,595,1171,2489
-110,20,70,549,622,1171,2446
100,60,30,593,578,1171,2428
-170,-40,-160,574,597,1171,2479
-50,-10,170,564,607,1171,2675
130,-10,160,558,613,1171,2637
-30,20,170,583,588,1171,2435
60,40,90,569,603,1172,2658
-110,20,90,573,599,1172,2591
160,-60,170,565,607,1172,2391
50,-60,-170,587,585,1172,2507
-30,30,-10,578,594,1172,2564
-150,30,160,577,595,1172,2645
50,20,120,573,599,1172,2691
70,-70,70,575,597,1172,2589
60,-10,0,571,601,1172,2555
50,0,150,568,605,1173,2719
60,20,-40,564,609,1173,2483
60,-20,20,571,602,1173,2628
-90,0,140,569,604,1173,2475
-110,70,90,551,622,1173,2389
-20,-50,-20,579,594,1173,2318
50,-80,-170,584,589,1173,2547
-60,40,-150,576,597,1173,2522
70,20,80,579,594,1173,2573
60,-70,-160,580,593,1173,2568
-160,-60,-10,583,590,1173,2543
90,10,-110,565,608,1173,2602
150,40,-20,589,585,1174,2495
70,10,130,573,601,1174,2617
-10,50,-10,561,613,1174,2397
-100,40,-50,564,611,1175,2562
120,20,0,579,596,1175,2505
80,0,80,608,567,1175,2572
170,-30,-40,603,572,1175,2417
-80,-10,-160,552,624,1176,2579
90,-10,-80,576,600,1176,2530
90,-10,-90,570,606,1176,2582
100,10,30,575,601,1176,2584
100,70,30,591,585,1176,2450
-10,-40,140,570,606,1176,2510
110,-20,-50,572,604,1176,2685
160,50,-20,596,580,1176,2502
90,20,30,587,589,1176,2550
120,-30,-60,589,588,1177,2677
100,-10,-10,552,625,1177,2599
120,-80,120,572,605,1177,2477
90,-60,-120,589,588,1177,2548
-160,-50,-160,585,593,1178,2625
60,-50,60,572,606,1178,2595
-70,30,-130,558,620,1178,2430
70,60,-70,567,611,1178,2484
-80,-10,-170,573,605,1178,2578
-40,10,-20,574,604,1178,2491
120,0,-20,584,594,1178,2579
-80,60,-130,587,591,1178,2462
70,-10,160,573,605,1178,2616
-90,0,130,568,610,1178,2503
80,-20,-130,571,607,1178,2621
70,-40,70,574,604,1178,2646
90,-20,-90,570,609,1179,2588
100,30,30,577,602,1179,2495
70,-30,60,567,612,1179,2552
-90,30,-90,574,605,1179,2441
90,-10,70,576,604,1180,2638
-110,70,-100,593,587,1180,2329
-170,-50,-20,602,578,1180,2448
170,-20,-170,574,606,1180,2621
10,-70,150,583,597,1180,2497
-110,-40,-140,565,615,1180,2634
140,-20,170,588,592,1180,2555
-120,60,100,572,608,1180,2536
130,-80,130,575,606,1181,2501
-100,40,-80,570,611,1181,2508
0,0,140,579,602,1181,2577
80,0,-70,581,600,1181,2567
80,20,60,589,592,1181,2558
100,-10,-20,571,610,1181,2610
80,-30,-120,560,622,1182,2635
130,60,0,584,598,1182,2325
-110,20,80,560,622,1182,2551
-110,-10,-170,562,620,1182,2531
-170,-10,-170,582,600,1182,2708
70,10,120,579,603,1182,2653
50,-50,-170,587,596,1183,2567
100,-80,100,568,615,1183,2515
-160,30,170,583,600,1183,2637
-140,60,130,552,632,1184,2578
90,-10,60,584,600,1184,2595
150,-30,-60,590,594,1184,2563
-10,40,-10,567,617,1184,2524
90,-20,-100,573,611,1184,2680
150,-80,150,567,617,1184,2533
110,30,20,596,588,1184,2641
-80,-60,-90,582,602,1184,2522
110,0,160,567,617,1184,2701
-100,40,30,572,612,1184,2578
70,-80,-150,599,585,1184,2588
70,0,-40,572,612,1184,2536
90,20,-100,575,610,1185,2567
-80,80,-140,579,606,1185,2489
110,-30,140,586,599,1185,2551
100,-10,120,579,606,1185,2642
140,-10,-50,589,596,1185,2669
80,-10,10,573,612,1185,2682
-90,50,40,579,606,1185,2536
40,-20,0,568,617,1185,2637
-160,80,150,582,603,1185,2346
-90,-50,-110,582,604,1186,2460
-110,0,170,581,605,1186,2760
-70,0,-60,577,609,1186,2466
100,-10,-30,586,600,1186,2594
20,0,130,596,591,1187,2560
40,20,-20,575,612,1187,2440
140,20,-170,565,622,1187,2659
-140,-50,-150,573,614,1187,2645
-120,10,160,589,598,1187,2546
70,0,130,587,600,1187,2546
160,-30,-50,596,592,1188,2580
-70,-30,100,588,600,1188,2600
-80,30,-30,575,613,1188,2666
90,10,-120,573,615,1188,2497
50,-30,30,577,612,1189,2537
-150,70,140,570,619,1189,2479
90,-40,100,581,608,1189,2605
70,-20,40,600,589,1189,2680
-60,0,-160,555,634,1189,2583
0,-10,140,576,613,1189,2499
-100,-30,-140,559,630,1189,2650
-140,30,150,585,605,1190,2647
50,-60,50,567,623,1190,2584
130,30,-10,591,599,1190,2621
120,-50,-80,583,607,1190,2449
90,-50,100,576,614,1190,2524
80,20,-80,558,632,1190,2569
-50,20,-20,582,608,1190,2623
-160,-10,-170,581,609,1190,2660
-120,-70,30,584,607,1191,2555
80,10,50,595,596,1191,2677
80,-80,-140,606,585,1191,2633
100,-40,-80,569,622,1191,2687
90,-10,-100,560,631,1191,2578
-90,-10,-170,590,601,1191,2614
-50,10,-170,573,619,1192,2543
170,80,-30,588,604,1192,2462
70,30,80,578,614,1192,2633
70,50,70,588,604,1192,2677
90,30,40,585,607,1192,2568
90,-30,-80,571,621,1192,2695
100,-10,-40,598,594,1192,2603
-80,10,-90,575,617,1192,2483
90,-10,110,592,601,1193,2706
80,-10,-180,589,604,1193,2647
90,-10,100,599,594,1193,2690
-130,-70,20,583,610,1193,2529
-170,70,-40,588,605,1193,2496
80,-10,180,589,604,1193,2647
80,10,-80,568,626,1194,2575
-70,30,-20,579,615,1194,2602
-110,-10,50,579,615,1194,2419
-30,-20,150,561,633,1194,2632
90,-50,-110,578,616,1194,2667
-160,50,160,584,610,1194,2536
-70,-10,140,578,616,1194,2724
40,-80,-180,591,603,1194,2587
40,-80,180,591,603,1194,2587
60,10,-30,579,615,1194,2616
70,40,80,578,617,1195,2712
100,0,20,569,626,1195,2734
110,-20,130,585,610,1195,2710
-140,10,170,576,619,1195,2634
-130,-40,-150,576,619,1195,2588
-130,50,120,576,619,1195,2543
90,0,40,592,603,1195,2652
-100,-70,50,587,608,1195,2632
170,10,-30,594,602,1196,2554
150,20,-30,609,587,1196,2545
-170,-20,-20,580,616,1196,2533
100,-10,-50,603,593,1196,2583
-170,50,170,572,624,1196,2544
-100,0,170,575,621,1196,2633
80,-40,-120,582,614,1196,2589
90,-10,-110,579,617,1196,2590
100,-40,120,587,609,1196,2611
150,20,-170,584,613,1197,2651
-70,40,0,566,631,1197,2482
50,-40,180,584,613,1197,2608
90,-30,-90,577,620,1197,2740
-70,0,-130,571,626,1197,2555
30,-30,10,581,616,1197,2512
90,0,-60,593,604,1197,2646
50,-40,-180,584,613,1197,2608
-170,-30,-160,571,626,1197,2596
140,-10,170,590,607,1197,2731
120,-20,-50,592,606,1198,2630
-70,-10,160,590,608,1198,2645
20,60,110,590,608,1198,2562
60,-20,30,580,618,1198,2690
30,0,130,603,595,1198,2596
90,60,40,602,596,1198,2558
90,-10,80,580,619,1199,2682
-40,60,180,589,610,1199,2525
-60,10,-150,582,617,1199,2483
50,50,-50,585,614,1199,2561
90,0,-90,573,626,1199,2586
-130,30,-10,569,630,1199,2608
-110,-70,40,595,604,1199,2596
110,40,20,576,623,1199,2664
-40,60,-180,589,610,1199,2525
120,50,-120,597,602,1199,2505
90,-10,-60,597,603,1200,2566
-170,-30,-20,606,594,1200,2545
-30,-40,130,589,611,1200,2744
90,-10,-70,581,619,1200,2607
90,-80,-130,609,591,1200,2646
110,-80,-110,603,597,1200,2671
-130,40,130,582,619,1201,2651
110,-10,140,593,608,1201,2731
70,0,-20,582,619,1201,2623
10,-40,10,594,608,1202,2483
-90,0,150,594,608,1202,2664
110,-60,120,593,609,1202,2562
120,30,-140,582,620,1202,2584
100,-10,-60,609,593,1202,2577
90,-10,130,592,611,1203,2592
-110,30,60,582,621,1203,2727
100,-10,130,595,608,1203,2696
-80,-20,-130,583,620,1203,2627
90,-40,-100,587,616,1203,2564
130,0,170,567,636,1203,2608
-130,-60,-140,577,626,1203,2643
60,-10,160,586,617,1203,2618
70,-70,-150,596,608,1204,2581
10,-20,140,586,618,1204,2615
30,-10,0,591,613,1204,2628
-60,-20,130,578,626,1204,2716
-140,20,160,585,619,1204,2633
180,-50,-170,605,599,1204,2706
-10,30,-10,591,613,1204,2479
90,40,50,580,624,1204,2712
80,-20,-140,579,625,1204,2781
-40,-70,110,598,606,1204,2509
130,-20,170,611,593,1204,2570
-180,-50,-170,605,599,1204,2706
30,-80,170,594,611,1205,2616
20,80,-30,588,617,1205,2599
70,0,120,608,597,1205,2556
-110,0,50,570,635,1205,2573
110,30,-130,583,622,1205,2579
-90,-10,90,593,612,1205,2532
50,40,-40,594,612,1206,2496
130,-80,-90,610,596,1206,2652
60,10,130,578,628,1206,2652
-100,0,70,590,616,1206,2510
120,-80,-100,605,601,1206,2672
170,-10,-170,597,610,1207,2698
160,-30,180,587,620,1207,2539
160,-30,-180,587,620,1207,2539
90,10,-100,583,624,1207,2598
-110,-40,50,586,621,1207,2626
-110,10,150,597,610,1207,2556
90,30,30,593,614,1207,2564
100,-80,-120,610,597,1207,2681
-50,0,-30,596,611,1207,2535
-90,-50,70,571,637,1208,2618
50,-20,10,586,622,1208,2614
30,50,100,602,606,1208,2599
20,10,-10,575,633,1208,2496
90,0,-70,581,627,1208,2659
80,-20,60,585,623,1208,2698
-70,10,-130,575,633,1208,2616
100,0,10,589,619,1208,2702
-90,0,160,582,627,1209,2705
40,10,-10,588,621,1209,2609
70,10,80,600,609,1209,2674
50,-40,40,575,634,1209,2637
90,60,-90,598,611,1209,2570
-60,0,-40,591,618,1209,2516
-150,-60,0,606,603,1209,2599
100,0,-160,591,618,1209,2685
-30,30,170,597,613,1210,2512
20,50,110,607,603,1210,2524
80,-50,-130,579,631,1210,2693
90,30,-90,595,615,1210,2687
80,0,-60,579,632,1211,2720
90,0,-140,576,635,1211,2641
70,-20,-170,586,625,1211,2579
80,-10,110,612,599,1211,2692
80,20,50,597,614,1211,2600
100,-20,-70,606,606,1212,2731
20,70,-30,584,628,1212,2530
-70,-20,-80,574,638,1212,2597
140,-50,-70,591,621,1212,2575
70,-20,50,594,618,1212,2735
80,0,-40,572,640,1212,2599
-100,10,90,573,639,1212,2578
110,-40,-70,583,629,1212,2702
-120,-30,-150,585,628,1213,2618
-30,70,10,595,618,1213,2569
180,-20,-30,616,597,1213,2459
-80,-20,100,605,608,1213,2768
-130,20,150,586,627,1213,2666
100,0,170,590,623,1213,2714
-180,-20,-30,616,597,1213,2459
70,0,70,600,614,1214,2683
70,20,70,593,621,1214,2754
-160,0,-10,613,601,1214,2513
-90,0,120,600,615,1215,2708
70,-20,-180,595,620,1215,2584
50,30,100,596,619,1215,2746
70,-20,180,595,620,1215,2584
60,60,70,599,616,1215,2718
80,0,-50,593,622,1215,2663
60,20,110,586,630,1216,2772
-100,-20,-150,585,631,1216,2613
70,-10,10,599,617,1216,2731
-50,70,-170,609,607,1216,2592
90,-10,120,599,617,1216,2701
-70,20,-130,577,639,1216,2559
10,10,130,612,604,1216,2643
90,-20,90,590,626,1216,2701
140,-80,-80,615,601,1216,2700
20,-20,10,600,617,1217,2678
90,-20,-110,590,627,1217,2753
90,-80,90,585,632,1217,2565
-90,-70,60,597,620,1217,2698
-40,-20,150,588,629,1217,2717
90,0,-110,582,636,1218,2683
100,0,-170,596,622,1218,2768
60,-70,60,602,616,1218,2614
-110,50,80,593,625,1218,2626
-160,10,-180,601,618,1219,2646
-40,60,10,586,633,1219,2605
-10,-50,-10,605,614,1219,2608
110,0,-10,595,624,1219,2644
-120,40,110,580,639,1219,2668
160,-80,160,577,642,1219,2581
-110,20,60,569,650,1219,2725
110,20,10,597,622,1219,2724
-160,10,180,601,618,1219,2646
80,0,70,619,601,1220,2705
60,0,130,598,622,1220,2631
120,-60,-90,592,628,1220,2621
100,0,-180,600,620,1220,2728
100,30,-110,592,628,1220,2746
-120,-10,-170,601,619,1220,2580
160,20,-170,587,633,1220,2680
100,0,180,600,620,1220,2728
-60,30,-150,576,644,1220,2639
-130,0,180,595,626,1221,2598
70,-30,-150,580,641,1221,2646
20,20,120,617,604,1221,2701
-50,-50,110,600,621,1221,2647
120,0,170,591,630,1221,2713
90,-10,-120,588,633,1221,2697
80,-30,-130,581,640,1221,2801
-130,0,-180,595,626,1221,2598
80,30,60,590,631,1221,2584
-100,-40,-130,587,634,1221,2732
-120,30,120,584,637,1221,2729
-110,30,0,575,646,1221,2645
120,-50,140,594,628,1222,2713
110,0,170,595,627,1222,2827
80,20,40,606,616,1222,2709
90,0,0,593,629,1222,2610
50,40,90,604,618,1222,2779
130,50,-130,599,623,1222,2641
40,-30,160,598,624,1222,2587
-80,-30,90,593,629,1222,2754
30,-10,140,610,612,1222,2708
80,10,60,610,612,1222,2707
150,0,180,598,625,1223,2779
-20,-30,140,586,637,1223,2730
90,-10,-150,597,626,1223,2631
60,-60,-160,610,613,1223,2688
90,-30,-100,595,628,1223,2714
80,60,50,615,608,1223,2696
150,0,-180,598,625,1223,2779
-30,-60,120,586,637,1223,2649
10,70,120,607,616,1223,2483
120,10,-10,619,605,1224,2740
60,-30,50,599,625,1224,2610
90,0,-100,593,631,1224,2619
170,10,-170,601,623,1224,2672
-40,0,170,575,649,1224,2712
30,10,120,607,617,1224,2745
80,-20,70,607,617,1224,2667
70,10,-60,584,640,1224,2809
90,0,-20,595,629,1224,2674
-150,0,180,588,637,1225,2681
130,-40,-70,605,620,1225,2647
-150,0,-180,588,637,1225,2681
60,10,120,593,632,1225,2777
180,0,-170,613,612,1225,2753
-40,50,-180,597,628,1225,2545
-120,20,140,606,619,1225,2655
-90,-20,80,607,618,1225,2628
-40,50,180,597,628,1225,2545
70,-10,150,601,624,1225,2707
-180,0,-170,613,612,1225,2753
100,20,-130,583,643,1226,2669
70,30,70,602,624,1226,2740
130,20,-160,589,637,1226,2703
-140,-20,-160,598,628,1226,2603
30,-40,20,602,624,1226,2719
-40,-50,-40,574,652,1226,2584
60,-30,-170,575,651,1226,2558
130,-50,150,597,630,1227,2650
-150,20,170,599,628,1227,2625
40,50,-40,595,632,1227,2596
110,-20,140,594,633,1227,2809
50,-50,50,597,630,1227,2758
80,-10,20,592,636,1228,2722
-40,-30,130,591,637,1228,2765
-110,30,70,579,649,1228,2739
80,-10,120,614,614,1228,2765
100,0,-90,600,628,1228,2611
120,-10,-40,608,620,1228,2791
10,50,-20,596,633,1229,2641
80,-70,-140,603,626,1229,2610
0,-50,140,596,633,1229,2704
50,0,-10,586,643,1229,2681
30,0,0,589,640,1229,2637
-110,40,-40,577,652,1229,2653
20,-80,160,609,620,1229,2673
70,0,90,621,608,1229,2748
-90,-10,-160,577,652,1229,2635
90,0,30,605,624,1229,2706
80,-10,40,612,618,1230,2770
-180,10,-170,592,638,1230,2650
110,20,-140,602,628,1230,2632
50,-10,0,602,628,1230,2674
-70,50,-140,604,626,1230,2447
30,-30,20,597,633,1230,2619
150,-10,180,603,627,1230,2751
180,10,-170,592,638,1230,2650
-150,50,150,587,643,1230,2655
150,-10,-180,603,627,1230,2751
40,-10,0,593,637,1230,2805
-120,60,-80,611,620,1231,2505
90,10,30,623,608,1231,2737
50,-20,170,601,630,1231,2671
80,10,40,616,615,1231,2691
-100,-30,60,597,634,1231,2701
80,-10,130,615,616,1231,2732
100,-60,110,602,629,1231,2664
140,-70,-80,609,622,1231,2670
80,-10,100,619,612,1231,2725
-160,-70,-160,603,628,1231,2570
-130,10,20,603,628,1231,2694
100,0,-80,602,630,1232,2627
-30,-30,140,605,627,1232,2765
60,0,120,603,630,1233,2689
100,20,20,609,624,1233,2760
10,-80,150,617,616,1233,2692
60,-20,170,593,641,1234,2776
30,-20,10,608,626,1234,2719
-80,-10,110,607,627,1234,2829
-150,80,140,602,632,1234,2419
-40,30,-10,589,645,1234,2715
40,30,100,601,633,1234,2792
100,-60,-110,609,625,1234,2716
80,-30,80,609,625,1234,2632
80,-10,170,614,620,1234,2731
-100,70,80,587,647,1234,2553
30,80,100,622,613,1235,2550
-100,50,60,583,652,1235,2670
150,-70,-70,609,626,1235,2674
10,-30,10,601,634,1235,2588
-110,30,80,580,655,1235,2675
-110,30,10,591,644,1235,2745
130,-10,170,600,635,1235,2795
-180,40,-180,583,653,1236,2623
70,60,60,611,625,1236,2698
90,0,-10,609,627,1236,2579
180,40,-180,583,653,1236,2623
-180,40,180,583,653,1236,2623
-20,10,-10,618,618,1236,2554
180,40,180,583,653,1236,2623
-160,30,-20,599,638,1237,2703
70,-40,-150,600,637,1237,2666
90,-60,100,609,628,1237,2564
-130,40,-30,592,645,1237,2731
110,-30,-60,598,639,1237,2756
100,40,-100,599,638,1237,2652
-80,-30,-110,604,633,1237,2664
90,-10,-160,603,634,1237,2675
110,-50,130,608,629,1237,2692
40,-60,40,595,642,1237,2748
-160,70,-50,598,639,1237,2693
140,-40,-70,608,630,1238,2672
150,-10,-50,622,616,1238,2719
120,-70,-100,613,625,1238,2648
100,-30,-70,608,630,1238,2829
130,-70,-90,613,625,1238,2639
100,0,0,602,636,1238,2767
110,10,-160,604,634,1238,2758
-30,50,0,598,641,1239,2694
160,60,-20,619,620,1239,2645
150,-80,-70,622,617,1239,2752
110,70,20,622,617,1239,2591
100,50,30,597,642,1239,2638
80,50,-70,629,610,1239,2577
90,0,-130,596,643,1239,2726
100,60,-100,618,622,1240,2592
80,-10,30,607,633,1240,2804
70,50,-60,622,618,1240,2516
-90,20,-70,598,642,1240,2493
40,-10,150,611,629,1240,2772
100,-70,-120,614,626,1240,2680
-20,-20,-10,622,618,1240,2555
50,10,130,598,642,1240,2806
-80,0,150,604,637,1241,2865
130,-40,160,613,628,1241,2707
80,40,60,607,634,1241,2717
100,10,-140,588,653,1241,2679
50,20,110,606,635,1241,2964
90,-20,-120,602,639,1241,2742
130,-20,-60,614,627,1241,2706
110,-70,-110,622,619,1241,2666
120,-40,-70,590,651,1241,2757
60,-10,10,611,631,1242,2761
-90,40,-110,612,630,1242,2574
-150,-10,-170,608,634,1242,2768
-70,-10,150,627,615,1242,2918
100,-10,-70,622,620,1242,2619
-50,-40,-50,615,627,1242,2735
-130,-20,-160,612,630,1242,2687
-120,30,-10,584,659,1243,2738
170,-60,180,607,636,1243,2606
-180,80,-40,618,625,1243,2579
-60,10,-30,600,643,1243,2559
170,-60,-180,607,636,1243,2606
-60,-10,170,597,646,1243,2751
90,-70,-130,608,635,1243,2650
160,70,-20,609,634,1243,2728
160,-80,-60,616,627,1243,2723
170,-80,170,584,659,1243,2614
180,80,-40,618,625,1243,2579
40,0,0,606,638,1244,2746
110,90,-120,640,604,1244,2466
60,-10,150,609,635,1244,2777
30,-30,150,622,622,1244,2749
-90,90,80,640,604,1244,2466
-30,90,20,640,604,1244,2466
90,10,-90,602,642,1244,2632
-60,90,50,640,604,1244,2466
180,90,170,640,604,1244,2466
-130,90,120,640,604,1244,2466
160,90,-170,640,604,1244,2466
140,90,-150,640,604,1244,2466
-50,90,40,640,604,1244,2466
-140,90,130,640,604,1244,2466
-180,90,170,640,604,1244,2466
20,90,-30,640,604,1244,2466
40,90,-50,640,604,1244,2466
120,90,-130,640,604,1244,2466
150,90,-160,640,604,1244,2466
10,90,-20,640,604,1244,2466
-40,90,30,640,604,1244,2466
-80,90,70,640,604,1244,2466
100,90,-110,640,604,1244,2466
-120,90,110,640,604,1244,2466
-170,90,160,640,604,1244,2466
50,90,-60,640,604,1244,2466
70,90,-80,640,604,1244,2466
-110,90,100,640,604,1244,2466
-20,90,10,640,604,1244,2466
170,0,-170,622,622,1244,2770
80,90,-90,640,604,1244,2466
170,90,180,640,604,1244,2466
0,90,-10,640,604,1244,2466
30,90,-40,640,604,1244,2466
-100,90,90,640,604,1244,2466
80,-80,80,605,639,1244,2657
110,-10,-40,619,625,1244,2733
130,90,-140,640,604,1244,2466
60,90,-70,640,604,1244,2466
-160,90,150,640,604,1244,2466
-10,90,0,640,604,1244,2466
-70,90,60,640,604,1244,2466
90,90,-100,640,604,1244,2466
170,90,-180,640,604,1244,2466
-150,90,140,640,604,1244,2466
170,-40,-170,605,640,1245,2617
120,10,-170,607,638,1245,2765
-150,-50,0,641,604,1245,2792
-170,0,-20,624,621,1245,2687
50,0,140,606,639,1245,2861
120,20,-150,598,647,1245,2761
110,-20,-60,607,638,1245,2836
80,0,60,621,624,1245,2794
70,10,70,615,631,1246,2795
110,-60,-100,609,637,1246,2713
-110,30,40,595,651,1246,2881
60,60,-60,598,648,1246,2695
90,0,-120,595,651,1246,2743
-10,-30,140,596,650,1246,2812
70,30,-50,617,630,1247,2674
180,50,180,597,650,1247,2648
180,50,-180,597,650,1247,2648
40,0,140,605,642,1247,2747
80,-50,90,609,638,1247,2794
70,0,80,624,623,1247,2759
-90,80,-130,607,640,1247,2581
-70,-50,-80,616,631,1247,2570
-60,-10,-50,610,637,1247,2529
-180,50,180,597,650,1247,2648
120,-30,160,629,618,1247,2665
170,-80,-50,623,624,1247,2733
-180,50,-180,597,650,1247,2648
-110,30,20,597,650,1247,2723
90,-10,-140,597,650,1247,2626
-60,20,-150,598,650,1248,2701
40,-40,30,603,645,1248,2787
-80,-70,70,604,644,1248,2764
30,40,100,622,626,1248,2738
40,20,110,611,637,1248,2883
-160,-40,-10,626,622,1248,2787
-40,-10,160,606,642,1248,2838
-60,-30,110,616,632,1248,2723
-50,-30,120,620,628,1248,2813
-20,20,-10,601,648,1249,2714
70,0,110,630,619,1249,2680
-60,40,0,599,650,1249,2793
100,40,30,606,643,1249,2830
-120,70,-90,619,630,1249,2517
20,30,-20,624,625,1249,2664
0,-20,140,603,646,1249,2700
-20,-60,-20,620,629,1249,2501
70,-10,130,603,647,1250,2660
60,-50,-160,607,643,1250,2726
50,-10,150,623,627,1250,2864
100,0,-150,609,641,1250,2727
-160,-50,-10,641,609,1250,2703
-50,-20,140,623,628,1251,2774
0,-60,140,612,639,1251,2666
60,-20,40,613,638,1251,2762
10,60,120,634,617,1251,2663
-70,-10,-70,588,663,1251,2603
-140,-10,-170,611,640,1251,2767
-70,-50,90,616,636,1252,2836
40,-30,20,614,638,1252,2853
80,-10,50,617,635,1252,2762
70,-30,-160,610,642,1252,2668
-40,-40,120,604,648,1252,2787
-180,-40,-160,609,643,1252,2736
90,-20,100,607,645,1252,2832
120,-40,150,623,629,1252,2696
180,-40,-160,609,643,1252,2736
150,-40,170,612,640,1252,2744
60,0,-10,605,648,1253,2755
-170,50,-30,631,622,1253,2658
-100,-40,60,625,628,1253,2775
-180,60,-30,622,631,1253,2750
180,60,-30,622,631,1253,2750
100,-50,-100,605,648,1253,2762
100,-10,-90,605,648,1253,2780
-100,-20,60,602,651,1253,2617
60,20,100,606,647,1253,2895
100,-20,120,604,650,1254,2827
-30,0,160,601,653,1254,2745
40,80,90,632,622,1254,2609
60,30,90,601,653,1254,2866
20,-40,20,624,631,1255,2619
80,20,30,620,635,1255,2804
-10,20,-10,600,655,1255,2533
90,-10,-130,603,652,1255,2718
-100,10,80,606,649,1255,2561
170,-30,-170,603,652,1255,2673
140,-20,-60,618,637,1255,2816
90,-10,140,600,656,1256,2796
20,80,110,629,627,1256,2559
160,20,-30,637,619,1256,2622
-50,0,180,602,654,1256,2716
100,-50,120,628,628,1256,2707
-50,0,-180,602,654,1256,2716
-100,10,120,615,641,1256,2700
150,-20,-180,619,638,1257,2816
10,0,0,599,658,1257,2523
90,0,20,610,647,1257,2786
40,50,90,637,620,1257,2794
-110,0,-180,609,648,1257,2751
80,30,-70,613,644,1257,2634
150,-20,180,619,638,1257,2816
-130,30,140,609,648,1257,2772
-110,0,180,609,648,1257,2751
70,-10,20,619,638,1257,2893
10,80,-20,617,640,1257,2743
-180,-80,-180,582,676,1258,2680
-180,-80,180,582,676,1258,2680
50,-20,20,625,633,1258,2772
180,-80,-180,582,676,1258,2680
90,-10,-170,625,633,1258,2792
-100,-10,60,620,638,1258,2540
-110,50,-80,604,654,1258,2567
180,-80,180,582,676,1258,2680
0,-70,140,612,646,1258,2703
100,-10,-80,615,643,1258,2676
-50,-70,100,611,648,1259,2676
-180,-30,-160,613,646,1259,2687
-110,30,90,591,668,1259,2937
-20,-50,130,605,654,1259,2729
180,-30,-160,613,646,1259,2687
-100,10,100,603,657,1260,2729
110,60,-110,622,638,1260,2684
80,-10,160,628,632,1260,2781
-80,-50,80,609,651,1260,2775
-60,-30,-60,602,658,1260,2696
20,-50,20,619,642,1261,2784
70,0,100,635,626,1261,2786
60,-40,60,614,647,1261,2766
80,-40,-130,612,649,1261,2671
30,20,110,620,641,1261,2726
-160,-30,-10,614,648,1262,2706
-70,-10,130,612,650,1262,2801
120,-20,-60,623,639,1262,2743
80,-20,-150,611,651,1262,2824
50,20,-20,615,647,1262,2790
50,-30,40,615,648,1263,2817
-140,-30,10,607,656,1263,2692
-170,-10,-20,616,647,1263,2708
70,30,60,609,654,1263,2869
70,-10,120,643,620,1263,2869
-150,-30,0,625,638,1263,2676
-90,60,60,618,645,1263,2632
120,-20,160,627,637,1264,2808
-70,-40,90,615,649,1264,2828
-140,0,-180,623,641,1264,2942
90,-20,-130,621,643,1264,2847
160,0,-40,647,617,1264,2667
60,10,-20,606,658,1264,2756
-70,-70,80,610,654,1264,2815
60,-10,140,620,644,1264,2803
-140,0,180,623,641,1264,2942
130,10,-170,607,657,1264,2871
120,-10,160,621,644,1265,2906
70,-80,70,626,639,1265,2701
-70,50,20,619,647,1266,2793
90,0,10,629,637,1266,2783
160,10,-170,623,643,1266,3005
100,10,20,618,648,1266,2844
100,-30,120,632,634,1266,2682
-110,30,50,609,657,1266,2901
80,-10,60,627,639,1266,2867
90,-30,100,622,644,1266,2758
40,-50,40,613,654,1267,2813
0,0,0,624,643,1267,2638
-150,-60,-150,620,647,1267,2680
80,10,30,641,626,1267,2849
110,-50,-90,610,657,1267,2755
-90,-10,80,628,639,1267,2658
-160,-10,-10,609,658,1267,2705
130,-10,-50,626,641,1267,2718
-110,30,-10,594,673,1267,2800
-90,-20,-140,618,649,1267,2731
90,-40,-110,605,662,1267,2786
30,-50,160,627,640,1267,2733
-130,-40,20,629,638,1267,2817
160,-70,-60,630,637,1267,2741
-140,-60,10,625,642,1267,2777
90,50,-80,620,648,1268,2649
110,10,0,618,650,1268,2909
-60,0,-170,591,677,1268,2796
-130,-10,-170,620,648,1268,2720
-90,60,-120,650,618,1268,2688
170,20,-170,615,654,1269,2601
80,-10,90,623,646,1269,2777
90,40,-80,637,632,1269,2774
10,80,120,629,640,1269,2586
100,-40,-90,608,661,1269,2830
-60,-20,120,621,649,1270,2881
-90,30,-100,600,670,1270,2613
-160,20,-180,629,641,1270,2742
-160,20,180,629,641,1270,2742
110,-40,140,626,644,1270,2685
50,30,-30,636,634,1270,2668
-60,-50,100,634,637,1271,2902
40,-20,10,616,655,1271,2897
30,30,-20,632,639,1271,2773
130,20,-20,622,649,1271,2848
10,-30,140,621,651,1272,2808
100,0,-70,628,644,1272,2782
80,0,50,628,644,1272,2916
-40,40,180,614,659,1273,2720
80,0,-30,611,662,1273,2780
-40,40,-180,614,659,1273,2720
60,20,-30,620,653,1273,2730
140,-50,160,612,661,1273,2691
-160,60,-40,630,643,1273,2755
-150,0,0,621,652,1273,2658
90,-10,180,625,649,1274,2799
90,20,20,633,641,1274,2884
-170,30,-180,615,659,1274,2796
-40,20,-180,625,649,1274,2709
70,-10,40,623,651,1274,2986
110,40,-110,632,642,1274,2778
-40,20,180,625,649,1274,2709
-100,80,-120,615,659,1274,2633
-140,-40,10,625,649,1274,2881
-30,-60,-30,620,654,1274,2596
90,-10,-180,625,649,1274,2799
-170,30,180,615,659,1274,2796
100,0,-10,621,653,1274,2925
50,80,80,634,640,1274,2639
110,-30,150,634,641,1275,2684
140,20,-30,640,635,1275,2855
0,-30,140,615,660,1275,2663
-170,-50,-160,631,645,1276,2788
90,10,-80,623,653,1276,2706
-60,70,-160,627,649,1276,2696
0,-80,140,642,634,1276,2774
-90,30,-40,613,663,1276,2881
70,-60,-150,621,655,1276,2789
110,-20,-70,638,638,1276,2875
-140,50,140,614,662,1276,2738
40,10,120,628,649,1277,2909
70,-10,30,625,652,1277,2950
-20,-10,150,622,655,1277,2871
-110,-50,-130,624,653,1277,2868
-100,40,40,620,657,1277,2818
-110,30,30,618,659,1277,2819
-160,-20,-10,618,659,1277,2758
-60,-70,90,627,650,1277,2788
90,-30,-110,625,652,1277,2761
80,0,40,634,644,1278,2872
80,-60,90,621,657,1278,2696
-40,70,20,625,653,1278,2711
50,-70,50,631,647,1278,2680
110,10,-150,623,655,1278,2921
100,30,20,630,648,1278,2783
70,0,-10,626,652,1278,2790
10,60,-20,618,660,1278,2536
-50,30,-10,623,655,1278,2867
90,0,-50,626,652,1278,2779
60,-10,120,641,638,1279,2879
140,0,-180,617,662,1279,2839
140,0,180,617,662,1279,2839
-80,50,30,615,664,1279,2758
-40,0,-20,630,649,1279,2751
70,-20,170,627,652,1279,2734
-50,-20,-40,624,656,1280,2703
-90,20,-80,619,661,1280,2632
160,-10,-170,616,664,1280,2868
20,40,110,629,651,1280,2708
20,0,0,626,654,1280,2824
-150,-40,0,646,634,1280,2859
70,10,60,646,635,1281,2905
80,10,-70,618,663,1281,2834
-170,-20,-160,622,659,1281,2811
-50,60,-170,630,651,1281,2542
170,-20,-40,648,633,1281,2615
100,-10,-110,615,666,1281,2861
-170,0,-170,629,652,1281,2901
-140,40,-30,624,657,1281,2890
140,-30,170,636,645,1281,2786
-100,10,130,626,656,1282,2786
-70,20,-30,607,675,1282,2782
-110,30,100,612,670,1282,2877
0,80,130,639,643,1282,2639
100,-30,-80,632,650,1282,2904
-140,-50,10,641,641,1282,2897
110,-10,-50,645,637,1282,2843
-20,-90,120,643,640,1283,2849
130,-90,-90,643,640,1283,2849
90,20,-90,614,669,1283,2687
100,-90,-120,643,640,1283,2849
50,10,-10,631,652,1283,2773
-170,-90,-30,643,640,1283,2849
-30,-90,110,643,640,1283,2849
80,-90,-140,643,640,1283,2849
-60,-90,80,643,640,1283,2849
120,-90,-100,643,640,1283,2849
90,-90,-130,643,640,1283,2849
-80,-90,60,643,640,1283,2849
20,-90,160,643,640,1283,2849
80,-10,70,639,644,1283,2855
-160,-90,-20,643,640,1283,2849
180,-90,-40,643,640,1283,2849
40,-90,-180,643,640,1283,2849
10,-90,150,643,640,1283,2849
110,-90,-110,643,640,1283,2849
-70,-90,70,643,640,1283,2849
-40,-90,100,643,640,1283,2849
-90,-90,50,643,640,1283,2849
60,-90,-160,643,640,1283,2849
-50,-90,90,643,640,1283,2849
160,-40,-180,619,664,1283,2715
0,-90,140,643,640,1283,2849
-180,-90,-40,643,640,1283,2849
-10,-90,130,643,640,1283,2849
140,-90,-80,643,640,1283,2849
-130,-90,10,643,640,1283,2849
160,-90,-60,643,640,1283,2849
40,-90,180,643,640,1283,2849
-150,-90,-10,643,640,1283,2849
-110,-90,30,643,640,1283,2849
140,-10,-180,631,652,1283,2921
50,-90,-170,643,640,1283,2849
30,-90,170,643,640,1283,2849
140,-10,180,631,652,1283,2921
160,-40,180,619,664,1283,2715
-120,-90,20,643,640,1283,2849
-140,-90,0,643,640,1283,2849
0,20,-10,615,668,1283,2554
150,-90,-70,643,640,1283,2849
-100,-90,40,643,640,1283,2849
170,-90,-50,643,640,1283,2849
70,-90,-150,643,640,1283,2849
80,0,-20,624,660,1284,2871
80,-10,140,634,650,1284,2792
-80,20,-110,622,662,1284,2736
-20,60,0,623,661,1284,2656
100,-10,140,622,662,1284,2869
100,-10,-100,622,662,1284,2875
0,-40,140,618,667,1285,2755
100,0,-100,624,661,1285,2736
80,-10,150,639,646,1285,2823
-80,30,-20,611,674,1285,2836
70,0,60,647,638,1285,2785
-150,70,-60,618,668,1286,2793
60,40,-40,626,660,1286,2697
-120,50,-60,627,659,1286,2696
-70,0,-50,626,660,1286,2696
-70,-10,120,621,665,1286,2625
100,-10,-120,616,670,1286,2873
90,0,-30,628,658,1286,2822
120,60,-120,630,656,1286,2749
-120,20,20,639,648,1287,2851
10,70,-20,634,653,1287,2623
110,-10,150,619,668,1287,2933
70,20,60,622,665,1287,2895
130,-30,-70,640,647,1287,2805
70,10,-50,622,665,1287,2918
-110,-30,-140,625,662,1287,2821
-80,-40,-100,620,667,1287,2675
-140,80,130,635,653,1288,2535
20,-30,20,633,655,1288,2742
80,30,50,625,663,1288,2818
100,-20,-80,632,656,1288,2853
-180,-80,-40,646,643,1289,2773
-60,-10,160,601,688,1289,2718
180,-80,-40,646,643,1289,2773
60,-80,60,639,650,1289,2786
130,-30,170,641,649,1290,2742
50,-10,10,638,652,1290,2766
-70,10,-40,611,679,1290,2676
-150,30,-20,628,662,1290,2791
150,-60,-70,631,659,1290,2790
60,50,-50,641,649,1290,2670
80,-30,-140,617,673,1290,3060
50,0,0,625,666,1291,2757
70,40,70,631,660,1291,2921
-100,10,110,626,665,1291,2834
70,-30,70,614,677,1291,2808
110,0,-170,629,662,1291,2913
70,-10,140,633,658,1291,2822
110,0,180,631,661,1292,3000
130,40,-10,626,666,1292,2754
-140,-40,-150,634,658,1292,2907
110,0,-180,631,661,1292,3000
150,30,-160,634,658,1292,2744
30,-50,30,642,650,1292,2791
110,-40,-80,625,667,1292,2928
-90,-40,70,635,658,1293,2781
140,10,-170,616,677,1293,2837
50,-80,50,645,648,1293,2821
-160,-20,-160,626,667,1293,2929
50,-20,30,644,649,1293,2825
-160,20,-20,633,660,1293,2779
90,-10,170,638,656,1294,2888
-150,-20,-160,639,655,1294,2747
-80,-10,-150,635,660,1295,2799
80,20,-70,622,673,1295,2854
-120,-10,-160,639,656,1295,2775
-110,10,50,629,667,1296,2744
-110,40,80,609,687,1296,2834
160,0,-170,628,668,1296,2862
30,-10,10,635,661,1296,2808
-70,0,-140,625,671,1296,2844
100,20,-120,620,677,1297,2977
70,20,-50,636,661,1297,2803
30,-20,20,637,660,1297,2824
-140,50,-40,613,684,1297,2709
-140,70,130,626,671,1297,2754
110,-30,-70,639,658,1297,2985
-100,10,140,633,665,1298,2801
-130,10,170,640,658,1298,2853
140,50,-140,611,687,1298,2877
20,-10,10,649,649,1298,2808
160,-60,-60,637,662,1299,2891
-170,-80,-170,612,687,1299,2734
120,30,0,635,664,1299,2888
0,70,130,636,663,1299,2667
-80,10,-100,626,673,1299,2755
-130,70,-80,630,670,1300,2650
100,-30,-90,640,660,1300,2958
30,-30,30,641,659,1300,2868
60,10,110,650,650,1300,2929
90,-50,-120,614,687,1301,2841
-130,-30,20,619,682,1301,2751
-90,-60,-100,636,666,1302,2845
120,0,-30,657,645,1302,2945
40,-80,40,641,661,1302,2844
70,40,-50,655,647,1302,2740
10,-50,10,640,662,1302,2706
70,-20,60,632,670,1302,2833
140,-30,-70,634,668,1302,2870
50,0,130,637,665,1302,2931
60,-40,-170,626,677,1303,2868
80,0,30,643,660,1303,2912
-100,30,-10,615,689,1304,2883
60,40,80,637,667,1304,2959
100,-20,-90,637,667,1304,2908
-110,20,120,639,665,1304,2873
100,0,-110,633,671,1304,2767
150,10,-170,616,688,1304,3052
-130,60,120,623,681,1304,2832
90,30,20,638,666,1304,2806
-40,-60,110,653,651,1304,2793
-90,0,170,635,669,1304,2810
70,-10,110,662,642,1304,2937
50,50,80,654,651,1305,2947
-180,-10,-30,645,660,1305,2778
-100,-50,-120,635,670,1305,2946
60,20,90,637,668,1305,2995
120,-30,-70,642,663,1305,2918
180,-10,-30,645,660,1305,2778
10,50,120,649,657,1306,2811
40,10,0,646,660,1306,2834
150,-50,170,652,654,1306,2696
-100,50,-100,635,671,1306,2631
90,50,40,645,661,1306,2911
-110,60,90,631,675,1306,2924
70,-10,50,636,670,1306,2923
-90,70,70,632,675,1307,2716
-90,20,-60,627,680,1307,2714
100,0,-140,631,676,1307,2885
130,-20,-180,649,658,1307,2755
30,0,10,626,681,1307,2873
50,-40,50,637,670,1307,2914
90,-30,-120,627,680,1307,2974
130,-20,180,649,658,1307,2755
-80,20,-40,646,661,1307,2738
60,80,70,646,662,1308,2730
70,-20,160,634,674,1308,2980
100,-20,130,633,675,1308,2984
110,30,-120,635,673,1308,2885
20,10,120,654,654,1308,2885
90,-10,150,644,664,1308,2927
80,-10,80,656,652,1308,2929
80,-20,-160,630,678,1308,2796
-120,-40,-140,629,680,1309,2921
180,-60,-170,632,677,1309,2790
-110,10,160,654,655,1309,2834
-170,80,-50,631,678,1309,2762
40,0,10,650,659,1309,2887
-90,40,20,625,684,1309,2887
90,-20,110,645,664,1309,2984
-180,-60,-170,632,677,1309,2790
-90,0,110,648,661,1309,2880
-80,40,10,626,684,1310,2991
10,0,130,646,665,1311,2945
-90,20,-90,640,671,1311,2785
-80,0,160,635,676,1311,2967
20,-50,150,637,674,1311,2902
40,40,90,654,657,1311,3061
60,-10,20,655,656,1311,3032
110,-20,150,635,677,1312,2896
40,-40,40,641,671,1312,2953
80,-60,-140,630,682,1312,2865
50,10,120,635,677,1312,2970
-30,20,-10,649,663,1312,2818
80,0,-10,644,668,1312,2879
140,60,-10,652,661,1313,2702
-110,-20,-150,645,668,1313,2833
60,0,0,637,676,1313,2910
-110,40,90,622,691,1313,2883
100,10,-130,624,689,1313,2904
-30,-30,-20,638,675,1313,2619
40,-20,150,647,666,1313,2987
-80,-20,-120,627,686,1313,2922
130,0,180,632,682,1314,2860
130,0,-180,632,682,1314,2860
130,40,-130,659,655,1314,2957
50,30,90,641,673,1314,3060
100,0,-120,632,682,1314,2828
30,-60,30,643,671,1314,2790
100,-40,130,649,665,1314,2907
-90,-30,70,654,660,1314,2777
80,30,40,642,672,1314,2855
90,-40,110,637,677,1314,3009
-80,0,130,634,680,1314,2748
80,-40,90,638,677,1315,2940
60,-20,50,646,669,1315,2879
120,70,10,656,659,1315,2738
-60,20,-20,639,676,1315,3030
40,0,130,646,669,1315,3055
50,-30,170,640,675,1315,2831
10,-20,10,629,686,1315,2881
40,-30,30,647,669,1316,2841
50,60,-50,641,675,1316,2930
0,80,-10,658,658,1316,2865
100,0,-20,657,659,1316,2998
-50,60,20,626,690,1316,2791
30,-40,30,651,665,1316,2865
100,-30,130,638,679,1317,2840
80,-20,80,646,671,1317,2741
100,0,-60,662,655,1317,2837
80,-40,-140,644,673,1317,2873
170,-70,-50,664,654,1318,2870
140,-20,180,663,655,1318,2859
140,-20,-180,663,655,1318,2859
-50,-40,110,657,661,1318,2951
40,-50,170,646,673,1319,2872
-80,-40,80,633,686,1319,3002
110,30,10,654,665,1319,2944
120,0,-180,636,683,1319,3041
90,0,-40,647,672,1319,2851
-100,-10,-160,648,671,1319,2890
50,-20,160,649,670,1319,3078
-110,80,-110,639,680,1319,2730
40,-70,40,640,679,1319,2832
120,0,180,636,683,1319,3041
-140,70,-70,642,677,1319,2730
40,-10,10,643,676,1319,2963
70,-50,80,629,690,1319,2894
110,-10,-80,659,660,1319,2843
120,40,-120,651,669,1320,2855
-120,0,180,665,655,1320,2776
130,-50,-80,639,681,1320,2858
-100,30,-70,637,683,1320,2751
-150,-20,0,648,672,1320,2873
70,-50,-150,629,691,1320,2862
-110,20,50,633,687,1320,2782
-120,0,-180,665,655,1320,2776
-30,-50,120,637,684,1321,2839
120,40,0,644,677,1321,2909
-10,-80,130,672,649,1321,2855
50,-10,20,659,662,1321,2909
100,-10,-130,649,672,1321,2897
70,80,60,651,671,1322,2818
-180,-20,-160,662,660,1322,2861
180,-20,-160,662,660,1322,2861
-140,0,10,649,673,1322,2880
-90,0,100,666,656,1322,2844
30,30,100,644,678,1322,3027
0,60,130,669,653,1322,2876
150,50,-20,657,665,1322,2756
-60,-40,100,658,666,1324,2983
60,30,80,649,675,1324,3034
-80,0,120,642,682,1324,2839
30,-80,30,641,683,1324,2822
-140,-20,10,635,689,1324,2852
-80,0,140,648,677,1325,3002
-130,-30,-150,646,679,1325,3057
160,-20,-170,645,680,1325,3013
140,0,-170,641,684,1325,3011
120,10,-160,643,682,1325,3038
60,-10,130,652,673,1325,2926
70,-10,100,667,659,1326,3007
-150,40,160,643,683,1326,2915
140,-60,-80,657,669,1326,2879
-120,-30,30,647,679,1326,2973
40,-40,160,649,677,1326,2834
-160,-80,-160,635,691,1326,2775
110,-10,-70,649,677,1326,2973
-80,70,60,644,682,1326,2796
-70,-30,90,664,662,1326,2950
-70,70,-150,660,666,1326,2860
100,-10,-140,644,682,1326,2840
-120,-20,-150,645,682,1327,2887
30,-20,30,649,678,1327,2999
-130,20,0,646,681,1327,2891
-130,-20,20,643,684,1327,2740
140,30,-150,654,674,1328,3063
-120,-60,-130,644,684,1328,2974
150,-20,-60,649,679,1328,2937
90,10,20,660,668,1328,2925
90,-10,160,648,680,1328,2921
120,-40,-80,646,682,1328,2948
90,40,40,633,695,1328,2967
-90,-20,70,645,684,1329,2899
110,-20,-80,666,663,1329,2913
-130,60,-70,647,682,1329,2862
80,20,20,672,657,1329,3058
100,-40,-100,647,682,1329,2936
-150,10,-10,639,690,1329,2865
90,-40,-120,643,687,1330,2929
110,0,-20,643,687,1330,3041
-160,40,170,644,686,1330,2773
-10,-70,130,646,684,1330,2902
-50,70,30,641,689,1330,2848
60,-10,110,663,667,1330,3048
-150,-50,-150,661,669,1330,2865
-10,80,140,665,665,1330,2697
-100,40,-90,651,679,1330,2793
110,-10,-60,657,673,1330,2837
30,20,-10,638,692,1330,2828
60,-10,30,663,667,1330,2972
30,-20,140,657,673,1330,2926
50,-10,140,654,676,1330,2971
-140,30,-20,624,707,1331,2813
130,10,-30,670,661,1331,2873
130,0,-40,663,668,1331,2894
120,-20,170,659,672,1331,2957
-90,30,-20,623,708,1331,3017
-150,-40,-150,656,676,1332,2910
90,20,-80,643,689,1332,2861
-10,-60,-10,648,684,1332,2652
-170,-80,-30,663,669,1332,2838
70,10,-40,646,686,1332,2952
100,10,10,646,687,1333,3021
-120,-20,30,640,693,1333,2814
-130,-50,20,666,667,1333,3026
60,-10,40,658,675,1333,2970
30,0,120,668,665,1333,2992
-70,-30,-80,626,707,1333,2907
-110,20,130,646,687,1333,2843
10,-40,140,650,684,1334,3030
-50,50,10,642,692,1334,2925
-120,-40,30,636,698,1334,2995
120,20,-10,674,660,1334,2957
70,0,0,660,674,1334,2962
130,10,-160,652,682,1334,3054
70,0,50,656,678,1334,2947
90,30,-80,652,682,1334,2982
-100,0,180,644,691,1335,2874
120,-20,-70,647,688,1335,3019
110,-10,-90,672,663,1335,2915
-100,0,-180,644,691,1335,2874
-40,-60,-40,638,697,1335,2802
170,70,-30,665,670,1335,2953
60,-20,160,654,681,1335,2934
100,20,10,667,668,1335,3072
-110,-10,-160,638,697,1335,2907
-130,-60,20,647,688,1335,2911
100,20,-110,642,693,1335,3027
-140,-30,-150,653,683,1336,3009
60,0,110,665,671,1336,2995
100,0,-50,667,669,1336,2922
70,-20,150,652,684,1336,3041
80,50,50,660,677,1337,3014
120,-70,130,643,694,1337,2797
-80,0,-80,626,711,1337,2822
140,20,-160,632,705,1337,2959
-20,0,150,651,686,1337,2736
-120,50,110,635,702,1337,2895
0,-50,0,641,697,1338,2834
-90,-60,60,651,687,1338,2971
-120,-10,30,638,700,1338,2937
130,-10,-180,659,679,1338,2947
80,0,20,642,696,1338,3022
150,-10,-170,660,678,1338,2969
-80,-20,90,669,669,1338,2972
-130,-50,-140,643,695,1338,2872
160,-50,-60,662,676,1338,2953
130,-10,180,659,679,1338,2947
-50,40,0,642,697,1339,3066
170,-50,-50,647,692,1339,2969
90,-50,110,651,688,1339,2905
50,20,100,665,674,1339,3147
60,-30,60,651,688,1339,2919
-10,-10,0,648,692,1340,2629
70,10,50,658,682,1340,2985
-50,-10,160,639,701,1340,3040
60,-20,150,652,689,1341,2969
170,-60,-50,666,675,1341,3015
80,0,0,656,685,1341,2914
40,-20,20,658,683,1341,3094
10,-80,10,643,698,1341,2871
-160,80,-60,644,697,1341,2867
70,10,-30,660,681,1341,3016
20,-60,20,642,700,1342,2885
90,-20,-140,649,693,1342,2952
90,80,40,654,688,1342,2834
110,20,-130,650,692,1342,2916
10,40,120,662,680,1342,2925
70,-40,80,631,712,1343,3029
110,-30,160,653,690,1343,2879
-80,-10,-140,647,696,1343,2877
-60,30,-10,666,677,1343,3094
160,-20,-50,676,667,1343,2879
90,-60,-130,648,695,1343,2941
100,10,-110,648,695,1343,2822
-130,-20,-150,652,692,1344,2939
100,0,-130,646,698,1344,2950
-180,0,-30,659,685,1344,2919
-50,50,-170,667,677,1344,2828
80,-30,-150,658,686,1344,3083
80,-20,-170,651,693,1344,2998
180,0,-30,659,685,1344,2919
-70,-20,100,667,677,1344,2985
-100,20,90,634,710,1344,2777
-110,30,-20,650,694,1344,3004
-20,-30,-10,666,678,1344,2772
100,30,-100,653,691,1344,2953
-100,20,80,658,687,1345,2872
120,10,-20,664,681,1345,2948
110,0,-160,662,683,1345,3103
-120,20,150,655,690,1345,2851
-80,-60,70,658,687,1345,3061
170,40,-170,639,706,1345,2913
50,10,0,663,682,1345,2947
140,10,-40,682,664,1346,2963
140,0,-50,679,667,1346,2913
-80,50,-130,648,698,1346,2712
60,40,70,656,690,1346,3190
-10,-20,140,647,699,1346,2970
100,50,-90,661,686,1347,2796
50,0,120,661,686,1347,3069
100,40,20,664,683,1347,2977
110,-70,120,640,707,1347,2873
100,-70,110,650,697,1347,2924
180,20,-170,661,686,1347,2852
100,-50,-110,645,702,1347,2964
100,0,-30,672,675,1347,2990
20,-20,20,660,687,1347,2919
-180,20,-170,661,686,1347,2852
80,80,50,654,693,1347,2862
40,40,-30,670,678,1348,2921
-150,-80,-150,651,697,1348,2831
-80,-20,-110,621,727,1348,2884
110,-50,-100,652,696,1348,3000
70,30,50,655,693,1348,3010
-80,10,-50,646,702,1348,2834
100,-10,-150,660,688,1348,2924
120,-10,-50,667,681,1348,2912
-110,40,-50,636,713,1349,3017
70,-30,-170,659,690,1349,2881
70,-10,60,668,681,1349,2889
0,70,-10,669,680,1349,2747
60,30,70,657,692,1349,3029
180,-70,-40,665,684,1349,2961
-40,-30,-30,666,683,1349,2890
-180,-70,-40,665,684,1349,2961
80,-20,130,664,685,1349,3057
110,20,0,664,685,1349,3027
90,-20,120,660,690,1350,3069
-120,40,-40,641,709,1350,2915
-140,-20,-150,666,684,1350,2902
-100,30,0,627,723,1350,2986
-130,20,160,654,696,1350,2905
-10,0,0,648,702,1350,2757
50,-10,120,674,676,1350,3049
-50,10,-20,658,692,1350,2868
70,10,40,657,693,1350,3025
80,30,30,660,690,1350,2926
-170,10,-170,656,694,1350,2987
170,20,-30,669,682,1351,2810
70,-60,80,666,685,1351,2890
-10,-20,0,663,689,1352,2738
160,-40,-60,664,688,1352,2959
60,-20,120,671,681,1352,2952
130,0,-170,646,706,1352,3019
-130,80,120,671,681,1352,2669
100,-20,-100,646,707,1353,3092
150,10,-40,674,679,1353,2947
110,40,10,659,694,1353,2930
60,10,-10,661,692,1353,2943
-80,-30,80,665,688,1353,3019
30,-40,150,674,680,1354,2948
-80,60,50,674,680,1354,2952
100,-20,-110,651,703,1354,3086
80,0,10,661,693,1354,3085
100,0,-40,671,683,1354,3049
20,-30,140,668,686,1354,2998
60,0,50,668,686,1354,2864
-120,20,160,669,686,1355,2846
100,-10,-160,661,694,1355,3064
130,30,-140,642,713,1355,3082
-100,-60,50,656,699,1355,3033
-100,10,70,662,693,1355,2960
60,10,100,686,670,1356,3074
70,-10,70,677,679,1356,2947
-20,-80,120,688,668,1356,2937
60,-20,140,670,686,1356,3003
-50,-20,130,658,698,1356,3055
70,50,60,666,690,1356,3143
-150,-70,-150,656,700,1356,2828
-140,20,-10,657,699,1356,2951
140,-70,150,662,694,1356,2996
40,-10,140,667,689,1356,3084
40,0,120,658,699,1357,3177
150,0,-170,661,696,1357,2981
150,-50,-70,665,692,1357,3034
60,30,-30,676,681,1357,2883
-120,10,170,667,690,1357,2879
70,40,60,671,686,1357,3074
130,60,-130,667,690,1357,2861
100,10,-120,640,717,1357,2945
-160,-80,-20,672,685,1357,2835
110,-10,160,653,704,1357,3168
100,40,-90,675,682,1357,2883
0,30,-10,659,699,1358,2789
80,10,-60,656,702,1358,3050
80,-50,-140,655,703,1358,3017
-70,-40,-80,649,709,1358,3013
110,-10,-140,665,693,1358,2919
180,-90,180,648,711,1359,2927
50,-90,50,648,711,1359,2927
160,-90,160,648,711,1359,2927
60,-90,60,648,711,1359,2927
60,-10,50,668,691,1359,2976
110,-10,-130,661,698,1359,2850
110,-90,110,648,711,1359,2927
150,-90,150,648,711,1359,2927
120,30,-130,646,713,1359,2999
80,-90,80,648,711,1359,2927
120,-90,120,648,711,1359,2927
90,-90,90,648,711,1359,2927
180,-90,-180,648,711,1359,2927
100,-90,100,648,711,1359,2927
130,-90,130,648,711,1359,2927
170,-90,170,648,711,1359,2927
70,-90,70,648,711,1359,2927
140,-90,140,648,711,1359,2927
-180,-90,-180,648,711,1359,2927
-20,-90,-20,648,711,1359,2927
-130,-90,-130,648,711,1359,2927
20,-90,20,648,711,1359,2927
-80,-90,-80,648,711,1359,2927
-60,-90,-60,648,711,1359,2927
30,50,-30,655,704,1359,2855
-40,-90,-40,648,711,1359,2927
-20,-40,130,661,698,1359,3131
-140,-90,-140,648,711,1359,2927
-100,-90,-100,648,711,1359,2927
-120,-90,-120,648,711,1359,2927
-70,70,50,664,695,1359,2881
-10,-90,-10,648,711,1359,2927
40,-90,40,648,711,1359,2927
-150,-90,-150,648,711,1359,2927
30,-90,30,648,711,1359,2927
-90,-90,-90,648,711,1359,2927
10,-90,10,648,711,1359,2927
-170,-90,-170,648,711,1359,2927
-180,-90,180,648,711,1359,2927
-160,-90,-160,648,711,1359,2927
-50,-90,-50,648,711,1359,2927
-70,-90,-70,648,711,1359,2927
0,-90,0,648,711,1359,2927
-110,-90,-110,648,711,1359,2927
-30,-90,-30,648,711,1359,2927
100,-20,-120,658,702,1360,3090
20,-80,20,658,702,1360,2888
-40,30,-180,654,706,1360,2884
-70,0,-150,644,716,1360,2918
-110,-60,40,667,693,1360,3057
-40,30,180,654,706,1360,2884
-50,-60,-50,656,704,1360,2883
-40,-20,140,658,702,1360,3152
-130,0,20,662,698,1360,2961
130,-60,-90,668,692,1360,2948
-30,10,160,662,699,1361,2898
100,-10,-170,656,705,1361,3064
110,10,-140,652,709,1361,2991
110,-40,-90,662,699,1361,3059
-110,20,140,666,695,1361,2839
110,-30,-80,676,685,1361,3064
50,-20,40,676,685,1361,2963
120,-50,-90,645,717,1362,2909
80,-20,90,671,691,1362,3003
140,40,-20,676,686,1362,2889
50,0,10,660,702,1362,2953
40,-60,170,670,692,1362,3072
-70,30,-10,654,708,1362,3037
140,-10,-170,672,691,1363,3058
50,40,80,680,683,1363,3199
-120,-60,30,664,699,1363,3055
90,10,-70,652,711,1363,2932
180,50,-30,666,697,1363,2997
70,0,40,664,699,1363,3014
70,0,10,666,697,1363,3126
130,-70,140,661,702,1363,2855
-180,50,-30,666,697,1363,2997
100,-10,160,661,703,1364,3139
180,10,-30,676,688,1364,2948
-180,10,-30,676,688,1364,2948
120,20,-140,664,700,1364,3015
100,-10,150,658,706,1364,3078
100,-20,-130,669,695,1364,3006
70,-20,70,658,706,1364,2945
90,-20,130,668,696,1364,3132
-110,30,110,636,729,1365,2985
100,-20,140,646,719,1365,2995
50,-10,30,677,688,1365,3041
110,0,-100,679,686,1365,2889
40,-30,40,674,691,1365,2987
60,-30,180,648,717,1365,3009
-100,30,-20,648,717,1365,3067
110,50,10,668,697,1365,2963
10,-60,10,655,710,1365,2974
-100,10,150,665,700,1365,2960
130,70,0,685,680,1365,2979
-120,40,120,654,711,1365,2948
100,10,-100,676,689,1365,2811
60,-30,-180,648,717,1365,3009
-140,10,0,665,701,1366,3020
-90,0,90,673,693,1366,2741
60,50,70,674,692,1366,3103
-140,60,-60,655,711,1366,2946
70,20,50,681,685,1366,3136
-90,30,-30,645,721,1366,3100
90,40,30,664,703,1367,2960
0,-80,0,660,707,1367,2916
110,0,-110,681,686,1367,2875
-100,30,-60,658,709,1367,2892
-10,80,0,694,673,1367,2929
-90,30,-10,647,721,1368,3026
80,-20,180,659,709,1368,3019
80,40,50,663,705,1368,3063
60,0,100,677,691,1368,3082
-130,70,120,648,720,1368,2943
80,-20,-180,659,709,1368,3019
80,30,20,679,689,1368,3033
-70,-60,80,665,703,1368,3087
130,20,-150,671,697,1368,3136
80,-20,100,673,696,1369,3012
170,-50,-170,674,695,1369,2959
60,-50,70,668,701,1369,2972
-40,-70,-40,666,703,1369,2799
30,10,0,670,699,1369,2923
30,-70,30,664,706,1370,3001
170,-10,-40,686,684,1370,2838
110,0,-120,673,697,1370,2889
100,-10,-180,669,701,1370,3114
30,-60,160,669,701,1370,2989
100,-10,180,669,701,1370,3114
70,-20,120,664,706,1370,3149
110,-20,160,660,710,1370,3112
-150,60,-50,672,699,1371,2986
50,-40,170,666,705,1371,2933
-120,30,-20,654,717,1371,3111
120,-20,-80,668,703,1371,3019
170,30,-170,652,719,1371,2910
30,-10,20,673,698,1371,2954
-70,40,-140,671,701,1372,2928
100,-30,-100,668,704,1372,3108
90,-30,-130,659,713,1372,3076
-120,80,-100,667,705,1372,2868
120,-10,170,664,708,1372,3115
-80,-50,-90,670,703,1373,2944
-60,60,-160,684,689,1373,2780
-10,-80,-10,667,706,1373,2957
40,-10,20,668,705,1373,3036
20,10,0,665,708,1373,3008
-120,30,130,653,720,1373,2994
-100,40,50,652,721,1373,3180
-120,20,10,669,705,1374,3087
-90,-30,-120,644,730,1374,3005
-150,40,-30,667,707,1374,2988
-140,40,150,677,697,1374,3010
-130,30,-20,641,733,1374,3021
-150,-10,0,674,700,1374,2958
80,-20,120,688,686,1374,3170
80,10,20,679,695,1374,3045
-130,-10,-160,667,707,1374,2978
20,20,-10,652,722,1374,2882
90,-30,110,671,704,1375,2898
-90,-10,-150,653,722,1375,2989
-30,-70,-30,654,721,1375,2802
-150,10,180,668,708,1376,2943
70,-40,-160,660,716,1376,3039
-150,10,-180,668,708,1376,2943
-150,-30,-150,670,706,1376,2989
140,40,-140,669,707,1376,3033
-50,-50,-50,668,708,1376,2958
50,-10,130,676,700,1376,3149
-80,-30,-100,656,721,1377,2895
80,-30,90,672,705,1377,3011
20,-10,130,697,680,1377,3077
110,0,-90,681,696,1377,2926
-170,-10,-160,669,708,1377,3068
180,-60,-40,683,694,1377,3116
-180,-60,-40,683,694,1377,3116
-50,-60,100,689,688,1377,3030
-110,40,-60,671,706,1377,3014
-110,-20,40,672,706,1378,2878
110,-10,-120,660,718,1378,2938
110,-10,-110,684,694,1378,2949
140,-10,-60,687,691,1378,3093
-100,30,10,649,729,1378,3044
-30,-30,130,665,713,1378,3269
60,30,60,667,712,1379,3153
-10,-10,140,681,698,1379,3017
-120,10,30,672,707,1379,2949
20,40,-20,661,718,1379,2937
-120,-50,30,686,693,1379,3143
120,50,0,683,697,1380,2964
-100,-40,50,674,706,1380,2919
70,70,-70,673,707,1380,3027
-160,-10,-160,664,716,1380,2972
150,0,-50,696,684,1380,3009
-130,80,-90,673,707,1380,2931
40,30,90,672,709,1381,3127
-20,-80,-20,682,699,1381,2976
80,70,-80,684,697,1381,2970
130,0,-160,658,723,1381,3109
-170,-70,-30,670,711,1381,3013
110,-20,-90,683,698,1381,3098
-150,-80,-10,685,696,1381,2872
60,10,90,680,701,1381,3084
100,80,30,673,708,1381,2917
70,-20,130,677,704,1381,3045
-140,0,-170,678,703,1381,3152
-50,20,-170,668,713,1381,3048
-80,70,-140,697,684,1381,2990
-130,50,-50,666,716,1382,2910
70,-10,90,693,689,1382,3100
160,-50,-180,688,694,1382,2954
160,-50,180,688,694,1382,2954
80,-20,140,681,701,1382,3080
140,0,-160,672,710,1382,3146
-110,40,100,647,736,1383,3041
-80,30,-10,671,712,1383,3071
100,-60,-120,666,717,1383,3093
50,-30,50,670,713,1383,3148
90,-70,100,663,720,1383,2973
70,0,30,670,713,1383,3127
-80,-10,100,698,685,1383,2993
-140,-60,-140,667,716,1383,3039
-20,80,150,695,688,1383,2832
80,30,-60,687,696,1383,3135
-60,70,40,668,715,1383,2949
-110,20,40,659,724,1383,2964
-50,40,-170,675,708,1383,2952
-170,60,170,680,703,1383,2936
-60,-10,150,674,710,1384,3093
-90,-40,-110,683,701,1384,3011
-150,80,-70,672,712,1384,2872
-90,50,50,661,723,1384,2969
90,10,10,676,708,1384,3222
40,0,20,691,693,1384,3064
-70,-10,110,666,718,1384,2928
20,30,110,699,686,1385,2893
-60,-10,140,660,725,1385,3205
10,20,-10,672,713,1385,2964
140,-40,170,675,710,1385,3019
-140,80,-80,670,715,1385,2896
0,-60,0,674,711,1385,2901
-110,50,90,653,732,1385,2991
110,-10,-100,705,680,1385,2969
-100,60,-110,695,690,1385,2952
80,-20,110,688,698,1386,3060
20,-60,150,679,707,1386,3082
170,50,-170,662,724,1386,2926
110,10,-10,677,709,1386,3114
50,-10,50,675,711,1386,3087
50,10,110,675,712,1387,3211
-160,-70,-20,669,718,1387,3068
70,-20,100,678,709,1387,3070
-140,-80,0,685,702,1387,2909
50,-20,150,679,708,1387,3107
-60,-30,100,676,711,1387,3046
-110,-30,40,674,714,1388,2982
50,-20,120,680,708,1388,2935
-80,0,-90,657,731,1388,2978
-60,-10,130,680,708,1388,3142
110,0,-150,683,706,1389,3136
-70,-20,-70,667,723,1390,2960
-50,-30,110,679,711,1390,3065
-30,-80,110,699,691,1390,3034
90,30,10,703,687,1390,3004
50,-50,-180,668,722,1390,3063
60,20,80,675,715,1390,3274
-100,20,100,678,712,1390,3078
-60,-60,90,692,698,1390,3191
110,0,-30,683,707,1390,3237
50,-50,180,668,722,1390,3063
90,-20,-150,670,720,1390,3024
100,10,-90,687,703,1390,2854
70,0,20,682,709,1391,3153
-160,60,160,667,724,1391,2983
-110,-60,-120,687,704,1391,3289
-100,10,160,671,720,1391,2958
-140,-80,-140,670,721,1391,2942
-40,10,170,656,735,1391,2958
120,0,-170,661,730,1391,3182
-170,40,-30,683,709,1392,3064
40,10,110,691,701,1392,3148
140,-20,-70,678,714,1392,3045
50,-10,40,690,703,1393,3042
60,-10,100,691,702,1393,3037
130,-20,-70,683,710,1393,3167
-110,0,-170,681,712,1393,2930
-180,-50,-160,686,707,1393,2986
-130,-80,10,680,713,1393,2923
150,-40,-70,695,698,1393,3022
90,-50,-130,674,719,1393,3117
-120,0,-170,665,728,1393,2994
140,10,-160,658,735,1393,3046
-120,50,-70,686,707,1393,2981
-160,40,-30,689,704,1393,3047
180,-50,-160,686,707,1393,2986
-20,-70,120,695,699,1394,3041
-120,0,30,680,714,1394,3093
150,-70,160,686,708,1394,3126
90,70,-90,695,699,1394,3014
60,0,10,679,715,1394,3157
80,20,-60,674,721,1395,3041
140,60,-140,667,728,1395,3007
-100,0,60,687,709,1396,3113
170,-40,-50,698,698,1396,3016
100,-10,170,686,710,1396,3196
-60,-40,-60,683,713,1396,3050
100,20,-100,679,717,1396,3086
120,0,-40,683,713,1396,3166
70,-20,140,693,703,1396,3165
-170,-60,-160,682,715,1397,2931
90,-20,140,673,724,1397,3092
40,-30,150,688,709,1397,3152
-70,60,40,692,705,1397,3109
-160,0,-170,686,712,1398,3102
-100,-60,-110,691,707,1398,3220
130,-10,-170,684,714,1398,3089
-30,-80,-30,690,708,1398,3011
-120,80,110,694,704,1398,2778
-80,-20,80,669,729,1398,2972
-20,-70,-20,680,719,1399,2865
-50,-10,-30,684,715,1399,2850
90,-40,-130,680,719,1399,3113
120,-60,-100,690,710,1400,3054
110,0,-130,689,711,1400,3044
130,-40,-80,687,713,1400,3071
110,-10,-150,688,712,1400,3116
70,60,50,713,687,1400,3119
60,0,40,692,709,1401,3012
40,-20,30,680,721,1401,3168
-100,-30,-130,686,715,1401,3131
-120,-80,20,686,715,1401,2949
80,-20,150,688,713,1401,3079
60,-20,130,691,710,1401,3094
-10,-60,130,672,730,1402,3027
-60,-60,-60,693,709,1402,3078
120,-60,140,695,707,1402,2972
100,-30,140,678,724,1402,3022
120,-30,-80,690,712,1402,3042
60,0,20,693,709,1402,3217
160,-30,-60,700,702,1402,3117
-80,30,-120,693,709,1402,2853
-90,20,-50,666,737,1403,3050
-80,-80,60,684,719,1403,3073
120,10,-150,680,724,1404,3157
150,-30,-180,685,719,1404,3210
-130,40,140,688,716,1404,3065
-20,80,10,705,699,1404,3018
-130,50,130,672,732,1404,3014
50,50,-40,694,710,1404,3001
-110,80,100,698,706,1404,2907
-130,-10,20,679,725,1404,3052
150,-30,180,685,719,1404,3210
-30,0,-10,687,717,1404,2941
70,10,30,696,708,1404,3164
40,-10,30,676,728,1404,3122
60,-20,60,688,716,1404,3196
80,-20,160,690,715,1405,3210
100,-40,-110,675,730,1405,3144
-10,70,140,702,703,1405,2942
-130,-80,-130,674,731,1405,2969
-140,20,170,691,714,1405,2991
160,40,-160,689,717,1406,3128
-110,-50,40,699,707,1406,3206
50,0,20,691,715,1406,3090
110,10,-130,682,724,1406,3046
40,-20,40,700,706,1406,3027
-110,-80,30,690,716,1406,3053
-110,-40,40,683,723,1406,3065
100,30,10,709,698,1407,3055
-140,-50,-140,690,717,1407,3102
-70,-50,80,689,718,1407,3232
-120,-30,-140,675,732,1407,3078
-160,-20,-150,676,731,1407,3046
-40,40,0,679,728,1407,3249
150,-20,-170,688,719,1407,3120
-150,0,-170,692,716,1408,3128
70,-20,110,689,719,1408,3241
60,10,0,697,711,1408,3090
50,-20,50,696,712,1408,3184
-140,-70,-140,677,731,1408,3054
60,60,60,713,696,1409,3160
110,80,20,688,721,1409,3000
70,-10,80,689,720,1409,3079
60,-60,70,694,715,1409,3149
-40,-10,-20,686,723,1409,3019
130,-20,-170,697,712,1409,3043
-100,-80,40,687,722,1409,3095
80,40,40,678,732,1410,3246
50,60,70,711,699,1410,3135
-140,-10,10,674,736,1410,3108
150,40,-150,694,716,1410,3142
-40,-30,120,687,724,1411,3111
60,-10,60,697,714,1411,3155
60,10,50,693,718,1411,3137
-70,-10,-60,692,719,1411,2901
20,0,10,687,724,1411,3144
60,40,60,706,705,1411,3256
-110,20,150,702,710,1412,2907
-50,-10,150,674,738,1412,3091
-10,-70,-10,695,717,1412,3047
70,20,-40,685,727,1412,3107
-10,60,140,708,704,1412,3133
-160,-40,-150,698,714,1412,3043
-130,10,180,693,720,1413,2992
110,0,-140,697,716,1413,3153
50,10,10,687,726,1413,3195
60,-10,90,710,703,1413,3051
-130,10,-180,693,720,1413,2992
60,10,60,693,720,1413,3138
-130,0,-170,702,711,1413,3079
-30,10,-10,689,725,1414,3049
-50,-70,-50,689,725,1414,2939
-60,10,-160,667,747,1414,3004
-60,-20,110,682,732,1414,3122
100,-20,-140,668,746,1414,3132
-180,-50,-40,707,707,1414,3107
120,-30,170,696,718,1414,3025
150,-30,-70,693,721,1414,3105
-160,-50,-150,691,723,1414,3051
0,50,-10,697,717,1414,3076
180,-50,-40,707,707,1414,3107
50,-50,60,696,719,1415,3080
170,-10,-160,705,710,1415,3186
-90,-50,60,679,736,1415,3207
110,-60,130,702,713,1415,2993
-100,30,-80,694,722,1416,3043
120,-20,180,701,715,1416,3152
-90,0,80,683,733,1416,3039
80,40,-60,700,716,1416,3075
60,0,90,703,713,1416,3153
110,0,-80,707,709,1416,3151
40,60,-40,692,724,1416,3131
0,50,130,706,710,1416,3090
120,-20,-180,701,715,1416,3152
170,-30,-160,706,711,1417,2998
-40,-80,-40,697,720,1417,3073
40,30,-20,689,728,1417,3098
-140,-10,-160,688,729,1417,3081
-170,40,-180,679,738,1417,3057
30,60,90,710,707,1417,3057
130,-30,-80,698,719,1417,3161
-170,-60,-30,711,706,1417,3224
-170,40,180,679,738,1417,3057
60,0,60,683,734,1417,3037
180,-40,-150,713,705,1418,3022
60,20,70,696,722,1418,3230
-60,60,30,683,735,1418,2971
-130,-40,-140,687,731,1418,3066
90,-30,-140,689,729,1418,3189
110,60,10,703,715,1418,2932
110,20,-120,692,726,1418,3060
-90,10,140,684,734,1418,3092
-180,-40,-150,713,705,1418,3022
40,60,80,698,720,1418,3107
110,-10,-160,708,710,1418,3161
-40,-50,110,699,719,1418,3113
60,0,30,694,724,1418,3114
60,10,10,712,707,1419,3176
120,-10,-60,696,723,1419,3142
140,-30,180,719,700,1419,3257
140,-30,-180,719,700,1419,3257
70,20,40,711,708,1419,3196
-90,-80,50,697,722,1419,3107
10,30,120,702,717,1419,3119
70,40,50,692,727,1419,3202
40,10,10,701,718,1419,3148
-80,0,-70,680,739,1419,3002
-100,-20,-140,694,725,1419,3036
-170,-40,-150,701,718,1419,3167
-80,0,-100,662,757,1419,3007
0,-70,0,694,725,1419,3050
50,-10,110,709,711,1420,3186
160,-30,-170,699,721,1420,3137
-100,50,70,694,726,1420,3244
-90,70,-130,723,697,1420,3070
60,-40,70,687,733,1420,3175
-10,-50,130,685,735,1420,3188
10,-50,140,696,724,1420,3220
50,-20,140,694,726,1420,3072
10,-10,10,685,735,1420,3028
-70,10,-140,673,747,1420,3012
80,-70,90,689,731,1420,3033
20,-70,20,682,739,1421,3126
-90,-10,70,693,728,1421,3066
-30,-10,150,682,739,1421,3274
70,30,40,691,730,1421,3196
120,0,-160,684,737,1421,3260
100,60,20,702,719,1421,2951
100,-50,-120,688,734,1422,3194
160,10,-40,712,710,1422,3162
70,-20,90,700,722,1422,3178
100,70,-100,692,730,1422,3136
30,-10,30,697,725,1422,3178
-170,-30,-150,702,720,1422,3073
-70,30,-140,684,739,1423,3194
-70,40,10,676,747,1423,3295
40,-10,40,691,732,1423,3117
80,-40,-150,687,736,1423,3071
170,-20,-160,705,718,1423,3088
-70,0,140,695,728,1423,3176
80,-40,100,701,722,1423,3139
100,50,20,701,722,1423,3130
90,10,-60,690,733,1423,3108
70,10,-20,696,728,1424,3123
100,-20,150,679,745,1424,3235
130,-10,-60,709,715,1424,3159
-50,-20,120,694,730,1424,3187
60,-40,-180,687,737,1424,3073
90,-60,110,705,719,1424,3015
30,-10,130,714,710,1424,3087
110,30,0,721,703,1424,3195
60,-40,180,687,737,1424,3073
110,-10,170,688,736,1424,3304
110,-10,-170,695,730,1425,3207
-80,-50,70,698,727,1425,3211
-180,-10,-160,713,712,1425,3156
80,-20,170,699,726,1425,3204
100,-30,-110,694,731,1425,3187
90,-30,120,694,731,1425,3134
-120,60,110,682,743,1425,3111
180,-10,-160,713,712,1425,3156
110,-30,170,701,725,1426,3144
80,-50,100,698,728,1426,3217
-70,-80,70,704,722,1426,3105
100,-60,120,700,726,1426,2990
-160,10,-20,704,722,1426,3032
110,0,-40,714,712,1426,3209
50,0,30,708,719,1427,3193
60,-50,-170,687,740,1427,3152
40,20,100,708,719,1427,3300
-60,-20,-50,692,735,1427,3059
130,-60,150,713,714,1427,2953
170,-40,-160,713,715,1428,3014
-90,0,-180,702,726,1428,3251
-90,10,130,709,719,1428,3040
110,0,-50,705,723,1428,3190
-60,-80,80,707,721,1428,3140
-110,-40,-130,701,727,1428,3215
90,-20,150,700,728,1428,3330
30,10,10,704,724,1428,3117
50,30,80,690,738,1428,3305
150,20,-160,688,740,1428,3238
-90,0,180,702,726,1428,3251
-30,-40,120,680,749,1429,3122
-120,-10,-150,694,735,1429,2999
180,-30,-150,720,709,1429,3079
110,-30,-90,695,734,1429,3126
80,10,-50,686,743,1429,3228
150,30,-30,712,717,1429,2986
60,30,50,697,732,1429,3231
-120,-80,-120,697,732,1429,2974
-180,-30,-150,720,709,1429,3079
130,-30,180,712,718,1430,3067
-170,20,-170,709,721,1430,3245
120,-50,150,693,737,1430,3245
-150,-70,-10,694,736,1430,3204
120,-20,-170,710,720,1430,3272
130,-30,-180,712,718,1430,3067
110,-60,-110,696,735,1431,3106
-20,10,150,697,734,1431,2994
40,20,-10,695,736,1431,3141
-30,80,20,712,719,1431,3046
-100,30,-50,701,731,1432,3124
100,-20,-150,687,745,1432,3262
60,10,40,701,731,1432,3254
60,20,-20,689,743,1432,3124
50,0,110,704,728,1432,3237
-90,-20,-130,699,733,1432,3044
110,-40,150,710,722,1432,3184
70,-30,80,684,748,1432,3159
-60,50,-160,714,718,1432,3077
-90,50,-120,700,733,1433,2931
-110,-10,40,697,736,1433,3088
140,-20,-170,715,718,1433,3122
130,-10,-160,702,731,1433,3241
90,20,10,718,715,1433,3236
-150,50,-40,695,738,1433,3086
10,-70,10,696,737,1433,3116
80,-30,100,697,736,1433,3158
60,20,60,691,743,1434,3315
-100,80,90,713,721,1434,2965
-100,-30,50,681,753,1434,3166
-80,20,-30,714,720,1434,3236
60,0,70,711,723,1434,3166
100,10,0,688,746,1434,3325
120,80,10,704,730,1434,3061
80,60,40,739,695,1434,3122
120,10,-30,709,725,1434,3148
-50,-80,-50,702,732,1434,3173
130,10,-150,699,736,1435,3241
100,10,-80,704,731,1435,2993
120,-10,-150,703,732,1435,3278
-180,0,-160,722,713,1435,3109
-70,0,-160,698,737,1435,3047
180,0,-160,722,713,1435,3109
-150,-10,-160,683,752,1435,3059
-40,-80,100,722,714,1436,3115
-110,40,-70,687,749,1436,3116
50,20,-10,714,722,1436,3087
80,30,10,719,717,1436,3149
50,-20,130,710,726,1436,3124
70,30,-40,712,724,1436,3123
-10,-30,0,703,733,1436,2825
-60,-40,90,703,734,1437,3129
-110,10,170,707,730,1437,3132
120,-40,-90,709,728,1437,3201
110,-20,-100,702,735,1437,3233
50,-30,160,691,746,1437,3277
20,0,120,724,714,1438,3149
160,30,-160,700,738,1438,3142
110,-40,-100,702,737,1439,3170
-60,0,-180,701,738,1439,3295
-60,0,180,701,738,1439,3295
-60,-10,-40,702,737,1439,3107
-80,40,20,700,739,1439,3269
-110,-80,-110,703,736,1439,3023
0,40,-10,704,735,1439,3059
50,-60,-180,710,729,1439,3205
50,-60,180,710,729,1439,3205
-70,-40,80,707,733,1440,3288
-60,-10,120,687,753,1440,3200
-130,10,10,702,738,1440,3119
-40,80,30,706,734,1440,3069
-50,0,170,697,743,1440,3222
-110,0,40,684,756,1440,3069
-80,10,-110,688,752,1440,3107
60,10,70,696,744,1440,3241
0,60,-10,697,743,1440,3015
140,-50,-80,710,730,1440,3237
160,0,-160,697,744,1441,3236
-90,0,-170,693,748,1441,3241
120,-40,160,720,721,1441,3293
120,-10,-160,695,746,1441,3258
90,-20,180,712,729,1441,3348
90,-20,-180,712,729,1441,3348
-50,80,40,710,731,1441,3116
-170,-20,-150,703,738,1441,3102
-90,10,150,695,746,1441,3212
60,10,80,711,731,1442,3280
-140,30,160,692,750,1442,3251
70,-30,180,709,733,1442,3224
70,10,20,715,727,1442,3364
110,50,-100,714,728,1442,2931
50,10,100,699,743,1442,3282
70,-30,-180,709,733,1442,3224
-80,-10,-120,696,746,1442,2952
160,30,-30,724,718,1442,3048
-30,80,160,725,718,1443,2954
-20,-20,140,707,736,1443,3269
-50,-80,90,722,722,1444,3149
-150,30,170,712,732,1444,3143
60,70,-60,711,733,1444,3177
60,-20,110,727,717,1444,3208
-10,0,140,721,723,1444,3041
-30,-40,-20,696,748,1444,2990
-40,20,-10,703,742,1445,3120
100,-50,130,697,748,1445,3212
-80,-10,-130,689,756,1445,3100
120,-10,-80,708,737,1445,3131
-90,30,0,686,759,1445,3291
90,-40,120,705,740,1445,3336
-180,40,-30,716,730,1446,3160
-80,0,180,710,736,1446,3256
90,-20,-170,705,741,1446,3344
-80,0,-180,710,736,1446,3256
180,40,-30,716,730,1446,3160
-130,20,170,703,743,1446,3100
90,50,30,713,734,1447,3324
110,30,-110,692,755,1447,3199
50,0,40,714,733,1447,3190
50,-40,60,703,744,1447,3198
80,-30,-160,700,747,1447,3257
-140,10,-180,701,747,1448,3280
-140,10,180,701,747,1448,3280
-70,0,-170,696,752,1448,3163
-120,10,-180,713,735,1448,3108
-10,70,0,710,738,1448,2995
-120,10,180,713,735,1448,3108
10,-10,130,711,737,1448,3206
-120,-50,-130,712,736,1448,3290
100,-80,-130,717,732,1449,3330
-80,0,170,704,745,1449,3140
-20,50,0,690,759,1449,3150
-100,30,-30,687,762,1449,3293
0,40,130,706,743,1449,3143
160,-70,170,696,753,1449,3158
60,-60,-170,720,730,1450,3239
-100,-50,50,705,745,1450,3191
100,-20,160,707,743,1450,3358
90,60,30,744,706,1450,3065
110,0,-70,707,743,1450,3202
40,-20,50,724,726,1450,3076
120,30,-10,715,736,1451,3187
60,10,20,723,728,1451,3236
-100,30,90,686,765,1451,3104
150,50,-150,690,761,1451,3163
-170,60,-40,712,739,1451,3245
-100,20,70,695,757,1452,3146
-100,10,60,707,745,1452,3245
110,-50,140,696,756,1452,3245
110,-20,-130,683,769,1452,3183
-90,10,120,712,740,1452,3089
-100,30,20,702,750,1452,3204
140,70,-10,719,733,1452,3227
30,-20,40,701,751,1452,3121
40,-20,140,698,755,1453,3335
-160,-30,-150,717,736,1453,3194
70,-70,80,705,748,1453,3205
10,10,0,703,751,1454,3092
90,-20,-160,704,750,1454,3264
120,0,-150,708,746,1454,3402
160,-10,-160,720,734,1454,3309
-90,40,30,704,750,1454,3247
-170,0,-160,729,726,1455,3277
30,-30,140,731,724,1455,3167
20,-20,130,701,754,1455,3140
30,10,110,735,720,1455,3308
180,30,-30,720,735,1455,3211
90,-30,130,727,728,1455,3311
-100,-40,-120,693,762,1455,3286
-180,30,-30,720,735,1455,3211
120,-10,-90,704,751,1455,3243
110,-20,-120,699,757,1456,3193
170,30,-30,731,725,1456,3149
-70,20,-140,694,763,1457,3117
120,-10,180,709,748,1457,3328
120,-10,-180,709,748,1457,3328
120,-10,-170,701,756,1457,3297
40,-10,130,712,745,1457,3383
130,50,-10,727,730,1457,3064
180,70,-40,722,736,1458,3200
-60,-70,-60,713,745,1458,3040
-90,80,80,723,735,1458,2984
-100,-80,-100,710,748,1458,3133
-90,-80,-90,706,752,1458,3229
-180,70,-40,722,736,1458,3200
60,10,30,728,730,1458,3326
110,10,-120,699,759,1458,3112
120,-10,-70,704,755,1459,3194
60,40,50,722,737,1459,3211
120,-80,-110,716,743,1459,3311
-90,20,-100,710,749,1459,3030
70,10,-10,711,748,1459,3270
-70,0,170,696,763,1459,3317
-70,0,150,702,757,1459,3133
60,-30,170,700,760,1460,3281
110,-20,-160,713,747,1460,3275
-40,-20,130,716,744,1460,3236
-130,30,150,702,758,1460,3153
110,-20,170,698,762,1460,3255
10,-60,140,710,750,1460,3326
70,-20,80,717,743,1460,3145
100,-20,-160,707,753,1460,3406
50,10,20,727,733,1460,3345
-30,-70,110,722,739,1461,3218
140,-60,160,726,735,1461,2906
60,50,60,734,727,1461,3397
-50,-30,-40,714,747,1461,3187
110,-80,-120,717,744,1461,3346
90,10,0,716,746,1462,3380
110,0,-60,715,747,1462,3198
-180,30,-170,691,771,1462,3323
180,30,-170,691,771,1462,3323
120,-20,-160,711,752,1463,3375
-20,-60,120,712,751,1463,3263
-150,20,-20,707,756,1463,3138
110,-20,-110,707,756,1463,3339
90,40,20,731,733,1464,3187
70,50,50,735,729,1464,3312
60,0,80,720,744,1464,3234
90,-20,160,718,746,1464,3343
70,10,0,720,744,1464,3345
-50,10,-180,699,766,1465,3194
40,-70,170,722,743,1465,3291
-100,40,60,702,763,1465,3424
50,20,90,731,734,1465,3405
90,10,-50,718,747,1465,3385
-50,10,180,699,766,1465,3194
120,20,-130,714,751,1465,3172
90,20,-70,704,761,1465,3189
-170,-50,-30,721,744,1465,3281
-100,-20,50,705,760,1465,3009
110,10,-20,724,742,1466,3245
180,60,180,716,750,1466,3068
150,60,-150,686,780,1466,3162
-30,-10,-10,722,744,1466,3108
180,60,-180,716,750,1466,3068
-120,70,110,687,779,1466,3086
90,10,-10,713,753,1466,3350
120,60,0,728,738,1466,2991
-180,60,180,716,750,1466,3068
160,-10,-50,735,731,1466,3163
70,20,30,733,733,1466,3294
-180,60,-180,716,750,1466,3068
90,10,-20,718,748,1466,3260
70,-50,-160,698,769,1467,3206
120,-20,-90,736,731,1467,3243
140,-40,-80,723,744,1467,3334
-110,-20,-140,712,755,1467,3153
130,-20,-80,719,749,1468,3287
180,20,-30,719,749,1468,3186
110,70,-110,719,749,1468,3220
-140,-40,-140,716,752,1468,3203
-180,20,-30,719,749,1468,3186
-100,30,80,701,768,1469,3249
50,-70,180,722,747,1469,3264
80,-30,110,715,754,1469,3288
110,-50,-110,710,759,1469,3170
-60,-50,90,717,752,1469,3306
-60,-80,-60,709,760,1469,3178
-40,0,160,715,754,1469,3261
-80,80,70,737,732,1469,3061
50,-70,-180,722,747,1469,3264
30,-70,160,730,739,1469,3291
60,-20,90,732,737,1469,3233
50,50,70,736,734,1470,3396
130,30,-20,732,738,1470,3161
60,-30,70,707,763,1470,3358
110,-20,-140,706,764,1470,3247
-150,60,150,693,777,1470,3222
80,50,40,718,752,1470,3344
100,-40,140,716,754,1470,3298
60,20,50,725,745,1470,3415
50,40,-30,738,732,1470,3214
170,0,-160,719,751,1470,3249
70,-40,-170,701,770,1471,3275
100,30,-90,695,776,1471,3231
90,-80,-140,731,740,1471,3333
-160,30,180,710,761,1471,3133
-70,-30,-70,716,755,1471,3158
-20,-30,130,730,741,1471,3487
-160,30,-180,710,761,1471,3133
50,0,100,719,752,1471,3284
110,20,-10,722,749,1471,3395
160,50,-160,701,771,1472,3234
50,40,70,734,738,1472,3382
-150,-50,-140,718,754,1472,3185
-180,-40,-40,728,744,1472,3149
180,-40,-40,728,744,1472,3149
130,0,-150,722,750,1472,3227
80,10,-40,707,765,1472,3342
120,10,-140,725,747,1472,3396
-150,-20,-150,719,753,1472,3150
-70,60,-150,735,738,1473,3106
140,-10,-160,722,751,1473,3245
150,-40,-180,722,751,1473,3209
150,-40,180,722,751,1473,3209
-100,20,110,725,749,1474,3213
130,80,0,721,753,1474,3137
-170,-50,-150,725,749,1474,3380
-140,-70,0,709,765,1474,3190
-80,-40,70,722,752,1474,3304
60,20,20,739,735,1474,3398
-120,-40,-130,723,752,1475,3270
70,10,10,722,753,1475,3430
-110,30,-30,711,764,1475,3309
60,-20,70,717,758,1475,3382
-150,50,160,704,771,1475,3221
70,20,20,743,733,1476,3368
-100,0,-170,711,765,1476,3263
-110,20,30,703,773,1476,3337
100,10,-30,737,739,1476,3341
120,70,-120,727,749,1476,3294
20,-10,20,729,747,1476,3264
30,0,20,720,756,1476,3166
-70,-80,-70,718,758,1476,3223
130,-80,-100,734,743,1477,3305
110,40,-100,736,741,1477,3154
-80,50,40,732,745,1477,3270
-110,-30,-130,726,751,1477,3079
-120,-70,-120,713,765,1478,3310
-160,-60,-20,743,735,1478,3285
160,-40,-170,718,760,1478,3118
100,-30,150,715,763,1478,3221
-120,-30,-130,725,753,1478,3098
130,-50,160,717,761,1478,3237
120,10,-130,710,769,1479,3423
60,-10,70,739,740,1479,3310
-70,20,-20,727,752,1479,3369
-100,40,-100,728,751,1479,3045
-70,0,130,715,764,1479,3419
80,20,10,750,729,1479,3434
150,0,-160,721,758,1479,3251
50,30,70,736,743,1479,3291
130,0,-50,735,744,1479,3295
-130,-30,-140,711,769,1480,3245
40,50,80,733,747,1480,3343
120,-30,-90,735,745,1480,3303
-80,0,110,717,763,1480,3206
-160,-60,-150,735,745,1480,3046
60,-70,-170,734,746,1480,3296
-130,-70,-130,713,767,1480,3223
40,0,110,726,754,1480,3356
90,10,-30,735,745,1480,3345
170,-70,-180,701,779,1480,3134
50,70,-50,729,751,1480,3285
110,-20,-150,731,749,1480,3211
170,-70,180,701,779,1480,3134
140,-80,-90,742,739,1481,3320
-60,80,50,724,757,1481,3111
-10,10,140,729,752,1481,3110
-90,-30,60,722,759,1481,3164
-130,-60,-130,722,759,1481,3315
-120,50,120,704,777,1481,3082
120,0,-120,728,754,1482,3306
40,-30,50,734,748,1482,3268
120,-10,-140,730,752,1482,3449
-100,20,130,730,752,1482,3107
110,-10,180,709,773,1482,3330
110,-10,-180,709,773,1482,3330
-30,40,0,722,761,1483,3410
-140,10,-170,727,756,1483,3281
-110,50,100,705,778,1483,3246
170,0,-40,738,745,1483,3221
100,-30,-120,708,775,1483,3400
20,20,110,753,730,1483,3105
-70,0,-180,718,766,1484,3380
90,-40,-140,723,761,1484,3242
-70,0,180,718,766,1484,3380
70,-40,90,723,761,1484,3348
-140,-30,-140,727,757,1484,3208
-90,-40,60,718,766,1484,3080
-120,30,140,714,770,1484,3244
-80,-80,-80,721,763,1484,3236
170,60,-30,730,755,1485,3268
100,-40,-120,716,769,1485,3161
50,-60,60,733,752,1485,3217
-80,20,-120,723,762,1485,3184
70,-50,90,712,773,1485,3370
100,10,-10,710,775,1485,3521
80,10,-30,730,755,1485,3404
120,30,-120,709,777,1486,3277
70,-80,-160,743,743,1486,3323
20,-70,150,729,757,1486,3294
70,50,-50,728,758,1486,3059
110,-20,-170,720,766,1486,3411
40,0,40,719,767,1486,3322
100,10,-70,724,762,1486,3206
120,-10,-120,737,750,1487,3189
70,30,20,739,748,1487,3359
100,20,-90,723,764,1487,3251
80,10,10,722,765,1487,3341
-100,-10,-150,731,756,1487,3176
50,10,30,741,746,1487,3304
150,-20,-70,745,742,1487,3282
150,-10,-160,726,762,1488,3242
40,-10,50,721,767,1488,3131
-130,40,-40,707,781,1488,3286
170,40,-30,735,753,1488,3220
-100,60,80,701,787,1488,3308
-70,0,160,721,767,1488,3371
130,-10,-70,743,745,1488,3315
160,10,-160,714,774,1488,3346
-90,30,10,722,766,1488,3400
80,10,-10,731,757,1488,3408
130,-40,170,732,757,1489,3312
-70,80,60,739,750,1489,3109
30,-20,130,745,744,1489,3223
90,-70,-140,737,752,1489,3303
120,-10,-100,730,759,1489,3199
50,0,50,740,749,1489,3297
-80,0,-170,715,774,1489,3262
-40,-10,150,718,772,1490,3432
70,60,-60,735,755,1490,3136
70,30,30,729,761,1490,3307
80,-80,-150,748,742,1490,3365
120,-50,-100,729,761,1490,3194
120,0,-130,737,754,1491,3366
-80,-10,-110,702,789,1491,3171
-160,50,170,714,777,1491,3174
60,70,60,736,755,1491,3167
-180,-70,-170,708,784,1492,3105
60,-20,100,739,753,1492,3260
20,-40,140,734,758,1492,3312
-60,50,20,714,778,1492,3294
180,-70,-170,708,784,1492,3105
150,10,-160,720,772,1492,3338
80,-30,120,728,764,1492,3400
-80,-30,70,712,780,1492,3017
110,20,-110,726,766,1492,3259
110,-20,-180,728,765,1493,3431
80,-70,-150,740,753,1493,3316
-90,10,-80,731,762,1493,3157
30,50,90,741,752,1493,3336
-50,30,-170,723,770,1493,3404
150,60,-20,746,747,1493,3159
100,-30,-130,725,768,1493,3408
120,10,-120,726,767,1493,3260
110,-20,180,728,765,1493,3431
20,50,-20,720,774,1494,3239
100,10,-50,737,757,1494,3395
110,-30,-100,730,764,1494,3307
70,-30,90,725,769,1494,3291
-70,-70,-70,726,768,1494,3235
-180,-20,-150,746,748,1494,3271
-100,30,70,717,777,1494,3357
180,-20,-150,746,748,1494,3271
100,-20,-180,716,779,1495,3510
100,-20,180,716,779,1495,3510
-110,-70,-110,732,763,1495,3329
40,0,30,730,765,1495,3356
100,10,-60,724,771,1495,3291
100,20,0,742,753,1495,3417
60,-10,80,736,759,1495,3310
110,10,-110,723,772,1495,3238
120,20,-120,721,775,1496,3225
100,10,-40,746,750,1496,3383
70,20,-30,733,763,1496,3366
120,-10,-130,736,760,1496,3255
-150,-60,-140,751,745,1496,3231
-10,-40,130,729,767,1496,3369
-30,-20,140,732,764,1496,3513
-40,-40,110,735,762,1497,3306
100,10,-20,745,752,1497,3367
140,-30,-80,758,739,1497,3280
40,-10,120,742,755,1497,3429
-40,-40,-30,722,775,1497,3225
-130,-20,-140,727,770,1497,3101
-80,-10,-90,714,783,1497,3122
-80,0,-60,715,782,1497,3108
-110,-50,-120,733,764,1497,3327
110,10,-100,737,761,1498,3184
90,-30,-150,712,786,1498,3363
-110,30,120,723,775,1498,3322
120,20,-20,744,754,1498,3340
30,-30,40,738,760,1498,3186
-10,50,140,744,755,1499,3258
-110,60,-100,750,749,1499,3230
150,-10,-60,751,748,1499,3244
90,-30,140,742,758,1500,3357
70,-70,-160,741,759,1500,3351
60,20,30,728,772,1500,3530
50,-20,60,743,757,1500,3387
50,-80,180,746,754,1500,3363
50,-80,-180,746,754,1500,3363
-30,60,10,719,781,1500,3089
60,-80,-170,747,753,1500,3339
-100,10,170,722,779,1501,3135
-10,10,0,723,778,1501,3169
-90,-50,-100,726,775,1501,3335
140,-30,-170,742,759,1501,3300
70,70,50,761,740,1501,3204
-90,30,-110,720,781,1501,3123
-20,70,150,755,747,1502,3234
120,-20,-150,747,756,1503,3304
-70,50,30,746,757,1503,3313
90,-20,170,728,775,1503,3460
-70,0,-40,724,779,1503,3204
-50,-50,100,748,755,1503,3414
-100,30,30,727,776,1503,3383
-80,-10,-80,718,785,1503,3180
-110,50,-90,724,779,1503,3096
120,-30,-180,736,768,1504,3403
120,-30,180,736,768,1504,3403
90,10,-40,745,759,1504,3418
-80,-10,-100,722,782,1504,3217
-90,10,-60,723,781,1504,3089
-90,10,110,730,774,1504,3332
90,30,-70,745,759,1504,3374
-90,10,-70,731,773,1504,3042
120,0,-50,749,756,1505,3423
-70,10,-30,728,777,1505,3219
80,-40,110,733,772,1505,3284
-130,-50,-130,740,765,1505,3209
-60,-50,-60,726,779,1505,3194
-20,20,150,734,771,1505,3305
120,-10,-110,759,747,1506,3108
40,-50,160,738,768,1506,3359
100,-30,160,738,768,1506,3282
80,-30,-170,728,778,1506,3402
-90,10,90,722,784,1506,3456
70,20,10,750,756,1506,3482
30,-10,40,738,768,1506,3261
130,-20,-160,752,754,1506,3285
90,-50,120,735,771,1506,3303
-80,-20,-100,710,796,1506,3271
40,-80,170,745,762,1507,3408
-100,30,-40,725,782,1507,3565
-110,40,110,708,799,1507,3270
60,-30,150,734,773,1507,3281
-170,30,-170,733,775,1508,3258
130,10,-40,750,758,1508,3178
-100,-50,-110,740,768,1508,3455
-110,10,180,719,789,1508,3210
50,0,90,741,767,1508,3331
-130,-70,10,735,773,1508,3222
-110,10,-180,719,789,1508,3210
-120,30,-30,721,787,1508,3220
80,20,-50,733,775,1508,3353
-170,30,-30,731,778,1509,3163
150,-80,-80,753,756,1509,3411
60,-30,160,735,774,1509,3422
-130,20,-10,724,785,1509,3221
50,40,60,754,755,1509,3365
50,30,-20,735,775,1510,3271
80,-60,100,734,776,1510,3258
-100,-10,50,733,777,1510,3230
130,20,-140,737,773,1510,3407
-40,-70,100,741,769,1510,3388
70,-30,170,760,751,1511,3377
0,10,0,737,774,1511,3249
50,-10,60,733,778,1511,3312
-160,10,-170,752,759,1511,3396
-110,10,40,730,781,1511,3390
60,30,40,747,764,1511,3389
-60,0,-30,725,786,1511,3229
-120,-20,-140,730,782,1512,3164
50,-30,60,739,773,1512,3460
10,20,120,752,760,1512,3488
100,-20,170,744,768,1512,3465
0,-30,10,737,775,1512,2979
-80,0,-110,726,786,1512,3350
150,-30,-170,739,773,1512,3554
60,-20,80,749,763,1512,3387
110,-70,-120,750,762,1512,3309
130,70,-130,744,768,1512,3293
-120,20,0,732,781,1513,3333
120,0,-140,762,751,1513,3459
60,20,10,761,752,1513,3392
-80,-10,90,725,788,1513,3154
-100,40,70,710,803,1513,3499
-40,50,10,730,783,1513,3413
30,60,-30,740,773,1513,3301
150,-70,-80,745,769,1514,3426
80,-30,130,741,773,1514,3318
50,-20,110,737,777,1514,3195
60,50,-40,739,776,1515,3252
80,50,-60,753,762,1515,3197
170,60,-170,743,772,1515,3345
-90,10,-90,737,778,1515,3280
-150,-40,-140,744,771,1515,3383
130,-50,-90,741,774,1515,3303
80,40,30,741,774,1515,3426
50,70,70,741,774,1515,3216
140,-10,-70,748,768,1516,3349
100,-20,-170,727,789,1516,3411
60,-70,70,734,782,1516,3326
90,60,-80,743,773,1516,3344
50,0,80,753,763,1516,3413
-30,-60,110,752,764,1516,3340
70,-60,-160,747,770,1517,3361
110,-40,-110,730,787,1517,3233
100,-70,-130,746,771,1517,3301
140,80,-10,744,774,1518,3223
-110,-10,-150,740,778,1518,3206
70,-30,150,742,776,1518,3435
-20,-40,-10,761,757,1518,3174
-80,10,-120,744,774,1518,3391
-130,-40,-130,738,780,1518,3354
-90,10,100,747,771,1518,3191
60,20,-10,753,765,1518,3351
-130,0,-160,750,768,1518,3223
-180,10,-160,757,762,1519,3253
180,10,-160,757,762,1519,3253
-40,80,170,767,752,1519,3051
-80,-70,-80,730,789,1519,3396
100,40,10,753,766,1519,3326
-140,50,150,723,796,1519,3406
-20,0,0,739,781,1520,3228
80,70,40,768,752,1520,3168
50,10,40,739,781,1520,3365
70,-30,120,754,766,1520,3382
-130,-10,-150,739,781,1520,3176
-100,20,60,732,788,1520,3329
120,-20,-100,747,774,1521,3279
70,-30,160,752,769,1521,3378
100,30,0,771,750,1521,3327
50,-20,70,756,765,1521,3332
170,50,-30,764,757,1521,3316
-80,40,-130,747,774,1521,3228
-70,-70,70,735,786,1521,3411
140,30,-30,741,781,1522,3289
10,-20,130,733,789,1522,3400
110,10,-90,745,777,1522,3316
-70,0,120,727,795,1522,3319
-100,30,-90,740,782,1522,3381
80,10,0,736,786,1522,3472
170,10,-160,752,770,1522,3305
-140,0,-160,749,775,1524,3169
170,20,-160,750,774,1524,3399
-80,30,0,728,796,1524,3559
160,60,-160,722,803,1525,3434
40,40,80,744,781,1525,3498
-50,-20,110,720,805,1525,3336
80,10,-20,746,779,1525,3524
170,-30,-50,752,773,1525,3405
50,10,90,740,785,1525,3473
0,-20,10,759,766,1525,3166
140,-70,-90,761,764,1525,3400
20,-30,30,730,796,1526,3329
-150,0,-160,745,781,1526,3359
160,20,-160,757,769,1526,3430
-90,-20,-120,733,793,1526,3287
80,-40,-160,727,799,1526,3421
110,10,-30,741,785,1526,3308
-80,-20,70,728,798,1526,3183
-130,50,-60,732,794,1526,3382
-120,0,-160,742,785,1527,3191
-90,-70,50,738,789,1527,3421
10,0,10,749,778,1527,3231
-60,0,160,736,791,1527,3410
80,-50,-150,728,799,1527,3395
140,70,-140,744,783,1527,3370
50,-10,90,763,764,1527,3325
-90,90,-140,753,775,1528,3384
140,20,-150,736,792,1528,3485
140,90,-10,753,775,1528,3384
-110,90,-120,753,775,1528,3384
-180,90,-50,753,775,1528,3384
-120,90,-110,753,775,1528,3384
-100,30,50,739,789,1528,3469
-150,90,-80,753,775,1528,3384
90,90,40,753,775,1528,3384
-60,90,-170,753,775,1528,3384
120,90,10,753,775,1528,3384
-160,-50,-20,767,761,1528,3427
-140,90,-90,753,775,1528,3384
130,90,0,753,775,1528,3384
150,90,-20,753,775,1528,3384
-30,90,160,753,775,1528,3384
10,90,120,753,775,1528,3384
30,90,100,753,775,1528,3384
-160,90,-70,753,775,1528,3384
-70,90,-160,753,775,1528,3384
170,90,-40,753,775,1528,3384
100,90,30,753,775,1528,3384
80,90,50,753,775,1528,3384
40,90,90,753,775,1528,3384
-80,90,-150,753,775,1528,3384
-20,90,150,753,775,1528,3384
110,90,20,753,775,1528,3384
20,90,110,753,775,1528,3384
-100,90,-130,753,775,1528,3384
50,90,80,753,775,1528,3384
-130,90,-100,753,775,1528,3384
-10,90,140,753,775,1528,3384
60,90,70,753,775,1528,3384
180,90,-50,753,775,1528,3384
70,90,60,753,775,1528,3384
60,20,40,756,772,1528,3494
-40,90,170,753,775,1528,3384
160,90,-30,753,775,1528,3384
-50,90,180,753,775,1528,3384
-170,90,-60,753,775,1528,3384
-50,90,-180,753,775,1528,3384
0,90,130,753,775,1528,3384
50,0,70,749,780,1529,3456
180,-50,-150,761,768,1529,3365
160,-20,-160,762,767,1529,3414
-100,70,-120,780,749,1529,3218
-180,-50,-150,761,768,1529,3365
80,60,-70,747,782,1529,3274
-50,-40,100,747,783,1530,3482
-110,70,100,736,794,1530,3256
-120,40,-50,746,784,1530,3483
-80,0,-160,739,791,1530,3248
-140,-60,-130,756,774,1530,3353
-100,20,120,765,765,1530,3173
140,-50,170,760,771,1531,3275
40,70,80,753,778,1531,3194
-110,40,-80,737,794,1531,3263
40,10,100,748,783,1531,3474
50,-10,100,766,765,1531,3334
90,40,-70,770,761,1531,3233
120,-70,-110,756,775,1531,3384
-50,-70,90,757,774,1531,3406
30,-80,160,762,770,1532,3465
-100,0,50,740,792,1532,3403
70,40,40,761,771,1532,3408
40,70,-40,766,766,1532,3363
20,-80,150,755,777,1532,3476
140,0,-150,763,769,1532,3518
-100,20,140,759,773,1532,3263
130,30,-130,741,791,1532,3404
40,10,20,749,784,1533,3471
50,20,0,747,786,1533,3318
140,-20,-160,771,762,1533,3332
-170,50,180,732,801,1533,3308
-170,50,-180,732,801,1533,3308
-80,-70,60,739,795,1534,3375
160,-80,-70,762,772,1534,3467
30,-50,150,749,785,1534,3471
130,-70,-100,771,763,1534,3333
120,-20,-110,765,769,1534,3329
110,-40,160,751,783,1534,3276
-80,-10,80,732,802,1534,3187
-60,40,10,737,797,1534,3506
-120,10,20,761,773,1534,3402
130,-30,-170,758,776,1534,3328
140,-40,-180,735,800,1535,3415
-50,20,-10,749,786,1535,3470
50,30,60,757,778,1535,3423
140,-40,180,735,800,1535,3415
-100,-70,-100,759,777,1536,3433
120,0,-110,757,779,1536,3320
-50,0,-20,756,780,1536,3265
60,20,0,767,769,1536,3391
-50,-30,100,756,780,1536,3386
90,50,-70,768,769,1537,3246
50,-10,70,754,783,1537,3334
30,-40,40,764,773,1537,3204
100,-40,150,744,793,1537,3413
-60,-30,-50,764,773,1537,3303
-110,0,-160,738,800,1538,3227
120,10,-110,746,793,1539,3327
160,-70,-70,760,779,1539,3407
50,10,50,750,789,1539,3480
70,-30,100,748,791,1539,3330
50,20,20,750,789,1539,3525
-10,20,140,757,782,1539,3381
-140,60,140,729,811,1540,3431
80,-30,180,763,777,1540,3426
80,-30,-180,763,777,1540,3426
90,-40,130,741,799,1540,3425
-90,60,70,742,798,1540,3456
-170,-70,-160,743,797,1540,3225
120,-20,-120,754,787,1541,3271
-70,-60,-70,738,803,1541,3461
-100,20,-60,733,808,1541,3288
90,30,0,781,760,1541,3305
-140,-10,-150,762,779,1541,3313
-90,20,-40,738,803,1541,3510
150,-60,170,763,778,1541,3179
60,30,30,753,788,1541,3575
170,-50,-160,775,767,1542,3189
-100,-70,40,754,789,1543,3310
40,-30,140,752,791,1543,3379
-90,0,70,729,814,1543,3235
50,20,30,753,790,1543,3459
-90,10,-50,755,788,1543,3197
100,-30,-140,740,804,1544,3459
120,40,-110,761,783,1544,3413
120,0,-90,759,785,1544,3451
160,-20,-60,743,801,1544,3442
130,10,-140,761,783,1544,3488
-60,0,170,758,786,1544,3591
160,-50,-170,765,779,1544,3343
-30,20,160,753,791,1544,3481
70,-30,130,764,781,1545,3417
90,70,30,766,779,1545,3276
50,-10,80,767,778,1545,3316
110,40,0,761,784,1545,3379
-80,60,-140,778,767,1545,3236
130,-10,-80,755,790,1545,3348
0,30,130,764,781,1545,3449
80,30,-50,758,788,1546,3559
30,40,-20,753,793,1546,3260
-110,20,20,740,806,1546,3467
150,30,-150,758,788,1546,3443
-70,-30,80,759,787,1546,3406
150,-40,-170,760,787,1547,3420
-90,-10,-140,748,799,1547,3384
-90,-70,-90,752,796,1548,3407
130,0,-140,761,787,1548,3457
-120,40,130,742,806,1548,3408
50,20,10,769,779,1548,3484
-20,60,150,766,782,1548,3426
30,40,90,772,776,1548,3575
50,20,60,762,786,1548,3690
100,60,-90,742,807,1549,3449
80,-30,140,766,783,1549,3436
0,20,130,765,784,1549,3388
50,-30,150,746,803,1549,3419
110,-30,-180,752,797,1549,3456
-60,-70,80,768,781,1549,3430
-160,50,-40,772,777,1549,3441
-100,50,-110,767,782,1549,3164
110,-30,180,752,797,1549,3456
120,-40,-100,755,794,1549,3335
-120,-70,20,766,784,1550,3271
-110,-70,30,765,785,1550,3340
130,20,-30,769,781,1550,3408
-60,40,-160,754,796,1550,3407
80,-60,-150,743,807,1550,3460
110,-30,-110,748,802,1550,3477
60,-30,120,765,785,1550,3386
-60,-20,100,737,813,1550,3375
150,-50,-180,750,801,1551,3308
-100,50,80,737,814,1551,3434
130,-20,-90,761,790,1551,3490
-140,50,-50,747,804,1551,3451
150,-50,180,750,801,1551,3308
50,20,80,759,792,1551,3665
-110,20,160,755,796,1551,3415
-100,30,100,741,810,1551,3196
0,-80,130,757,795,1552,3526
120,20,-110,751,801,1552,3359
-20,70,10,759,794,1553,3276
-120,-60,-120,756,797,1553,3442
30,0,40,765,788,1553,3530
110,10,-40,763,790,1553,3459
-150,-50,-10,771,783,1554,3495
40,-20,130,762,792,1554,3505
90,20,-60,754,800,1554,3540
0,-50,130,760,794,1554,3635
140,-20,-80,782,772,1554,3365
90,-30,-160,745,809,1554,3646
120,-20,-130,775,779,1554,3411
-100,30,40,759,795,1554,3640
130,-30,-90,775,780,1555,3523
120,0,-100,765,790,1555,3339
-80,10,-40,752,803,1555,3305
-100,30,60,744,812,1556,3465
60,60,-50,757,799,1556,3261
150,70,-150,751,805,1556,3476
10,-80,140,764,792,1556,3491
-70,50,-150,763,793,1556,3345
40,-50,50,761,796,1557,3461
110,10,-80,763,794,1557,3377
40,0,50,765,792,1557,3384
50,10,80,782,775,1557,3544
70,40,-40,767,790,1557,3308
-130,10,-170,769,789,1558,3244
0,10,130,759,799,1558,3460
10,-70,140,762,796,1558,3468
20,60,100,774,784,1558,3239
0,-10,10,773,785,1558,3282
-70,-10,-50,752,806,1558,3195
-150,20,180,773,785,1558,3254
-150,20,-180,773,785,1558,3254
100,-30,-150,749,809,1558,3650
-130,30,-30,747,812,1559,3459
40,-40,50,770,789,1559,3378
70,20,0,770,789,1559,3484
20,10,10,743,816,1559,3252
130,50,-120,772,787,1559,3345
180,20,-160,761,799,1560,3455
-20,50,150,756,804,1560,3393
-110,60,100,751,809,1560,3385
90,20,0,753,807,1560,3668
160,-30,-160,769,791,1560,3382
50,20,50,752,808,1560,3494
70,30,10,786,774,1560,3453
-180,20,-160,761,799,1560,3455
-140,-50,-130,770,791,1561,3402
20,-20,30,773,788,1561,3306
-140,10,-10,767,794,1561,3476
40,20,90,765,796,1561,3580
120,50,-110,784,777,1561,3221
-150,-60,-10,779,783,1562,3481
30,70,90,773,789,1562,3267
30,0,30,770,792,1562,3566
-170,-40,-30,769,793,1562,3380
10,30,-10,755,807,1562,3431
130,-10,-150,763,799,1562,3363
-60,20,-10,773,791,1564,3455
100,-40,-130,763,801,1564,3381
40,-40,150,774,790,1564,3427
-90,-20,60,753,811,1564,3392
20,40,100,785,779,1564,3475
-100,0,-160,764,800,1564,3359
60,-30,140,771,794,1565,3519
50,30,50,778,787,1565,3523
90,-30,150,769,796,1565,3448
160,40,-30,771,794,1565,3276
110,20,-90,778,787,1565,3480
-50,-40,-40,777,788,1565,3348
110,20,-100,772,794,1566,3386
50,10,60,770,796,1566,3672
-70,-20,90,782,784,1566,3513
-90,50,60,749,817,1566,3611
-80,-40,-90,749,817,1566,3403
60,-50,80,762,804,1566,3431
-90,10,160,766,800,1566,3348
50,-40,160,779,788,1567,3522
80,40,-50,778,789,1567,3382
30,0,110,781,786,1567,3468
140,10,-150,782,785,1567,3549
170,-80,-60,777,790,1567,3514
-90,-30,-110,752,815,1567,3490
-90,40,40,747,820,1567,3440
60,-30,130,782,785,1567,3541
-120,-50,-120,769,799,1568,3310
100,-50,-130,770,799,1569,3510
150,-20,-160,769,800,1569,3438
110,30,-100,760,809,1569,3488
-140,-50,0,765,804,1569,3560
-150,10,-170,788,781,1569,3382
-100,20,-70,757,813,1570,3302
20,-40,30,762,808,1570,3234
-80,-20,-90,752,818,1570,3417
-160,-50,-140,770,800,1570,3613
-20,40,0,758,812,1570,3518
90,-40,-150,754,816,1570,3438
-80,10,130,750,820,1570,3485
30,20,100,780,790,1570,3595
-130,-30,-130,775,796,1571,3257
-40,-60,100,780,791,1571,3478
-170,70,-50,781,790,1571,3461
120,-20,-140,778,793,1571,3571
50,0,60,766,805,1571,3570
130,40,-120,763,808,1571,3382
-40,-30,110,771,801,1572,3431
50,20,70,780,792,1572,3657
0,-40,130,765,807,1572,3593
20,50,100,776,796,1572,3371
-90,0,-160,750,823,1573,3411
30,-10,120,763,810,1573,3440
100,40,-80,786,787,1573,3342
30,20,0,781,792,1573,3422
170,-70,-60,774,799,1573,3504
130,-10,-90,769,804,1573,3373
70,-30,110,770,804,1574,3439
0,-10,130,767,807,1574,3407
-80,10,140,770,804,1574,3460
110,-30,-160,751,823,1574,3544
-60,-30,90,774,800,1574,3337
10,10,120,787,787,1574,3486
-80,0,-50,745,829,1574,3441
110,-50,150,759,816,1575,3488
-50,-10,140,775,800,1575,3556
-140,-40,-130,796,779,1575,3454
-120,20,170,780,795,1575,3322
100,20,-80,753,822,1575,3431
60,40,40,774,802,1576,3476
120,0,-80,766,810,1576,3464
-20,-50,120,770,806,1576,3485
-10,-80,120,771,805,1576,3614
20,-30,130,767,809,1576,3526
-70,30,0,749,827,1576,3595
-70,-50,-70,757,819,1576,3367
-70,-10,100,794,782,1576,3452
-50,80,180,793,784,1577,3245
140,0,-60,791,786,1577,3504
160,-40,-160,774,803,1577,3356
-90,10,70,750,827,1577,3365
-80,0,-120,726,851,1577,3579
-50,80,-180,793,784,1577,3245
90,-50,-140,755,822,1577,3490
50,-50,170,764,814,1578,3529
-130,-60,-120,776,802,1578,3357
110,-30,-120,773,805,1578,3619
90,80,-90,796,782,1578,3583
-160,0,-20,768,810,1578,3510
150,20,-40,792,787,1579,3459
-140,-20,-140,776,803,1579,3282
130,-40,-90,774,805,1579,3463
-150,0,-10,765,814,1579,3515
90,-80,100,753,827,1580,3509
50,10,70,772,808,1580,3616
20,-10,30,790,790,1580,3444
-10,40,140,760,821,1581,3387
-110,-40,-120,752,829,1581,3353
10,-30,20,777,804,1581,3376
-120,-10,-140,777,804,1581,3433
70,-60,90,782,799,1581,3377
-60,-10,110,742,839,1581,3416
120,0,-60,769,812,1581,3602
-140,-40,0,781,800,1581,3524
110,-50,-120,774,807,1581,3535
80,-30,150,773,809,1582,3556
150,80,-20,775,807,1582,3379
160,-60,-70,763,819,1582,3532
70,40,30,771,811,1582,3523
0,-60,130,775,807,1582,3650
30,-50,40,785,798,1583,3609
50,-30,140,768,815,1583,3527
-130,-40,10,787,796,1583,3497
70,30,-30,781,803,1584,3602
150,70,-20,783,801,1584,3521
-90,40,-120,765,819,1584,3413
-100,40,80,749,835,1584,3575
120,-30,-100,780,805,1585,3459
100,-80,110,747,838,1585,3472
60,-40,170,772,814,1586,3439
-110,30,130,785,801,1586,3605
60,30,-20,776,810,1586,3497
-160,-40,-20,794,792,1586,3550
30,-30,130,767,820,1587,3395
-70,-60,70,771,817,1588,3574
-80,30,10,757,831,1588,3580
80,-30,160,769,819,1588,3555
10,-30,130,770,818,1588,3660
0,-40,10,788,800,1588,3311
100,-60,-130,759,830,1589,3557
80,80,-80,787,802,1589,3504
-80,-30,-90,754,835,1589,3529
80,-50,110,774,815,1589,3494
-30,-50,-20,774,816,1590,3321
70,20,-20,784,806,1590,3693
100,-30,170,768,822,1590,3614
-130,50,140,769,821,1590,3469
20,-90,150,789,802,1591,3637
-90,-90,40,789,802,1591,3637
0,-90,130,789,802,1591,3637
10,-90,140,789,802,1591,3637
140,-90,-90,789,802,1591,3637
-150,-90,-20,789,802,1591,3637
120,-90,-110,789,802,1591,3637
-100,-90,30,789,802,1591,3637
-110,-90,20,789,802,1591,3637
60,-90,-170,789,802,1591,3637
50,-90,-180,789,802,1591,3637
70,-90,-160,789,802,1591,3637
-50,-90,80,789,802,1591,3637
-40,-90,90,789,802,1591,3637
-130,-90,0,789,802,1591,3637
-160,-90,-30,789,802,1591,3637
80,-90,-150,789,802,1591,3637
-170,-90,-40,789,802,1591,3637
40,-60,50,769,822,1591,3515
50,-90,180,789,802,1591,3637
-20,-90,110,789,802,1591,3637
-140,-90,-10,789,802,1591,3637
40,-90,170,789,802,1591,3637
160,-90,-70,789,802,1591,3637
-30,-90,100,789,802,1591,3637
130,-90,-100,789,802,1591,3637
70,-30,140,794,797,1591,3466
-180,-90,-50,789,802,1591,3637
170,-20,-150,785,806,1591,3570
-80,-90,50,789,802,1591,3637
-10,-90,120,789,802,1591,3637
170,-90,-60,789,802,1591,3637
110,-90,-120,789,802,1591,3637
-70,-90,60,789,802,1591,3637
150,-90,-80,789,802,1591,3637
-120,-90,10,789,802,1591,3637
100,-90,-130,789,802,1591,3637
180,-90,-50,789,802,1591,3637
-60,-90,70,789,802,1591,3637
90,-90,-140,789,802,1591,3637
-140,-70,-130,792,799,1591,3488
30,-90,160,789,802,1591,3637
-180,-30,-40,784,808,1592,3359
-120,60,-90,790,802,1592,3401
-140,20,-180,788,804,1592,3519
-30,-30,120,783,809,1592,3614
-140,20,180,788,804,1592,3519
180,-30,-40,784,808,1592,3359
40,10,40,785,807,1592,3490
-110,70,-110,793,800,1593,3463
0,0,130,792,801,1593,3625
140,50,-20,785,808,1593,3327
80,-50,-160,771,822,1593,3645
130,10,-130,787,806,1593,3603
180,-10,-150,813,781,1594,3567
110,-60,-120,779,815,1594,3541
-100,70,90,767,827,1594,3441
-180,-10,-150,813,781,1594,3567
60,30,20,785,809,1594,3588
70,-40,180,779,815,1594,3563
-170,10,-160,807,787,1594,3545
70,-40,-180,779,815,1594,3563
40,-10,110,798,797,1595,3622
60,40,-30,773,822,1595,3454
-160,20,-170,781,814,1595,3447
80,20,0,784,811,1595,3665
60,-50,-180,774,821,1595,3577
-110,-60,-110,768,827,1595,3687
-90,-10,60,759,836,1595,3337
140,40,-130,786,809,1595,3467
100,-30,-160,759,836,1595,3643
-150,-10,-150,765,830,1595,3494
150,10,-50,794,801,1595,3546
60,-50,180,774,821,1595,3577
-160,60,-50,785,810,1595,3529
20,30,-10,776,819,1595,3476
110,-30,-170,777,818,1595,3601
-40,10,-10,787,808,1595,3376
60,-40,80,766,829,1595,3617
170,-30,-150,798,797,1595,3552
170,-40,-150,789,807,1596,3469
-70,-20,-60,774,822,1596,3437
160,-60,180,776,820,1596,3375
0,0,10,773,823,1596,3321
160,-60,-180,776,820,1596,3375
50,-70,60,773,823,1596,3468
10,-40,20,780,816,1596,3269
-20,10,0,775,821,1596,3358
-100,40,100,762,835,1597,3471
-120,20,-10,761,836,1597,3618
160,0,-50,808,789,1597,3490
40,30,80,775,822,1597,3649
-160,30,-30,772,826,1598,3427
-140,20,-20,772,826,1598,3459
-60,-60,80,775,823,1598,3631
160,70,-160,757,841,1598,3439
120,-30,-170,778,820,1598,3557
-120,10,-170,779,819,1598,3485
-100,20,50,776,822,1598,3674
-30,60,160,794,804,1598,3563
-100,-30,-120,766,832,1598,3512
30,30,90,784,814,1598,3531
40,20,0,777,821,1598,3493
-110,50,110,761,838,1599,3378
120,10,-40,779,820,1599,3432
90,-30,160,778,821,1599,3631
-50,-20,-30,774,825,1599,3607
150,0,-150,778,821,1599,3591
90,-60,-140,768,831,1599,3632
70,-50,-170,777,822,1599,3530
-160,-70,-150,775,824,1599,3501
-140,30,-30,762,837,1599,3556
140,-30,-160,785,814,1599,3489
140,10,-50,796,803,1599,3533
130,20,-130,777,823,1600,3527
-130,30,160,780,820,1600,3427
-30,70,160,798,802,1600,3548
-110,20,10,769,831,1600,3617
70,20,-10,786,814,1600,3610
-90,10,80,766,834,1600,3517
-10,30,140,789,812,1601,3542
-60,20,-160,757,844,1601,3500
-170,-10,-150,805,796,1601,3563
40,10,30,786,815,1601,3616
140,30,-140,772,829,1601,3635
-30,-50,110,797,804,1601,3575
-130,20,180,803,798,1601,3479
-110,20,0,762,839,1601,3540
-130,20,-180,803,798,1601,3479
140,20,-40,782,819,1601,3576
60,80,-60,791,810,1601,3504
80,-30,170,789,812,1601,3692
-80,-40,60,765,837,1602,3384
-100,10,50,780,822,1602,3540
-10,-40,0,803,799,1602,3400
100,30,-80,757,845,1602,3545
-100,-20,-130,776,826,1602,3560
90,-30,-170,768,834,1602,3736
70,-40,100,775,828,1603,3517
120,0,-70,783,820,1603,3601
-30,0,150,765,839,1604,3622
120,-30,-160,788,817,1605,3694
50,20,40,780,825,1605,3547
-80,-60,60,784,821,1605,3600
120,-40,170,785,820,1605,3629
-120,-40,-120,771,835,1606,3436
180,70,-180,765,841,1606,3333
-60,0,120,777,829,1606,3599
180,70,180,765,841,1606,3333
-180,70,180,765,841,1606,3333
-180,70,-180,765,841,1606,3333
-10,-30,130,791,815,1606,3638
70,80,-70,802,804,1606,3489
100,80,-100,814,793,1607,3587
-80,0,-150,783,824,1607,3496
-100,40,90,752,855,1607,3605
-170,70,170,766,842,1608,3285
-80,20,-20,793,815,1608,3558
0,-20,130,768,840,1608,3548
170,-60,-60,799,810,1609,3587
30,-40,140,804,805,1609,3572
100,-30,-170,780,829,1609,3768
-170,20,-30,776,833,1609,3444
150,-60,-80,787,822,1609,3493
90,20,-50,795,814,1609,3637
140,-60,-90,794,815,1609,3562
-80,-50,60,791,818,1609,3685
110,10,-60,779,831,1610,3644
-60,30,0,781,829,1610,3648
-120,-40,20,786,824,1610,3576
-170,-60,-150,794,816,1610,3496
110,30,-10,812,798,1610,3556
-180,-80,-50,789,821,1610,3598
-160,-40,-140,785,825,1610,3657
-20,30,150,790,820,1610,3512
180,-80,-50,789,821,1610,3598
130,-20,-150,800,810,1610,3548
110,-80,120,751,860,1611,3487
-160,40,180,783,828,1611,3578
180,-70,-50,794,817,1611,3590
-180,-70,-50,794,817,1611,3590
180,-60,-160,774,837,1611,3513
40,50,-30,787,824,1611,3480
-160,40,-180,783,828,1611,3578
-180,50,-170,789,822,1611,3491
180,50,-170,789,822,1611,3491
-90,-60,50,793,818,1611,3648
-180,-60,-160,774,837,1611,3513
80,-40,-170,781,830,1611,3619
-160,-60,-140,796,816,1612,3477
-80,10,160,754,858,1612,3610
130,60,-10,808,804,1612,3351
-120,-20,-130,797,815,1612,3409
-90,10,170,757,855,1612,3585
60,-30,80,791,822,1613,3607
-130,60,130,768,845,1613,3618
80,20,-40,795,818,1613,3679
0,-70,130,794,820,1614,3622
90,-40,140,786,828,1614,3624
-130,-50,10,791,823,1614,3592
170,-60,-170,795,820,1615,3562
-20,-80,110,788,827,1615,3614
-80,-10,-70,773,842,1615,3406
80,-80,90,768,847,1615,3563
50,-30,70,811,804,1615,3666
-80,60,60,775,840,1615,3611
30,10,20,794,821,1615,3603
100,20,-10,789,826,1615,3740
-70,10,-150,758,857,1615,3586
130,-20,-100,791,825,1616,3469
80,-40,120,773,843,1616,3517
130,-40,-180,790,826,1616,3709
120,-80,130,755,861,1616,3545
130,-40,180,790,826,1616,3709
120,30,-110,779,837,1616,3516
110,10,-50,799,817,1616,3601
110,10,-70,796,820,1616,3549
90,-40,-160,784,833,1617,3661
110,-30,-130,783,834,1617,3639
30,30,-10,774,843,1617,3490
-180,40,-170,791,826,1617,3608
180,40,-170,791,826,1617,3608
-50,-10,130,778,840,1618,3547
-60,30,-160,774,844,1618,3669
20,-10,120,803,815,1618,3500
40,10,50,796,822,1618,3600
-20,40,150,795,823,1618,3449
20,-50,140,803,816,1619,3617
80,40,20,791,828,1619,3549
100,50,-80,809,810,1619,3455
-120,50,-80,794,826,1620,3328
110,60,-100,781,839,1620,3524
-90,0,60,790,830,1620,3446
-100,30,-100,781,839,1620,3465
60,50,50,810,811,1621,3708
-40,-20,120,800,821,1621,3564
100,70,20,809,812,1621,3427
170,70,-170,761,860,1621,3475
130,-80,140,761,860,1621,3580
-140,-60,0,808,813,1621,3650
-80,-10,-60,784,838,1622,3396
100,-50,140,792,830,1622,3570
-150,60,-60,793,830,1623,3577
-150,-30,-140,786,837,1623,3548
160,-50,-70,797,826,1623,3659
-50,-60,90,812,811,1623,3660
80,20,-10,790,833,1623,3688
120,10,-100,801,822,1623,3547
-160,0,-160,818,805,1623,3713
80,30,0,811,813,1624,3597
140,-80,150,772,852,1624,3610
90,50,20,798,826,1624,3725
-10,60,0,785,839,1624,3501
170,-50,-60,806,818,1624,3642
160,80,-30,801,823,1624,3526
-30,70,20,794,831,1625,3454
170,-10,-150,803,822,1625,3586
-40,-20,-20,793,832,1625,3496
-80,10,120,793,833,1626,3406
10,-40,130,785,841,1626,3751
-110,-40,30,802,824,1626,3624
100,-30,180,778,848,1626,3805
170,10,-40,801,825,1626,3610
100,-30,-180,778,848,1626,3805
50,80,-50,800,827,1627,3571
-80,0,-130,788,839,1627,3521
-110,-20,-130,779,848,1627,3548
-90,30,20,794,833,1627,3762
-110,10,30,801,827,1628,3612
40,-20,120,789,839,1628,3477
-120,-20,20,798,830,1628,3575
20,20,0,785,843,1628,3534
90,40,10,810,819,1629,3510
140,-10,-150,815,815,1630,3656
90,40,-60,827,803,1630,3499
-30,-80,100,795,835,1630,3736
-90,60,-130,820,810,1630,3406
-150,-70,-140,806,824,1630,3586
130,-30,-160,812,818,1630,3626
-150,30,-30,799,832,1631,3537
60,-30,90,810,821,1631,3542
-50,0,160,797,834,1631,3823
-60,0,130,788,844,1632,3715
120,40,-10,808,824,1632,3452
180,-60,-50,805,827,1632,3724
-90,20,100,795,837,1632,3568
-100,30,110,790,842,1632,3585
-180,-60,-50,805,827,1632,3724
-20,-10,0,783,849,1632,3473
-120,30,150,794,838,1632,3488
-80,0,-140,789,843,1632,3503
-170,-40,-140,811,822,1633,3651
50,40,50,811,822,1633,3455
-160,-10,-150,792,841,1633,3464
-60,80,-170,814,819,1633,3412
-70,-40,-70,800,833,1633,3467
150,-30,-160,791,842,1633,3615
-20,-10,140,791,842,1633,3670
150,10,-150,812,822,1634,3560
-170,-80,-40,799,835,1634,3648
120,-60,-110,804,830,1634,3593
20,0,20,793,841,1634,3577
50,-20,90,800,834,1634,3475
150,-80,160,782,852,1634,3646
-150,-40,-10,821,814,1635,3634
110,20,-20,802,833,1635,3693
-50,30,0,805,830,1635,3678
160,20,-40,821,814,1635,3521
100,50,10,811,825,1636,3610
40,-60,160,821,815,1636,3696
-130,-70,-120,802,834,1636,3494
-70,-50,70,807,829,1636,3829
50,-20,80,825,811,1636,3611
20,10,110,832,804,1636,3732
40,40,70,812,825,1637,3729
30,70,-30,813,824,1637,3502
-90,20,80,780,857,1637,3463
-40,-50,100,808,829,1637,3711
-80,0,100,800,837,1637,3590
-20,-40,120,806,831,1637,3729
-60,10,-170,783,854,1637,3736
30,20,10,786,851,1637,3581
40,-10,60,809,828,1637,3569
20,30,100,822,816,1638,3561
-100,10,180,781,857,1638,3643
-100,10,-180,781,857,1638,3643
130,0,-60,807,831,1638,3710
50,50,60,814,824,1638,3756
-60,10,-20,797,841,1638,3519
110,-30,-150,779,860,1639,3727
50,-30,130,819,820,1639,3669
80,50,30,798,841,1639,3751
10,0,120,789,850,1639,3746
0,-30,130,794,845,1639,3811
120,-30,-110,814,825,1639,3606
-100,20,-50,788,852,1640,3650
110,80,-110,829,811,1640,3614
-100,20,-80,797,843,1640,3548
60,30,10,825,815,1640,3696
90,20,-10,804,836,1640,3749
-100,-10,-140,808,832,1640,3589
-80,-20,-80,802,838,1640,3417
-70,40,20,790,850,1640,3668
-40,-50,-30,799,842,1641,3473
-130,10,0,793,848,1641,3625
100,20,-70,794,847,1641,3628
-160,70,160,784,857,1641,3369
-30,30,0,798,843,1641,3630
40,-20,60,811,830,1641,3716
-110,30,-40,798,844,1642,3655
50,30,-10,790,852,1642,3582
160,-10,-150,808,834,1642,3580
70,-50,100,790,852,1642,3631
-130,0,10,804,838,1642,3624
90,20,-40,809,833,1642,3757
110,-40,-120,785,857,1642,3641
-70,0,110,797,845,1642,3495
-70,20,-10,800,842,1642,3689
-170,-50,-140,800,842,1642,3702
20,70,100,807,835,1642,3512
10,50,110,810,833,1643,3622
100,-60,130,808,835,1643,3578
-40,60,170,817,826,1643,3581
60,30,-10,813,830,1643,3656
-90,10,60,794,849,1643,3603
130,0,-130,806,838,1644,3690
-140,0,0,810,834,1644,3634
120,-50,160,782,863,1645,3573
140,-10,-80,807,838,1645,3481
40,-30,130,812,833,1645,3658
-80,50,50,809,836,1645,3674
100,-40,-140,800,846,1646,3608
10,60,110,823,823,1646,3549
-110,-30,-120,789,857,1646,3476
110,-60,140,812,834,1646,3462
30,-60,150,817,829,1646,3685
-160,70,-60,805,842,1647,3592
-90,40,50,793,854,1647,3746
40,20,10,797,850,1647,3604
-70,-40,70,802,845,1647,3660
-30,50,160,798,849,1647,3580
20,-50,30,814,834,1648,3536
-150,10,-160,812,836,1648,3633
100,-70,120,795,853,1648,3594
-130,-60,10,815,833,1648,3705
-110,30,-60,803,845,1648,3668
-140,40,160,800,848,1648,3731
10,-20,20,804,845,1649,3535
-100,20,20,798,851,1649,3737
90,-30,180,795,854,1649,3842
-90,0,-80,780,869,1649,3450
90,-30,-180,795,854,1649,3842
50,-60,170,829,821,1650,3759
-100,20,150,793,857,1650,3548
-60,-50,80,824,826,1650,3613
130,30,-120,793,857,1650,3668
160,50,-30,848,803,1651,3616
170,30,-160,771,880,1651,3737
150,-10,-150,799,852,1651,3659
-170,10,-30,813,838,1651,3528
60,-60,80,814,838,1652,3694
130,-60,-100,817,835,1652,3680
-90,20,-30,799,853,1652,3734
-80,-60,-80,778,874,1652,3721
140,80,-140,809,843,1652,3540
-120,-60,-110,791,861,1652,3611
130,10,-120,801,851,1652,3650
-40,-10,140,798,854,1652,3828
150,0,-60,819,834,1653,3654
180,60,-40,818,835,1653,3670
150,20,-150,806,847,1653,3842
-80,30,-130,808,845,1653,3614
50,30,40,823,830,1653,3694
-180,60,-40,818,835,1653,3670
140,-40,-170,810,844,1654,3681
-90,30,30,800,854,1654,3603
50,-20,100,819,835,1654,3550
150,-10,-70,833,821,1654,3577
-110,-20,30,811,843,1654,3677
60,-30,100,813,842,1655,3622
60,-60,-180,827,828,1655,3768
-90,70,80,794,861,1655,3649
-50,-10,120,791,864,1655,3657
60,-60,180,827,828,1655,3768
-100,20,0,792,863,1655,3627
170,-20,-50,808,848,1656,3758
80,20,-20,808,848,1656,3790
-60,0,150,792,864,1656,3770
70,-80,80,781,875,1656,3580
160,80,-160,804,852,1656,3459
130,-10,-100,797,859,1656,3560
160,-80,170,794,862,1656,3664
160,-40,-70,819,837,1656,3625
-140,30,170,814,842,1656,3452
10,40,-10,808,848,1656,3675
70,50,40,807,850,1657,3782
120,-50,-110,820,837,1657,3571
-80,20,-130,808,849,1657,3683
110,-70,130,798,859,1657,3572
130,-10,-140,820,837,1657,3690
-50,0,150,788,869,1657,3700
-90,10,-40,824,833,1657,3636
-170,-30,-140,816,842,1658,3627
40,0,80,824,834,1658,3748
40,0,100,813,845,1658,3765
-110,50,-100,819,839,1658,3509
-150,40,170,805,853,1658,3690
150,40,-30,818,840,1658,3556
-130,-20,10,813,846,1659,3675
-130,-50,-120,811,848,1659,3508
90,-50,-150,810,849,1659,3742
40,30,70,829,830,1659,3724
120,-70,140,800,859,1659,3644
40,80,-40,814,845,1659,3626
-120,0,20,823,836,1659,3787
-20,-50,-10,830,830,1660,3596
-100,-60,40,823,837,1660,3830
-20,30,0,808,852,1660,3754
90,20,-20,818,842,1660,3697
-40,-80,90,808,852,1660,3785
-110,20,-10,783,878,1661,3694
130,80,-130,833,828,1661,3585
-60,-40,80,823,838,1661,3642
-120,70,-100,815,847,1662,3577
-110,-10,30,803,859,1662,3671
60,-30,110,817,845,1662,3586
-100,-40,-110,785,877,1662,3656
-180,-40,-140,833,830,1663,3603
170,-80,-180,791,872,1663,3686
-160,-30,-140,811,852,1663,3648
180,-40,-140,833,830,1663,3603
170,-80,180,791,872,1663,3686
80,40,10,830,833,1663,3706
-90,-50,50,808,856,1664,3534
40,0,60,810,854,1664,3710
-40,60,20,806,858,1664,3549
-110,30,-70,810,854,1664,3554
-100,20,40,809,855,1664,3794
-90,20,70,801,863,1664,3511
130,0,-120,821,844,1665,3723
130,-10,-130,823,842,1665,3693
-120,-60,20,816,849,1665,3793
-120,-10,20,799,866,1665,3663
40,50,70,840,825,1665,3706
-140,40,-40,792,873,1665,3685
-100,-30,40,812,854,1666,3632
-150,10,-20,819,847,1666,3725
-80,0,90,799,867,1666,3503
-80,10,-30,826,840,1666,3646
-170,20,-160,812,854,1666,3552
140,50,-130,791,876,1667,3655
-120,-70,-110,814,853,1667,3600
110,-40,170,804,863,1667,3643
130,-20,-130,827,840,1667,3622
150,-30,-80,815,853,1668,3774
10,-10,20,820,848,1668,3468
100,20,-50,821,847,1668,3821
-140,-30,-130,827,842,1669,3551
180,0,-150,854,815,1669,3721
-40,30,0,824,845,1669,3644
120,80,-120,843,826,1669,3653
-160,-80,-30,818,851,1669,3686
-80,-30,60,785,884,1669,3518
170,80,-170,822,847,1669,3439
50,60,-40,812,857,1669,3603
-110,-50,-110,810,859,1669,3604
100,-40,-150,801,868,1669,3744
-180,0,-150,854,815,1669,3721
150,80,-150,810,860,1670,3479
-120,50,130,814,856,1670,3607
-170,-30,-30,831,839,1670,3644
110,70,10,840,830,1670,3638
-160,-20,-140,816,854,1670,3591
100,20,-60,797,874,1671,3770
-10,-70,120,808,863,1671,3854
-40,20,170,805,866,1671,3702
90,30,-60,815,856,1671,3725
-100,-60,-100,820,852,1672,3795
-70,60,50,816,856,1672,3649
-50,-40,90,806,866,1672,3640
90,-30,170,810,862,1672,3919
-90,30,80,802,870,1672,3522
-110,40,120,787,886,1673,3708
-60,-20,-40,811,862,1673,3643
-90,20,-20,817,856,1673,3808
-60,0,140,801,872,1673,3652
-10,20,0,822,852,1674,3765
-100,60,90,810,864,1674,3492
120,10,-90,828,846,1674,3563
-30,30,160,812,862,1674,3668
-170,0,-30,841,833,1674,3680
150,-40,-160,815,859,1674,3707
140,0,-140,824,850,1674,3782
-70,80,-160,836,838,1674,3523
-120,40,-60,809,865,1674,3706
160,-20,-150,838,837,1675,3729
110,30,-90,811,864,1675,3676
-90,-60,-90,802,873,1675,3730
-100,50,90,811,864,1675,3639
-50,10,170,812,863,1675,3700
170,-50,-150,854,822,1676,3586
-50,-80,80,812,864,1676,3789
-90,0,-60,790,886,1676,3596
90,-60,120,828,848,1676,3612
-150,70,150,795,881,1676,3541
-90,20,0,809,867,1676,3789
-170,-70,-40,836,841,1677,3612
-110,40,-90,820,857,1677,3595
180,-50,-50,829,848,1677,3790
-180,-50,-50,829,848,1677,3790
-80,40,30,819,859,1678,3740
20,60,-20,814,864,1678,3531
110,50,0,832,846,1678,3585
-60,-80,70,819,859,1678,3799
120,-40,-180,818,860,1678,3626
-80,-80,50,834,844,1678,3773
40,10,90,817,861,1678,3834
120,-40,180,818,860,1678,3626
-130,20,-20,804,874,1678,3764
110,-30,-140,794,885,1679,3754
90,-70,110,818,861,1679,3643
-30,-20,130,825,854,1679,3914
150,-50,-80,810,869,1679,3796
130,-20,-110,819,860,1679,3571
180,-80,-170,798,881,1679,3748
-120,-50,20,827,852,1679,3701
100,-40,-160,814,865,1679,3818
-30,-20,-10,792,887,1679,3518
-180,-80,-170,798,881,1679,3748
-40,0,-10,815,864,1679,3605
-80,10,150,808,872,1680,3771
80,30,-40,823,857,1680,3896
-130,60,-80,828,852,1680,3643
130,20,-120,814,866,1680,3660
-180,80,-180,837,844,1681,3497
180,80,180,837,844,1681,3497
-70,-80,60,827,854,1681,3821
-70,-10,-40,813,868,1681,3518
-180,80,180,837,844,1681,3497
-100,20,-10,796,885,1681,3771
120,-60,150,819,862,1681,3595
180,80,-180,837,844,1681,3497
-110,-10,-140,813,868,1681,3599
-150,-50,-130,848,833,1681,3727
-170,-60,-40,834,848,1682,3763
-90,20,-110,830,852,1682,3702
130,-70,150,812,870,1682,3662
120,20,-30,827,855,1682,3654
120,-30,-120,836,846,1682,3752
-60,-40,-50,823,859,1682,3666
-110,-30,30,822,861,1683,3730
-150,-60,-130,817,866,1683,3575
10,40,110,852,831,1683,3769
10,-50,130,833,850,1683,3850
-120,60,120,786,897,1683,3770
-90,-80,40,833,850,1683,3778
40,-20,110,825,858,1683,3484
60,-80,70,804,879,1683,3647
170,80,-40,839,845,1684,3641
-90,-40,50,794,890,1684,3562
110,20,-80,818,866,1684,3717
120,20,-100,815,869,1684,3600
40,20,40,843,842,1685,3734
-130,-30,10,832,853,1685,3830
-40,70,170,842,843,1685,3637
130,-20,-120,830,855,1685,3622
-80,-10,70,804,881,1685,3643
-50,-10,110,819,866,1685,3632
120,30,-20,829,856,1685,3747
-100,20,-90,813,873,1686,3563
-80,10,110,814,872,1686,3538
150,-40,-80,826,860,1686,3746
-100,20,10,805,881,1686,3908
120,60,-110,825,861,1686,3597
70,30,0,846,840,1686,3710
130,-30,-100,833,854,1687,3682
-150,70,-70,822,865,1687,3570
30,-60,40,822,865,1687,3663
160,0,-150,810,877,1687,3764
-90,0,-70,822,865,1687,3606
160,60,-30,831,856,1687,3847
40,-70,50,810,877,1687,3735
-140,60,-70,810,878,1688,3665
70,30,-10,840,848,1688,3743
-170,50,-40,835,853,1688,3726
-170,-80,-160,809,879,1688,3691
170,-40,-60,835,854,1689,3807
-100,-10,40,837,852,1689,3663
-90,20,90,811,878,1689,3638
90,-50,130,811,878,1689,3740
-90,10,-100,821,869,1690,3691
-150,50,-50,834,856,1690,3868
180,-30,-140,835,855,1690,3790
160,-50,-160,822,868,1690,3671
50,-80,60,810,880,1690,3705
140,-20,-150,830,860,1690,3693
20,-60,140,843,847,1690,3754
-180,-30,-140,835,855,1690,3790
-50,-50,90,826,864,1690,3836
10,10,10,844,846,1690,3680
-90,-40,-100,807,884,1691,3663
-20,-20,0,819,872,1691,3547
-130,-20,-130,831,860,1691,3608
-70,10,130,833,858,1691,3786
-90,20,150,825,866,1691,3706
130,-60,160,833,858,1691,3627
-30,40,160,833,859,1692,3691
-90,-10,-130,797,895,1692,3649
-90,50,70,802,890,1692,3772
40,10,80,821,871,1692,3764
-140,70,140,808,884,1692,3640
-120,-30,20,836,856,1692,3874
150,-50,-170,835,857,1692,3546
100,-40,160,819,873,1692,3685
-110,30,-80,828,864,1692,3630
130,10,-50,846,846,1692,3830
60,40,30,840,853,1693,3786
-110,30,-50,819,874,1693,3836
30,10,30,840,853,1693,3733
80,-40,130,823,870,1693,3792
-100,-40,40,830,863,1693,3641
130,-10,-110,824,869,1693,3655
160,-30,-70,825,868,1693,3833
20,0,30,847,846,1693,3661
-90,20,-10,817,877,1694,3898
-150,-80,-20,830,864,1694,3766
130,-20,-140,846,848,1694,3784
-110,20,170,840,854,1694,3703
-110,-50,30,816,878,1694,3804
130,0,-80,829,865,1694,3821
50,30,30,853,841,1694,3773
130,0,-70,833,861,1694,3811
20,70,-20,843,852,1695,3645
-130,70,-90,837,858,1695,3674
150,40,-140,841,854,1695,3753
-100,10,-60,821,874,1695,3601
40,20,50,829,867,1696,3723
100,20,-20,822,874,1696,3806
-20,-70,110,832,864,1696,3853
-50,40,10,823,873,1696,3850
170,10,-150,818,878,1696,3743
130,-10,-120,828,869,1697,3600
-90,0,-50,815,882,1697,3560
90,20,-30,831,867,1698,3861
-60,10,-180,801,898,1699,3811
140,-20,-90,853,846,1699,3635
-60,-10,-30,817,882,1699,3596
-50,-20,100,825,874,1699,3618
-60,10,180,801,898,1699,3811
-10,-60,120,824,875,1699,3920
70,-60,-170,840,860,1700,3836
-70,30,10,792,908,1700,3927
90,-40,-170,826,874,1700,3831
30,80,-30,834,867,1701,3718
-100,10,-70,823,878,1701,3605
-170,80,170,848,853,1701,3543
-110,-60,30,842,859,1701,3854
-160,-70,-30,832,870,1702,3738
140,-50,-90,833,869,1702,3838
-80,0,80,812,890,1702,3610
80,20,-30,828,874,1702,3964
40,30,60,846,856,1702,3816
-150,-20,-140,835,867,1702,3687
-100,-50,40,825,877,1702,3629
-90,-20,-110,823,880,1703,3620
-120,10,10,843,860,1703,3791
-130,70,130,811,892,1703,3676
30,-20,50,821,882,1703,3700
120,-40,-110,825,878,1703,3603
-10,-20,10,833,871,1704,3594
-80,-20,60,814,890,1704,3718
-80,80,-150,853,851,1704,3583
-100,0,40,827,877,1704,3813
70,40,20,840,864,1704,3780
-70,40,-150,831,873,1704,3830
140,-30,-90,842,862,1704,3686
-80,20,-10,838,866,1704,3961
-30,-40,110,838,866,1704,3845
40,20,20,839,866,1705,3834
160,70,-30,847,858,1705,3826
120,10,-50,838,867,1705,3786
50,-40,70,839,866,1705,3803
-130,40,-50,836,869,1705,3843
30,-10,50,836,869,1705,3720
-110,10,-170,809,896,1705,3632
50,-30,120,841,864,1705,3678
30,-20,120,837,869,1706,3870
-100,-80,30,844,862,1706,3798
-50,-10,-20,824,882,1706,3600
-80,10,-130,803,903,1706,3800
90,-40,150,835,871,1706,3850
-140,-10,0,818,888,1706,3853
-120,30,160,818,888,1706,3565
20,0,110,850,857,1707,3889
-90,-20,50,828,879,1707,3620
-140,-30,0,858,849,1707,3937
-80,50,-140,849,858,1707,3672
-130,30,170,842,865,1707,3661
140,20,-140,830,878,1708,4002
-40,-40,100,842,866,1708,3824
-90,10,-180,817,892,1709,3876
-100,40,-110,848,861,1709,3638
120,10,-80,843,866,1709,3679
70,-40,110,827,882,1709,3721
-100,20,160,821,888,1709,3693
-90,10,180,817,892,1709,3876
-20,20,0,845,864,1709,3767
130,60,-120,823,887,1710,3653
140,-70,160,820,890,1710,3760
60,30,0,853,857,1710,3890
60,-40,160,842,869,1711,3937
20,-40,130,832,879,1711,3898
140,10,-140,843,868,1711,3952
40,-10,70,850,861,1711,3648
-100,30,120,848,863,1711,3685
60,60,50,866,845,1711,3817
50,50,-30,823,889,1712,3858
-110,0,-150,816,896,1712,3738
40,20,30,851,861,1712,3735
170,20,-150,819,893,1712,3746
130,-50,-100,826,887,1713,3724
130,-40,-100,840,873,1713,3664
-150,30,-180,831,883,1714,3616
-150,30,180,831,883,1714,3616
-10,-50,120,837,877,1714,3932
-60,60,40,842,872,1714,3722
-140,-80,-10,842,872,1714,3831
-10,-20,130,844,870,1714,3838
-160,-10,-20,830,884,1714,3835
-90,-30,50,835,879,1714,3783
-90,40,60,810,905,1715,3880
-160,-80,-150,822,893,1715,3702
80,-60,110,834,881,1715,3643
80,-60,-160,845,871,1716,3853
-130,-40,-120,857,859,1716,3708
-90,20,110,839,877,1716,3786
-70,-10,90,832,884,1716,3693
50,30,20,853,863,1716,3901
120,-40,-170,848,868,1716,3715
160,10,-150,813,904,1717,3927
-40,0,150,831,886,1717,4044
40,-10,80,848,869,1717,3791
40,0,70,856,861,1717,3901
130,40,-20,844,873,1717,3680
-40,70,30,835,882,1717,3688
-70,10,150,817,900,1717,3713
-100,10,40,830,888,1718,3883
130,-50,170,828,890,1718,3841
-110,20,-20,833,885,1718,3856
80,-40,180,836,882,1718,3933
-120,0,-150,822,896,1718,3615
40,30,-10,828,890,1718,3713
80,-40,-180,836,882,1718,3933
10,50,-10,837,881,1718,3767
-100,-20,40,842,876,1718,3613
90,30,-50,848,871,1719,3954
-180,10,-150,859,860,1719,3696
180,10,-150,859,860,1719,3696
-10,40,0,858,861,1719,3733
100,-50,-140,842,877,1719,3869
-90,20,130,831,888,1719,3791
-100,-50,-100,826,894,1720,3825
-70,-20,80,828,892,1720,3771
140,30,-130,835,885,1720,3904
10,20,0,849,871,1720,3867
-110,0,30,848,872,1720,3948
-130,-10,10,828,892,1720,3822
100,-40,-170,843,877,1720,3832
80,30,-10,862,858,1720,3860
-40,10,160,825,896,1721,3769
-160,30,-170,827,894,1721,3750
-90,20,120,838,883,1721,3548
60,-70,-180,852,870,1722,4000
50,-50,160,844,878,1722,3910
-160,10,-160,864,858,1722,3828
-30,-10,140,836,886,1722,3929
-80,10,170,828,894,1722,3989
110,-40,-180,833,889,1722,3778
20,10,20,839,883,1722,3851
110,-40,180,833,889,1722,3778
60,-70,180,852,870,1722,4000
-100,20,-100,826,897,1723,3813
90,-50,140,853,870,1723,3923
0,50,120,872,852,1724,3847
-160,80,160,845,879,1724,3646
20,-20,120,848,876,1724,3710
-100,-20,-120,812,912,1724,3726
-80,10,100,844,880,1724,3654
-70,-30,-60,853,872,1725,3495
-160,-30,-20,859,866,1725,3852
40,20,80,856,869,1725,3878
-90,30,90,834,892,1726,3686
-100,20,30,838,888,1726,3870
-140,70,-80,841,885,1726,3622
30,10,100,874,853,1727,3851
-90,40,70,813,914,1727,3706
160,-30,-150,849,878,1727,4031
-170,-10,-30,848,879,1727,3690
100,-40,170,842,885,1727,3845
-130,50,-70,846,881,1727,3833
50,-70,170,856,871,1727,3986
-140,0,-150,860,868,1728,3602
-90,0,-90,821,907,1728,3878
100,-50,150,837,891,1728,3859
40,-70,160,866,862,1728,3992
180,-20,-40,844,885,1729,3749
70,-40,120,846,883,1729,3804
-110,-80,20,854,875,1729,3893
80,80,40,858,871,1729,3829
40,0,90,846,883,1729,4077
-180,-20,-40,844,885,1729,3749
40,-80,50,823,906,1729,3730
80,-70,-160,842,888,1730,3871
70,30,-20,857,873,1730,3935
-80,-50,-80,823,907,1730,3757
140,-30,-150,863,867,1730,3811
90,-70,-150,840,890,1730,3813
-30,-70,100,855,875,1730,3835
-120,30,-40,852,878,1730,3773
-40,-20,110,852,878,1730,3758
30,10,40,858,873,1731,3818
150,-20,-80,857,874,1731,3766
-180,20,-150,851,880,1731,3712
90,-40,-180,834,897,1731,3927
180,20,-150,851,880,1731,3712
-50,10,-10,836,895,1731,3745
90,-40,180,834,897,1731,3927
-30,20,0,836,895,1731,3874
70,80,50,865,866,1731,3818
70,-40,170,851,880,1731,3905
-140,10,-160,851,880,1731,3671
140,-20,-100,837,895,1732,3764
40,40,-20,835,897,1732,3797
-100,10,-170,824,908,1732,3812
-150,80,150,843,889,1732,3704
140,-40,-90,845,887,1732,3755
-140,-50,-120,859,874,1733,3970
40,60,70,883,850,1733,3733
10,-50,20,849,884,1733,3720
10,70,110,860,873,1733,3753
-130,-80,0,855,878,1733,3855
-90,30,-120,833,900,1733,3872
120,-30,-150,846,887,1733,3889
-90,60,80,843,891,1734,3800
-110,30,140,853,881,1734,3662
-120,20,-180,860,874,1734,3766
-120,20,180,860,874,1734,3766
40,-30,60,856,878,1734,3901
-80,0,-40,843,891,1734,3713
20,80,-20,853,881,1734,3816
30,0,50,849,886,1735,3731
-70,50,40,847,888,1735,3691
-130,-10,-140,843,893,1736,3726
-120,20,-20,821,915,1736,3934
40,40,60,861,875,1736,3857
110,-40,-170,840,896,1736,3883
-100,60,-120,854,882,1736,3644
-10,50,0,846,890,1736,3807
80,-50,120,855,881,1736,3819
170,0,-150,865,871,1736,3769
-90,20,140,852,885,1737,3733
-150,-40,-130,846,891,1737,3778
-150,-30,-10,860,877,1737,3915
130,-40,-170,856,881,1737,3891
30,-70,150,864,873,1737,4000
-70,0,-30,838,899,1737,3673
-10,-10,10,850,887,1737,3727
-50,70,180,872,866,1738,3669
140,-20,-140,859,879,1738,3817
-50,60,-180,859,879,1738,3823
100,40,0,865,873,1738,3771
-50,70,-180,872,866,1738,3669
50,-40,150,866,872,1738,3950
50,60,60,865,873,1738,3879
-50,60,180,859,879,1738,3823
140,0,-70,848,890,1738,3809
-120,-80,10,860,879,1739,3878
130,0,-90,853,886,1739,3811
100,30,-10,878,861,1739,3857
30,30,80,856,883,1739,3847
70,-40,130,859,880,1739,3929
-170,40,-170,831,908,1739,3789
-140,-60,-120,859,880,1739,3731
130,0,-100,851,888,1739,3785
-150,-70,-20,854,886,1740,3913
60,80,60,870,870,1740,3825
40,-40,140,859,881,1740,3881
-80,20,0,834,906,1740,3970
110,-80,-130,862,878,1740,3995
-90,0,-150,842,899,1741,3856
40,20,60,867,874,1741,3987
40,20,70,860,881,1741,4010
70,60,40,877,864,1741,3884
90,-80,-150,876,865,1741,3951
-80,-20,-70,843,898,1741,3722
60,-50,170,842,900,1742,3971
130,-80,-110,867,875,1742,3935
-140,-20,0,868,874,1742,3783
-90,80,-140,870,873,1743,3674
140,-50,180,850,893,1743,3745
140,-50,-180,850,893,1743,3745
-70,10,-20,842,901,1743,3889
160,30,-150,851,892,1743,3833
40,10,60,853,890,1743,3975
80,-80,-160,868,875,1743,3987
-100,40,110,842,901,1743,3851
-50,-30,90,858,885,1743,3641
90,-60,-150,851,893,1744,3977
-110,-70,-100,858,886,1744,3730
50,-50,70,861,883,1744,3950
10,0,20,865,879,1744,3791
-20,-20,130,870,874,1744,4029
140,-10,-100,849,895,1744,3703
150,-20,-150,857,888,1745,3961
-120,40,140,833,912,1745,3950
-150,-10,-10,855,890,1745,3900
-170,-20,-30,865,880,1745,3828
0,20,0,844,902,1746,3808
110,-50,160,850,896,1746,3864
80,-40,140,854,892,1746,3968
-130,10,-160,861,885,1746,3687
150,30,-140,856,890,1746,3952
130,30,-30,862,884,1746,3917
110,-40,-130,840,907,1747,3972
-50,50,20,853,894,1747,3899
30,40,80,856,891,1747,4017
70,-60,100,855,892,1747,3723
-80,70,70,834,913,1747,3769
90,40,0,887,860,1747,3781
-90,30,60,849,899,1748,3773
-80,-30,-80,857,891,1748,3876
-100,20,-20,852,896,1748,3875
-50,60,30,855,894,1749,3791
100,20,-40,864,885,1749,3986
110,40,-90,870,879,1749,3787
-130,40,150,838,911,1749,3875
180,-50,-140,857,892,1749,3831
-180,-50,-140,857,892,1749,3831
120,-80,-120,868,881,1749,3990
160,-70,-80,883,867,1750,3960
-120,40,-70,842,908,1750,3779
30,-80,150,854,896,1750,4073
-170,60,-180,849,901,1750,3811
-130,0,-150,866,884,1750,3703
100,-40,-180,851,899,1750,3954
-120,-50,-110,848,902,1750,3765
40,-20,70,860,890,1750,3814
100,-40,180,851,899,1750,3954
-170,60,180,849,901,1750,3811
-80,-10,-50,833,918,1751,3646
120,-30,-130,871,880,1751,3963
120,-30,-140,864,887,1751,3895
80,50,-50,851,900,1751,3847
130,-30,-150,875,877,1752,3900
100,-80,-140,876,876,1752,4006
0,10,10,849,903,1752,3719
120,70,0,874,878,1752,3879
30,-80,40,842,911,1753,3834
-90,0,50,867,886,1753,3834
40,-50,150,869,884,1753,3910
-70,10,140,849,904,1753,3951
70,-70,-170,857,896,1753,4007
-40,50,170,854,899,1753,3831
140,60,-20,882,871,1753,3764
-90,-10,-120,838,915,1753,3730
-110,10,20,871,882,1753,3862
-90,20,10,842,912,1754,3962
30,20,90,852,902,1754,3859
30,50,80,867,887,1754,3857
-40,-10,-10,861,893,1754,3676
150,-30,-150,864,890,1754,3934
20,20,10,846,908,1754,3812
-80,0,70,829,926,1755,3623
70,-50,-180,849,906,1755,4058
70,-50,180,849,906,1755,4058
180,80,-50,875,880,1755,3810
80,-50,-170,842,913,1755,3951
100,20,-30,858,897,1755,4027
-180,80,-50,875,880,1755,3810
100,-70,-140,852,903,1755,3839
90,30,-10,883,872,1755,3856
-100,10,-80,838,918,1756,3721
110,20,-30,863,893,1756,3846
-50,-30,-30,858,898,1756,3906
170,-70,-70,877,879,1756,3996
-140,-70,-10,853,904,1757,3985
-90,30,50,835,923,1758,3928
-60,-10,100,851,907,1758,3831
40,-80,160,866,892,1758,4051
40,-30,120,867,891,1758,3923
50,-30,80,872,886,1758,3876
90,-50,-160,854,904,1758,3845
60,-80,180,869,890,1759,4045
50,30,0,864,895,1759,3987
70,-40,160,865,894,1759,3939
60,-80,-180,869,890,1759,4045
-70,20,-150,844,915,1759,3963
110,50,-90,869,890,1759,3740
-160,-60,-30,881,878,1759,3875
170,50,-160,835,925,1760,3890
-170,30,-160,852,908,1760,3698
-80,-50,50,857,903,1760,3837
160,-80,-80,882,878,1760,4026
80,30,-30,868,892,1760,4044
-150,-80,-140,838,922,1760,3764
180,30,-160,849,911,1760,3869
-70,10,160,842,918,1760,3907
-40,-70,90,858,902,1760,3976
-180,30,-160,849,911,1760,3869
130,0,-110,850,911,1761,3820
-160,20,-30,864,897,1761,3833
-70,70,60,851,910,1761,3723
50,-80,170,869,893,1762,4092
140,-20,-130,865,897,1762,3857
-10,-50,0,864,898,1762,3874
110,-70,-130,857,905,1762,3920
70,-80,-170,872,890,1762,4010
-110,40,130,850,912,1762,3905
-50,20,180,854,909,1763,3908
10,-60,130,878,885,1763,3938
140,-10,-140,874,889,1763,3931
-50,20,-180,854,909,1763,3908
50,-30,110,865,899,1764,3817
-70,-20,-50,855,909,1764,3807
-140,-70,-120,861,903,1764,3723
170,20,-40,861,903,1764,3902
-110,-40,-110,822,942,1764,3695
-110,50,120,853,911,1764,3798
30,-70,40,843,921,1764,3916
140,-40,-160,882,883,1765,4037
-150,40,-40,869,896,1765,3907
-30,-60,-20,855,910,1765,3804
10,70,-10,865,901,1766,3835
30,-10,110,868,898,1766,3919
-90,-10,50,869,897,1766,3704
-60,-20,90,855,911,1766,3827
-110,30,150,864,902,1766,3761
-60,70,50,863,904,1767,3797
-100,-30,-110,838,929,1767,3838
40,10,70,875,892,1767,3948
130,20,-40,863,904,1767,3943
-20,0,140,864,904,1768,3864
-150,20,-170,879,889,1768,3787
100,60,10,872,896,1768,3772
-40,-30,100,874,894,1768,3761
-150,-20,-10,872,897,1769,3943
100,-60,-140,869,900,1769,4071
-20,-60,110,866,903,1769,4012
-70,30,-150,859,910,1769,3991
80,40,-40,871,898,1769,3886
90,80,30,877,892,1769,3940
70,-40,150,862,907,1769,4015
-80,40,40,868,902,1770,3880
-100,80,-130,876,894,1770,3805
150,-80,-90,878,892,1770,4007
-170,-20,-140,864,906,1770,3926
-70,0,100,861,909,1770,3730
90,-40,160,865,906,1771,4012
80,-70,100,853,918,1771,3844
-50,-50,-40,864,907,1771,3713
30,60,80,886,885,1771,3767
140,-80,-100,891,880,1771,4023
60,-40,90,860,911,1771,3900
30,-40,130,865,906,1771,3916
110,-50,-130,854,918,1772,3966
120,10,-60,869,903,1772,3970
-60,70,-170,886,886,1772,3800
140,-60,170,869,903,1772,3907
40,80,80,896,877,1773,3838
50,-60,70,864,909,1773,3900
-110,60,110,850,923,1773,3860
-20,-30,120,867,906,1773,4077
-100,0,-150,845,929,1774,3821
-100,10,-50,866,908,1774,3764
60,-40,150,867,907,1774,4061
30,10,50,860,914,1774,3833
-140,60,150,842,932,1774,3878
-10,-10,130,863,911,1774,3944
-120,-30,-120,887,887,1774,3788
160,-10,-60,872,903,1775,3980
140,-10,-110,866,909,1775,3855
-60,0,110,870,905,1775,3852
140,-10,-90,878,898,1776,3805
110,-40,-140,878,898,1776,4161
140,-20,-110,859,917,1776,3912
-50,-70,80,874,903,1777,4018
-40,-60,-30,863,914,1777,3848
80,-40,170,880,897,1777,4029
-140,-80,-130,844,933,1777,3748
-30,10,0,890,888,1778,3873
-170,-50,-40,885,893,1778,4051
-30,50,10,850,928,1778,3982
-10,30,0,862,916,1778,3985
-100,50,100,842,936,1778,3740
-100,20,-30,851,927,1778,4174
-30,0,0,864,915,1779,3804
-100,20,-40,856,923,1779,4027
50,80,70,894,885,1779,3835
-80,-90,-70,857,923,1780,3933
130,-90,140,857,923,1780,3933
-140,-90,-130,857,923,1780,3933
-130,-90,-120,857,923,1780,3933
20,-90,30,857,923,1780,3933
160,-90,170,857,923,1780,3933
80,60,30,894,886,1780,3928
100,-90,110,857,923,1780,3933
-100,-90,-90,857,923,1780,3933
0,-90,10,857,923,1780,3933
120,-70,-120,876,904,1780,3997
-30,-90,-20,857,923,1780,3933
50,-90,60,857,923,1780,3933
-180,-90,-170,857,923,1780,3933
0,60,120,880,900,1780,3852
-40,-90,-30,857,923,1780,3933
170,-90,180,857,923,1780,3933
-20,-90,-10,857,923,1780,3933
-10,-90,0,857,923,1780,3933
-120,-90,-110,857,923,1780,3933
150,-90,160,857,923,1780,3933
180,-90,-170,857,923,1780,3933
-150,-90,-140,857,923,1780,3933
140,-90,150,857,923,1780,3933
80,30,-20,886,894,1780,3975
80,-90,90,857,923,1780,3933
170,-40,-140,882,898,1780,4049
30,-90,40,857,923,1780,3933
70,-90,80,857,923,1780,3933
-50,-90,-40,857,923,1780,3933
90,-90,100,857,923,1780,3933
40,-90,50,857,923,1780,3933
170,-90,-180,857,923,1780,3933
-90,-90,-80,857,923,1780,3933
-90,20,50,849,931,1780,4008
-80,10,-180,848,932,1780,3961
-80,10,180,848,932,1780,3961
110,-90,120,857,923,1780,3933
-170,-90,-160,857,923,1780,3933
60,-90,70,857,923,1780,3933
120,-90,130,857,923,1780,3933
-110,-90,-100,857,923,1780,3933
-130,10,-10,868,912,1780,3952
-90,30,70,873,907,1780,3953
10,30,110,876,904,1780,4000
-160,-90,-150,857,923,1780,3933
-90,30,40,863,917,1780,3982
-60,-90,-50,857,923,1780,3933
10,-90,20,857,923,1780,3933
-90,20,60,875,905,1780,3902
-70,-90,-60,857,923,1780,3933
-80,10,90,879,901,1780,3757
-70,-30,70,861,920,1781,3826
-80,-10,60,857,924,1781,3694
-20,60,10,865,916,1781,3898
-10,10,10,866,915,1781,3738
50,40,40,898,883,1781,3840
150,-70,-90,891,891,1782,4006
140,-70,-100,899,883,1782,4112
-80,20,140,886,897,1783,3918
-160,-20,-20,872,911,1783,3929
10,80,-10,878,905,1783,3932
150,-70,170,843,940,1783,3909
160,-40,-150,880,903,1783,4104
50,30,10,888,895,1783,4029
130,20,-110,863,920,1783,3919
120,10,-70,874,910,1784,3965
130,-70,-110,885,899,1784,4120
20,-80,30,865,919,1784,3941
100,30,-70,864,920,1784,3979
-60,-30,80,880,904,1784,3897
-40,-10,130,883,901,1784,3984
30,-50,140,882,902,1784,4100
20,20,100,872,912,1784,4010
180,60,-170,862,922,1784,3778
-180,60,-170,862,922,1784,3778
90,50,-60,889,895,1784,3909
10,20,110,889,896,1785,4013
-140,50,-60,873,912,1785,4034
120,-50,170,870,915,1785,3938
40,30,50,880,906,1786,3917
110,20,-40,883,903,1786,4076
70,-40,140,870,917,1787,4065
-30,-60,100,870,917,1787,4000
30,80,90,899,888,1787,3790
140,0,-80,877,910,1787,3823
90,60,20,891,896,1787,3904
140,-20,-120,872,915,1787,3872
-140,80,140,868,920,1788,3767
90,40,-50,896,892,1788,3851
180,-20,-140,887,902,1789,4212
-150,60,160,850,939,1789,3945
-180,-20,-140,887,902,1789,4212
10,-10,120,871,918,1789,4080
70,40,-30,865,924,1789,3808
120,50,-10,907,882,1789,3865
-80,10,70,857,932,1789,3875
-140,-10,-140,895,895,1790,3801
-170,-40,-130,888,902,1790,3919
160,40,-150,872,918,1790,3960
-10,0,10,877,913,1790,3912
-150,0,-150,875,915,1790,3803
-130,60,140,845,945,1790,3921
-90,20,20,879,911,1790,3951
-30,10,150,846,944,1790,3868
40,-40,60,875,916,1791,3955
-150,-70,-130,893,898,1791,3835
-50,70,40,864,927,1791,3814
-80,10,0,871,920,1791,3887
-90,50,-130,893,899,1792,3826
-90,40,90,858,934,1792,3733
-70,10,-160,849,943,1792,4054
50,40,-20,874,918,1792,3965
150,50,-140,858,934,1792,4055
-120,-80,-110,876,916,1792,3842
-80,10,80,869,923,1792,3725
-90,50,80,862,931,1793,3813
130,-30,-110,887,906,1793,3888
170,-80,-70,886,907,1793,4110
90,30,-40,885,908,1793,4102
-120,40,-80,879,915,1794,3787
-110,20,-60,871,923,1794,3981
40,-10,90,856,938,1794,3966
-160,-50,-130,900,894,1794,4111
-70,10,170,868,926,1794,4057
150,-60,180,882,913,1795,4071
-90,-30,-100,850,945,1795,4015
-110,80,-120,894,901,1795,3871
130,10,-110,861,934,1795,3953
110,-40,-160,890,905,1795,4112
20,-80,140,871,924,1795,4148
150,-60,-180,882,913,1795,4071
180,-60,-150,875,921,1796,4160
-70,10,180,864,932,1796,3992
-70,10,-180,864,932,1796,3992
110,-60,-130,872,924,1796,4120
170,-60,-160,895,901,1796,4162
-180,-60,-150,875,921,1796,4160
10,60,-10,866,931,1797,3859
30,20,30,886,911,1797,4019
-170,60,-50,906,891,1797,3956
0,40,120,888,909,1797,4121
-170,80,-60,898,899,1797,3941
120,20,-90,873,924,1797,3933
-40,-30,-20,858,939,1797,3860
150,-10,-140,872,925,1797,4113
160,20,-150,882,916,1798,4065
170,-30,-60,876,922,1798,4101
-100,10,-90,878,920,1798,3910
60,-40,130,877,921,1798,4096
30,-30,120,860,938,1798,4057
160,50,-150,875,923,1798,4082
160,-60,-170,888,910,1798,4117
-110,20,-70,888,911,1799,3961
100,80,20,888,911,1799,4027
0,-50,10,877,922,1799,3971
160,-70,180,865,934,1799,3970
160,-70,-180,865,934,1799,3970
-130,-70,0,881,918,1799,4013
-120,-70,10,882,918,1800,4041
-180,-80,-60,900,900,1800,4143
20,-60,30,871,929,1800,3968
-110,-80,-100,877,923,1800,3892
-80,-40,-80,851,949,1800,3810
180,-80,-60,900,900,1800,4143
-150,50,170,850,950,1800,4200
180,-40,-50,889,912,1801,4056
-90,-60,40,889,912,1801,4113
20,10,30,882,919,1801,3882
-70,20,0,860,941,1801,4114
110,-60,150,879,922,1801,3960
-180,-40,-50,889,912,1801,4056
-80,-60,50,892,910,1802,4222
-40,40,170,885,917,1802,3919
150,50,-30,900,902,1802,3982
30,50,-20,865,937,1802,3958
70,40,10,906,896,1802,4115
-40,-50,90,895,908,1803,4039
-20,-50,110,885,918,1803,4152
10,-20,120,877,926,1803,3999
140,20,-130,882,921,1803,4196
170,-30,-140,895,908,1803,4167
80,70,-70,876,927,1803,3966
170,40,-160,854,949,1803,3925
-130,-80,-120,866,938,1804,3826
60,-50,90,870,934,1804,4042
180,-10,-40,905,899,1804,3917
-40,-60,90,897,907,1804,4053
-180,-10,-40,905,899,1804,3917
-90,10,-110,872,933,1805,3987
60,40,-20,877,928,1805,3892
-120,70,120,863,942,1805,3835
-160,60,170,877,928,1805,3918
110,20,-60,888,917,1805,4105
-140,50,160,862,943,1805,4080
100,-50,-150,886,919,1805,3992
-160,-30,-130,879,927,1806,3911
140,10,-130,891,915,1806,4272
-80,30,20,891,915,1806,4081
0,-50,120,893,913,1806,4109
30,-20,110,876,930,1806,4046
40,-10,100,892,914,1806,3976
-10,-30,10,899,907,1806,3840
70,-70,90,874,932,1806,4028
30,20,20,893,913,1806,4060
140,-10,-120,909,898,1807,3875
-110,-60,-100,868,939,1807,3880
-170,10,-150,885,922,1807,3843
80,-40,150,876,931,1807,4157
180,-70,-60,903,904,1807,4086
-90,40,80,872,935,1807,3907
70,50,-40,880,927,1807,3928
-50,20,0,875,932,1807,4009
-180,-70,-60,903,904,1807,4086
-30,-30,-10,870,938,1808,3844
130,-30,-140,882,926,1808,4108
20,-70,140,896,912,1808,4151
110,20,-70,885,923,1808,4003
-80,20,10,862,946,1808,4133
-40,30,170,885,923,1808,3930
40,-20,100,883,926,1809,3795
-50,-60,-40,854,955,1809,3893
-60,0,-20,876,933,1809,3868
70,70,-60,883,926,1809,3894
-40,20,0,892,918,1810,4058
-70,10,-170,859,951,1810,4040
-90,20,30,866,944,1810,4024
-120,60,130,844,966,1810,4008
-160,40,-40,884,926,1810,3989
-100,10,30,881,930,1811,4038
-50,0,140,875,936,1811,4099
-150,20,-30,890,921,1811,4006
-140,20,-170,894,917,1811,3893
-170,0,-150,919,893,1812,4126
150,-20,-140,888,924,1812,4119
150,20,-50,899,913,1812,4137
110,-40,-150,887,925,1812,4142
140,-30,-140,897,915,1812,3976
-20,-30,0,897,915,1812,3821
100,-60,140,886,926,1812,3937
140,-10,-130,896,916,1812,3978
120,30,-100,869,943,1812,3879
150,-10,-80,891,922,1813,4036
-110,-70,20,895,918,1813,4080
120,20,-40,888,925,1813,3970
20,-70,30,882,931,1813,3998
150,-30,-140,910,903,1813,4109
-10,-40,120,894,919,1813,4046
-130,80,130,883,931,1814,3862
40,60,-30,877,937,1814,4019
160,-20,-70,897,917,1814,4049
10,-80,20,869,945,1814,4047
-60,-30,-40,891,924,1815,4014
10,-80,130,881,934,1815,4191
-130,-30,-120,887,928,1815,3851
40,30,40,927,888,1815,3983
60,-40,100,892,923,1815,4098
170,-10,-50,896,920,1816,4068
10,-70,20,883,933,1816,4106
-80,10,-170,866,950,1816,3904
-130,-70,-110,883,933,1816,3846
140,-30,-100,878,938,1816,4026
-90,-50,40,880,936,1816,3873
-180,0,-40,903,914,1817,4017
80,-40,160,890,927,1817,4118
-100,-70,-90,877,940,1817,3926
-50,-60,80,895,922,1817,4136
180,0,-40,903,914,1817,4017
-90,10,50,891,927,1818,4074
-70,-60,60,909,909,1818,4224
180,50,-40,907,911,1818,4097
-90,20,40,890,928,1818,4129
-180,50,-40,907,911,1818,4097
-60,-90,60,902,917,1819,4157
110,-90,-130,902,917,1819,4157
100,-90,-140,902,917,1819,4157
150,-90,-90,902,917,1819,4157
-140,-90,-20,902,917,1819,4157
-50,-90,70,902,917,1819,4157
-100,-70,30,900,919,1819,4083
20,-90,140,902,917,1819,4157
0,-90,120,902,917,1819,4157
-90,-90,30,902,917,1819,4157
-170,-80,-50,908,911,1819,4221
-170,-90,-50,902,917,1819,4157
-130,-90,-10,902,917,1819,4157
130,-90,-110,902,917,1819,4157
-20,-90,100,902,917,1819,4157
-100,-90,20,902,917,1819,4157
-60,-70,70,899,920,1819,4011
-40,-90,80,902,917,1819,4157
-80,-90,40,902,917,1819,4157
140,-90,-100,902,917,1819,4157
70,-90,-170,902,917,1819,4157
-30,-90,90,902,917,1819,4157
-70,-90,50,902,917,1819,4157
-110,-90,10,902,917,1819,4157
10,-90,130,902,917,1819,4157
-150,-90,-30,902,917,1819,4157
-10,-90,110,902,917,1819,4157
60,-90,180,902,917,1819,4157
-160,-90,-40,902,917,1819,4157
170,-90,-70,902,917,1819,4157
40,-90,160,902,917,1819,4157
-180,-90,-60,902,917,1819,4157
-120,-90,0,902,917,1819,4157
60,-90,-180,902,917,1819,4157
180,-90,-60,902,917,1819,4157
80,-90,-160,902,917,1819,4157
50,-90,170,902,917,1819,4157
90,-90,-150,902,917,1819,4157
-130,20,-170,882,937,1819,3922
30,-90,150,902,917,1819,4157
120,-90,-120,902,917,1819,4157
80,-50,130,897,922,1819,4148
160,-90,-80,902,917,1819,4157
-70,10,120,881,939,1820,3938
-100,30,-110,888,932,1820,3969
100,40,-70,914,906,1820,3936
-70,-70,60,895,925,1820,3999
-80,-40,50,887,934,1821,3938
120,-40,-160,894,927,1821,4041
50,-30,100,895,926,1821,3929
-40,-70,-30,866,955,1821,4023
-120,80,-110,908,913,1821,3945
-60,20,0,873,948,1821,4086
0,80,0,892,929,1821,4055
140,60,-130,875,946,1821,3909
160,10,-50,909,913,1822,4076
-120,-10,-130,889,933,1822,4111
-30,-70,-20,884,938,1822,4005
170,-20,-140,911,911,1822,4292
60,50,40,904,918,1822,4088
20,-50,130,889,933,1822,4238
30,30,70,894,928,1822,3984
20,80,100,913,910,1823,3860
170,-60,-70,909,914,1823,4142
-90,0,-100,882,941,1823,4110
-120,10,-160,887,936,1823,3938
140,0,-130,902,921,1823,4080
90,-40,170,879,944,1823,4100
130,-30,-120,909,915,1824,4108
150,10,-140,887,937,1824,4036
-160,50,180,883,941,1824,4220
-160,50,-180,883,941,1824,4220
80,-70,-170,914,911,1825,4178
-140,10,-20,885,940,1825,3991
-80,10,-20,878,948,1826,4000
70,50,30,899,927,1826,4142
-80,30,30,884,942,1826,3909
150,0,-140,888,938,1826,4042
140,0,-120,895,931,1826,3985
-150,80,-80,918,909,1827,4005
160,-60,-80,895,932,1827,4094
-70,-50,60,897,930,1827,4112
90,30,-20,924,903,1827,4203
-90,-70,40,893,934,1827,4015
150,30,-40,906,921,1827,3909
140,10,-120,892,935,1827,4315
50,-40,140,891,936,1827,4075
130,-30,-130,894,933,1827,4066
-90,30,100,896,932,1828,4029
-160,-70,-140,906,922,1828,3994
-90,10,-170,876,952,1828,4046
110,20,-50,898,930,1828,4148
-90,10,-30,899,930,1829,4067
-100,30,130,911,918,1829,3871
-110,20,-30,892,937,1829,4098
-80,40,-140,876,953,1829,4138
-60,-60,70,895,934,1829,4183
-90,-10,-60,880,950,1830,4004
-160,20,-160,887,943,1830,3911
-170,-70,-150,909,921,1830,3958
-130,50,150,878,952,1830,4115
-160,80,-70,915,915,1830,4004
0,-80,10,870,960,1830,4132
-110,20,180,906,925,1831,4020
-90,-20,-100,880,951,1831,3939
130,10,-100,898,933,1831,4155
140,30,-40,903,928,1831,3973
-110,20,-180,906,925,1831,4020
-100,-80,-90,897,934,1831,4018
170,-70,-170,882,949,1831,4053
-150,-60,-20,904,927,1831,4135
-30,-50,100,895,937,1832,4094
60,-40,120,902,930,1832,4067
30,-30,50,884,948,1832,3978
30,30,0,893,939,1832,3976
30,40,70,902,931,1833,4170
-130,30,-40,887,946,1833,4113
90,60,-70,886,947,1833,4090
-120,10,0,890,943,1833,4148
-60,20,-170,894,939,1833,4214
180,90,-180,906,928,1834,4029
110,90,-110,906,928,1834,4029
-90,90,90,906,928,1834,4029
140,90,-140,906,928,1834,4029
120,-40,-120,881,953,1834,4042
-160,90,160,906,928,1834,4029
-70,70,-160,910,924,1834,3906
-130,90,130,906,928,1834,4029
-60,90,60,906,928,1834,4029
-170,90,170,906,928,1834,4029
-120,90,120,906,928,1834,4029
160,90,-160,906,928,1834,4029
130,90,-130,906,928,1834,4029
-110,10,-160,893,941,1834,4184
-70,90,70,906,928,1834,4029
-110,40,-100,894,940,1834,3986
-50,90,50,906,928,1834,4029
100,90,-100,906,928,1834,4029
-110,90,110,906,928,1834,4029
-80,50,60,893,941,1834,4154
120,90,-120,906,928,1834,4029
-180,90,180,906,928,1834,4029
-180,90,-180,906,928,1834,4029
-140,90,140,906,928,1834,4029
-100,90,100,906,928,1834,4029
-150,90,150,906,928,1834,4029
150,90,-150,906,928,1834,4029
80,90,-80,906,928,1834,4029
90,90,-90,906,928,1834,4029
-80,90,80,906,928,1834,4029
170,90,-170,906,928,1834,4029
180,90,180,906,928,1834,4029
70,90,-70,906,928,1834,4029
20,90,-20,906,928,1834,4029
-20,90,20,906,928,1834,4029
60,90,-60,906,928,1834,4029
-20,-70,-10,902,932,1834,4014
-30,90,30,906,928,1834,4029
40,30,30,917,917,1834,4048
10,90,-10,906,928,1834,4029
-10,90,10,906,928,1834,4029
30,90,-30,906,928,1834,4029
50,90,-50,906,928,1834,4029
0,90,0,906,928,1834,4029
40,90,-40,906,928,1834,4029
-40,90,40,906,928,1834,4029
130,-40,-160,891,944,1835,4078
-100,60,100,879,956,1835,3896
20,-10,110,905,930,1835,4042
-160,-80,-40,916,919,1835,4261
20,40,90,903,932,1835,4057
80,50,20,904,931,1835,4123
-170,-60,-140,900,936,1836,4232
-80,-70,50,894,942,1836,3982
40,30,0,890,946,1836,4044
60,-40,110,899,937,1836,4168
-90,-10,-70,874,962,1836,3935
160,0,-140,894,942,1836,4220
20,50,90,909,928,1837,3929
-60,60,-170,909,929,1838,3998
150,-20,-90,885,953,1838,4073
60,-40,140,903,935,1838,4228
130,70,-10,918,921,1839,4127
0,70,120,916,923,1839,3957
-100,-10,-130,875,964,1839,3989
-130,-60,-110,891,948,1839,3895
140,40,-30,908,931,1839,3930
-110,-20,-120,889,951,1840,4068
-80,0,60,884,956,1840,3970
-90,0,-140,870,970,1840,4121
-180,-70,-160,905,936,1841,4017
80,-60,-170,909,932,1841,4271
-130,80,-100,924,917,1841,3975
20,40,-10,874,967,1841,4228
-110,30,-90,903,938,1841,3999
-140,80,-90,929,912,1841,4018
30,20,40,931,910,1841,4080
180,-70,-160,905,936,1841,4017
-70,-10,80,892,950,1842,3985
-140,-20,-130,905,937,1842,3905
130,30,-110,892,950,1842,3941
-50,-70,-40,865,977,1842,4082
10,-70,130,916,926,1842,4293
-110,60,-110,901,942,1843,3931
70,-50,110,890,953,1843,4115
60,70,-50,872,972,1844,4041
100,30,-20,930,914,1844,4109
110,30,-80,899,945,1844,4067
160,10,-140,899,945,1844,4175
-80,-20,-60,902,942,1844,3920
110,-50,-140,904,941,1845,4125
-120,20,-170,912,933,1845,4061
-30,-20,120,899,946,1845,4097
170,70,-40,912,933,1845,4006
120,-50,-120,886,959,1845,4048
60,-60,90,911,934,1845,4017
20,0,40,901,945,1846,4007
-10,-30,120,907,939,1846,4118
30,20,50,892,954,1846,4072
0,-60,10,896,950,1846,3986
90,-60,130,912,935,1847,4210
0,-80,120,895,952,1847,4201
130,-50,-180,901,947,1848,4074
-80,10,-10,879,969,1848,4084
-70,-10,-30,889,959,1848,3792
120,-80,140,864,984,1848,4111
130,-50,180,901,947,1848,4074
130,10,-60,911,938,1849,4259
110,60,0,924,926,1850,3915
-120,50,-90,901,949,1850,3950
-90,-80,-80,914,936,1850,4131
30,20,80,920,930,1850,4144
-100,-60,30,916,934,1850,4151
180,-60,-60,921,930,1851,4257
0,-40,120,907,944,1851,4181
-30,-30,110,918,933,1851,4130
50,-30,90,897,954,1851,4132
-180,-60,-60,921,930,1851,4257
-90,10,-10,885,966,1851,4049
-60,-40,70,915,936,1851,4012
-80,-10,-40,902,950,1852,3881
90,70,-80,897,955,1852,4156
110,40,-10,922,930,1852,4115
-10,50,130,925,927,1852,4162
70,-60,180,919,933,1852,4184
70,-60,-180,919,933,1852,4184
-40,-20,100,894,958,1852,3901
-80,10,-140,878,975,1853,4235
170,-10,-140,931,922,1853,4184
-80,-80,-70,912,941,1853,4274
80,-50,-180,893,960,1853,4364
-20,-60,-10,904,949,1853,3891
80,-50,180,893,960,1853,4364
110,80,10,920,934,1854,4124
-100,10,-40,913,941,1854,4193
-90,-50,-90,876,978,1854,4055
-90,-10,-80,877,977,1854,4138
-50,0,-10,915,939,1854,4030
110,30,-20,924,930,1854,4094
-150,-80,-30,929,925,1854,4298
-90,10,0,892,963,1855,4125
150,-60,-90,919,936,1855,4209
-70,-20,70,879,976,1855,4105
-60,50,30,914,941,1855,4153
-160,-40,-130,916,939,1855,4114
-60,-60,-50,885,971,1856,3996
50,-60,160,940,916,1856,4274
10,80,110,933,923,1856,3903
80,60,-60,904,952,1856,4051
-50,-40,80,920,937,1857,3962
20,-30,120,917,940,1857,4065
-80,-30,50,888,969,1857,3930
-60,-20,-30,884,973,1857,4140
-170,-50,-130,911,946,1857,4230
0,-10,20,929,929,1858,4056
10,-60,20,894,964,1858,4062
170,60,-160,891,967,1858,3887
0,-20,20,914,944,1858,4004
-10,-80,110,903,955,1858,4186
-50,50,180,900,958,1858,4115
-30,-80,-20,896,962,1858,4298
-30,-10,0,898,960,1858,3843
120,50,-100,937,921,1858,4129
-50,50,-180,900,958,1858,4115
20,-10,40,910,949,1859,4101
-20,-80,-10,892,967,1859,4229
-90,-70,-80,897,962,1859,4120
90,30,-30,923,936,1859,4190
40,-40,130,910,950,1860,4140
-90,0,-40,889,971,1860,3908
-90,-40,-90,912,948,1860,4013
-120,20,-30,892,968,1860,4097
130,-40,-110,917,943,1860,4154
-150,-60,-120,918,943,1861,4283
120,-60,160,910,951,1861,4090
-160,-50,-30,911,950,1861,4178
-120,50,140,908,953,1861,4141
80,40,0,939,922,1861,4159
50,40,30,932,930,1862,4077
110,-50,170,904,958,1862,4244
-80,60,70,903,959,1862,4135
140,-50,-170,911,951,1862,4237
30,-40,50,920,942,1862,4073
130,-80,150,871,991,1862,4125
90,-70,-160,928,934,1862,4284
-150,-30,-130,924,938,1862,4032
-140,-40,-120,911,951,1862,4016
-120,80,120,917,945,1862,4021
100,30,-60,907,955,1862,4177
40,-60,150,941,921,1862,4167
-80,20,70,890,973,1863,4065
-10,-60,0,930,933,1863,3900
-60,-80,-50,918,945,1863,4287
-160,-60,-130,918,945,1863,4129
-110,-10,-130,903,960,1863,4125
-10,-80,0,891,972,1863,4206
150,20,-140,915,948,1863,4320
-60,30,10,889,975,1864,4176
-100,-40,-100,876,988,1864,4105
160,-10,-130,921,943,1864,4186
0,-60,120,928,936,1864,4237
-50,-50,80,916,948,1864,4170
60,-60,170,933,932,1865,4199
110,-80,130,882,983,1865,4164
160,-30,-140,941,924,1865,4201
0,70,0,901,964,1865,4048
-160,0,-150,943,922,1865,4262
150,0,-130,930,935,1865,4238
-170,-40,-40,917,949,1866,4158
90,-50,150,905,961,1866,4303
100,60,-80,922,944,1866,4122
-50,0,130,887,979,1866,4135
60,-50,160,920,946,1866,4278
-60,10,170,888,978,1866,4197
140,-60,-100,924,942,1866,4397
140,20,-120,907,960,1867,4239
-40,0,140,892,975,1867,4326
170,0,-140,928,939,1867,4120
160,-10,-140,927,940,1867,4227
-100,30,140,909,958,1867,4219
-40,-80,-30,909,959,1868,4293
0,-70,10,904,964,1868,4174
-60,-50,-50,900,968,1868,4026
-70,-60,-60,891,978,1869,4073
160,-20,-140,941,928,1869,4273
120,-40,-140,916,953,1869,4260
-80,20,80,908,961,1869,4172
-70,10,0,905,964,1869,3987
-110,-30,-110,911,959,1870,4111
-110,-50,-100,900,970,1870,4080
150,-40,-150,934,936,1870,4258
150,-10,-90,915,955,1870,4108
-60,-50,70,920,950,1870,4202
30,20,60,930,940,1870,4171
20,30,90,922,948,1870,4211
-70,-40,-60,920,950,1870,3980
30,10,60,901,969,1870,4166
160,30,-40,911,960,1871,4191
20,30,0,899,972,1871,4107
120,-60,-120,897,974,1871,4237
120,30,-30,928,943,1871,4214
-80,20,130,933,938,1871,4211
-130,-50,-110,923,949,1872,4102
-50,-10,100,910,962,1872,3917
-50,0,110,898,974,1872,4117
-160,10,-30,907,965,1872,4147
-120,0,-140,913,960,1873,3947
40,-50,140,926,947,1873,4249
10,-30,120,917,956,1873,4288
-90,40,-130,917,956,1873,4130
-100,0,-60,888,985,1873,3940
-40,-10,110,906,967,1873,4107
120,-40,-130,914,959,1873,4353
50,-50,150,922,952,1874,4223
-60,10,-10,902,972,1874,4117
-170,40,-40,930,944,1874,4188
-10,-70,0,921,953,1874,4164
-50,0,120,921,954,1875,4120
-40,40,10,917,958,1875,4272
-10,80,10,916,959,1875,4173
-110,-30,20,909,966,1875,4220
-80,10,60,910,965,1875,4129
-70,40,30,903,972,1875,4123
-70,-80,-60,932,943,1875,4306
-90,30,110,906,969,1875,4123
-100,-30,30,917,959,1876,4097
-40,-10,120,907,969,1876,4275
-150,-50,-20,917,959,1876,4197
180,-10,-140,941,935,1876,4281
-70,0,-20,900,976,1876,4010
-180,-10,-140,941,935,1876,4281
-40,-40,90,923,953,1876,4078
-170,50,-170,912,964,1876,4203
-70,-40,60,906,971,1877,3911
-140,30,180,919,958,1877,4039
-170,-30,-130,922,955,1877,4127
-140,30,-180,919,958,1877,4039
40,-30,110,918,959,1877,4152
-170,-60,-50,918,959,1877,4290
120,40,-100,919,958,1877,4178
-100,-60,-90,897,981,1878,4238
10,-40,120,918,960,1878,4399
-110,70,110,892,986,1878,4030
140,0,-110,922,956,1878,4062
-80,-30,-70,902,977,1879,4087
-50,-20,-20,894,985,1879,4174
170,60,-40,920,959,1879,4307
-100,0,-50,903,976,1879,3922
40,-20,80,922,958,1880,4208
-90,10,-20,898,982,1880,4162
-80,0,-30,902,978,1880,3999
-110,-60,20,922,958,1880,4175
140,10,-60,939,941,1880,4141
-10,60,130,929,951,1880,4034
0,30,0,901,979,1880,4213
150,10,-60,941,940,1881,4199
150,-30,-90,921,960,1881,4341
150,-10,-130,924,957,1881,4261
-110,10,-60,926,956,1882,4032
-110,10,10,929,953,1882,4165
70,-50,170,929,953,1882,4313
-100,10,10,905,977,1882,4078
20,-20,40,916,966,1882,4154
50,-40,80,917,965,1882,4168
100,-80,120,890,992,1882,4179
10,-50,120,938,945,1883,4349
100,70,-90,907,976,1883,4276
150,-50,-160,928,955,1883,4312
-140,-80,-20,941,942,1883,4338
50,50,50,921,963,1884,4230
-20,-80,100,917,967,1884,4170
180,-40,-130,935,949,1884,4353
-180,-40,-130,935,949,1884,4353
-100,40,120,924,961,1885,4036
100,-70,-150,933,952,1885,4316
-100,50,110,894,991,1885,4044
50,-40,130,917,968,1885,4243
-50,-80,-40,918,967,1885,4313
20,60,90,937,948,1885,3993
140,-40,-100,928,957,1885,4107
-100,10,-10,914,972,1886,4166
-60,40,20,912,974,1886,4256
170,10,-140,915,971,1886,4004
140,-30,-130,939,947,1886,4088
160,-70,-90,947,939,1886,4289
-90,40,100,918,968,1886,4103
150,-20,-100,931,956,1887,4294
-50,40,180,916,971,1887,4112
130,-60,170,927,960,1887,4210
160,-50,-80,938,949,1887,4213
-80,10,-150,895,992,1887,4232
140,-80,160,885,1002,1887,4145
0,-70,120,923,964,1887,4488
-50,40,-180,916,971,1887,4112
-20,0,10,917,971,1888,3906
-80,40,60,925,963,1888,4117
90,40,-10,944,944,1888,4230
-90,-10,-90,893,995,1888,4289
-170,20,-150,918,970,1888,3977
-60,-70,-50,895,993,1888,4114
-120,0,10,900,988,1888,4333
-120,-40,-110,910,978,1888,4017
-100,-20,30,906,982,1888,4076
-150,-10,-140,909,980,1889,4129
40,30,10,924,965,1889,4260
160,-40,-80,937,952,1889,4327
-110,10,-50,923,966,1889,4233
100,30,-50,922,967,1889,4248
70,-70,180,936,953,1889,4356
70,-70,-180,936,953,1889,4356
0,80,120,945,945,1890,3969
60,-70,80,908,982,1890,4207
30,-10,60,924,966,1890,4153
-100,10,0,908,982,1890,4308
-60,10,130,904,986,1890,4178
-140,20,-30,928,963,1891,4116
-30,-10,130,934,957,1891,4414
-180,0,-140,937,954,1891,4098
-100,0,-70,913,978,1891,4022
-110,20,-50,916,975,1891,4340
180,0,-140,937,954,1891,4098
80,-50,140,913,978,1891,4297
160,-30,-80,931,961,1892,4300
140,30,-120,910,982,1892,4144
-90,-40,40,910,982,1892,4126
60,40,20,947,945,1892,4234
-80,20,110,913,979,1892,3942
-170,-70,-50,942,950,1892,4272
170,-50,-70,934,958,1892,4322
40,40,50,938,955,1893,4044
110,-80,-140,948,945,1893,4359
-20,10,140,907,986,1893,4125
-80,-70,-70,913,980,1893,4159
40,30,20,934,960,1894,4290
-160,50,-50,945,949,1894,4224
120,-50,-180,917,977,1894,4308
-10,20,10,934,960,1894,4238
140,0,-100,927,967,1894,4125
10,10,110,933,961,1894,4450
120,-50,180,917,977,1894,4308
90,-60,-160,934,960,1894,4375
-80,-60,-70,913,982,1895,4256
-60,10,140,900,995,1895,4222
-140,-60,-10,930,965,1895,4286
-140,-60,-110,930,965,1895,4134
-110,50,130,932,964,1896,4117
60,50,-30,916,980,1896,4154
180,10,-40,930,966,1896,4121
10,10,20,951,945,1896,4169
-90,-10,-110,914,982,1896,4169
-180,10,-40,930,966,1896,4121
-110,80,110,931,966,1897,4195
160,-50,-150,937,960,1897,4323
-100,20,170,923,974,1897,4299
-70,-20,-40,921,976,1897,4056
-80,30,-140,913,984,1897,4282
30,0,100,924,973,1897,4203
-80,-20,-50,913,985,1898,3916
-90,10,-160,916,982,1898,4244
150,60,-140,890,1008,1898,4232
-90,20,160,933,965,1898,4279
-50,-20,90,917,981,1898,4050
10,20,10,932,966,1898,4158
-80,40,50,922,977,1899,4349
30,-50,130,917,982,1899,4270
-80,70,-150,949,950,1899,4029
-130,-80,-10,955,944,1899,4291
100,-50,160,912,988,1900,4292
-90,-10,-50,917,983,1900,4185
40,-20,90,916,984,1900,4181
120,-40,-150,947,953,1900,4426
120,60,-10,956,945,1901,4216
-150,-50,-120,940,961,1901,4255
150,-20,-130,950,951,1901,4256
10,0,110,951,950,1901,4289
-30,0,140,920,982,1902,4332
-70,-30,60,923,979,1902,4252
-90,-10,-100,910,992,1902,4223
-120,30,-50,928,975,1903,4377
-180,40,-160,924,979,1903,4338
180,40,-160,924,979,1903,4338
-140,-30,-120,933,970,1903,3986
120,20,-50,931,972,1903,4293
150,-40,-90,932,972,1904,4290
120,-80,-130,950,954,1904,4364
-10,0,130,933,971,1904,4296
-70,10,-10,923,981,1904,4202
-130,0,0,931,973,1904,4258
-70,-70,-60,906,998,1904,4179
70,60,-50,922,982,1904,4068
130,-60,-110,933,972,1905,4390
140,20,-50,936,969,1905,4272
-110,20,-40,926,980,1906,4306
-110,-20,20,930,976,1906,4347
100,-50,170,936,970,1906,4426
-70,0,90,928,978,1906,4020
30,10,70,934,972,1906,4267
-100,10,-160,897,1009,1906,4335
-90,50,90,908,998,1906,4067
150,-10,-110,952,954,1906,4305
100,-60,-150,946,960,1906,4433
150,-70,-100,964,942,1906,4336
-30,-80,90,927,979,1906,4220
110,-70,-140,942,965,1907,4368
160,-60,-160,932,975,1907,4382
-30,20,150,922,985,1907,4122
30,0,60,926,982,1908,4182
150,-10,-120,934,974,1908,4236
0,0,120,938,971,1909,4208
-80,30,50,918,991,1909,4321
-60,-10,-20,920,989,1909,4141
30,-60,140,956,953,1909,4369
90,-80,110,915,994,1909,4198
90,-80,-160,951,959,1910,4359
90,-50,-170,928,982,1910,4363
120,80,0,942,968,1910,4242
-100,0,30,925,985,1910,4377
150,0,-70,946,964,1910,4259
30,10,90,941,969,1910,4269
-100,-50,30,924,986,1910,4186
110,-70,140,926,984,1910,4273
100,-80,-150,951,960,1911,4363
-90,0,-130,898,1013,1911,4209
80,-80,-170,949,962,1911,4380
70,-50,130,924,987,1911,4407
110,70,-100,912,999,1911,4401
-20,-40,110,954,957,1911,4306
20,-20,110,935,977,1912,4249
-40,10,0,923,989,1912,4185
-90,30,120,929,983,1912,4132
150,-50,-90,942,970,1912,4319
-110,20,-80,951,961,1912,4281
-130,40,-60,926,986,1912,4382
-70,-30,-50,934,979,1913,4229
-80,30,40,929,984,1913,4427
-140,-40,-10,944,969,1913,4354
70,40,-20,939,974,1913,4179
-90,20,-120,924,989,1913,4227
140,0,-90,940,973,1913,4158
-40,-40,-20,921,993,1914,4138
-100,0,-140,929,985,1914,4317
-90,60,90,922,992,1914,3991
-130,0,-140,951,963,1914,4183
-70,20,10,918,996,1914,4302
150,-20,-120,940,974,1914,4274
130,-50,-110,918,996,1914,4341
30,20,70,942,972,1914,4209
130,50,-20,968,947,1915,4266
170,-80,-170,924,991,1915,4246
-110,60,120,916,999,1915,3999
-110,0,20,910,1005,1915,4218
-20,80,20,936,979,1915,4332
-130,-20,-120,942,973,1915,4037
140,-50,-100,948,967,1915,4404
160,20,-140,939,977,1916,4273
170,-50,-140,946,970,1916,4305
-130,40,160,943,973,1916,4321
120,20,-80,938,978,1916,4212
170,-70,-80,962,954,1916,4337
-120,-60,10,930,986,1916,4317
150,-80,170,906,1010,1916,4183
-120,-60,-100,929,987,1916,4170
-30,-40,100,941,976,1917,4330
20,-40,120,934,983,1917,4261
-70,10,100,914,1003,1917,3986
50,-40,120,948,969,1917,4250
-110,10,0,943,974,1917,4301
20,10,100,951,966,1917,4349
80,-50,170,931,986,1917,4533
130,10,-90,943,974,1917,4321
100,-50,180,938,979,1917,4313
-120,30,-70,915,1002,1917,4292
100,-50,-180,938,979,1917,4313
0,-30,120,938,980,1918,4477
-100,-80,20,949,969,1918,4291
-60,10,120,925,993,1918,4286
-90,-30,-90,916,1002,1918,4273
160,-40,-140,974,944,1918,4382
120,-50,-130,936,982,1918,4319
-110,0,-140,929,989,1918,4271
-110,20,-90,921,997,1918,4091
-80,20,100,933,985,1918,4150
-140,0,-10,937,981,1918,4313
-140,40,170,942,976,1918,4257
160,-80,180,914,1005,1919,4256
130,40,-110,940,979,1919,4090
-60,10,150,907,1012,1919,4345
80,70,30,956,963,1919,4225
60,-70,170,953,966,1919,4419
-160,-40,-30,958,961,1919,4291
-110,-80,10,951,968,1919,4314
160,-80,-180,914,1005,1919,4256
160,-10,-70,955,964,1919,4308
-40,20,160,906,1014,1920,4309
-100,50,-120,958,962,1920,4186
-140,-50,-10,946,974,1920,4321
90,-70,120,946,974,1920,4174
-80,20,120,924,996,1920,4193
160,60,-150,909,1011,1920,4289
0,20,10,946,974,1920,4192
70,70,40,962,959,1921,4152
70,-80,-180,955,966,1921,4421
70,-80,180,955,966,1921,4421
-90,20,170,911,1010,1921,4210
-140,30,-40,931,990,1921,4347
30,30,60,936,985,1921,4158
-70,10,110,912,1010,1922,4062
110,-50,-180,948,974,1922,4441
110,-50,180,948,974,1922,4441
-90,-80,30,952,970,1922,4265
-120,-80,0,955,967,1922,4278
-150,-40,-20,958,964,1922,4355
10,40,100,952,971,1923,4344
150,60,-30,970,953,1923,4261
80,-60,120,942,981,1923,4465
150,10,-130,945,978,1923,4150
-110,-50,20,936,987,1923,4382
-180,20,-40,937,987,1924,4222
10,50,100,951,973,1924,4190
-90,10,40,924,1000,1924,4278
-130,-60,0,940,984,1924,4364
180,20,-40,937,987,1924,4222
90,-50,160,957,967,1924,4499
90,50,10,952,973,1925,4395
-10,-70,110,936,989,1925,4559
100,30,-30,953,972,1925,4393
0,30,120,943,982,1925,4381
-40,-80,80,932,994,1926,4302
90,-50,180,942,984,1926,4417
180,-30,-50,938,988,1926,4342
-80,50,70,921,1005,1926,4074
180,50,-160,945,981,1926,4181
-100,20,-180,911,1015,1926,4332
-180,-30,-50,938,988,1926,4342
-100,20,180,911,1015,1926,4332
-180,50,-160,945,981,1926,4181
-110,30,-100,922,1004,1926,4171
-100,70,100,923,1003,1926,4238
90,-50,-180,942,984,1926,4417
-90,-20,-90,923,1003,1926,4366
40,50,60,961,965,1926,4337
130,20,-100,943,984,1927,4310
120,40,-20,957,970,1927,4385
-70,60,-160,947,980,1927,4171
110,-60,-140,948,979,1927,4361
-120,30,170,932,995,1927,4311
160,-20,-80,945,982,1927,4424
-90,0,-110,915,1012,1927,4427
-10,70,130,960,968,1928,4191
-90,50,100,917,1011,1928,4135
-130,-10,-130,960,968,1928,4098
100,-50,-160,932,996,1928,4349
150,-10,-100,963,965,1928,4285
-100,-10,30,946,982,1928,4298
-60,10,160,933,995,1928,4364
-80,20,-140,925,1003,1928,4198
-130,20,-30,930,998,1928,4270
100,40,-10,960,968,1928,4363
0,20,120,942,987,1929,4372
-70,-80,50,942,987,1929,4299
-80,30,70,942,987,1929,4382
160,0,-130,958,971,1929,4392
-80,40,70,932,997,1929,4294
170,-60,-150,951,979,1930,4387
20,-30,40,934,996,1930,4064
-80,40,80,936,994,1930,4197
-60,-80,60,946,985,1931,4306
-80,-20,50,909,1022,1931,4194
10,-10,30,951,980,1931,4185
-150,0,-20,937,995,1932,4327
-110,-40,20,957,975,1932,4391
-90,-10,40,936,996,1932,4346
-60,-10,90,920,1012,1932,4228
-20,-10,130,953,979,1932,4489
-130,10,-150,955,977,1932,4095
-80,20,150,941,991,1932,4270
10,30,100,977,955,1932,4405
-120,-70,-100,938,994,1932,4057
-180,-80,-70,970,963,1933,4336
150,-20,-110,958,975,1933,4271
60,-50,100,921,1012,1933,4406
50,-70,160,969,964,1933,4478
180,-80,-70,970,963,1933,4336
-170,-80,-60,971,962,1933,4362
20,20,20,955,978,1933,4221
-140,40,-50,951,983,1934,4343
40,-50,60,943,991,1934,4300
-160,-70,-40,954,980,1934,4428
130,-80,-120,963,971,1934,4388
100,-70,130,945,989,1934,4240
170,-40,-70,954,981,1935,4401
90,-50,170,947,988,1935,4352
-120,-30,10,947,988,1935,4341
120,-70,150,944,991,1935,4318
-120,-40,10,957,978,1935,4411
130,10,-80,939,996,1935,4313
-120,-20,-120,935,1000,1935,4253
170,50,-40,958,977,1935,4397
-90,-20,-60,936,999,1935,4148
-120,10,-10,925,1010,1935,4369
-130,20,-160,957,978,1935,4211
-100,-20,-110,956,980,1936,4298
-90,-10,-40,922,1014,1936,4026
110,-50,-150,940,996,1936,4406
-150,40,180,935,1001,1936,4272
100,-50,-170,944,992,1936,4451
-150,40,-180,935,1001,1936,4272
120,-70,-130,957,979,1936,4468
-100,-50,-90,924,1013,1937,4353
100,-60,150,947,990,1937,4390
150,40,-130,946,991,1937,4240
-170,-80,-150,945,992,1937,4331
30,30,40,959,978,1937,4173
-100,80,100,944,993,1937,4247
-70,50,50,952,986,1938,4403
-80,10,-160,925,1013,1938,4393
-100,10,20,939,999,1938,4273
-140,0,-140,967,972,1939,4194
-80,0,-10,937,1002,1939,4151
-80,30,80,933,1006,1939,4320
-70,40,40,949,990,1939,4375
40,-30,70,957,982,1939,4289
-150,20,-160,948,991,1939,4450
-110,20,-170,951,988,1939,4332
-80,-80,40,950,989,1939,4331
-90,-60,-80,918,1021,1939,4421
-50,-80,70,944,995,1939,4334
90,-60,140,935,1005,1940,4397
-110,10,-10,935,1005,1940,4322
100,50,-70,969,971,1940,4138
0,0,20,969,971,1940,4174
-10,80,130,978,963,1941,4117
-10,10,130,959,982,1941,4343
-180,-70,-150,935,1006,1941,4384
-100,-40,30,956,985,1941,4237
150,-30,-130,980,961,1941,4270
180,-20,-130,967,974,1941,4461
-140,10,-150,944,997,1941,4206
-180,-20,-130,967,974,1941,4461
-80,20,90,950,991,1941,4216
180,-70,-150,935,1006,1941,4384
180,-80,-160,937,1005,1942,4317
-20,10,10,960,982,1942,4349
180,20,-140,960,982,1942,4196
-180,-80,-160,937,1005,1942,4317
-180,20,-140,960,982,1942,4196
-130,-80,-110,954,988,1942,4399
-90,-20,40,949,994,1943,4223
80,-80,100,932,1011,1943,4252
-20,20,140,952,991,1943,4118
90,70,20,959,984,1943,4302
-50,-30,80,964,979,1943,4134
130,-50,-170,950,993,1943,4529
-160,60,-60,965,979,1944,4358
-70,20,-160,930,1014,1944,4305
20,-50,120,950,994,1944,4417
10,-10,110,948,996,1944,4398
-160,40,-170,947,997,1944,4396
160,20,-50,966,978,1944,4323
70,-50,160,933,1011,1944,4461
-110,30,160,955,989,1944,4263
0,10,120,942,1003,1945,4386
-90,-30,40,922,1023,1945,4324
-30,-70,90,952,993,1945,4429
60,-80,170,977,968,1945,4484
180,-70,-70,984,961,1945,4431
150,20,-130,955,990,1945,4314
170,30,-150,942,1003,1945,4356
170,-30,-130,965,980,1945,4350
150,0,-120,963,982,1945,4275
-40,-30,90,948,997,1945,4155
-180,-70,-70,984,961,1945,4431
-180,40,-40,950,996,1946,4569
180,40,-40,950,996,1946,4569
-130,-60,-100,960,986,1946,4174
-120,40,150,962,984,1946,4340
0,40,0,942,1004,1946,4340
-100,50,120,953,993,1946,4178
130,20,-50,958,988,1946,4461
100,30,-40,950,997,1947,4452
-180,-50,-60,965,982,1947,4380
140,-80,-110,979,968,1947,4369
-150,-40,-120,945,1002,1947,4243
180,-50,-60,965,982,1947,4380
-150,-80,-130,954,993,1947,4302
-20,-70,100,954,993,1947,4483
-20,-20,120,955,993,1948,4305
-20,60,140,974,974,1948,4362
-160,-80,-140,957,991,1948,4333
80,40,-30,942,1006,1948,4378
150,-80,-100,986,962,1948,4309
-20,-10,10,941,1007,1948,4078
-160,10,-150,958,991,1949,4214
-130,50,-80,957,992,1949,4070
120,-60,-130,944,1005,1949,4621
160,-80,-90,985,964,1949,4293
-40,-20,-10,944,1006,1950,4218
-50,30,180,939,1011,1950,4371
-50,30,-180,939,1011,1950,4371
-10,70,10,937,1013,1950,4371
160,0,-60,963,988,1951,4238
-70,30,20,941,1010,1951,4523
-130,70,140,937,1014,1951,4185
-100,0,-80,942,1009,1951,4164
60,60,-40,939,1013,1952,4193
-70,-10,70,948,1004,1952,4226
-150,10,-150,964,988,1952,4233
40,-70,150,982,970,1952,4483
-60,0,-10,945,1007,1952,4238
150,30,-130,972,980,1952,4343
-130,-40,-110,953,999,1952,4160
170,-80,-80,987,965,1952,4284
30,10,80,981,972,1953,4441
-70,-50,-60,931,1022,1953,4266
-70,10,70,958,995,1953,4392
-10,-60,110,968,985,1953,4441
-120,-80,-100,958,996,1954,4448
-70,0,0,953,1001,1954,4225
-30,-40,-10,943,1011,1954,4138
50,70,-40,946,1008,1954,4375
60,-50,150,956,998,1954,4391
30,30,50,986,968,1954,4298
-80,-60,40,956,998,1954,4420
130,-40,-140,971,983,1954,4454
110,-60,160,961,994,1955,4501
-70,-70,50,980,975,1955,4312
-80,30,60,951,1004,1955,4322
-170,-50,-50,950,1005,1955,4442
130,-70,160,937,1018,1955,4378
180,-50,-130,979,976,1955,4245
-180,-50,-130,979,976,1955,4245
-150,-70,-30,954,1001,1955,4431
-140,-80,-120,967,988,1955,4375
-60,0,100,950,1006,1956,4214
60,70,50,978,978,1956,4228
110,60,-90,958,998,1956,4186
130,-40,-130,972,984,1956,4319
130,50,-110,961,995,1956,4291
-60,50,-170,953,1003,1956,4193
140,-60,-180,953,1004,1957,4333
10,0,30,971,986,1957,4255
170,-60,-80,989,968,1957,4360
40,-60,60,948,1009,1957,4361
140,10,-110,957,1000,1957,4336
140,-60,180,953,1004,1957,4333
30,-40,120,951,1006,1957,4321
80,-60,130,956,1001,1957,4443
20,-60,130,973,984,1957,4612
150,-60,-170,962,995,1957,4344
130,-40,-120,954,1003,1957,4423
-120,30,-60,947,1011,1958,4508
0,-10,120,962,996,1958,4365
140,-70,-110,984,974,1958,4458
-130,-40,0,967,991,1958,4428
110,-50,-170,949,1009,1958,4560
80,40,-10,967,992,1959,4389
-160,-60,-40,976,983,1959,4338
180,10,-140,948,1011,1959,4265
-180,10,-140,948,1011,1959,4265
-40,0,0,959,1000,1959,4378
50,-50,80,966,994,1960,4588
180,-30,-130,973,987,1960,4585
50,70,60,973,987,1960,4300
-100,40,-120,969,991,1960,4228
-180,-30,-130,973,987,1960,4585
110,30,-30,971,990,1961,4426
50,-80,160,995,966,1961,4513
-30,80,30,954,1007,1961,4442
-10,-50,110,973,989,1962,4480
140,-30,-110,960,1002,1962,4458
-160,-40,-120,972,990,1962,4200
-100,-10,-120,938,1024,1962,4444
-60,-30,70,970,992,1962,4121
-100,-30,-100,950,1013,1963,4388
120,70,-110,955,1008,1963,4395
120,20,-60,970,993,1963,4496
-80,-90,30,978,986,1964,4398
120,-90,-130,978,986,1964,4398
-20,-90,90,978,986,1964,4398
130,-90,-120,978,986,1964,4398
-130,-90,-20,978,986,1964,4398
20,-90,130,978,986,1964,4398
-160,-90,-50,978,986,1964,4398
90,-90,-160,978,986,1964,4398
170,0,-50,964,1000,1964,4474
-50,-90,60,978,986,1964,4398
-30,-90,80,978,986,1964,4398
100,-90,-150,978,986,1964,4398
30,-90,140,978,986,1964,4398
160,-90,-90,978,986,1964,4398
180,-90,-70,978,986,1964,4398
-90,-90,20,978,986,1964,4398
170,-90,-80,978,986,1964,4398
80,-90,-170,978,986,1964,4398
10,-90,120,978,986,1964,4398
40,-90,150,978,986,1964,4398
50,-90,160,978,986,1964,4398
-120,70,130,936,1028,1964,4274
60,-90,170,978,986,1964,4398
-150,-90,-40,978,986,1964,4398
-50,10,0,954,1010,1964,4257
-140,-90,-30,978,986,1964,4398
-10,-90,100,978,986,1964,4398
70,-90,-180,978,986,1964,4398
70,-90,180,978,986,1964,4398
140,-90,-110,978,986,1964,4398
-180,-90,-70,978,986,1964,4398
-110,-90,0,978,986,1964,4398
-70,-90,40,978,986,1964,4398
-10,40,130,954,1010,1964,4558
110,-90,-140,978,986,1964,4398
-120,-90,-10,978,986,1964,4398
170,-40,-130,983,981,1964,4624
-40,-90,70,978,986,1964,4398
150,-90,-100,978,986,1964,4398
-170,-90,-60,978,986,1964,4398
-50,-10,-10,961,1003,1964,4229
-100,-90,10,978,986,1964,4398
-60,-90,50,978,986,1964,4398
0,-90,110,978,986,1964,4398
150,-30,-100,972,993,1965,4451
160,-60,-90,979,986,1965,4536
-40,-70,80,965,1000,1965,4407
180,70,-50,971,994,1965,4238
-90,70,-140,963,1002,1965,4249
-80,-10,-30,937,1028,1965,4186
80,40,-20,974,991,1965,4456
-180,70,-50,971,994,1965,4238
-40,-50,80,974,992,1966,4383
160,-20,-130,989,977,1966,4544
-120,-50,10,959,1007,1966,4475
-140,20,-160,952,1014,1966,4273
60,40,10,984,982,1966,4474
-70,-20,60,958,1008,1966,4231
-70,60,60,943,1023,1966,4440
-160,-50,-120,978,988,1966,4356
100,40,-60,976,991,1967,4415
-150,30,-170,968,999,1967,4332
-80,-70,40,988,979,1967,4360
-90,0,-120,928,1039,1967,4607
40,40,40,988,979,1967,4289
-110,40,140,949,1018,1967,4270
-130,-50,0,966,1001,1967,4406
-50,30,10,959,1008,1967,4389
90,40,-40,972,996,1968,4332
70,40,0,977,991,1968,4406
-60,-60,60,967,1001,1968,4504
-30,-20,110,966,1002,1968,4471
-110,10,-70,954,1014,1968,4309
-60,-20,80,946,1022,1968,4275
0,60,0,948,1020,1968,4234
140,70,-20,976,992,1968,4487
-20,50,10,954,1014,1968,4455
-20,20,10,976,992,1968,4496
120,60,-100,970,998,1968,4194
-60,-70,60,981,988,1969,4330
-140,-50,-110,970,999,1969,4387
-150,-80,-40,992,977,1969,4373
20,20,90,981,988,1969,4518
180,-60,-140,967,1002,1969,4482
-180,-60,-140,967,1002,1969,4482
0,-20,120,968,1001,1969,4506
170,30,-40,946,1023,1969,4454
-100,10,-100,950,1019,1969,4381
-50,-70,70,975,994,1969,4351
-80,-50,40,951,1019,1970,4444
130,30,-40,975,995,1970,4500
-90,10,10,959,1011,1970,4424
130,70,-120,950,1020,1970,4392
170,-20,-130,972,998,1970,4344
140,-60,-170,950,1020,1970,4484
-50,-40,-30,939,1031,1970,4181
50,40,-10,965,1006,1971,4385
140,-40,-150,968,1003,1971,4452
-180,30,-40,983,988,1971,4391
-90,0,40,968,1003,1971,4437
-120,60,-100,966,1005,1971,4233
-150,-20,-130,973,998,1971,4310
-70,20,140,960,1011,1971,4355
180,30,-40,983,988,1971,4391
-50,10,160,957,1015,1972,4530
-50,20,170,947,1025,1972,4379
130,80,-10,966,1006,1972,4442
-80,30,90,951,1021,1972,4422
-90,80,90,951,1021,1972,4237
-90,10,-120,959,1013,1972,4506
150,-30,-120,985,988,1973,4422
120,-50,-170,972,1001,1973,4603
170,-70,-160,958,1015,1973,4511
160,-20,-90,982,991,1973,4479
-160,-80,-50,988,985,1973,4412
-120,-50,-100,960,1013,1973,4307
-10,20,130,958,1015,1973,4455
-130,60,150,941,1032,1973,4257
-170,-70,-140,962,1012,1974,4352
10,-60,120,990,984,1974,4672
-110,-80,-90,961,1013,1974,4437
0,-30,20,962,1012,1974,4323
140,-30,-120,974,1000,1974,4482
30,-10,100,975,999,1974,4474
-170,-10,-140,986,988,1974,4558
170,-10,-130,986,989,1975,4333
170,20,-140,976,999,1975,4536
-120,-20,10,964,1011,1975,4532
-140,70,150,955,1020,1975,4255
60,40,-10,969,1006,1975,4329
-140,-80,-30,996,979,1975,4334
30,-30,110,976,999,1975,4379
150,-70,-180,957,1019,1976,4514
150,0,-110,968,1008,1976,4459
150,-70,180,957,1019,1976,4514
140,40,-120,959,1017,1976,4256
170,-20,-60,960,1016,1976,4454
120,-50,-140,978,999,1977,4411
-70,50,-160,973,1004,1977,4208
-80,20,160,951,1026,1977,4315
-30,40,10,951,1026,1977,4424
-20,30,10,965,1012,1977,4492
-100,30,160,959,1019,1978,4385
-130,30,180,974,1004,1978,4453
-130,30,-180,974,1004,1978,4453
-90,0,-30,971,1007,1978,4324
-140,-40,-110,964,1014,1978,4310
30,30,30,974,1004,1978,4352
130,-70,-120,980,998,1978,4522
70,-50,120,950,1028,1978,4563
-90,40,110,976,1002,1978,4281
-90,-20,-80,951,1028,1979,4363
-70,-10,-20,963,1016,1979,4181
150,-40,-100,963,1016,1979,4571
160,-30,-130,973,1006,1979,4397
-110,-70,-90,956,1023,1979,4272
20,10,40,974,1006,1980,4332
-160,-10,-140,976,1004,1980,4466
90,40,-20,985,995,1980,4499
150,-60,-100,987,994,1981,4513
-110,50,-110,976,1005,1981,4366
10,-20,30,958,1023,1981,4355
-40,80,40,964,1017,1981,4531
40,-50,130,968,1013,1981,4320
180,30,-150,981,1001,1982,4293
130,-40,-150,978,1004,1982,4515
-180,30,-150,981,1001,1982,4293
-110,10,-80,964,1018,1982,4274
20,20,30,984,999,1983,4396
130,10,-70,970,1013,1983,4489
160,-70,-170,968,1015,1983,4542
-90,-60,30,965,1018,1983,4377
-80,20,20,954,1029,1983,4332
-40,-60,80,993,991,1984,4389
-110,10,-150,947,1037,1984,4391
120,-60,170,960,1024,1984,4450
-150,30,-40,982,1002,1984,4445
-120,10,-150,976,1008,1984,4328
-60,10,0,961,1024,1985,4362
-80,20,170,948,1037,1985,4379
-100,60,110,954,1032,1986,4028
50,-40,100,965,1021,1986,4396
30,60,-20,958,1028,1986,4435
70,-50,150,973,1013,1986,4642
-70,0,70,960,1026,1986,4231
20,30,80,985,1001,1986,4354
-70,-60,50,977,1009,1986,4425
-140,60,160,944,1042,1986,4337
-100,0,-90,954,1032,1986,4402
40,-80,150,1004,983,1987,4541
-130,-30,0,986,1001,1987,4346
-110,10,-20,953,1034,1987,4375
-50,-60,70,992,995,1987,4460
30,-70,140,1000,988,1988,4662
-150,70,160,967,1021,1988,4295
170,-40,-80,998,990,1988,4441
30,-50,50,985,1004,1989,4430
-70,20,130,959,1030,1989,4381
160,10,-130,973,1016,1989,4618
10,30,0,959,1030,1989,4361
120,20,-70,976,1013,1989,4478
140,-70,170,960,1029,1989,4440
150,0,-100,991,999,1990,4339
-30,-60,90,987,1003,1990,4403
-110,-40,-100,972,1018,1990,4511
50,-50,140,982,1009,1991,4390
170,0,-130,991,1000,1991,4494
80,-70,110,993,998,1991,4342
-80,0,-20,964,1027,1991,4407
150,-30,-110,975,1016,1991,4634
-160,-70,-130,973,1018,1991,4388
140,-40,-110,966,1026,1992,4666
0,10,20,985,1007,1992,4352
-100,20,-110,964,1028,1992,4531
-20,-60,100,990,1002,1992,4434
-80,0,50,960,1033,1993,4426
-30,60,20,969,1024,1993,4457
-20,70,140,993,1001,1994,4368
160,-30,-110,978,1016,1994,4570
-170,-40,-120,984,1010,1994,4300
80,-50,150,974,1020,1994,4546
160,-30,-90,1003,991,1994,4537
-170,40,-160,977,1018,1995,4489
-60,30,-170,965,1030,1995,4542
100,50,0,986,1009,1995,4489
20,20,40,986,1010,1996,4281
50,-70,70,956,1040,1996,4438
-90,10,30,982,1014,1996,4544
20,-40,40,980,1016,1996,4347
20,40,80,978,1018,1996,4461
-70,80,70,976,1021,1997,4382
130,-60,-180,955,1042,1997,4492
-100,10,-150,962,1035,1997,4512
70,40,-10,1003,994,1997,4331
180,-10,-130,976,1021,1997,4565
130,-60,180,955,1042,1997,4492
-180,-10,-130,976,1021,1997,4565
-60,40,-170,963,1034,1997,4427
-70,0,-10,967,1030,1997,4325
-170,-60,-130,963,1034,1997,4622
-90,30,130,958,1039,1997,4552
50,-40,90,984,1014,1998,4550
70,-60,110,991,1007,1998,4562
-80,80,80,961,1037,1998,4286
160,-40,-90,990,1008,1998,4479
60,50,30,998,1000,1998,4435
-20,70,20,955,1043,1998,4532
30,-20,60,980,1018,1998,4520
160,0,-120,1001,997,1998,4494
30,30,10,983,1016,1999,4450
-90,20,180,955,1044,1999,4340
-10,30,130,978,1021,1999,4522
-30,-50,90,984,1015,1999,4430
-60,-40,60,992,1007,1999,4174
-80,-10,50,964,1035,1999,4423
-90,-50,30,991,1008,1999,4319
-90,20,-180,955,1044,1999,4340
-90,-70,30,1006,993,1999,4440
-40,-90,-20,972,1028,2000,4265
-110,-90,-90,972,1028,2000,4265
-170,-70,-60,1011,989,2000,4574
30,50,70,993,1007,2000,4511
150,-90,170,972,1028,2000,4265
-90,70,90,960,1040,2000,4350
20,-90,40,972,1028,2000,4265
90,-90,110,972,1028,2000,4265
-120,-90,-100,972,1028,2000,4265
40,-90,60,972,1028,2000,4265
-10,-90,10,972,1028,2000,4265
-50,-90,-30,972,1028,2000,4265
0,-90,20,972,1028,2000,4265
-80,-90,-60,972,1028,2000,4265
-130,-80,-20,1010,990,2000,4374
130,-90,150,972,1028,2000,4265
160,-90,-180,972,1028,2000,4265
-140,-90,-120,972,1028,2000,4265
80,-90,100,972,1028,2000,4265
70,-80,90,963,1037,2000,4350
-80,20,50,978,1022,2000,4521
-20,-90,0,972,1028,2000,4265
70,-90,90,972,1028,2000,4265
140,-90,160,972,1028,2000,4265
-180,-90,-160,972,1028,2000,4265
180,-90,-160,972,1028,2000,4265
-130,-90,-110,972,1028,2000,4265
160,-90,180,972,1028,2000,4265
-160,-90,-140,972,1028,2000,4265
100,-90,120,972,1028,2000,4265
-60,-90,-40,972,1028,2000,4265
-90,-90,-70,972,1028,2000,4265
-70,-90,-50,972,1028,2000,4265
-100,-90,-80,972,1028,2000,4265
-30,-90,-10,972,1028,2000,4265
-170,-90,-150,972,1028,2000,4265
30,-90,50,972,1028,2000,4265
-150,-90,-130,972,1028,2000,4265
170,-90,-170,972,1028,2000,4265
50,-90,70,972,1028,2000,4265
60,-90,80,972,1028,2000,4265
10,-90,30,972,1028,2000,4265
120,-90,140,972,1028,2000,4265
110,-90,130,972,1028,2000,4265
170,40,-40,973,1028,2001,4475
-150,0,-140,969,1032,2001,4284
160,-10,-120,1009,992,2001,4395
-20,50,140,977,1024,2001,4426
-110,70,120,970,1031,2001,4302
-30,-30,100,956,1045,2001,4371
150,-60,-160,968,1033,2001,4550
-120,40,-90,977,1025,2002,4446
140,-50,-160,975,1027,2002,4750
-160,30,-160,985,1017,2002,4270
110,40,-80,990,1012,2002,4538
80,-50,160,975,1027,2002,4521
140,70,-130,977,1025,2002,4432
-60,-50,60,977,1026,2003,4451
-100,-10,-70,956,1047,2003,4430
40,50,-20,960,1043,2003,4440
-140,-10,-130,989,1014,2003,4474
-120,60,140,964,1039,2003,4233
-20,-30,110,999,1005,2004,4678
30,70,80,1005,999,2004,4379
70,-60,170,993,1011,2004,4676
-60,20,-180,958,1046,2004,4625
-80,40,90,976,1028,2004,4329
-60,20,180,958,1046,2004,4625
-100,-70,20,998,1006,2004,4489
-70,0,80,974,1030,2004,4401
-110,-60,-90,956,1049,2005,4467
130,-50,-120,983,1022,2005,4550
-80,20,60,982,1023,2005,4612
-40,-10,100,968,1037,2005,4329
-100,10,-30,969,1037,2006,4557
50,-60,80,993,1013,2006,4463
30,0,70,989,1017,2006,4597
-100,30,150,991,1016,2007,4531
40,-40,120,964,1043,2007,4470
-130,-30,-110,973,1034,2007,4325
-100,10,-20,963,1044,2007,4517
150,0,-80,978,1030,2008,4482
-80,20,40,968,1040,2008,4567
120,30,-90,975,1033,2008,4411
160,30,-140,995,1013,2008,4603
-90,-50,-80,965,1043,2008,4456
150,30,-50,985,1023,2008,4408
-150,60,170,971,1038,2009,4432
-20,80,140,1016,993,2009,4310
70,-50,140,976,1033,2009,4668
-80,10,50,986,1024,2010,4504
100,70,10,1001,1009,2010,4429
-160,-60,-120,983,1027,2010,4489
10,60,100,978,1032,2010,4276
170,-30,-80,1001,1009,2010,4574
-80,-50,-70,968,1042,2010,4467
-160,-50,-40,982,1028,2010,4586
-100,-80,-80,996,1014,2010,4449
170,-30,-70,999,1012,2011,4574
20,-80,130,1005,1006,2011,4667
150,-40,-140,1001,1010,2011,4596
-180,-60,-70,1011,1000,2011,4548
-50,80,50,972,1039,2011,4535
180,-60,-70,1011,1000,2011,4548
-130,10,-20,971,1040,2011,4573
-140,-70,-20,984,1027,2011,4496
30,40,-10,976,1036,2012,4501
-50,20,10,962,1050,2012,4557
-20,-50,100,982,1030,2012,4603
-50,-50,70,993,1019,2012,4508
-70,-10,60,978,1035,2013,4305
30,40,60,995,1018,2013,4394
-120,-70,0,992,1021,2013,4469
-60,20,10,968,1045,2013,4380
-110,-70,10,1003,1010,2013,4540
30,-20,100,993,1021,2014,4413
-110,10,-90,957,1057,2014,4457
-100,-10,-60,970,1044,2014,4451
110,30,-70,984,1030,2014,4501
160,-20,-120,1010,1004,2014,4535
-10,-40,110,969,1045,2014,4614
30,0,90,963,1052,2015,4603
-160,70,170,987,1028,2015,4394
60,-60,160,1009,1006,2015,4734
-70,20,70,1011,1005,2016,4455
30,-80,140,1013,1003,2016,4624
-100,0,-40,983,1034,2017,4521
-60,50,40,985,1032,2017,4519
-120,-80,-10,1017,1000,2017,4448
-170,-50,-120,1001,1016,2017,4344
-60,80,60,977,1041,2018,4435
40,70,70,1013,1005,2018,4383
-120,20,-60,988,1031,2019,4569
80,-60,-180,986,1033,2019,4722
40,-30,100,987,1032,2019,4385
80,-60,180,986,1033,2019,4722
160,40,-140,976,1043,2019,4487
0,50,0,976,1043,2019,4473
150,10,-120,994,1025,2019,4489
170,40,-150,966,1053,2019,4545
140,90,-20,1024,996,2020,4466
-150,90,-90,1024,996,2020,4466
-30,90,150,1024,996,2020,4466
-100,90,-140,1024,996,2020,4466
20,90,100,1024,996,2020,4466
0,90,120,1024,996,2020,4466
80,90,40,1024,996,2020,4466
40,90,80,1024,996,2020,4466
-160,90,-80,1024,996,2020,4466
-80,90,-160,1024,996,2020,4466
-180,90,-60,1024,996,2020,4466
-40,90,160,1024,996,2020,4466
60,90,60,1024,996,2020,4466
100,90,20,1024,996,2020,4466
-60,90,-180,1024,996,2020,4466
70,90,50,1024,996,2020,4466
-110,90,-130,1024,996,2020,4466
90,90,30,1024,996,2020,4466
-120,10,-20,972,1048,2020,4547
30,90,90,1024,996,2020,4466
-40,-10,0,983,1037,2020,4351
-130,-10,0,976,1044,2020,4488
170,90,-50,1024,996,2020,4466
-170,90,-70,1024,996,2020,4466
130,90,-10,1024,996,2020,4466
-10,90,130,1024,996,2020,4466
-20,90,140,1024,996,2020,4466
-130,90,-110,1024,996,2020,4466
120,90,0,1024,996,2020,4466
-60,90,180,1024,996,2020,4466
10,90,110,1024,996,2020,4466
-90,90,-150,1024,996,2020,4466
-70,90,-170,1024,996,2020,4466
160,90,-40,1024,996,2020,4466
150,90,-30,1024,996,2020,4466
180,90,-60,1024,996,2020,4466
-90,0,-10,984,1036,2020,4244
50,90,70,1024,996,2020,4466
-140,90,-100,1024,996,2020,4466
-80,-40,-70,975,1045,2020,4537
-50,90,170,1024,996,2020,4466
-120,90,-120,1024,996,2020,4466
110,90,10,1024,996,2020,4466
-30,60,150,999,1021,2020,4521
-60,10,110,965,1056,2021,4357
-150,-70,-120,1004,1017,2021,4441
140,30,-50,994,1028,2022,4543
0,-40,110,996,1026,2022,4654
-100,-30,20,977,1045,2022,4553
170,-50,-80,1021,1001,2022,4607
-120,-30,-110,981,1041,2022,4519
50,-40,110,983,1040,2023,4603
160,-10,-80,992,1031,2023,4519
-80,-20,-40,978,1045,2023,4196
-150,50,-60,994,1029,2023,4630
-90,-20,-70,980,1043,2023,4496
-80,0,0,978,1046,2024,4410
40,70,-30,990,1034,2024,4642
0,-50,110,1008,1016,2024,4593
-50,10,150,962,1062,2024,4514
-90,0,-20,974,1050,2024,4403
150,-50,-100,1003,1021,2024,4606
-80,-40,40,975,1050,2025,4359
-10,-20,120,999,1027,2026,4663
50,50,40,1018,1008,2026,4529
0,-60,110,1007,1019,2026,4600
90,50,-50,1001,1025,2026,4524
-160,-20,-130,1022,1005,2027,4460
-130,-50,-100,992,1035,2027,4359
-100,-50,20,982,1046,2028,4562
-110,-10,20,989,1039,2028,4707
-70,-40,50,1000,1028,2028,4387
-170,30,-150,977,1051,2028,4493
-80,50,80,972,1056,2028,4327
-150,-60,-110,1022,1006,2028,4422
-100,40,130,990,1038,2028,4421
-70,-50,50,996,1032,2028,4452
-90,10,20,980,1048,2028,4474
20,70,90,1006,1022,2028,4446
-30,20,10,997,1031,2028,4674
-40,30,10,986,1043,2029,4509
-50,10,140,981,1048,2029,4604
-50,0,0,997,1032,2029,4349
70,-70,100,992,1037,2029,4563
130,-60,-120,1005,1024,2029,4670
-10,-30,110,980,1049,2029,4621
60,-80,80,986,1043,2029,4470
-100,70,-130,984,1046,2030,4370
60,-50,120,982,1048,2030,4568
-150,10,-30,990,1040,2030,4467
-110,-80,0,1023,1008,2031,4498
-90,-40,30,978,1053,2031,4430
-40,-40,80,995,1036,2031,4560
-130,-70,-10,1008,1023,2031,4519
-170,10,-140,998,1034,2032,4417
90,40,-30,1016,1016,2032,4531
-10,30,10,992,1040,2032,4594
150,-50,-150,989,1043,2032,4872
-70,0,60,994,1039,2033,4465
-160,20,-150,1009,1024,2033,4516
-180,-40,-60,1007,1026,2033,4672
180,-40,-60,1007,1026,2033,4672
20,10,50,1000,1034,2034,4551
-110,30,170,1001,1033,2034,4521
80,50,-40,1008,1026,2034,4611
-70,20,150,982,1052,2034,4513
120,-50,-160,995,1040,2035,4794
160,-10,-90,1017,1018,2035,4599
-80,60,80,966,1069,2035,4290
-110,20,-100,973,1062,2035,4506
-130,60,-90,993,1042,2035,4529
140,-60,-110,1006,1029,2035,4770
60,-50,130,978,1057,2035,4682
-90,50,110,1016,1020,2036,4375
-120,0,0,985,1051,2036,4718
-170,-20,-130,1031,1005,2036,4867
-100,-20,-100,981,1055,2036,4754
110,-60,-150,1014,1023,2037,4629
160,-50,-90,1024,1013,2037,4625
130,40,-30,995,1042,2037,4529
-150,-60,-30,1003,1034,2037,4504
-110,-30,10,1001,1036,2037,4578
110,-50,-160,991,1046,2037,4719
80,-70,180,1017,1020,2037,4591
140,80,-20,1007,1030,2037,4560
80,-70,-180,1017,1020,2037,4591
-140,-10,-10,994,1044,2038,4522
-80,10,10,1001,1037,2038,4592
50,60,-30,987,1051,2038,4507
10,-30,30,988,1050,2038,4562
-140,-70,-110,1001,1037,2038,4424
50,40,20,1014,1024,2038,4628
-80,50,-150,1007,1031,2038,4370
-100,20,-170,991,1047,2038,4603
-140,-60,-100,1003,1035,2038,4349
160,-30,-100,1024,1014,2038,4585
-50,10,120,992,1047,2039,4527
-80,20,30,971,1068,2039,4595
-20,30,140,1001,1038,2039,4606
60,-50,140,990,1050,2040,4634
-140,50,-70,977,1063,2040,4676
-40,20,10,992,1048,2040,4565
-90,0,30,993,1047,2040,4660
-20,-40,0,998,1042,2040,4352
90,-70,-170,1015,1025,2040,4623
-90,-30,-80,979,1061,2040,4653
-70,40,50,980,1061,2041,4660
30,0,80,1023,1019,2042,4654
170,30,-140,1012,1030,2042,4639
-160,30,-40,1005,1037,2042,4532
160,-20,-110,1029,1013,2042,4594
-50,10,130,982,1060,2042,4605
-90,10,-150,975,1067,2042,4447
-170,30,-40,1011,1031,2042,4486
160,40,-40,999,1044,2043,4448
180,-30,-120,1036,1007,2043,4661
-40,-20,90,989,1054,2043,4272
140,-40,-140,1013,1030,2043,4540
-160,60,-180,990,1053,2043,4473
-160,60,180,990,1053,2043,4473
-180,-30,-120,1036,1007,2043,4661
130,-50,-130,1002,1042,2044,4611
-70,-20,-30,987,1057,2044,4295
140,-50,-110,1004,1040,2044,4748
-110,10,-40,999,1045,2044,4436
-150,60,-70,1006,1038,2044,4490
-100,-10,-80,971,1073,2044,4347
150,0,-90,1008,1036,2044,4358
-110,60,130,970,1074,2044,4327
0,40,110,1008,1036,2044,4529
-40,50,20,979,1065,2044,4654
-70,20,80,990,1054,2044,4370
170,-60,-140,1006,1038,2044,4637
-150,-50,-110,1003,1042,2045,4546
-180,-50,-70,1033,1012,2045,4592
-20,40,10,1000,1045,2045,4555
130,-50,-160,1011,1034,2045,4841
180,-50,-70,1033,1012,2045,4592
-40,60,30,995,1051,2046,4678
-100,-70,-80,988,1058,2046,4345
-80,60,-150,1019,1027,2046,4466
170,-30,-120,1015,1031,2046,4445
-70,10,60,1011,1035,2046,4533
140,10,-70,1008,1038,2046,4572
-70,10,10,1001,1045,2046,4658
160,-40,-100,1029,1018,2047,4654
-50,-40,70,997,1050,2047,4443
130,60,-20,1036,1011,2047,4526
30,30,20,1007,1040,2047,4580
-100,-60,20,994,1053,2047,4621
-90,-10,30,983,1065,2048,4575
-170,0,-140,1014,1035,2049,4581
120,30,-40,1010,1039,2049,4736
30,-10,70,1000,1049,2049,4544
-100,-10,-50,989,1060,2049,4335
70,50,20,996,1053,2049,4650
10,-80,120,1017,1032,2049,4755
20,-70,130,1023,1026,2049,4813
40,-40,70,1018,1031,2049,4626
-140,-30,-10,1001,1048,2049,4707
100,-70,-160,1025,1024,2049,4637
150,20,-120,1019,1030,2049,4493
-120,-10,10,994,1056,2050,4607
-30,30,10,1000,1050,2050,4699
10,20,20,999,1051,2050,4443
-170,-60,-60,1027,1024,2051,4630
160,-30,-120,1021,1030,2051,4583
-70,20,120,985,1066,2051,4547
140,50,-30,1025,1026,2051,4498
20,0,100,1027,1024,2051,4752
-90,30,150,995,1056,2051,4530
170,50,-150,996,1055,2051,4477
-140,30,-170,1009,1043,2052,4733
-60,10,10,1000,1052,2052,4496
-70,50,60,989,1063,2052,4530
-10,10,20,999,1053,2052,4353
90,-60,150,999,1055,2054,4764
50,-60,150,1021,1033,2054,4685
-130,-20,0,993,1061,2054,4732
130,60,-110,1002,1053,2055,4306
20,-10,50,992,1063,2055,4525
-50,40,20,997,1058,2055,4742
-90,60,100,984,1071,2055,4250
-100,0,-10,995,1060,2055,4447
-120,20,-70,985,1070,2055,4466
-60,-40,-40,991,1064,2055,4352
-100,-30,-90,1015,1041,2056,4786
120,-60,-180,990,1066,2056,4817
40,40,-10,1013,1043,2056,4587
120,-60,180,990,1066,2056,4817
160,-60,-150,1006,1050,2056,4639
-80,20,-180,979,1077,2056,4610
-170,50,-50,1022,1034,2056,4534
10,20,100,1035,1021,2056,4745
-80,20,180,979,1077,2056,4610
-30,30,150,1002,1055,2057,4570
60,60,40,1019,1038,2057,4500
-30,-20,0,992,1065,2057,4565
-120,20,-40,976,1081,2057,4729
-80,70,80,992,1065,2057,4468
-130,-70,-100,1025,1032,2057,4436
170,-10,-120,1037,1021,2058,4525
-130,40,-70,984,1074,2058,4546
50,60,50,996,1062,2058,4550
-120,20,-160,1013,1045,2058,4657
-30,-10,120,992,1066,2058,4639
-80,40,100,1021,1038,2059,4462
-80,-30,-50,996,1063,2059,4463
-90,-10,-30,1004,1055,2059,4415
90,-60,-170,1013,1046,2059,4754
-170,20,-40,1018,1041,2059,4651
-30,80,150,1033,1026,2059,4460
-100,-20,20,994,1065,2059,4660
60,40,0,1010,1050,2060,4572
150,-40,-130,1003,1057,2060,4736
-110,-30,-100,1003,1057,2060,4719
-60,-20,-20,991,1069,2060,4439
160,-10,-110,1016,1045,2061,4737
-100,-80,10,1033,1028,2061,4551
-100,70,110,996,1065,2061,4402
70,60,30,1010,1051,2061,4563
140,20,-110,998,1063,2061,4439
-70,70,70,1002,1059,2061,4492
30,40,50,1016,1046,2062,4572
170,10,-50,1011,1051,2062,4779
-70,20,160,978,1084,2062,4641
-120,30,-80,1004,1058,2062,4515
150,-40,-110,1016,1046,2062,4793
170,-20,-120,1016,1047,2063,4517
160,-20,-100,1026,1037,2063,4632
20,-10,100,1025,1038,2063,4588
-110,0,-70,1010,1053,2063,4541
110,30,-50,1006,1058,2064,4881
-90,-80,20,1037,1027,2064,4592
-120,-50,0,995,1069,2064,4716
10,10,30,1028,1036,2064,4480
-170,70,-60,1011,1053,2064,4594
-170,-50,-60,1024,1041,2065,4582
10,-50,110,1018,1047,2065,4739
-10,0,20,1016,1049,2065,4473
10,-20,110,1008,1057,2065,4667
-70,10,90,991,1074,2065,4484
-160,-70,-50,1040,1026,2066,4695
-170,70,-180,1022,1044,2066,4535
-100,0,-20,981,1085,2066,4510
-30,-40,90,1008,1058,2066,4470
-170,20,-140,1024,1042,2066,4516
-60,-10,-10,991,1075,2066,4457
110,40,-20,1026,1040,2066,4710
110,70,0,1035,1031,2066,4668
-170,70,180,1022,1044,2066,4535
-70,40,60,1010,1057,2067,4656
110,-70,-150,1025,1042,2067,4717
20,50,-10,997,1070,2067,4605
100,-60,-160,1024,1043,2067,4747
-20,0,130,1006,1061,2067,4700
-50,0,100,1000,1067,2067,4390
170,-60,-90,1039,1028,2067,4644
130,-60,-170,1012,1055,2067,4888
80,-60,140,1005,1062,2067,4736
-90,20,-130,1010,1058,2068,4552
-130,-40,-100,1012,1056,2068,4581
10,-70,120,1034,1034,2068,4831
150,70,-30,1021,1047,2068,4758
-180,-40,-120,1054,1014,2068,4747
110,30,-40,999,1069,2068,4795
180,-40,-120,1054,1014,2068,4747
-40,10,150,1002,1066,2068,4738
-80,50,90,977,1091,2068,4423
-150,-30,-120,999,1069,2068,4501
100,-60,160,1002,1066,2068,4760
-160,50,-170,1003,1065,2068,4675
-80,10,40,999,1070,2069,4706
-90,-20,-50,995,1074,2069,4588
-100,0,-30,998,1071,2069,4608
-80,-30,-60,984,1085,2069,4648
-120,-60,-90,1007,1062,2069,4439
50,-80,70,1005,1064,2069,4587
-150,50,-180,1008,1061,2069,4557
-150,50,180,1008,1061,2069,4557
-170,-40,-50,1026,1043,2069,4731
-110,0,-80,997,1073,2070,4577
-70,30,40,1005,1065,2070,4618
-60,60,50,995,1075,2070,4621
-170,-30,-40,1016,1054,2070,4785
-90,-80,-70,1035,1035,2070,4520
-130,30,-50,1009,1061,2070,4714
-150,-50,-30,1025,1045,2070,4587
170,-30,-100,1042,1028,2070,4650
-160,0,-140,1022,1049,2071,4558
10,-40,110,1019,1052,2071,4875
-30,10,10,1027,1044,2071,4658
160,-50,-100,1034,1037,2071,4815
-60,0,0,1000,1072,2072,4387
110,-60,170,1003,1069,2072,4800
-100,-40,-90,994,1078,2072,4713
-100,-40,20,1004,1068,2072,4532
-120,20,-50,993,1079,2072,4673
-10,-60,100,1022,1050,2072,4689
40,-30,80,1013,1059,2072,4701
-30,70,30,1009,1063,2072,4714
50,40,0,1011,1061,2072,4661
150,70,-140,995,1077,2072,4585
20,50,80,1009,1064,2073,4544
-110,-50,10,1000,1073,2073,4698
-110,0,10,992,1081,2073,4606
-180,-40,-70,1038,1036,2074,4507
30,-50,120,1015,1059,2074,4528
-100,0,20,1000,1074,2074,4805
-130,-60,-90,1009,1065,2074,4588
-90,50,-140,1031,1043,2074,4405
-90,30,-130,996,1078,2074,4778
180,-40,-70,1038,1036,2074,4507
-30,0,130,1007,1067,2074,4731
-70,20,-180,1001,1074,2075,4468
-60,20,170,1007,1068,2075,4508
-30,70,150,1024,1051,2075,4570
-150,-30,-20,1018,1057,2075,4876
-70,20,180,1001,1074,2075,4468
140,-40,-130,1040,1035,2075,4649
160,-10,-100,1023,1052,2075,4621
-80,30,120,1012,1064,2076,4536
170,-40,-90,1037,1039,2076,4660
-90,-40,-80,993,1083,2076,4763
50,50,-20,1021,1055,2076,4624
-50,-10,90,1015,1061,2076,4398
-120,30,-90,997,1080,2077,4521
110,30,-60,1020,1057,2077,4659
100,40,-50,1027,1050,2077,4633
30,-30,60,1010,1067,2077,4652
110,-80,-150,1040,1037,2077,4814
20,-50,40,1015,1062,2077,4576
100,-80,-160,1038,1040,2078,4861
160,-50,-140,1032,1046,2078,4924
0,50,110,1027,1051,2078,4572
120,-50,-150,1026,1052,2078,4871
170,-50,-130,1028,1050,2078,4742
-10,-10,20,1018,1060,2078,4488
40,60,60,1027,1051,2078,4586
160,-40,-130,1041,1037,2078,4757
40,-70,60,1009,1069,2078,4649
170,-30,-90,1047,1032,2079,4561
20,20,50,1037,1042,2079,4567
-110,40,-110,1014,1065,2079,4485
-10,-40,10,1024,1055,2079,4466
20,-20,100,1036,1043,2079,4541
120,-60,-140,1026,1053,2079,4721
-160,-50,-110,1029,1051,2080,4416
-110,-60,10,1017,1063,2080,4752
20,20,60,1020,1060,2080,4603
-100,-10,-90,997,1083,2080,4788
70,-70,170,1041,1040,2081,4671
-60,-30,-30,999,1082,2081,4532
120,-80,-140,1045,1036,2081,4735
-110,-40,10,1018,1063,2081,4547
140,-60,-160,1012,1069,2081,4826
-10,-80,100,1035,1046,2081,4749
-70,20,170,982,1099,2081,4696
50,-50,90,1018,1064,2082,4683
140,10,-100,1026,1056,2082,4522
-70,20,100,1014,1068,2082,4390
90,-80,-170,1043,1039,2082,4846
-100,0,-130,1000,1082,2082,4584
-180,70,-170,1026,1057,2083,4738
170,10,-130,1018,1065,2083,4750
-170,60,-170,1005,1078,2083,4551
-80,30,110,987,1096,2083,4453
0,-80,110,1041,1042,2083,4777
180,70,-170,1026,1057,2083,4738
-10,-20,20,1021,1062,2083,4536
100,40,-20,1043,1040,2083,4693
80,-80,180,1042,1041,2083,4847
80,-80,-180,1042,1041,2083,4847
110,50,-80,1036,1047,2083,4651
20,30,10,1024,1060,2084,4550
150,-60,-150,1013,1071,2084,4707
-130,-60,-10,1017,1067,2084,4714
-170,-50,-110,1026,1058,2084,4413
-20,-80,90,1036,1049,2085,4735
-80,30,100,1022,1063,2085,4680
-70,-30,-40,995,1090,2085,4474
-90,-70,-70,1031,1054,2085,4512
170,-70,-90,1050,1036,2086,4591
150,-70,-110,1042,1044,2086,4589
-150,30,-160,1004,1082,2086,4721
-110,-50,-90,1009,1077,2086,4733
60,-70,90,1019,1067,2086,4642
160,70,-150,1022,1064,2086,4706
20,-60,120,1021,1065,2086,4918
130,-70,170,1009,1077,2086,4769
180,-50,-120,1049,1038,2087,4573
-120,-40,-100,1005,1082,2087,4644
180,-60,-80,1053,1034,2087,4685
-180,-60,-80,1053,1034,2087,4685
-100,-60,-80,1011,1076,2087,4602
-180,-50,-120,1049,1038,2087,4573
-140,60,-80,1012,1075,2087,4579
-140,-60,-20,1023,1064,2087,4707
-160,0,-30,1020,1067,2087,4745
-80,-10,-20,1004,1084,2088,4620
-140,-20,-120,1030,1058,2088,4661
40,40,30,1029,1059,2088,4489
-160,-40,-40,1042,1046,2088,4697
-110,70,-120,1025,1063,2088,4467
-80,-10,40,1026,1062,2088,4633
-10,-70,100,1043,1045,2088,4983
180,-60,-130,1022,1067,2089,4695
-30,50,150,1018,1071,2089,4695
-120,-70,-90,1031,1058,2089,4454
-70,20,110,989,1100,2089,4380
-180,-60,-130,1022,1067,2089,4695
-150,-70,-40,1044,1046,2090,4683
-140,-50,-20,1014,1076,2090,4656
130,20,-90,1022,1068,2090,4685
0,30,110,1028,1062,2090,4764
180,60,-50,1036,1055,2091,4682
-100,-10,-110,1005,1086,2091,4788
-70,30,80,1024,1067,2091,4497
-70,30,70,1039,1052,2091,4681
-180,60,-50,1036,1055,2091,4682
-40,0,130,1004,1087,2091,4674
-100,0,0,1006,1085,2091,4652
-70,40,-160,1002,1089,2091,4641
170,-50,-90,1048,1044,2092,4764
150,-40,-120,1051,1041,2092,4851
-50,-20,-10,1005,1087,2092,4568
20,0,50,1016,1077,2093,4549
-130,50,160,1025,1068,2093,4637
70,-60,160,1032,1061,2093,5032
0,-30,110,1011,1082,2093,4699
60,-50,110,1013,1080,2093,4849
160,-70,-160,1017,1076,2093,4829
140,-40,-120,1033,1060,2093,4836
-70,10,80,1000,1093,2093,4450
130,-80,-130,1052,1041,2093,4705
60,-60,100,1016,1078,2094,4816
-50,-20,80,1008,1086,2094,4485
20,-30,110,1041,1053,2094,4625
-70,10,30,1025,1069,2094,4710
170,-20,-70,1030,1065,2095,4712
-100,-20,-70,1015,1080,2095,4608
-130,-50,-10,1011,1085,2096,4710
40,-30,90,1015,1081,2096,4730
-50,50,30,1015,1081,2096,4876
-20,-40,100,1030,1066,2096,4802
20,30,70,1014,1082,2096,4586
0,-70,110,1055,1041,2096,4891
-30,-20,100,1016,1080,2096,4592
-100,60,120,1015,1082,2097,4443
-60,40,30,1005,1092,2097,4754
-160,-60,-50,1044,1053,2097,4726
160,-60,-100,1041,1056,2097,4692
-80,-70,30,1032,1065,2097,4732
40,50,50,1027,1070,2097,4717
-110,-20,-110,1024,1073,2097,4917
40,-60,140,1050,1047,2097,4840
30,-60,130,1054,1043,2097,4837
170,-20,-100,1038,1060,2098,4628
-160,10,-140,1040,1058,2098,4536
-90,-30,30,1016,1082,2098,4701
70,-80,170,1054,1045,2099,4874
-70,30,30,999,1100,2099,4642
-70,20,40,1008,1092,2100,4755
10,10,100,1019,1081,2100,4627
160,0,-110,1027,1073,2100,4719
120,-60,-170,1042,1058,2100,5125
-90,10,-130,1002,1098,2100,4859
-150,40,-50,1030,1070,2100,4749
160,-60,-140,1033,1068,2101,4710
90,-60,170,1043,1058,2101,4915
-60,20,130,1006,1096,2102,4678
-80,0,40,1031,1071,2102,4842
-120,-60,0,1025,1077,2102,4818
-70,20,-170,1021,1081,2102,4678
-70,10,50,1013,1089,2102,4651
10,40,0,1002,1100,2102,4746
-30,0,10,1017,1086,2103,4575
70,-60,120,1031,1072,2103,4801
-50,-30,-20,996,1107,2103,4603
120,-70,160,1012,1091,2103,4771
20,20,80,1032,1071,2103,4685
-100,-20,-90,1015,1089,2104,4779
50,-50,130,1013,1091,2104,4687
-110,40,150,1020,1084,2104,4616
130,-50,-140,1032,1072,2104,4719
-160,-30,-30,1041,1063,2104,4950
120,-70,-140,1033,1071,2104,4821
80,-60,170,1018,1086,2104,5024
30,-60,50,1025,1079,2104,4761
140,-80,-120,1064,1040,2104,4690
-90,-70,20,1041,1063,2104,4714
-80,-80,30,1054,1051,2105,4602
100,-60,170,1026,1079,2105,4990
-80,-70,-60,1037,1068,2105,4702
-70,0,50,1020,1085,2105,4623
-40,0,120,1020,1085,2105,4864
-80,20,-170,1007,1098,2105,4669
-20,-20,10,1029,1077,2106,4757
150,40,-40,1031,1075,2106,4592
-30,-80,80,1054,1052,2106,4716
-80,30,140,1041,1065,2106,4630
-70,30,60,1016,1090,2106,4498
70,50,-30,1038,1068,2106,4671
30,70,-20,1030,1076,2106,4895
-100,-70,10,1058,1048,2106,4737
-10,-40,100,1037,1070,2107,4708
80,50,10,1037,1070,2107,4876
160,-70,-100,1052,1055,2107,4546
10,-30,110,1038,1069,2107,4871
-180,-70,-80,1058,1049,2107,4685
180,-70,-80,1058,1049,2107,4685
160,20,-130,1045,1062,2107,4875
-50,60,40,1019,1088,2107,4738
-110,0,-50,1050,1057,2107,4673
-20,40,140,1022,1085,2107,4696
40,-80,60,1032,1075,2107,4768
80,60,20,1052,1055,2107,4733
-130,-50,-90,1021,1086,2107,4626
0,-40,20,1017,1090,2107,4703
-70,30,-160,1022,1085,2107,4831
-160,-80,-130,1031,1077,2108,4668
-70,-30,50,1017,1091,2108,4528
-140,30,-160,1023,1085,2108,4784
-40,-50,-20,1019,1089,2108,4562
110,-70,150,1023,1085,2108,4795
0,10,110,1039,1069,2108,4766
130,-70,-130,1043,1066,2109,4886
150,80,-30,1039,1070,2109,4667
-90,20,-170,1012,1097,2109,4883
90,-60,160,1029,1080,2109,4859
110,-60,-180,1037,1072,2109,5155
110,-60,180,1037,1072,2109,5155
-100,-10,20,1006,1103,2109,4655
-90,30,160,1034,1076,2110,4837
-20,-60,90,1029,1081,2110,4863
-90,10,-140,1009,1101,2110,4702
-120,10,-60,1033,1077,2110,4607
-150,-80,-120,1034,1076,2110,4621
-110,10,-100,1024,1086,2110,4703
-90,30,140,1042,1069,2111,4756
180,-30,-60,1053,1058,2111,4719
-170,10,-40,1035,1076,2111,4855
0,20,20,1034,1077,2111,4469
-180,-30,-60,1053,1058,2111,4719
-80,-30,40,1003,1109,2112,4510
70,80,-60,1012,1100,2112,4789
30,-30,100,1036,1076,2112,4817
-130,-40,-10,1043,1069,2112,4894
-70,-80,40,1063,1049,2112,4701
170,-20,-110,1047,1065,2112,4803
-100,30,-120,1038,1074,2112,4765
-130,0,-10,1026,1086,2112,4913
150,-70,-170,1021,1091,2112,4804
-80,-80,-60,1056,1056,2112,4556
10,-40,30,1008,1105,2113,4485
-60,-80,50,1060,1053,2113,4712
20,60,-10,1014,1099,2113,4692
110,50,-10,1027,1086,2113,4688
-70,-10,-10,1027,1086,2113,4610
-90,-20,30,1041,1073,2114,4625
40,-50,70,1029,1085,2114,4752
100,-60,-180,1057,1057,2114,5030
110,-80,140,1040,1074,2114,4784
150,-50,-110,1038,1076,2114,4858
140,-70,-120,1058,1056,2114,4761
170,-10,-60,1034,1080,2114,4903
-140,50,170,1024,1090,2114,4667
-60,20,120,1027,1087,2114,4691
-40,60,160,1037,1077,2114,4643
100,-60,180,1057,1057,2114,5030
-130,70,150,1009,1105,2114,4443
-170,-60,-120,1067,1047,2114,4632
20,30,40,1046,1069,2115,4523
170,0,-120,1050,1065,2115,4668
-110,30,-180,1040,1075,2115,4751
-80,-20,-30,1035,1080,2115,4451
-110,30,180,1040,1075,2115,4751
-70,-40,-50,1026,1090,2116,4751
-100,-20,-80,1029,1087,2116,4643
180,-50,-80,1042,1074,2116,4709
-70,-20,-20,1026,1090,2116,4401
-170,50,-160,1024,1092,2116,4686
-60,0,10,1036,1080,2116,4587
20,30,60,1041,1075,2116,4634
-70,60,70,1015,1101,2116,4544
-120,-30,0,1032,1084,2116,4812
-180,-50,-80,1042,1074,2116,4709
-40,10,10,1038,1079,2117,4482
-10,-10,120,1045,1072,2117,4774
180,-80,-150,1054,1063,2117,4701
-110,-70,-80,1043,1074,2117,4546
-180,-80,-150,1054,1063,2117,4701
30,-10,80,1025,1092,2117,4681
130,-60,-130,1046,1071,2117,4917
-170,-50,-70,1052,1066,2118,4636
-110,0,-20,1020,1098,2118,4669
170,-30,-110,1043,1075,2118,4807
-90,-60,-70,1010,1108,2118,4698
-120,70,-110,1040,1078,2118,4621
-70,20,60,1033,1085,2118,4834
-180,-20,-120,1048,1071,2119,4619
-70,-60,40,1058,1061,2119,4759
90,-60,-180,1031,1088,2119,5091
0,60,110,1040,1079,2119,4586
140,-70,180,1027,1092,2119,4781
-50,-80,60,1050,1069,2119,4809
-60,-20,70,1016,1103,2119,4500
180,-20,-120,1048,1071,2119,4619
80,80,-70,1036,1083,2119,4811
160,30,-130,1056,1063,2119,4873
140,-70,-180,1027,1092,2119,4781
90,-60,180,1031,1088,2119,5091
-120,-40,0,1037,1082,2119,4741
-70,-70,-50,1041,1079,2120,4911
-170,-80,-140,1047,1073,2120,4703
-170,-10,-130,1058,1062,2120,4686
-130,30,-170,1035,1085,2120,4687
-90,60,-140,1049,1071,2120,4620
10,-60,110,1044,1076,2120,4969
-150,-10,-20,1042,1078,2120,4747
-80,10,30,1005,1115,2120,4911
-70,-70,40,1046,1074,2120,4657
30,-20,90,1026,1094,2120,4667
170,-10,-110,1064,1057,2121,4683
-120,20,-80,1039,1082,2121,4610
130,30,-100,1016,1105,2121,4696
60,-80,160,1064,1057,2121,4958
-90,0,0,1032,1090,2122,4645
-140,70,160,1016,1106,2122,4478
-150,-60,-40,1048,1074,2122,4867
-80,-60,30,1044,1078,2122,4715
30,-70,50,1027,1095,2122,4693
-10,60,10,1027,1095,2122,4741
-60,20,150,1025,1097,2122,4742
-40,80,160,1057,1065,2122,4561
170,70,-160,1038,1085,2123,4782
-150,20,-150,1037,1086,2123,4701
-20,-10,120,1050,1073,2123,4888
-70,20,50,1030,1093,2123,4801
-100,-30,-80,1030,1093,2123,4692
-100,-40,-80,1034,1090,2124,4791
-70,0,10,1028,1096,2124,4764
60,-70,160,1064,1060,2124,4853
30,60,70,1052,1072,2124,4631
-140,20,-150,1048,1076,2124,4654
20,10,90,1042,1083,2125,4978
-40,-80,70,1053,1072,2125,4802
-80,30,130,1038,1087,2125,4725
160,-40,-120,1058,1067,2125,4836
-120,30,180,1034,1092,2126,4709
20,30,50,1057,1069,2126,4755
-50,-70,-30,1048,1078,2126,4697
-120,30,-180,1034,1092,2126,4709
50,40,10,1050,1076,2126,4805
-110,0,-90,1014,1112,2126,4668
-60,-30,60,1039,1087,2126,4486
-60,-70,-40,1044,1082,2126,4778
-60,-10,80,1029,1097,2126,4598
-110,0,0,1034,1093,2127,4875
-60,-80,-40,1043,1084,2127,4626
-60,0,90,1025,1102,2127,4632
-120,-50,-80,1034,1093,2127,4550
-110,50,140,1028,1099,2127,4663
60,80,-50,1009,1118,2127,4824
-120,50,150,1027,1100,2127,4657
180,60,-160,1033,1095,2128,4625
-180,60,-160,1033,1095,2128,4625
-120,70,140,1016,1112,2128,4389
170,-60,-130,1042,1086,2128,4677
140,-50,-120,1039,1089,2128,4881
180,10,-130,1056,1072,2128,4718
-80,0,30,1031,1097,2128,4787
-180,10,-130,1056,1072,2128,4718
180,-40,-90,1059,1070,2129,4825
-180,-40,-80,1057,1072,2129,4762
-110,-10,-120,1049,1080,2129,4906
-140,-30,-110,1029,1100,2129,4809
0,-20,110,1058,1071,2129,4906
-180,-40,-90,1059,1070,2129,4825
-80,-50,30,1056,1073,2129,4712
180,-40,-80,1057,1072,2129,4762
170,0,-110,1038,1091,2129,4591
100,-70,140,1030,1099,2129,4887
-140,-50,-100,1037,1093,2130,4564
0,30,10,1046,1085,2131,4945
-110,0,-60,1020,1111,2131,4647
160,10,-60,1054,1077,2131,4767
160,0,-70,1063,1068,2131,4824
50,80,-40,1013,1119,2132,4868
140,50,-120,1056,1076,2132,4737
-140,40,-60,1037,1095,2132,4966
-70,40,70,1023,1109,2132,4734
150,-60,-110,1055,1077,2132,4806
-130,40,170,1044,1088,2132,4624
160,0,-90,1032,1100,2132,4732
100,-60,-170,1055,1077,2132,4980
-100,-10,-100,1030,1102,2132,5010
-170,-50,-90,1069,1063,2132,4711
-80,20,-150,1008,1125,2133,4870
180,-20,-50,1005,1128,2133,5061
-180,-20,-50,1005,1128,2133,5061
-70,-80,-50,1056,1077,2133,4623
-120,50,-100,1038,1095,2133,4754
-110,-20,10,1026,1107,2133,4839
-160,-50,-50,1054,1079,2133,4810
140,-50,-130,1058,1076,2134,4842
-70,30,50,1032,1102,2134,4910
170,-70,-150,1028,1106,2134,4942
160,10,-120,1069,1065,2134,4831
-170,-60,-70,1066,1069,2135,4866
140,30,-110,1036,1099,2135,4622
-80,50,100,1048,1087,2135,4615
-90,-20,-40,1031,1104,2135,4701
-30,-50,-10,1029,1106,2135,4542
20,40,70,1030,1105,2135,4790
-150,-10,-130,1054,1081,2135,4733
160,30,-50,1037,1098,2135,4788
-50,10,10,1035,1101,2136,4695
120,-80,150,1047,1089,2136,4828
150,-80,-110,1083,1053,2136,4661
-120,0,-130,1056,1080,2136,4828
-120,40,-100,1040,1096,2136,4665
60,-60,150,1055,1081,2136,5009
160,-80,-170,1076,1060,2136,4756
-70,30,90,1047,1089,2136,4564
160,50,-40,1071,1066,2137,4715
-130,20,-40,1028,1109,2137,4884
10,-10,100,1077,1060,2137,4833
-170,40,-150,1030,1108,2138,4576
140,-60,-130,1067,1071,2138,4870
130,30,-50,1057,1081,2138,4845
-150,-40,-30,1063,1075,2138,4793
150,10,-70,1055,1083,2138,4738
0,0,30,1063,1075,2138,4691
10,20,30,1054,1084,2138,4727
-100,30,170,1034,1104,2138,4989
-160,30,-150,1037,1102,2139,4596
-50,10,110,1039,1100,2139,4819
50,-50,120,1035,1104,2139,4855
160,80,-150,1016,1123,2139,4639
-80,0,10,1059,1080,2139,4733
30,40,40,1062,1077,2139,4663
170,-40,-120,1056,1084,2140,4872
-100,-20,-50,1030,1110,2140,4738
160,-40,-110,1065,1075,2140,4879
160,-80,-100,1090,1050,2140,4684
120,30,-80,1042,1098,2140,4798
-140,-70,-30,1072,1068,2140,4801
-110,-70,0,1074,1066,2140,4793
100,-80,130,1053,1087,2140,4752
100,40,-30,1046,1094,2140,4835
-60,70,60,1031,1109,2140,4712
-130,-70,-20,1077,1064,2141,4830
180,40,-150,1073,1068,2141,4626
90,-80,120,1047,1094,2141,4727
-100,-20,10,1044,1097,2141,4734
20,-40,110,1054,1087,2141,4853
-110,70,130,1034,1107,2141,4500
120,40,-30,1057,1084,2141,4832
-170,-20,-40,1034,1107,2141,4977
90,-70,180,1070,1071,2141,4990
90,-70,-180,1070,1071,2141,4990
-60,20,160,1020,1121,2141,4672
-180,40,-150,1073,1068,2141,4626
-130,70,-100,1066,1075,2141,4768
120,80,-110,1032,1109,2141,4967
-140,-80,-110,1044,1098,2142,4688
-70,-10,50,1036,1106,2142,4753
20,-50,110,1057,1085,2142,4971
0,20,110,1060,1082,2142,4849
-110,20,-160,1041,1101,2142,4865
-50,-80,-30,1036,1106,2142,4703
-180,30,-140,1051,1092,2143,4709
180,30,-140,1051,1092,2143,4709
140,80,-130,1007,1136,2143,4794
90,80,-80,1040,1103,2143,4845
-20,-80,0,1053,1090,2143,4844
-90,-10,20,1051,1092,2143,4788
10,70,100,1057,1087,2144,4677
-100,-10,-40,1061,1083,2144,4698
80,-60,160,1041,1103,2144,4902
60,50,-20,1043,1101,2144,4713
100,50,-60,1055,1089,2144,4774
-110,-30,0,1047,1097,2144,4680
-140,10,-30,1061,1083,2144,4658
-60,10,100,1038,1106,2144,4538
-90,40,120,1042,1103,2145,4591
-90,-60,20,1051,1094,2145,4858
-120,40,160,1035,1110,2145,4620
-110,0,-10,1029,1116,2145,4820
160,50,-140,1046,1100,2146,4702
-110,-40,-90,1030,1116,2146,4760
80,-70,170,1080,1066,2146,4978
-30,-80,-10,1047,1099,2146,4804
-110,-40,-80,1054,1092,2146,4615
140,-60,-120,1057,1089,2146,5021
-10,20,20,1053,1094,2147,4833
-20,-70,90,1074,1073,2147,4910
-110,-30,-90,1028,1119,2147,4631
130,20,-60,1048,1099,2147,4818
-130,40,-80,1044,1103,2147,4630
-110,0,-40,1036,1112,2148,4665
170,-80,-90,1088,1060,2148,4757
140,-50,-150,1064,1084,2148,5045
170,-20,-90,1056,1092,2148,4665
-100,40,140,1040,1108,2148,4624
-120,-50,-90,1038,1110,2148,4721
-100,-50,-80,1023,1125,2148,4946
-110,-10,-60,1037,1111,2148,4662
-130,30,-60,1018,1131,2149,4923
-100,0,10,1052,1097,2149,4771
-40,-70,-20,1046,1103,2149,4672
-60,-10,0,1035,1114,2149,4644
50,-80,150,1072,1078,2150,5028
-40,30,160,1052,1098,2150,4850
-180,0,-130,1068,1082,2150,4877
-90,70,100,1037,1113,2150,4610
-60,20,40,1055,1095,2150,4886
-90,0,10,1028,1122,2150,4821
40,-40,80,1068,1082,2150,4884
170,-10,-100,1039,1111,2150,4614
-120,-30,-10,1038,1112,2150,4697
120,70,-10,1080,1070,2150,4848
-160,40,-160,1049,1101,2150,4574
180,0,-130,1068,1082,2150,4877
-170,-50,-80,1086,1064,2150,4761
-50,0,10,1050,1100,2150,4635
130,-60,-160,1069,1081,2150,5155
-20,-30,100,1059,1092,2151,4868
-60,30,20,1021,1130,2151,4982
-170,-40,-90,1075,1076,2151,4776
-140,70,-90,1060,1091,2151,4770
10,10,40,1059,1092,2151,4619
-40,-80,-20,1042,1109,2151,4738
100,80,-90,1044,1107,2151,4948
120,30,-50,1051,1101,2152,4898
170,-80,-160,1088,1064,2152,4775
-50,20,160,1033,1119,2152,4879
110,80,-100,1045,1107,2152,4982
-60,10,30,1055,1098,2153,4874
-150,10,-140,1060,1093,2153,4667
130,-80,160,1058,1095,2153,4819
-140,-40,-20,1064,1089,2153,4915
80,-60,150,1053,1100,2153,4903
-40,0,110,1048,1105,2153,4753
160,60,-40,1077,1076,2153,4812
-60,10,20,1046,1107,2153,4884
150,80,-140,1016,1137,2153,4757
-110,-10,-70,1057,1096,2153,4689
-120,20,-90,1046,1107,2153,4511
100,-70,-170,1081,1072,2153,5010
-70,20,90,1057,1097,2154,4651
150,30,-120,1078,1076,2154,4918
-30,-30,90,1044,1110,2154,4551
90,-70,130,1059,1095,2154,5040
-170,-70,-70,1092,1062,2154,4823
-170,80,180,1011,1143,2154,4569
80,-80,110,1046,1108,2154,4712
130,-50,-150,1065,1089,2154,5007
-130,-30,-20,1058,1096,2154,4672
-170,80,-180,1011,1143,2154,4569
-70,-60,-50,1040,1115,2155,4698
-70,10,40,1042,1113,2155,4807
-120,-70,-10,1081,1074,2155,4857
-90,-30,-60,1046,1109,2155,4645
-110,10,-140,1065,1090,2155,4838
-50,80,170,1072,1085,2157,4641
-180,80,-170,1014,1143,2157,4563
-20,20,20,1063,1094,2157,4823
130,80,-120,1015,1142,2157,4895
180,80,-170,1014,1143,2157,4563
160,0,-100,1085,1072,2157,4973
-40,0,10,1068,1089,2157,4680
-100,-50,10,1039,1118,2157,4790
0,0,110,1053,1104,2157,4891
-60,-70,50,1084,1074,2158,4767
150,-80,180,1086,1072,2158,4820
-100,60,-130,1060,1098,2158,4733
-100,30,-180,1048,1110,2158,4772
-50,-60,-30,1044,1114,2158,4810
150,-50,-120,1054,1104,2158,4794
150,-80,-180,1086,1072,2158,4820
-100,30,180,1048,1110,2158,4772
-180,-30,-100,1060,1098,2158,4891
20,30,30,1063,1095,2158,4815
180,-30,-100,1060,1098,2158,4891
-40,10,140,1012,1146,2158,4844
-20,-20,110,1047,1112,2159,5011
-150,70,170,1039,1120,2159,4575
-120,-60,-80,1058,1101,2159,4839
-140,40,180,1048,1111,2159,4714
-60,-60,-40,1040,1119,2159,4730
-110,-50,0,1053,1106,2159,4843
30,-10,90,1050,1109,2159,4813
-140,40,-180,1048,1111,2159,4714
-170,0,-130,1053,1106,2159,4709
-160,20,-140,1056,1103,2159,4841
-140,0,-20,1070,1089,2159,4988
30,-80,50,1058,1101,2159,4903
-120,-20,0,1033,1126,2159,4846
170,20,-50,1044,1116,2160,4873
-100,-30,10,1059,1101,2160,4785
-80,20,-160,1041,1119,2160,4817
-60,-10,70,1059,1101,2160,4621
-10,-50,100,1060,1100,2160,4924
-60,30,40,1045,1116,2161,4874
40,80,-30,1036,1125,2161,4951
-160,-70,-120,1082,1079,2161,4915
-170,-30,-50,1065,1096,2161,4863
-160,-20,-30,1066,1095,2161,4959
110,-70,-160,1086,1076,2162,5013
20,-80,40,1049,1113,2162,4893
-120,-40,-90,1055,1107,2162,4672
-80,10,20,1043,1119,2162,4841
40,40,0,1065,1097,2162,4774
110,-60,-160,1071,1091,2162,4880
70,-80,100,1043,1119,2162,4669
-160,-30,-120,1066,1097,2163,4653
-80,-20,40,1053,1110,2163,4772
180,-80,-80,1081,1082,2163,4829
110,-60,-170,1077,1086,2163,5096
-90,-30,-70,1032,1131,2163,4803
-80,-60,-60,1043,1120,2163,4728
140,-80,170,1080,1083,2163,4834
10,0,100,1078,1085,2163,4830
-180,-80,-80,1081,1082,2163,4829
-80,30,150,1067,1097,2164,4768
-160,-40,-110,1072,1092,2164,4580
-60,-60,50,1060,1104,2164,4837
150,10,-110,1060,1104,2164,4964
-160,80,170,1026,1138,2164,4599
-50,-50,-30,1031,1133,2164,4748
-150,-40,-110,1053,1111,2164,4862
0,-10,30,1058,1106,2164,4686
-120,-10,0,1026,1139,2165,4893
20,30,20,1069,1096,2165,4771
-110,-10,-90,1041,1124,2165,4640
140,10,-90,1050,1115,2165,4945
20,20,70,1058,1107,2165,4827
40,-80,140,1080,1085,2165,5093
-110,-30,-80,1061,1104,2165,4722
90,-80,-180,1076,1090,2166,5032
-140,-20,-10,1056,1110,2166,4920
-50,-30,70,1065,1101,2166,4560
170,20,-130,1083,1083,2166,4727
-70,-50,40,1072,1094,2166,4684
-70,20,30,1046,1120,2166,5011
-50,-10,0,1040,1126,2166,4689
140,-70,-170,1058,1108,2166,4875
-20,0,20,1052,1114,2166,4722
90,-80,180,1076,1090,2166,5032
180,-30,-80,1093,1074,2167,4844
-110,10,-30,1041,1126,2167,4899
20,70,-10,1062,1105,2167,4859
0,-20,30,1069,1098,2167,4835
170,-40,-100,1094,1073,2167,4960
-30,-70,-10,1054,1113,2167,4692
-120,10,-50,1044,1123,2167,4876
-150,-70,-110,1083,1084,2167,4961
-180,-30,-80,1093,1074,2167,4844
180,-40,-100,1095,1073,2168,4894
-110,-10,10,1026,1142,2168,4934
150,20,-60,1079,1089,2168,4907
-130,0,-130,1067,1101,2168,4735
-180,-40,-100,1095,1073,2168,4894
-130,30,-70,1042,1126,2168,4875
-120,0,-10,1043,1125,2168,5071
150,50,-130,1066,1103,2169,4876
-160,-50,-100,1092,1077,2169,4628
-70,40,90,1068,1101,2169,4558
130,-60,-140,1090,1079,2169,4855
-10,40,10,1060,1109,2169,4784
-50,20,20,1061,1108,2169,4931
70,-60,150,1055,1114,2169,5089
-100,-60,10,1070,1099,2169,4762
-100,20,-160,1049,1121,2170,4885
-120,-40,-10,1086,1084,2170,4668
-110,-10,-80,1070,1100,2170,4727
80,70,-60,1055,1115,2170,4854
-120,-30,-100,1056,1114,2170,4710
100,40,-40,1067,1103,2170,4983
-50,-70,60,1091,1080,2171,4969
-130,10,-140,1067,1104,2171,4707
150,-60,-120,1084,1087,2171,4926
120,-70,-150,1088,1083,2171,5061
-100,0,-100,1031,1140,2171,5009
150,-50,-140,1099,1072,2171,5171
130,-70,-180,1049,1123,2172,4880
140,60,-120,1063,1109,2172,4662
60,-80,90,1043,1129,2172,4674
130,-70,180,1049,1123,2172,4880
-120,10,-140,1065,1107,2172,4866
-40,70,160,1067,1105,2172,4809
0,-80,20,1067,1105,2172,5021
-110,30,-110,1052,1121,2173,4812
-180,-30,-90,1092,1081,2173,4839
180,-30,-90,1092,1081,2173,4839
-60,20,140,1054,1119,2173,4748
-120,10,-80,1052,1121,2173,4672
-120,30,-170,1059,1114,2173,4739
-30,10,20,1075,1098,2173,4754
-30,10,140,1055,1118,2173,5025
10,50,90,1052,1121,2173,4618
0,-40,100,1076,1097,2173,5023
-10,-30,20,1069,1104,2173,4674
-100,-40,-70,1058,1115,2173,4758
-160,40,-50,1073,1101,2174,4873
140,-70,-150,1079,1095,2174,5056
160,80,-40,1068,1106,2174,4833
-170,-40,-80,1073,1101,2174,4955
-150,60,-180,1043,1131,2174,4793
-150,60,180,1043,1131,2174,4793
100,-80,-170,1087,1087,2174,4976
150,-50,-130,1064,1111,2175,5072
150,-60,-140,1076,1099,2175,5132
-70,10,20,1056,1119,2175,5009
-70,0,30,1075,1100,2175,4829
30,-40,60,1061,1114,2175,4929
-140,10,-140,1069,1106,2175,4708
0,10,30,1072,1104,2176,4786
10,-80,30,1060,1116,2176,5033
140,-70,-160,1071,1105,2176,4780
-150,80,160,1041,1135,2176,4574
20,-20,50,1050,1126,2176,4774
40,-40,110,1072,1104,2176,4820
0,-50,100,1062,1114,2176,5046
170,80,-160,1023,1153,2176,4618
10,-50,30,1051,1125,2176,4828
0,-10,110,1064,1112,2176,4893
-150,-50,-40,1071,1105,2176,5007
120,-70,-170,1086,1090,2176,4960
110,-70,-170,1086,1090,2176,5172
-70,-10,0,1074,1102,2176,4779
30,80,-20,1054,1122,2176,4954
40,-50,120,1062,1115,2177,4783
-60,-20,-10,1044,1133,2177,4632
-50,60,170,1083,1094,2177,4794
120,-60,-150,1077,1100,2177,4916
130,-70,-170,1060,1117,2177,4821
140,-60,-150,1079,1098,2177,5119
-90,20,-160,1056,1121,2177,4953
160,-50,-130,1077,1100,2177,5252
160,0,-80,1059,1118,2177,4898
-120,0,-70,1045,1132,2177,4846
120,-70,-180,1050,1128,2178,4926
10,40,90,1072,1106,2178,4728
-20,10,20,1062,1116,2178,4651
120,-70,180,1050,1128,2178,4926
100,60,-70,1072,1106,2178,4750
40,40,20,1079,1099,2178,4875
10,30,10,1061,1117,2178,4972
-110,20,-110,1068,1111,2179,4869
-100,-70,-70,1065,1114,2179,4599
150,-70,-160,1078,1101,2179,4920
-40,-30,80,1066,1113,2179,4758
30,-20,80,1052,1127,2179,4868
-90,-50,20,1067,1112,2179,4808
-170,-40,-70,1099,1080,2179,5079
170,-20,-80,1086,1093,2179,4886
-100,-10,-20,1051,1128,2179,4857
-50,30,170,1059,1121,2180,5011
10,0,40,1068,1112,2180,4884
-180,-40,-110,1087,1093,2180,4912
180,-40,-110,1087,1093,2180,4912
-80,-30,-40,1048,1132,2180,4786
-40,-30,-10,1054,1126,2180,4725
160,-50,-110,1076,1104,2180,5001
140,10,-80,1072,1108,2180,4884
120,-70,-160,1083,1097,2180,5126
-60,-50,50,1077,1103,2180,4719
-130,-80,-100,1062,1119,2181,4697
30,50,60,1059,1122,2181,4961
140,20,-100,1065,1116,2181,4831
-10,50,10,1068,1113,2181,4768
170,40,-140,1074,1107,2181,4891
-10,0,120,1073,1108,2181,4864
-110,-20,0,1051,1131,2182,4963
-160,-60,-60,1068,1114,2182,4908
0,70,110,1085,1097,2182,4834
-150,-20,-20,1055,1127,2182,5133
-20,60,20,1063,1119,2182,4889
-50,20,30,1080,1102,2182,4799
80,-80,170,1080,1102,2182,5110
180,-50,-100,1090,1092,2182,4812
-130,-20,-110,1081,1101,2182,4860
-180,-50,-100,1090,1092,2182,4812
-150,30,-150,1065,1118,2183,4792
-80,-10,-10,1033,1150,2183,4749
-160,-60,-110,1097,1086,2183,4869
130,20,-80,1065,1118,2183,4911
-70,-30,-30,1055,1128,2183,4792
-10,-80,10,1076,1107,2183,4996
-170,-30,-120,1115,1068,2183,5005
50,-70,150,1086,1098,2184,5122
-110,-20,-80,1075,1109,2184,4826
70,-70,160,1105,1079,2184,5091
-140,80,150,1045,1139,2184,4631
-90,-40,-70,1045,1139,2184,5034
-40,-60,-20,1061,1123,2184,4820
-60,20,110,1047,1137,2184,4624
-30,40,150,1062,1122,2184,4948
-180,20,-130,1067,1118,2185,4689
100,-70,-180,1090,1095,2185,5147
-120,-80,-90,1068,1117,2185,4714
170,-10,-70,1071,1114,2185,5015
-90,0,20,1047,1138,2185,5020
-140,40,-170,1059,1126,2185,4726
-120,10,-30,1050,1135,2185,4871
180,20,-130,1067,1118,2185,4689
-170,-40,-60,1067,1118,2185,4855
-170,-80,-70,1091,1094,2185,4870
100,-70,180,1090,1095,2185,5147
-140,0,-130,1091,1094,2185,4859
-170,-40,-100,1106,1080,2186,4856
-90,-10,-20,1063,1123,2186,4837
-130,-30,-10,1076,1110,2186,4913
-50,-50,60,1077,1109,2186,4900
-30,-10,110,1060,1126,2186,4924
-100,-20,-60,1066,1120,2186,4736
50,50,30,1075,1111,2186,4841
-120,10,-70,1055,1131,2186,4757
130,-70,-160,1079,1107,2186,4969
-70,40,80,1068,1118,2186,4819
-140,-50,-30,1082,1104,2186,4981
-170,-20,-120,1082,1105,2187,4891
-150,40,-160,1037,1150,2187,4738
-180,-70,-140,1053,1134,2187,5053
-70,30,130,1071,1116,2187,4773
-40,10,120,1062,1125,2187,4866
-120,80,130,1071,1116,2187,4656
-100,-10,10,1054,1133,2187,4952
-120,-20,-10,1058,1129,2187,4877
180,-70,-140,1053,1134,2187,5053
-120,-10,-120,1057,1130,2187,4962
-120,-20,-110,1065,1123,2188,4788
140,-50,-140,1066,1122,2188,4997
-100,0,-120,1034,1154,2188,5071
-30,-70,80,1097,1091,2188,4918
-160,-10,-130,1082,1106,2188,4935
-150,-60,-100,1079,1109,2188,4945
-140,-70,-100,1083,1105,2188,4946
-150,70,-80,1059,1129,2188,4824
-50,-60,60,1068,1120,2188,4933
30,-40,110,1077,1111,2188,4896
-40,50,160,1040,1148,2188,4853
-60,30,180,1072,1116,2188,4966
-20,-50,90,1067,1121,2188,4918
-60,30,-180,1072,1116,2188,4966
-70,20,20,1042,1147,2189,4875
-170,-70,-130,1070,1119,2189,4998
-60,10,70,1060,1129,2189,4869
90,70,-70,1061,1128,2189,4895
-30,-10,10,1077,1112,2189,4787
-40,70,40,1065,1124,2189,5020
110,-80,-160,1096,1093,2189,5051
-160,-50,-60,1082,1107,2189,4856
60,50,20,1096,1094,2190,5002
130,-60,-150,1096,1094,2190,5078
-40,-50,70,1069,1121,2190,4912
-160,70,-70,1063,1127,2190,4806
-80,-40,-60,1061,1129,2190,4996
-160,60,-170,1049,1141,2190,4821
20,-60,40,1071,1119,2190,4912
-140,-30,-20,1054,1136,2190,4881
20,10,70,1067,1123,2190,4859
-60,-50,-40,1040,1150,2190,4919
130,40,-100,1093,1097,2190,4835
-130,-30,-100,1077,1113,2190,4886
20,-70,40,1063,1128,2191,4834
40,-60,70,1069,1122,2191,4983
20,40,0,1064,1127,2191,4811
-130,80,140,1060,1131,2191,4649
50,-80,80,1047,1144,2191,4689
-60,0,80,1088,1103,2191,4652
-120,-50,-10,1061,1130,2191,4908
-110,-60,-80,1069,1122,2191,4821
-110,-10,-20,1059,1133,2192,4856
10,70,0,1079,1113,2192,4822
40,-60,130,1076,1116,2192,5038
-70,-20,50,1056,1136,2192,4686
30,-80,130,1092,1100,2192,5179
20,10,60,1047,1145,2192,4906
150,-70,-150,1083,1109,2192,4873
50,-60,140,1081,1111,2192,5078
-30,-60,80,1085,1107,2192,4925
30,-20,70,1060,1133,2193,4830
140,20,-60,1091,1102,2193,4913
-90,40,130,1064,1129,2193,4794
90,60,10,1087,1106,2193,4943
-100,10,-140,1051,1142,2193,4868
-70,50,70,1045,1148,2193,4726
120,-80,-150,1103,1090,2193,5105
-90,30,170,1061,1133,2194,4801
-130,50,-90,1063,1131,2194,4749
-70,30,110,1059,1135,2194,4676
170,-50,-120,1085,1109,2194,5160
-10,-20,110,1078,1116,2194,4918
-140,30,-50,1061,1133,2194,5034
20,80,-10,1068,1126,2194,5069
-120,-20,-80,1081,1113,2194,4734
-110,-20,-60,1056,1138,2194,4776
140,-90,-120,1103,1092,2195,5044
-160,-90,-60,1103,1092,2195,5044
-170,-90,-70,1103,1092,2195,5044
-90,-90,10,1103,1092,2195,5044
-40,-90,60,1103,1092,2195,5044
-100,-90,0,1103,1092,2195,5044
-10,-90,90,1103,1092,2195,5044
40,-90,140,1103,1092,2195,5044
-180,-90,-80,1103,1092,2195,5044
-110,-90,-10,1103,1092,2195,5044
70,-90,170,1103,1092,2195,5044
30,-90,130,1103,1092,2195,5044
130,-90,-130,1103,1092,2195,5044
-30,-90,70,1103,1092,2195,5044
80,-90,-180,1103,1092,2195,5044
100,-90,-160,1103,1092,2195,5044
10,-90,110,1103,1092,2195,5044
0,-60,100,1069,1126,2195,5099
0,-90,100,1103,1092,2195,5044
-70,-90,30,1103,1092,2195,5044
180,-90,-80,1103,1092,2195,5044
90,-90,-170,1103,1092,2195,5044
60,-90,160,1103,1092,2195,5044
-100,50,130,1067,1128,2195,4833
-110,-20,-70,1075,1120,2195,4906
-80,40,-150,1068,1127,2195,5004
110,-90,-150,1103,1092,2195,5044
110,-70,170,1058,1137,2195,4964
-80,-90,20,1103,1092,2195,5044
80,-90,180,1103,1092,2195,5044
-120,-20,-70,1090,1105,2195,4742
20,-90,120,1103,1092,2195,5044
-60,-90,40,1103,1092,2195,5044
-120,-90,-20,1103,1092,2195,5044
-150,-90,-50,1103,1092,2195,5044
160,-90,-100,1103,1092,2195,5044
-50,-90,50,1103,1092,2195,5044
150,-90,-110,1103,1092,2195,5044
70,-60,130,1061,1134,2195,4929
120,-90,-140,1103,1092,2195,5044
170,-90,-90,1103,1092,2195,5044
-40,20,30,1085,1110,2195,4777
-130,-90,-30,1103,1092,2195,5044
-20,-90,80,1103,1092,2195,5044
-140,-90,-40,1103,1092,2195,5044
50,-90,150,1103,1092,2195,5044
120,-70,170,1066,1130,2196,4914
-110,-10,0,1054,1142,2196,4943
20,60,80,1081,1115,2196,4876
-140,60,170,1051,1145,2196,4825
-140,-60,-30,1083,1113,2196,4954
180,-60,-120,1097,1100,2197,4810
10,-10,40,1093,1104,2197,4976
50,-50,100,1074,1123,2197,5066
120,-60,-160,1103,1094,2197,5169
20,40,60,1075,1122,2197,4918
-180,-60,-120,1097,1100,2197,4810
-150,40,-170,1071,1126,2197,4786
20,0,90,1061,1136,2197,5007
-30,20,20,1103,1095,2198,4828
110,60,-80,1091,1107,2198,4762
-170,30,-140,1075,1123,2198,4735
-130,-50,-20,1070,1128,2198,4983
130,-70,-140,1089,1109,2198,5117
-120,0,-20,1076,1122,2198,4939
50,-70,80,1069,1129,2198,4754
-60,80,180,1078,1120,2198,4715
-60,80,-180,1078,1120,2198,4715
-130,-40,-20,1071,1128,2199,4802
-50,20,150,1062,1137,2199,4907
-110,0,-130,1064,1135,2199,4854
-110,-50,-70,1067,1133,2200,4655
-170,-50,-100,1122,1078,2200,4973
170,10,-120,1084,1116,2200,4738
-40,10,20,1080,1120,2200,4785
-80,70,90,1052,1148,2200,4674
-90,-40,-60,1054,1146,2200,4893
-50,20,140,1078,1122,2200,4962
-80,-40,30,1077,1123,2200,4881
-130,50,170,1038,1162,2200,4701
-160,-90,-130,1083,1118,2201,4912
-110,-30,-60,1089,1112,2201,4722
-130,-40,-90,1065,1136,2201,5117
140,-90,170,1083,1118,2201,4912
-170,-90,-140,1083,1118,2201,4912
110,-90,140,1083,1118,2201,4912
-100,-90,-70,1083,1118,2201,4912
120,50,-20,1090,1111,2201,4907
170,-90,-160,1083,1118,2201,4912
100,-90,130,1083,1118,2201,4912
120,-90,150,1083,1118,2201,4912
-120,-90,-90,1083,1118,2201,4912
-90,-90,-60,1083,1118,2201,4912
50,-90,80,1083,1118,2201,4912
-20,-90,10,1083,1118,2201,4912
180,-90,-150,1083,1118,2201,4912
-70,-20,-10,1066,1135,2201,4715
150,-90,-180,1083,1118,2201,4912
150,-90,180,1083,1118,2201,4912
0,-90,30,1083,1118,2201,4912
-80,-90,-50,1083,1118,2201,4912
40,-90,70,1083,1118,2201,4912
-60,20,20,1067,1134,2201,5009
-140,-90,-110,1083,1118,2201,4912
-180,-90,-150,1083,1118,2201,4912
30,-90,60,1083,1118,2201,4912
-10,-90,20,1083,1118,2201,4912
130,-90,160,1083,1118,2201,4912
-40,20,20,1081,1120,2201,4741
-150,-90,-120,1083,1118,2201,4912
-30,-90,0,1083,1118,2201,4912
-40,-90,-10,1083,1118,2201,4912
10,-90,40,1083,1118,2201,4912
-70,-90,-40,1083,1118,2201,4912
60,-90,90,1083,1118,2201,4912
160,-90,-170,1083,1118,2201,4912
-130,-90,-100,1083,1118,2201,4912
-60,-90,-30,1083,1118,2201,4912
20,-90,50,1083,1118,2201,4912
-110,-90,-80,1083,1118,2201,4912
-50,-90,-20,1083,1118,2201,4912
80,-90,110,1083,1118,2201,4912
70,-90,100,1083,1118,2201,4912
90,-90,120,1083,1118,2201,4912
-160,-70,-60,1101,1101,2202,4971
-160,20,-40,1070,1132,2202,4960
-110,80,120,1070,1132,2202,4717
110,40,-30,1085,1117,2202,4908
170,80,-50,1093,1109,2202,4899
-60,20,70,1083,1119,2202,4795
120,40,-90,1089,1113,2202,4969
40,-40,90,1071,1131,2202,5028
-120,30,-100,1063,1140,2203,4647
10,30,90,1096,1107,2203,4880
30,-60,120,1071,1132,2203,5136
-90,-50,-70,1071,1132,2203,4882
-80,-10,30,1095,1108,2203,4900
160,-60,-130,1082,1121,2203,5208
-70,30,120,1054,1149,2203,4811
20,10,80,1088,1116,2204,5109
-60,30,50,1067,1137,2204,5110
-100,10,-110,1043,1161,2204,4980
180,-50,-90,1104,1101,2205,4871
-160,-80,-60,1106,1099,2205,4932
-180,-50,-90,1104,1101,2205,4871
180,-50,-110,1112,1093,2205,4982
-180,-50,-110,1112,1093,2205,4982
80,-70,120,1083,1122,2205,5150
-100,80,110,1064,1141,2205,4719
-40,-20,0,1080,1125,2205,4708
-120,60,150,1041,1164,2205,4738
10,50,0,1069,1136,2205,4975
-110,-30,-70,1093,1112,2205,4854
150,-70,-120,1110,1096,2206,5080
-70,30,140,1081,1125,2206,5097
-130,40,180,1089,1117,2206,4923
-130,40,-180,1089,1117,2206,4923
-110,-80,-80,1084,1122,2206,4700
-30,-10,100,1071,1135,2206,4909
-60,50,50,1058,1148,2206,5049
-100,20,-120,1061,1145,2206,4936
-100,-10,0,1061,1145,2206,4823
-100,-40,-60,1094,1113,2207,4941
50,-60,90,1073,1134,2207,5078
160,-70,-150,1086,1121,2207,4926
-50,70,50,1060,1147,2207,5025
170,-40,-110,1101,1106,2207,4944
30,-50,60,1078,1130,2208,4951
-120,-10,-90,1098,1110,2208,4941
-160,70,-180,1068,1140,2208,4774
110,-70,160,1083,1125,2208,4991
-30,50,20,1081,1127,2208,4960
-30,-60,-10,1078,1130,2208,4919
-160,70,180,1068,1140,2208,4774
70,-80,160,1086,1123,2209,5187
-100,-10,-10,1075,1134,2209,5127
180,-20,-90,1086,1123,2209,4923
-180,-30,-70,1102,1107,2209,4979
-180,-20,-90,1086,1123,2209,4923
-40,-70,70,1117,1092,2209,4993
110,-80,-170,1101,1108,2209,5136
-180,50,-50,1102,1107,2209,5007
140,40,-40,1080,1129,2209,4904
100,-80,180,1098,1111,2209,5130
-20,30,20,1090,1119,2209,4871
100,-80,-180,1098,1111,2209,5130
170,-70,-140,1087,1122,2209,5003
-40,40,20,1068,1141,2209,4924
-20,-10,20,1093,1116,2209,4931
180,-30,-70,1102,1107,2209,4979
180,50,-50,1102,1107,2209,5007
40,-70,140,1099,1111,2210,5181
-60,-40,50,1083,1127,2210,4669
90,60,-60,1074,1136,2210,5049
-90,-10,-10,1084,1126,2210,4839
-90,60,110,1064,1146,2210,4759
-110,-50,-80,1075,1135,2210,4901
-130,-80,-30,1095,1115,2210,5059
-160,50,-160,1069,1142,2211,4817
-180,-10,-50,1074,1137,2211,5061
-110,-10,-10,1069,1142,2211,4911
140,-60,-140,1104,1107,2211,5120
-150,20,-40,1094,1117,2211,5056
-150,-50,-100,1078,1133,2211,4880
110,40,-70,1096,1115,2211,4872
-20,-50,0,1088,1123,2211,4865
180,-10,-50,1074,1137,2211,5061
-60,10,90,1065,1146,2211,4902
-140,-40,-100,1070,1141,2211,5062
-60,0,60,1094,1117,2211,4891
-60,0,70,1099,1112,2211,4791
180,30,-130,1102,1110,2212,4849
-130,10,-30,1072,1140,2212,4916
-50,10,20,1068,1144,2212,4885
150,-70,-140,1091,1121,2212,5041
-100,40,150,1072,1140,2212,4931
-180,30,-130,1102,1110,2212,4849
170,60,-150,1055,1157,2212,4899
70,70,-50,1077,1135,2212,4986
150,10,-100,1091,1121,2212,4927
-140,-80,-40,1104,1109,2213,5042
-80,30,-150,1071,1142,2213,4978
-20,-30,10,1096,1117,2213,4897
-40,-10,10,1086,1127,2213,4734
-150,-80,-50,1110,1103,2213,5016
-80,-20,-20,1065,1148,2213,4804
-110,-40,0,1084,1129,2213,4850
-130,60,160,1051,1163,2214,4850
30,40,0,1084,1130,2214,4938
10,-20,100,1092,1122,2214,4996
-60,-40,-30,1073,1141,2214,4865
180,-30,-110,1084,1130,2214,4879
-100,70,120,1076,1138,2214,4713
-90,-80,-60,1082,1132,2214,4766
140,-70,-130,1106,1108,2214,5110
-180,-30,-110,1084,1130,2214,4879
110,-70,180,1110,1104,2214,5069
40,-80,70,1068,1146,2214,4743
110,-70,-180,1110,1104,2214,5069
180,-60,-90,1113,1102,2215,4893
-40,-60,70,1101,1114,2215,4892
-110,-20,-90,1063,1152,2215,4801
-70,-50,-50,1071,1144,2215,5066
-60,40,40,1069,1146,2215,4968
-100,-30,-70,1074,1141,2215,5027
-180,-60,-90,1113,1102,2215,4893
180,-70,-130,1093,1123,2216,5065
160,20,-120,1102,1114,2216,5134
-180,-70,-130,1093,1123,2216,5065
40,-40,100,1095,1121,2216,4979
-80,0,20,1065,1151,2216,5107
-180,-10,-120,1099,1117,2216,4932
180,-10,-120,1099,1117,2216,4932
90,50,0,1103,1113,2216,5110
170,-50,-100,1093,1123,2216,5123
-170,-40,-110,1112,1105,2217,4764
-100,-30,-60,1096,1121,2217,4884
-110,-60,0,1094,1123,2217,4831
-60,40,50,1062,1155,2217,5134
-80,-50,-60,1075,1142,2217,5108
-100,-10,-30,1086,1131,2217,4997
-120,20,-100,1065,1153,2218,4702
170,-60,-100,1094,1124,2218,4933
-10,60,120,1082,1136,2218,4994
120,50,-90,1092,1126,2218,4990
-120,0,-80,1083,1136,2219,4849
100,70,-80,1064,1155,2219,4999
10,20,40,1082,1137,2219,4767
-110,-20,-100,1075,1144,2219,4891
-140,20,-40,1077,1142,2219,4999
10,-70,30,1081,1139,2220,4938
-160,-50,-80,1128,1092,2220,4903
100,-70,150,1080,1140,2220,5039
-130,-70,-90,1104,1116,2220,4875
10,80,0,1090,1130,2220,5097
60,-60,140,1091,1129,2220,5168
130,20,-70,1087,1133,2220,5013
150,-60,-130,1112,1108,2220,5203
20,0,60,1065,1156,2221,4837
110,70,-90,1072,1149,2221,5041
160,-70,-140,1097,1124,2221,4892
70,50,10,1103,1118,2221,5137
-30,60,30,1071,1150,2221,4909
-120,-60,-20,1093,1128,2221,4914
-120,10,-90,1059,1163,2222,4855
-180,-20,-60,1087,1135,2222,5084
20,-30,50,1092,1130,2222,4882
180,-20,-60,1087,1135,2222,5084
-30,0,120,1064,1158,2222,5131
-60,-60,40,1103,1120,2223,4954
20,-70,120,1095,1128,2223,5176
-140,-30,-30,1080,1143,2223,4874
-60,20,30,1090,1133,2223,4997
40,40,10,1092,1131,2223,5109
-50,70,170,1096,1128,2224,4962
-30,-50,80,1090,1134,2224,4886
140,40,-110,1108,1116,2224,4726
-30,30,20,1094,1130,2224,5011
130,-70,-150,1110,1114,2224,5201
90,50,-40,1116,1108,2224,4982
-120,-20,-90,1103,1121,2224,4921
-150,-30,-30,1102,1122,2224,5005
-140,-70,-40,1112,1112,2224,5088
-100,0,-110,1061,1163,2224,5022
40,60,-20,1064,1160,2224,4964
-100,50,-130,1090,1134,2224,4728
-120,-80,-20,1092,1133,2225,5107
160,70,-40,1105,1120,2225,5040
-110,0,-100,1062,1163,2225,4962
-160,-10,-30,1090,1135,2225,5121
-90,-30,-50,1059,1166,2225,4908
-120,40,170,1080,1145,2225,4998
140,60,-30,1105,1120,2225,4900
-80,30,160,1102,1124,2226,4941
-100,-40,-50,1096,1130,2226,4836
140,-80,180,1088,1138,2226,4951
160,-80,-160,1087,1139,2226,4983
-130,-60,-20,1089,1137,2226,5009
130,-80,-140,1111,1115,2226,5100
140,-80,-180,1088,1138,2226,4951
-70,-40,40,1090,1137,2227,4769
-60,10,40,1083,1144,2227,4954
160,-60,-110,1099,1128,2227,4973
160,-60,-120,1103,1124,2227,5125
-70,80,-170,1092,1135,2227,4804
0,70,10,1097,1130,2227,4966
-120,-60,-10,1109,1118,2227,4980
-100,-80,-70,1096,1132,2228,4733
-120,-30,-70,1103,1125,2228,4843
-30,-40,80,1090,1138,2228,4811
140,-70,-140,1122,1106,2228,5272
-130,-20,-10,1050,1178,2228,5141
-160,0,-130,1081,1147,2228,4825
-130,20,-150,1093,1135,2228,4875
-60,0,20,1090,1138,2228,4888
-90,-20,20,1084,1144,2228,4822
100,-70,160,1086,1142,2228,5036
-70,70,80,1069,1159,2228,4714
90,-70,170,1116,1113,2229,5244
100,60,0,1099,1130,2229,5060
-130,20,-60,1063,1166,2229,5028
-70,0,20,1080,1149,2229,4902
80,60,-50,1079,1151,2230,5083
-150,-70,-100,1093,1137,2230,4942
-120,0,-30,1076,1154,2230,4891
-110,-60,-10,1105,1125,2230,4952
-40,-40,70,1116,1114,2230,4940
-110,40,160,1081,1149,2230,4907
-50,20,130,1094,1137,2231,4930
-110,60,-120,1107,1124,2231,4933
-10,40,120,1089,1142,2231,4996
-50,0,90,1085,1147,2232,4798
-160,-80,-120,1086,1146,2232,5042
160,-50,-120,1080,1152,2232,5086
150,10,-80,1106,1126,2232,5107
150,-80,-170,1086,1146,2232,5007
30,-70,130,1118,1114,2232,5210
-50,50,40,1075,1157,2232,5019
-90,-80,-50,1090,1142,2232,4889
130,-80,170,1080,1153,2233,4978
-40,0,20,1117,1116,2233,4814
-140,-60,-40,1114,1119,2233,5000
-50,0,20,1089,1144,2233,4909
-130,-60,-30,1113,1121,2234,4891
-100,-20,0,1093,1141,2234,5050
120,-80,-160,1102,1132,2234,5138
-170,-60,-110,1116,1118,2234,4966
-130,30,-160,1112,1122,2234,4998
180,-20,-100,1127,1107,2234,4945
-180,-20,-100,1127,1107,2234,4945
70,60,-40,1077,1158,2235,4987
60,60,-30,1087,1148,2235,4955
160,-70,-110,1110,1125,2235,5021
-90,-20,-30,1073,1162,2235,4845
-120,-10,-70,1074,1161,2235,4813
-80,-10,0,1085,1150,2235,4976
-60,30,30,1080,1155,2235,5085
-130,-20,-20,1065,1170,2235,5028
-170,-70,-120,1103,1132,2235,5077
-70,30,100,1081,1155,2236,4755
0,80,10,1103,1133,2236,5192
-100,-40,10,1110,1126,2236,4816
-90,-10,10,1090,1146,2236,5082
40,50,40,1111,1125,2236,4955
150,40,-120,1098,1139,2237,4906
-10,50,120,1128,1109,2237,5089
-150,-70,-50,1119,1118,2237,5131
-170,-10,-120,1113,1124,2237,4852
-10,30,20,1116,1121,2237,5067
-110,-40,-70,1098,1139,2237,4924
30,40,30,1090,1147,2237,4911
-110,60,140,1082,1156,2238,4915
90,-80,170,1109,1129,2238,5166
-140,-70,-90,1097,1141,2238,4844
-110,0,-30,1068,1170,2238,4892
30,-80,60,1080,1158,2238,4766
-70,-40,-40,1071,1167,2238,4980
-120,-30,-90,1101,1138,2239,4938
20,-80,120,1112,1127,2239,5209
-110,-10,-30,1078,1161,2239,4984
160,-70,-130,1106,1133,2239,5036
-90,80,100,1068,1171,2239,4755
-170,-60,-80,1110,1129,2239,4955
170,-10,-80,1097,1143,2240,5160
-70,50,80,1087,1153,2240,5045
-60,60,60,1075,1165,2240,4894
160,-80,-110,1118,1122,2240,5067
-60,-30,-20,1082,1158,2240,4819
-160,-40,-50,1096,1144,2240,5020
-60,10,50,1072,1168,2240,4952
-130,-10,-120,1108,1133,2241,4933
-60,-10,60,1106,1135,2241,4754
-10,10,120,1099,1142,2241,4998
-50,10,30,1101,1140,2241,4974
-60,30,110,1082,1159,2241,4913
70,-70,110,1103,1138,2241,5108
-120,-70,-80,1095,1146,2241,5055
60,-60,130,1093,1148,2241,5131
-90,-30,-40,1089,1152,2241,4860
120,70,-100,1091,1150,2241,5088
-160,40,-150,1089,1153,2242,4955
20,-30,100,1108,1134,2242,5010
-170,0,-40,1098,1144,2242,5137
-130,-20,-90,1109,1133,2242,4889
-150,0,-130,1102,1140,2242,4970
180,50,-150,1092,1150,2242,5016
60,-80,150,1110,1132,2242,5260
180,10,-120,1098,1144,2242,4889
-180,50,-150,1092,1150,2242,5016
-180,10,-120,1098,1144,2242,4889
-20,-70,0,1081,1161,2242,4971
40,90,-30,1079,1164,2243,4977
120,90,-110,1079,1164,2243,4977
90,90,-80,1079,1164,2243,4977
-160,90,170,1079,1164,2243,4977
-140,90,150,1079,1164,2243,4977
180,90,-170,1079,1164,2243,4977
150,90,-140,1079,1164,2243,4977
10,90,0,1079,1164,2243,4977
0,90,10,1079,1164,2243,4977
-30,90,40,1079,1164,2243,4977
-120,90,130,1079,1164,2243,4977
-20,90,30,1079,1164,2243,4977
50,90,-40,1079,1164,2243,4977
110,90,-100,1079,1164,2243,4977
20,90,-10,1079,1164,2243,4977
-180,90,-170,1079,1164,2243,4977
-130,90,140,1079,1164,2243,4977
-100,90,110,1079,1164,2243,4977
-60,10,80,1101,1142,2243,4898
-110,90,120,1079,1164,2243,4977
30,90,-20,1079,1164,2243,4977
-80,90,90,1079,1164,2243,4977
-170,90,-180,1079,1164,2243,4977
130,90,-120,1079,1164,2243,4977
-170,90,180,1079,1164,2243,4977
80,90,-70,1079,1164,2243,4977
60,90,-50,1079,1164,2243,4977
140,90,-130,1079,1164,2243,4977
50,-50,110,1096,1147,2243,5129
170,90,-160,1079,1164,2243,4977
-40,0,100,1086,1157,2243,4894
160,90,-150,1079,1164,2243,4977
-90,90,100,1079,1164,2243,4977
-110,-60,-70,1102,1141,2243,4915
-150,90,160,1079,1164,2243,4977
-60,90,70,1079,1164,2243,4977
-40,90,50,1079,1164,2243,4977
100,90,-90,1079,1164,2243,4977
-70,90,80,1079,1164,2243,4977
-10,90,20,1079,1164,2243,4977
-50,90,60,1079,1164,2243,4977
-80,-40,-50,1070,1173,2243,4966
-50,-10,80,1079,1164,2243,4919
70,90,-60,1079,1164,2243,4977
-170,-30,-90,1108,1136,2244,4877
-20,-40,90,1065,1179,2244,4883
-60,20,50,1079,1165,2244,5067
-170,-70,-80,1111,1133,2244,4965
-60,40,60,1090,1154,2244,4961
-160,-30,-40,1115,1129,2244,5112
170,-70,-130,1095,1149,2244,4975
-130,-20,-80,1115,1129,2244,4975
10,-20,40,1101,1144,2245,4835
70,80,40,1101,1144,2245,4990
170,-80,-150,1090,1155,2245,4979
-50,30,20,1073,1172,2245,5135
-100,-30,-50,1095,1150,2245,4744
-10,10,30,1102,1143,2245,5005
-10,20,120,1091,1155,2246,5002
30,50,-10,1103,1143,2246,5181
-150,-50,-90,1108,1138,2246,5003
70,-60,140,1080,1166,2246,5119
-10,-30,100,1119,1127,2246,5060
-130,20,-50,1073,1173,2246,5045
-170,60,-160,1079,1167,2246,4979
-80,40,120,1088,1158,2246,4879
-80,-60,20,1110,1136,2246,5017
-160,-50,-70,1107,1140,2247,5055
-140,-40,-30,1098,1149,2247,5050
-110,-20,-10,1098,1149,2247,5073
-130,30,-80,1074,1173,2247,4920
-80,60,90,1080,1167,2247,4789
-40,10,30,1103,1144,2247,4884
-50,-40,-20,1071,1176,2247,4823
-170,-80,-130,1096,1151,2247,5045
-120,-20,-20,1092,1155,2247,5108
-120,-70,-20,1126,1121,2247,5033
170,-60,-120,1098,1150,2248,5331
-100,-60,-70,1091,1157,2248,5019
180,-20,-110,1115,1133,2248,4940
180,-80,-140,1094,1154,2248,4980
-180,-20,-110,1115,1133,2248,4940
-40,10,130,1076,1172,2248,5128
-130,0,-20,1086,1162,2248,5110
-180,-80,-140,1094,1154,2248,4980
-110,20,-150,1091,1157,2248,5009
0,-50,20,1097,1152,2249,4967
60,-60,110,1110,1139,2249,5217
-90,-40,20,1103,1146,2249,4960
-170,10,-130,1123,1126,2249,5091
-170,70,-170,1095,1154,2249,4924
-130,-60,-80,1086,1164,2250,5044
-160,-70,-110,1119,1131,2250,5056
-10,30,120,1110,1140,2250,5015
150,20,-110,1115,1135,2250,5039
10,60,0,1090,1160,2250,5059
170,30,-50,1100,1150,2250,4957
-60,30,170,1087,1163,2250,5106
110,40,-40,1119,1131,2250,5107
170,-50,-110,1132,1118,2250,5065
-90,30,-140,1083,1167,2250,5055
-60,70,70,1084,1166,2250,4822
-130,-70,-30,1129,1122,2251,5045
-60,-10,10,1089,1162,2251,4916
90,-70,140,1096,1155,2251,5092
-180,40,-140,1109,1142,2251,5008
180,40,-140,1109,1142,2251,5008
140,-80,-130,1111,1140,2251,5146
80,80,30,1104,1148,2252,5005
-80,80,90,1071,1181,2252,4826
-10,0,30,1102,1150,2252,4972
-110,30,-170,1091,1161,2252,5063
-90,40,-140,1098,1154,2252,5060
-20,10,130,1096,1156,2252,5040
-120,-30,-20,1108,1144,2252,5096
170,-10,-90,1114,1139,2253,5200
80,50,-30,1132,1121,2253,5078
-170,-30,-110,1113,1140,2253,5001
-130,-10,-10,1088,1165,2253,5107
-80,-80,-50,1108,1145,2253,4860
-60,-20,60,1113,1140,2253,4950
-80,40,110,1097,1156,2253,5085
-150,-80,-110,1092,1161,2253,5099
-20,-10,110,1099,1155,2254,5140
-130,-10,-100,1101,1153,2254,4989
-30,10,30,1104,1150,2254,4935
-20,-60,0,1101,1153,2254,5063
120,-80,160,1092,1162,2254,5073
-120,-30,-80,1110,1144,2254,4766
-180,0,-120,1137,1118,2255,5077
-40,20,150,1060,1195,2255,5150
100,-70,170,1115,1140,2255,5146
-50,20,40,1091,1164,2255,5095
60,-70,150,1141,1114,2255,5217
-40,30,20,1099,1156,2255,5163
60,80,50,1110,1145,2255,5054
-40,40,160,1083,1172,2255,5098
-120,-10,-80,1116,1139,2255,5023
180,0,-120,1137,1118,2255,5077
10,-70,110,1111,1144,2255,5239
0,-70,20,1095,1161,2256,5103
150,-70,-130,1126,1130,2256,5332
-30,-30,0,1095,1161,2256,5104
20,-10,60,1090,1166,2256,4937
-110,-80,-10,1112,1145,2257,5107
-80,30,170,1102,1155,2257,5101
-100,-50,-70,1090,1167,2257,5170
20,-60,110,1109,1148,2257,5206
-140,50,-80,1083,1174,2257,5015
-140,-80,-100,1088,1169,2257,5148
-90,-40,-50,1094,1164,2258,5036
-40,-40,-10,1082,1176,2258,4909
-70,0,40,1099,1159,2258,5034
90,-70,150,1093,1165,2258,5154
20,-80,50,1097,1161,2258,4887
50,-60,130,1093,1166,2259,5230
-160,-70,-70,1113,1146,2259,5006
-150,-60,-50,1115,1144,2259,5072
-120,0,-100,1096,1163,2259,5070
-90,20,-140,1078,1182,2260,5209
-100,-70,-60,1119,1141,2260,4950
80,-80,160,1123,1137,2260,5102
-50,-40,60,1114,1146,2260,4907
180,-60,-110,1119,1141,2260,5173
-100,-80,-60,1101,1159,2260,4963
-90,-10,0,1094,1166,2260,5162
-180,-60,-110,1119,1141,2260,5173
90,80,20,1118,1143,2261,5041
-150,-20,-120,1100,1161,2261,5101
-100,-60,-60,1109,1152,2261,4919
-90,30,-180,1083,1178,2261,4922
-90,30,180,1083,1178,2261,4922
-110,-10,-100,1069,1192,2261,5023
170,30,-130,1115,1147,2262,5001
-30,-30,80,1103,1159,2262,4855
-50,30,40,1091,1171,2262,5166
-60,10,60,1095,1167,2262,5045
-120,50,160,1073,1189,2262,4842
-150,-60,-60,1112,1150,2262,5126
-100,-60,0,1112,1150,2262,5057
-110,-40,-60,1128,1135,2263,4884
-100,10,-120,1090,1173,2263,5060
-60,50,60,1104,1159,2263,5071
-10,10,40,1113,1150,2263,5090
-160,10,-40,1085,1178,2263,5140
-100,-80,0,1109,1154,2263,5118
0,10,40,1112,1151,2263,4916
-160,-60,-80,1141,1122,2263,5009
-120,-40,-80,1093,1171,2264,5018
0,-30,30,1097,1167,2264,4932
150,-80,-120,1121,1143,2264,5128
-120,20,-150,1115,1149,2264,5015
-160,-40,-60,1130,1134,2264,5081
110,60,-10,1128,1136,2264,4998
-90,-40,-40,1119,1145,2264,4886
-80,-80,-40,1118,1146,2264,4877
-90,-60,10,1128,1137,2265,4981
-50,40,30,1090,1175,2265,5178
-110,-70,-70,1125,1140,2265,5019
-10,-70,10,1089,1176,2265,5095
-130,-20,-100,1115,1150,2265,5138
-120,0,-60,1104,1161,2265,5081
-10,-50,10,1112,1154,2266,5001
-10,70,20,1120,1146,2266,5138
-150,50,-170,1087,1179,2266,4972
-170,-60,-90,1138,1129,2267,5003
-60,-30,50,1124,1143,2267,4927
40,-50,80,1117,1150,2267,5127
150,60,-130,1095,1172,2267,5166
130,70,-20,1146,1121,2267,5103
-110,-70,-10,1114,1153,2267,5164
-100,40,-130,1108,1159,2267,5235
-70,30,-180,1097,1171,2268,5154
-170,-10,-40,1100,1168,2268,5228
-50,50,170,1100,1168,2268,5031
140,-80,-140,1119,1149,2268,5234
180,80,-60,1118,1150,2268,5001
-70,-80,-40,1117,1151,2268,4966
-160,-20,-120,1120,1148,2268,5031
-70,30,180,1097,1171,2268,5154
-180,80,-60,1118,1150,2268,5001
-120,-10,-30,1103,1165,2268,5031
-130,20,-70,1075,1193,2268,5051
-90,-70,0,1116,1152,2268,5020
-160,-30,-110,1123,1145,2268,5044
-90,20,-150,1086,1183,2269,5224
-80,80,-160,1117,1152,2269,4865
-170,-30,-100,1122,1147,2269,4992
30,-30,90,1114,1155,2269,5161
10,-60,30,1104,1165,2269,5198
-70,80,80,1091,1178,2269,4931
130,-80,-150,1117,1153,2270,5205
-30,20,30,1115,1156,2271,5045
-70,-60,30,1118,1153,2271,5060
-30,10,130,1102,1169,2271,5117
10,30,20,1121,1150,2271,5034
-90,-70,-60,1110,1161,2271,4893
-140,-60,-90,1119,1153,2272,5019
-170,-30,-80,1130,1142,2272,5124
160,20,-60,1131,1141,2272,5105
-70,30,150,1110,1162,2272,5082
-170,-60,-100,1127,1145,2272,5043
170,0,-60,1125,1147,2272,5289
90,-70,160,1105,1167,2272,5223
-120,-10,-10,1094,1179,2273,5055
-40,60,40,1104,1169,2273,5151
60,70,-40,1100,1173,2273,5083
-90,-80,10,1116,1157,2273,5128
10,60,90,1117,1156,2273,4958
-90,-50,-60,1095,1179,2274,5126
-120,-80,-80,1097,1177,2274,5042
-80,-40,-40,1101,1173,2274,5059
10,20,50,1116,1158,2274,5043
-120,10,-40,1102,1172,2274,5133
10,20,90,1118,1157,2275,5079
-150,-40,-100,1109,1166,2275,5029
-130,-20,-30,1101,1174,2275,5099
-70,-70,30,1135,1140,2275,5190
-40,-10,90,1094,1181,2275,4831
170,-80,-100,1146,1130,2276,5113
-60,60,-180,1121,1155,2276,4983
-60,60,180,1121,1155,2276,4983
-110,-80,-70,1102,1174,2276,5010
50,80,60,1115,1161,2276,5077
-160,-50,-90,1141,1136,2277,5061
-90,40,140,1091,1186,2277,5000
-130,-80,-90,1101,1176,2277,5093
100,50,-50,1128,1150,2278,5224
70,-80,150,1128,1150,2278,5155
-150,-40,-40,1111,1167,2278,5117
120,30,-70,1106,1172,2278,5173
-100,30,-170,1104,1174,2278,5080
-170,-20,-110,1138,1141,2279,4997
-100,-70,-10,1122,1157,2279,5054
170,-70,-120,1126,1153,2279,5182
-10,80,20,1120,1159,2279,5278
-130,-10,-80,1129,1151,2280,5005
160,60,-140,1114,1166,2280,5193
-130,0,-80,1100,1180,2280,4917
160,10,-110,1124,1156,2280,5079
-140,40,-70,1103,1177,2280,5243
-50,10,100,1109,1171,2280,4933
-40,-20,80,1113,1167,2280,4813
80,-70,160,1134,1146,2280,5384
-20,-20,100,1122,1159,2281,5306
-100,20,-150,1109,1172,2281,5135
-100,-70,0,1121,1160,2281,5217
-50,-60,50,1129,1152,2281,5157
10,-80,110,1143,1139,2282,5277
-60,20,80,1132,1150,2282,5092
-30,-20,90,1110,1172,2282,4910
160,10,-100,1126,1156,2282,5077
-160,30,-140,1100,1182,2282,4915
-80,-70,20,1129,1153,2282,5178
-30,40,20,1115,1167,2282,5150
-120,-60,-70,1107,1175,2282,5273
40,50,-10,1128,1154,2282,5190
-100,40,160,1087,1195,2282,5205
-30,0,110,1105,1177,2282,5206
-80,-70,10,1124,1159,2283,4993
-100,-50,-60,1102,1181,2283,5015
180,-70,-120,1121,1162,2283,5134
-80,-30,-30,1091,1192,2283,5024
180,-70,-110,1125,1158,2283,5193
180,-70,-90,1138,1145,2283,5004
-180,-70,-90,1138,1145,2283,5004
40,80,70,1117,1166,2283,5175
-180,-70,-110,1125,1158,2283,5193
-180,-70,-120,1121,1162,2283,5134
30,80,80,1119,1165,2284,5212
130,40,-40,1132,1152,2284,5129
-30,20,140,1078,1206,2284,5228
0,-30,100,1130,1154,2284,5237
80,50,0,1121,1163,2284,5363
-30,-20,10,1140,1144,2284,5040
-160,-60,-100,1142,1142,2284,5052
-10,-50,90,1106,1178,2284,5239
-40,30,40,1099,1185,2284,5117
-130,-30,-30,1128,1156,2284,5015
170,-70,-100,1137,1147,2284,4980
-100,-20,-40,1097,1188,2285,4858
120,30,-60,1109,1176,2285,5242
-100,60,130,1113,1172,2285,4982
-130,-70,-80,1116,1169,2285,4963
-180,-20,-70,1140,1145,2285,5146
180,-20,-70,1140,1145,2285,5146
20,-40,50,1114,1171,2285,5039
-10,-60,10,1098,1187,2285,5181
-120,-10,-40,1117,1168,2285,5010
-110,-10,-110,1103,1182,2285,5339
-180,-10,-100,1136,1150,2286,5051
-110,-70,-20,1126,1160,2286,5194
180,-10,-100,1136,1150,2286,5051
-150,0,-30,1125,1162,2287,5243
-140,50,180,1083,1204,2287,4963
10,40,80,1123,1164,2287,5024
10,-80,40,1108,1179,2287,4979
-140,50,-180,1083,1204,2287,4963
-30,0,20,1127,1160,2287,4967
-120,10,-100,1118,1169,2287,5024
-130,-30,-90,1109,1179,2288,5161
-70,-10,10,1104,1184,2288,4975
-60,-20,0,1111,1177,2288,4699
-60,80,70,1104,1184,2288,5106
-10,-60,90,1105,1183,2288,5271
-120,-20,-100,1127,1161,2288,4959
-110,40,170,1108,1180,2288,5167
110,-80,150,1117,1171,2288,5141
-50,40,170,1099,1189,2288,5103
60,-70,100,1123,1166,2289,5153
-70,-80,-30,1130,1159,2289,4892
-60,20,60,1110,1179,2289,5086
20,40,50,1132,1157,2289,5086
50,-70,140,1141,1148,2289,5404
-140,-10,-120,1117,1172,2289,5078
-60,70,-180,1125,1165,2290,5103
-140,-20,-30,1111,1179,2290,5073
100,50,-10,1145,1145,2290,5334
150,-80,-130,1135,1155,2290,5328
0,30,20,1127,1163,2290,5181
-160,-40,-100,1141,1149,2290,4925
-60,70,180,1125,1165,2290,5103
20,-10,90,1123,1167,2290,5158
-130,-50,-30,1119,1171,2290,5068
100,-80,140,1126,1165,2291,5171
-170,-30,-60,1131,1160,2291,5155
40,-60,120,1115,1176,2291,5346
-120,-10,-100,1130,1161,2291,5128
-120,40,-110,1133,1158,2291,4943
100,80,10,1142,1149,2291,5123
-110,50,150,1106,1185,2291,4982
-150,-40,-50,1136,1155,2291,4998
-80,-50,-50,1092,1199,2291,5072
-80,50,110,1099,1193,2292,5006
-10,-10,30,1129,1163,2292,5077
-160,-60,-70,1136,1156,2292,5055
-10,0,40,1124,1168,2292,5015
20,50,70,1119,1173,2292,5162
-170,40,-50,1128,1164,2292,5148
180,70,-160,1128,1164,2292,5164
-180,70,-160,1128,1164,2292,5164
20,0,70,1118,1174,2292,5059
-120,-40,-70,1112,1180,2292,5188
-120,-10,-20,1127,1166,2293,5121
-150,-70,-60,1138,1155,2293,5194
60,-60,120,1102,1191,2293,5172
-50,60,50,1106,1188,2294,5205
-140,30,-60,1105,1189,2294,5185
-80,-10,20,1117,1177,2294,5053
-110,50,-120,1110,1184,2294,4912
-80,40,130,1098,1196,2294,5007
50,70,50,1138,1156,2294,5078
-120,0,-50,1111,1184,2295,5252
0,-70,100,1129,1166,2295,5302
-160,50,-60,1135,1160,2295,5193
80,-70,150,1109,1186,2295,5316
10,30,70,1132,1163,2295,5233
10,30,50,1142,1153,2295,5115
-70,-80,30,1134,1161,2295,5208
-130,-20,-40,1127,1168,2295,5186
-50,20,120,1120,1176,2296,5120
-120,40,-180,1129,1167,2296,5257
-20,0,30,1135,1161,2296,5028
-70,30,-170,1104,1192,2296,5245
50,-80,140,1146,1150,2296,5342
130,70,-110,1105,1191,2296,5122
-120,40,180,1129,1167,2296,5257
-30,-40,70,1131,1166,2297,4880
0,20,30,1121,1176,2297,5114
-150,-50,-50,1122,1175,2297,5224
10,-50,100,1125,1172,2297,5360
-40,80,50,1121,1176,2297,5346
-140,-50,-40,1119,1178,2297,5127
-50,-80,-20,1133,1164,2297,5065
-120,0,-90,1135,1162,2297,5189
160,40,-130,1154,1144,2298,5164
-60,20,90,1120,1178,2298,5049
-70,-30,-20,1095,1203,2298,5052
120,60,-90,1134,1165,2299,4996
-50,70,60,1125,1174,2299,5120
-60,30,120,1117,1182,2299,4928
0,0,100,1118,1181,2299,5099
170,10,-110,1140,1159,2299,5084
-130,-10,-90,1137,1162,2299,5046
-20,20,30,1152,1147,2299,4975
60,60,30,1133,1166,2299,5065
10,-60,100,1149,1151,2300,5255
-70,-10,40,1106,1194,2300,5096
-180,-20,-80,1148,1152,2300,5183
110,50,-70,1133,1167,2300,5237
-10,-10,110,1146,1154,2300,5254
-180,-10,-110,1155,1145,2300,5017
180,-10,-110,1155,1145,2300,5017
180,-20,-80,1148,1152,2300,5183
-160,-60,-90,1132,1168,2300,5084
-20,-30,90,1115,1186,2301,5132
150,50,-40,1133,1168,2301,5011
-110,-10,-50,1114,1187,2301,5048
-100,10,-130,1111,1190,2301,5228
-120,0,-40,1102,1199,2301,5191
-100,30,-130,1120,1181,2301,5119
-90,-70,10,1137,1165,2302,5260
-40,50,30,1106,1196,2302,5181
-70,-50,-40,1115,1187,2302,5175
-120,50,170,1120,1182,2302,5157
-60,-80,-30,1136,1166,2302,5038
-50,10,60,1116,1186,2302,4997
-60,0,30,1116,1186,2302,5041
-50,20,110,1112,1191,2303,5090
130,50,-30,1153,1150,2303,5192
170,-60,-110,1123,1180,2303,5239
-60,-70,40,1141,1162,2303,5215
-170,50,-150,1112,1191,2303,4993
-140,40,-160,1125,1178,2303,5219
-90,80,-150,1143,1160,2303,5006
-60,0,50,1109,1195,2304,5078
0,-80,100,1149,1155,2304,5338
140,-80,-170,1133,1171,2304,5269
-80,-80,20,1123,1181,2304,5225
180,-60,-100,1141,1163,2304,5104
-40,-50,60,1112,1192,2304,4959
-130,10,-70,1121,1183,2304,5082
-180,-60,-100,1141,1163,2304,5104
-50,80,60,1123,1181,2304,5283
40,-50,110,1136,1169,2305,5240
50,60,40,1122,1183,2305,5156
-60,30,60,1107,1198,2305,5153
-120,60,-110,1120,1185,2305,5128
-150,-30,-110,1127,1178,2305,5060
-130,40,-90,1114,1191,2305,4999
-110,-50,-60,1128,1177,2305,5218
160,-70,-120,1148,1157,2305,5342
70,-70,150,1135,1171,2306,5456
-150,-60,-70,1154,1152,2306,5199
-40,10,110,1128,1178,2306,4932
-150,-70,-90,1136,1170,2306,5279
-150,80,-90,1145,1161,2306,5046
40,-70,70,1108,1198,2306,5002
-30,80,40,1129,1178,2307,5409
-160,-40,-80,1152,1155,2307,5063
-160,-40,-90,1164,1143,2307,5058
30,-50,110,1125,1182,2307,5270
90,-80,130,1138,1169,2307,5215
-90,70,110,1122,1185,2307,4996
-130,40,-170,1117,1190,2307,5295
-90,50,120,1120,1187,2307,5066
-150,-70,-70,1136,1171,2307,5228
-30,30,30,1141,1166,2307,5144
0,-60,20,1109,1199,2308,5155
-120,-70,-30,1136,1172,2308,5236
110,80,0,1151,1157,2308,5208
20,40,40,1154,1154,2308,5116
-130,0,-90,1134,1174,2308,5067
160,10,-70,1144,1164,2308,5295
-10,20,30,1139,1169,2308,5100
-20,0,120,1146,1162,2308,5062
-50,30,160,1113,1196,2309,5261
-20,-20,20,1127,1182,2309,5204
10,-30,100,1139,1170,2309,5301
20,-20,90,1142,1167,2309,5393
50,-70,90,1131,1178,2309,5085
-90,-60,-60,1115,1194,2309,5129
-70,30,160,1120,1189,2309,5170
-80,60,100,1113,1196,2309,5101
-170,-70,-110,1137,1172,2309,5335
170,20,-120,1149,1160,2309,5067
-70,30,170,1101,1208,2309,5133
80,-70,140,1129,1181,2310,5230
-150,30,-50,1120,1190,2310,5264
-150,20,-140,1137,1173,2310,5166
150,-80,-140,1132,1178,2310,5302
-170,80,-70,1138,1172,2310,5059
-140,-20,-20,1090,1220,2310,5307
-10,70,120,1141,1169,2310,5144
130,-80,-180,1139,1171,2310,5265
-20,70,30,1128,1182,2310,5261
130,-80,180,1139,1171,2310,5265
10,10,50,1128,1182,2310,5119
10,-10,90,1140,1170,2310,5304
-110,30,-120,1114,1196,2310,5140
-50,-20,0,1110,1200,2310,5019
160,-80,-130,1139,1171,2310,5326
-90,-60,-50,1127,1184,2311,5195
120,-80,170,1136,1175,2311,5301
160,-80,-120,1149,1162,2311,5317
-180,0,-110,1122,1189,2311,5129
-30,-10,20,1137,1174,2311,4966
180,0,-110,1122,1189,2311,5129
0,0,40,1136,1175,2311,5136
-60,30,80,1129,1182,2311,5048
70,50,-20,1153,1158,2311,5149
-80,-10,10,1115,1197,2312,5177
-60,-80,40,1142,1170,2312,5266
80,-70,130,1144,1168,2312,5230
-50,30,50,1120,1192,2312,5001
180,20,-50,1127,1185,2312,5102
130,-80,-160,1123,1189,2312,5241
-180,20,-50,1127,1185,2312,5102
-120,-20,-30,1124,1188,2312,5189
-100,80,-140,1142,1171,2313,5044
-170,-70,-100,1148,1165,2313,5242
-70,40,120,1120,1193,2313,4899
10,-40,100,1133,1180,2313,5224
140,-80,-150,1132,1181,2313,5288
-170,40,-140,1125,1188,2313,4948
-50,-10,10,1118,1196,2314,5001
-160,80,-80,1133,1181,2314,5036
10,30,40,1155,1159,2314,5210
-60,60,70,1123,1191,2314,5242
-130,0,-70,1138,1176,2314,5187
60,-80,140,1155,1159,2314,5258
-60,50,180,1136,1178,2314,5013
-110,40,-120,1127,1187,2314,5210
-170,-20,-90,1150,1164,2314,5172
-60,50,-180,1136,1178,2314,5013
-130,80,-110,1158,1157,2315,5135
-90,-70,-50,1137,1178,2315,5056
-80,-60,-50,1105,1210,2315,5062
10,80,100,1126,1189,2315,5151
30,-60,60,1099,1216,2315,5179
-80,30,180,1102,1214,2316,5279
10,30,80,1130,1186,2316,5201
110,40,-50,1132,1184,2316,5327
-60,30,140,1130,1186,2316,5193
-150,-60,-80,1133,1183,2316,5120
-80,30,-180,1102,1214,2316,5279
-120,-50,-70,1128,1189,2317,5213
150,-80,-160,1156,1161,2317,5282
-170,60,-60,1150,1167,2317,5354
-180,-80,-90,1166,1151,2317,5150
-110,-10,-40,1130,1187,2317,5164
-140,-50,-90,1118,1199,2317,5259
-130,0,-100,1141,1176,2317,4969
180,-80,-90,1166,1151,2317,5150
180,-80,-100,1151,1167,2318,5265
-60,-30,-10,1116,1202,2318,5061
-40,20,40,1129,1189,2318,4994
120,-80,-170,1133,1185,2318,5260
110,40,-60,1136,1182,2318,5414
-140,-20,-40,1120,1198,2318,5338
10,0,90,1131,1187,2318,5242
-70,50,90,1134,1184,2318,4982
-50,-10,70,1128,1190,2318,5144
-180,-80,-100,1151,1167,2318,5265
170,-80,-110,1149,1170,2319,5312
-50,20,70,1121,1198,2319,5115
-40,-80,-10,1142,1177,2319,5113
-40,-30,70,1141,1178,2319,4995
-170,-30,-70,1154,1166,2320,5164
-30,-80,70,1152,1168,2320,5323
-110,10,-110,1104,1216,2320,5275
160,-80,-150,1149,1171,2320,5232
30,40,20,1157,1163,2320,5276
-70,-70,20,1140,1180,2320,5115
-10,-70,90,1141,1179,2320,5394
-140,-20,-110,1142,1178,2320,5252
120,40,-40,1147,1173,2320,5095
-170,20,-130,1148,1173,2321,5158
-20,60,130,1115,1206,2321,5195
-140,-60,-50,1144,1177,2321,5194
40,-50,90,1125,1197,2322,5327
20,80,90,1135,1187,2322,5176
-60,0,40,1117,1205,2322,5181
-90,-20,-20,1141,1181,2322,5232
-130,-10,-40,1133,1189,2322,5169
-160,10,-130,1146,1176,2322,5224
80,-80,120,1146,1176,2322,5269
-140,-70,-60,1133,1190,2323,5175
-130,20,-80,1112,1211,2323,5184
-10,-80,90,1157,1166,2323,5378
60,-70,140,1156,1167,2323,5439
-90,-30,20,1123,1200,2323,5209
-50,-80,50,1154,1169,2323,5284
-80,-40,-30,1143,1180,2323,4997
-80,-20,-10,1136,1188,2324,5230
-120,80,-120,1161,1163,2324,5169
-40,30,30,1145,1179,2324,5322
0,10,100,1143,1181,2324,5166
-170,-20,-100,1150,1175,2325,5059
-30,-50,70,1122,1203,2325,4951
-90,30,-170,1121,1204,2325,5279
-20,80,30,1140,1186,2326,5342
0,-80,30,1119,1207,2326,5055
-180,60,-150,1106,1220,2326,5091
-60,20,100,1125,1201,2326,5211
180,60,-150,1106,1220,2326,5091
150,10,-90,1134,1193,2327,5147
-120,30,-160,1134,1193,2327,5228
-170,-80,-90,1157,1170,2327,5210
-140,-70,-80,1146,1181,2327,5235
-110,80,-130,1157,1170,2327,5080
-150,60,-170,1127,1200,2327,5084
0,-20,100,1153,1175,2328,5238
-50,-30,-10,1119,1209,2328,5031
-140,80,-100,1160,1168,2328,5088
-90,40,150,1113,1215,2328,5267
0,40,10,1129,1199,2328,5218
-130,10,-90,1140,1188,2328,5014
-140,-70,-50,1139,1189,2328,5278
-40,-80,60,1157,1172,2329,5319
-20,10,30,1140,1189,2329,5135
-120,20,-110,1124,1205,2329,5214
160,10,-90,1140,1189,2329,5091
-140,-90,-100,1137,1193,2330,5195
50,-90,90,1137,1193,2330,5195
110,-90,150,1137,1193,2330,5195
-70,-90,-30,1137,1193,2330,5195
-160,-90,-120,1137,1193,2330,5195
110,-80,-180,1146,1184,2330,5331
-40,-90,0,1137,1193,2330,5195
-150,-90,-110,1137,1193,2330,5195
-20,-90,20,1137,1193,2330,5195
-180,-90,-140,1137,1193,2330,5195
140,-90,-180,1137,1193,2330,5195
160,-90,-160,1137,1193,2330,5195
-30,-90,10,1137,1193,2330,5195
-60,30,160,1117,1213,2330,5152
30,-40,70,1136,1194,2330,5248
-130,-90,-90,1137,1193,2330,5195
170,-90,-150,1137,1193,2330,5195
-80,-90,-40,1137,1193,2330,5195
20,-90,60,1137,1193,2330,5195
-10,-90,30,1137,1193,2330,5195
180,-90,-140,1137,1193,2330,5195
140,-90,180,1137,1193,2330,5195
0,-90,40,1137,1193,2330,5195
100,-90,140,1137,1193,2330,5195
-100,-90,-60,1137,1193,2330,5195
80,-90,120,1137,1193,2330,5195
30,-90,70,1137,1193,2330,5195
150,-90,-170,1137,1193,2330,5195
10,40,70,1158,1172,2330,5215
-50,-90,-10,1137,1193,2330,5195
90,-90,130,1137,1193,2330,5195
-90,-90,-50,1137,1193,2330,5195
40,70,60,1159,1171,2330,5126
120,-90,160,1137,1193,2330,5195
-170,-90,-130,1137,1193,2330,5195
130,-90,170,1137,1193,2330,5195
-130,50,180,1128,1202,2330,5220
40,-90,80,1137,1193,2330,5195
-60,-90,-20,1137,1193,2330,5195
70,-90,110,1137,1193,2330,5195
-120,-20,-60,1159,1171,2330,5226
-130,30,-90,1112,1218,2330,5191
110,-80,180,1146,1184,2330,5331
60,-90,100,1137,1193,2330,5195
-130,50,-180,1128,1202,2330,5220
-120,-90,-80,1137,1193,2330,5195
10,-90,50,1137,1193,2330,5195
-110,-90,-70,1137,1193,2330,5195
-110,30,-160,1143,1188,2331,5169
-160,-40,-70,1142,1189,2331,5111
-120,30,-110,1115,1216,2331,5119
-140,-20,-50,1126,1205,2331,5136
-130,-10,-30,1119,1212,2331,5242
130,40,-50,1136,1196,2332,5194
-160,-70,-100,1153,1179,2332,5331
-170,0,-120,1148,1184,2332,5153
30,-40,100,1152,1180,2332,5359
-120,-10,-60,1129,1203,2332,5241
-110,-60,-60,1140,1192,2332,5446
-20,0,40,1172,1160,2332,5079
-120,-10,-110,1122,1210,2332,5198
-130,60,-100,1149,1183,2332,5219
-130,-40,-30,1137,1195,2332,5087
120,40,-50,1155,1177,2332,5312
-10,-80,20,1129,1204,2333,5123
-140,-20,-80,1181,1152,2333,5118
-140,-10,-60,1161,1172,2333,5077
-130,-50,-80,1110,1223,2333,5323
-120,-10,-50,1141,1192,2333,5162
130,50,-100,1166,1167,2333,5167
-20,-80,80,1152,1182,2334,5300
40,50,30,1169,1165,2334,5168
-130,-70,-40,1142,1192,2334,5356
50,70,-30,1129,1206,2335,5252
170,0,-100,1150,1185,2335,5219
-110,40,-180,1150,1185,2335,5260
-50,40,40,1134,1201,2335,5273
-60,30,100,1137,1198,2335,5193
-150,40,-60,1138,1197,2335,5440
-110,40,180,1150,1185,2335,5260
-10,-40,90,1146,1190,2336,5104
50,-60,100,1152,1184,2336,5263
10,30,60,1165,1171,2336,5349
-70,60,80,1116,1220,2336,5201
100,-80,170,1153,1183,2336,5391
-130,10,-40,1116,1220,2336,5289
-110,80,130,1131,1205,2336,4985
-150,-80,-70,1150,1186,2336,5193
-60,-80,-20,1156,1180,2336,5003
-150,-60,-90,1154,1183,2337,5170
-60,40,180,1127,1210,2337,5253
-130,-30,-80,1155,1182,2337,5172
-60,40,-180,1127,1210,2337,5253
0,20,50,1143,1194,2337,5143
-130,10,-110,1154,1183,2337,5189
0,80,110,1137,1200,2337,5189
-130,0,-40,1132,1205,2337,5213
-160,-10,-120,1150,1188,2338,5127
110,-80,160,1156,1182,2338,5306
130,30,-90,1134,1204,2338,5293
-150,10,-130,1170,1168,2338,5134
-160,-70,-90,1157,1181,2338,5223
-90,-30,-30,1136,1202,2338,5044
70,-70,140,1138,1200,2338,5349
-160,-80,-80,1160,1178,2338,5231
-50,-70,50,1143,1195,2338,5426
70,-80,110,1149,1189,2338,5322
-160,-80,-90,1147,1192,2339,5215
-140,-40,-40,1161,1178,2339,5239
-100,-20,-10,1142,1197,2339,5425
-30,20,40,1164,1175,2339,5113
-50,40,50,1131,1208,2339,5233
140,40,-50,1142,1197,2339,5265
-110,-70,-30,1150,1189,2339,5292
-70,-20,40,1150,1189,2339,5230
150,20,-70,1160,1179,2339,5223
-30,-80,0,1147,1192,2339,5153
-140,-10,-90,1156,1183,2339,5038
10,-40,40,1116,1224,2340,5196
120,80,-10,1157,1183,2340,5352
170,-80,-140,1147,1193,2340,5281
-70,50,-170,1159,1181,2340,5158
-80,-70,-50,1145,1195,2340,5222
-140,20,-140,1149,1191,2340,5246
-110,-20,-20,1139,1201,2340,5187
-120,50,-110,1129,1211,2340,5100
-50,10,40,1132,1208,2340,5160
-70,-40,-30,1110,1230,2340,5254
-130,-70,-50,1155,1185,2340,5193
-50,0,80,1148,1192,2340,5171
-150,-10,-120,1136,1204,2340,5096
-140,-10,-20,1138,1203,2341,5311
50,50,-10,1148,1193,2341,5321
-140,30,-150,1156,1185,2341,5402
-50,-30,60,1148,1193,2341,5029
30,50,50,1150,1191,2341,5367
140,20,-70,1149,1192,2341,5269
-10,0,110,1135,1207,2342,5357
-160,-30,-80,1157,1185,2342,5174
-150,10,-40,1142,1200,2342,5231
-140,80,160,1134,1208,2342,5064
-100,50,140,1133,1209,2342,5019
-80,-50,-40,1143,1199,2342,5276
10,20,60,1159,1183,2342,5347
170,-80,-120,1148,1194,2342,5316
60,70,40,1165,1177,2342,5195
-60,-70,30,1151,1192,2343,5204
20,-40,100,1150,1193,2343,5321
-120,0,-120,1136,1207,2343,5412
-130,-10,-110,1147,1196,2343,5387
30,-30,70,1148,1195,2343,5319
40,-60,80,1134,1209,2343,5262
-40,-40,60,1161,1182,2343,5224
-30,0,30,1158,1185,2343,5132
20,-50,50,1147,1196,2343,5161
20,0,80,1142,1202,2344,5291
150,40,-50,1167,1177,2344,5304
-140,60,180,1130,1214,2344,5102
70,50,0,1155,1189,2344,5338
-110,-20,-50,1141,1203,2344,5120
-140,60,-180,1130,1214,2344,5102
-90,60,120,1126,1218,2344,5191
-50,30,30,1132,1212,2344,5414
-130,-80,-50,1161,1184,2345,5230
0,20,100,1158,1187,2345,5311
150,30,-60,1158,1187,2345,5347
-30,-40,0,1131,1214,2345,5250
180,-80,-110,1151,1194,2345,5328
-90,-50,-40,1143,1202,2345,5187
-20,30,30,1162,1183,2345,5364
-180,-80,-110,1151,1194,2345,5328
-70,-60,-40,1135,1210,2345,5203
-130,-10,-50,1137,1209,2346,5187
-110,0,-120,1127,1219,2346,5374
10,0,50,1132,1214,2346,5237
70,70,30,1160,1186,2346,5147
30,40,10,1140,1206,2346,5308
-90,80,110,1135,1211,2346,5113
-20,-80,10,1141,1205,2346,5140
30,-30,80,1159,1187,2346,5399
-140,70,170,1130,1217,2347,5052
-140,-30,-100,1140,1207,2347,5297
40,60,50,1141,1206,2347,5307
-70,70,-170,1153,1194,2347,5278
-80,-20,30,1164,1184,2348,5269
-50,80,70,1139,1209,2348,5240
-40,20,130,1155,1193,2348,5255
-120,-70,-40,1156,1192,2348,5244
-180,20,-120,1157,1191,2348,5191
-150,-30,-40,1156,1192,2348,5153
180,20,-120,1157,1191,2348,5191
-130,80,150,1142,1206,2348,5042
-60,-50,-30,1134,1214,2348,5292
-130,0,-30,1117,1232,2349,5350
-60,80,80,1138,1211,2349,5173
90,-80,160,1154,1195,2349,5452
-50,20,100,1144,1205,2349,5007
-40,70,50,1144,1205,2349,5312
-140,-30,-40,1168,1181,2349,5158
-120,-50,-20,1158,1191,2349,5239
-140,-80,-60,1164,1185,2349,5167
-140,-50,-50,1176,1173,2349,5169
-100,-50,-50,1145,1204,2349,5248
90,50,-30,1167,1182,2349,5155
-170,-80,-80,1171,1179,2350,5262
-70,-30,40,1150,1200,2350,5294
-160,-30,-70,1151,1199,2350,5356
-80,30,-170,1126,1224,2350,5270
-50,20,50,1149,1201,2350,5138
70,-70,130,1132,1219,2351,5312
-30,10,120,1129,1222,2351,5416
-50,-80,-10,1170,1181,2351,5075
-130,10,-100,1171,1180,2351,5161
-100,80,120,1133,1218,2351,5012
-130,-20,-50,1160,1191,2351,5219
-120,10,-110,1139,1212,2351,5342
-70,-30,-10,1147,1204,2351,5119
-100,-20,-20,1129,1222,2351,5291
160,40,-50,1157,1194,2351,5256
-30,70,40,1141,1210,2351,5293
10,-30,40,1149,1203,2352,5201
-140,0,-90,1157,1195,2352,5253
100,50,-40,1166,1186,2352,5220
100,-80,150,1154,1198,2352,5325
-80,40,140,1159,1193,2352,5374
-40,20,140,1137,1215,2352,5244
-150,70,180,1146,1207,2353,5063
-140,60,-90,1146,1207,2353,5214
-100,50,150,1153,1200,2353,5077
-10,10,50,1150,1203,2353,5208
-150,70,-180,1146,1207,2353,5063
-160,-70,-80,1170,1183,2353,5355
-20,20,130,1137,1216,2353,5227
-20,30,130,1130,1223,2353,5230
50,-80,130,1176,1177,2353,5354
-50,-20,70,1152,1201,2353,5069
140,70,-120,1120,1234,2354,5211
-50,50,50,1146,1209,2355,5341
-20,40,20,1153,1202,2355,5397
-110,50,160,1149,1206,2355,5068
-130,10,-80,1144,1212,2356,5149
-80,-70,-40,1160,1196,2356,5036
-20,-50,80,1128,1228,2356,5179
-110,-30,-10,1176,1180,2356,5424
-20,-40,80,1148,1208,2356,5162
-150,-20,-50,1134,1222,2356,5315
10,-70,100,1149,1207,2356,5443
170,-70,-110,1170,1186,2356,5484
0,50,100,1135,1221,2356,5115
150,-80,-150,1165,1191,2356,5370
-20,10,40,1177,1179,2356,5083
-120,80,140,1146,1210,2356,5031
0,-10,100,1164,1193,2357,5379
-170,-10,-110,1168,1189,2357,5204
-70,40,100,1144,1214,2358,5101
-120,-80,-40,1156,1202,2358,5360
-130,-70,-70,1160,1198,2358,5352
-70,40,110,1151,1207,2358,5109
-60,30,70,1147,1211,2358,5140
-20,10,50,1166,1192,2358,5119
-20,0,110,1144,1214,2358,5334
-10,-20,100,1170,1188,2358,5378
-140,-10,-80,1173,1186,2359,5264
60,-80,100,1150,1209,2359,5254
-50,-50,-20,1137,1222,2359,5175
-80,-30,30,1133,1226,2359,5255
40,-90,90,1170,1190,2360,5383
-140,-90,-90,1170,1190,2360,5383
-70,-90,-20,1170,1190,2360,5383
-40,-90,10,1170,1190,2360,5383
-10,-90,40,1170,1190,2360,5383
150,-90,-160,1170,1190,2360,5383
-50,-90,0,1170,1190,2360,5383
-130,-90,-80,1170,1190,2360,5383
-180,-90,-130,1170,1190,2360,5383
60,-90,110,1170,1190,2360,5383
-20,-90,30,1170,1190,2360,5383
90,-90,140,1170,1190,2360,5383
30,70,70,1165,1195,2360,5248
80,50,-10,1166,1194,2360,5413
20,-70,110,1170,1190,2360,5521
-100,-90,-50,1170,1190,2360,5383
120,-90,170,1170,1190,2360,5383
-120,-90,-70,1170,1190,2360,5383
110,-90,160,1170,1190,2360,5383
-60,-90,-10,1170,1190,2360,5383
70,-90,120,1170,1190,2360,5383
20,-90,70,1170,1190,2360,5383
-80,-90,-30,1170,1190,2360,5383
-160,-90,-110,1170,1190,2360,5383
100,-90,150,1170,1190,2360,5383
0,-90,50,1170,1190,2360,5383
-150,-90,-100,1170,1190,2360,5383
-100,40,170,1166,1194,2360,5442
160,-90,-150,1170,1190,2360,5383
180,-90,-130,1170,1190,2360,5383
50,-90,100,1170,1190,2360,5383
-80,40,170,1155,1205,2360,5280
130,-90,180,1170,1190,2360,5383
130,-90,-180,1170,1190,2360,5383
80,-90,130,1170,1190,2360,5383
30,-90,80,1170,1190,2360,5383
170,-90,-140,1170,1190,2360,5383
-170,-90,-120,1170,1190,2360,5383
140,-90,-170,1170,1190,2360,5383
-110,-90,-60,1170,1190,2360,5383
-90,-90,-40,1170,1190,2360,5383
-30,-90,20,1170,1190,2360,5383
10,-90,60,1170,1190,2360,5383
-130,-60,-40,1163,1198,2361,5370
-70,60,-170,1171,1190,2361,5170
-150,-50,-60,1170,1191,2361,5185
170,50,-140,1157,1204,2361,5255
180,10,-50,1160,1202,2362,5499
-110,-60,-20,1170,1192,2362,5401
-70,-40,-20,1155,1207,2362,5172
-180,10,-50,1160,1202,2362,5499
90,-80,140,1150,1212,2362,5357
-50,10,80,1160,1202,2362,5187
140,-80,-160,1161,1201,2362,5438
70,60,20,1146,1216,2362,5343
-130,0,-60,1145,1218,2363,5403
40,-80,130,1172,1191,2363,5523
-110,-20,-30,1136,1227,2363,5172
-60,-20,50,1161,1202,2363,5271
-70,-20,0,1156,1207,2363,5202
-160,30,-50,1158,1205,2363,5416
10,10,60,1161,1202,2363,5301
-110,-80,-30,1157,1207,2364,5481
-160,-80,-70,1175,1189,2364,5371
-90,-20,10,1155,1209,2364,5249
160,-80,-140,1164,1200,2364,5421
-120,70,150,1153,1211,2364,5130
-120,-70,-60,1156,1208,2364,5354
-130,0,-120,1153,1212,2365,5298
-30,-20,80,1152,1213,2365,5166
-100,-60,-10,1155,1210,2365,5378
-100,-30,-40,1155,1210,2365,5212
40,-70,130,1178,1187,2365,5563
-50,10,50,1140,1225,2365,5123
-70,-50,30,1162,1204,2366,5216
-50,30,150,1137,1229,2366,5269
-150,-50,-70,1179,1187,2366,5240
-60,30,150,1162,1204,2366,5279
30,-70,60,1157,1209,2366,5205
-140,-80,-70,1171,1196,2367,5177
-150,-20,-30,1139,1228,2367,5468
-60,30,130,1150,1217,2367,5374
-130,70,160,1158,1209,2367,5123
-50,0,30,1153,1214,2367,5266
-140,-10,-50,1158,1209,2367,5250
-50,10,70,1143,1224,2367,5240
-140,0,-30,1143,1224,2367,5298
-130,-30,-40,1156,1211,2367,5226
-120,-20,-50,1145,1222,2367,5216
80,70,20,1175,1192,2367,5250
-120,-40,-60,1162,1205,2367,5183
-110,-60,-30,1161,1207,2368,5147
-80,-50,20,1176,1192,2368,5237
-50,-50,50,1153,1215,2368,5124
-120,-60,-30,1174,1194,2368,5319
-50,-20,10,1150,1218,2368,5151
-70,-50,-30,1142,1226,2368,5261
40,-50,100,1180,1188,2368,5478
-20,20,40,1170,1198,2368,5210
170,0,-90,1177,1192,2369,5443
-110,0,-110,1129,1240,2369,5101
10,10,90,1167,1202,2369,5345
50,-80,90,1146,1223,2369,5237
-120,-20,-40,1157,1212,2369,5214
20,50,0,1181,1188,2369,5308
70,-70,120,1171,1199,2370,5515
-140,10,-40,1163,1207,2370,5458
-170,-80,-100,1156,1214,2370,5266
-150,-80,-80,1167,1203,2370,5233
-170,-80,-120,1176,1194,2370,5470
170,40,-50,1162,1208,2370,5479
-40,10,100,1159,1211,2370,5164
-150,-50,-80,1179,1191,2370,5318
-160,-20,-40,1167,1203,2370,5595
-130,-80,-40,1161,1209,2370,5620
10,30,30,1154,1217,2371,5280
-180,0,-50,1150,1221,2371,5668
-70,80,90,1134,1237,2371,5203
-30,0,100,1147,1224,2371,5168
180,0,-50,1150,1221,2371,5668
0,20,40,1181,1190,2371,5302
-50,20,60,1147,1224,2371,5128
-140,-80,-50,1160,1212,2372,5552
-90,40,160,1171,1201,2372,5326
-20,-70,80,1165,1207,2372,5508
10,40,10,1169,1203,2372,5461
-60,50,70,1154,1218,2372,5176
-150,-30,-50,1187,1185,2372,5268
-100,-80,-20,1160,1212,2372,5490
-160,-30,-50,1171,1202,2373,5370
-140,0,-80,1164,1209,2373,5236
-70,-10,30,1162,1211,2373,5384
-130,-80,-60,1183,1190,2373,5138
-60,40,110,1157,1216,2373,5149
150,70,-130,1139,1234,2373,5296
160,30,-120,1190,1183,2373,5450
-90,-50,-50,1144,1229,2373,5292
50,50,20,1192,1181,2373,5343
-30,10,40,1155,1218,2373,5149
-100,-20,-30,1163,1210,2373,5277
-150,-20,-110,1166,1207,2373,5209
-130,-40,-80,1154,1220,2374,5524
-110,70,140,1158,1216,2374,5205
-60,-30,0,1149,1225,2374,5051
-160,60,-70,1166,1208,2374,5496
-130,-10,-20,1142,1232,2374,5250
120,60,-20,1180,1194,2374,5173
-90,30,-160,1137,1237,2374,5298
-90,-20,0,1156,1219,2375,5576
-150,-10,-60,1189,1186,2375,5310
-100,-70,-20,1173,1202,2375,5366
-120,-70,-70,1152,1223,2375,5185
-50,0,70,1177,1198,2375,5271
-130,-60,-70,1152,1223,2375,5428
80,80,-60,1146,1229,2375,5391
-60,-10,20,1144,1231,2375,5216
-40,20,50,1173,1203,2376,5119
-150,-70,-80,1163,1213,2376,5331
-130,0,-110,1178,1198,2376,5396
-180,-80,-130,1164,1212,2376,5460
-60,-10,50,1168,1208,2376,5272
-140,0,-70,1159,1217,2376,5258
-110,-40,-50,1178,1198,2376,5291
180,-80,-130,1164,1212,2376,5460
-70,-10,20,1177,1199,2376,5358
-180,40,-50,1175,1201,2376,5333
30,-70,120,1177,1199,2376,5552
-110,-50,-10,1163,1213,2376,5287
180,40,-50,1175,1201,2376,5333
-140,10,-80,1153,1223,2376,5260
-40,20,120,1167,1209,2376,5367
70,80,-50,1141,1236,2377,5352
-90,50,140,1149,1228,2377,5252
-80,-50,-30,1150,1227,2377,5155
-140,0,-50,1154,1223,2377,5261
20,-20,60,1163,1214,2377,5463
160,70,-140,1150,1227,2377,5344
-120,40,-170,1165,1213,2378,5216
-150,-20,-40,1175,1203,2378,5276
-120,-60,-40,1178,1200,2378,5231
170,-80,-130,1163,1215,2378,5445
-120,-40,-20,1171,1208,2379,5193
50,-60,120,1159,1220,2379,5409
-100,-30,0,1168,1211,2379,5398
-80,80,100,1151,1228,2379,5177
-140,-40,-90,1137,1243,2380,5407
-180,-10,-90,1191,1189,2380,5217
-140,-60,-80,1168,1212,2380,5384
-120,20,-140,1174,1206,2380,5505
-140,-40,-50,1183,1197,2380,5221
-150,0,-80,1186,1194,2380,5170
-140,40,-80,1132,1248,2380,5287
180,-10,-90,1191,1189,2380,5217
-150,-40,-90,1176,1205,2381,5241
-90,-50,10,1157,1224,2381,5304
-110,-30,-50,1166,1215,2381,5296
-160,70,-170,1170,1211,2381,5101
-10,20,50,1184,1197,2381,5218
-80,30,-160,1126,1256,2382,5387
-110,-50,-50,1163,1219,2382,5336
-90,40,170,1168,1214,2382,5331
0,50,10,1157,1225,2382,5278
160,10,-80,1168,1214,2382,5362
170,70,-150,1169,1213,2382,5383
-90,-70,-10,1159,1223,2382,5333
50,-70,130,1166,1216,2382,5567
-10,80,120,1156,1226,2382,5277
-130,60,170,1154,1228,2382,5096
140,50,-110,1182,1201,2383,5247
-130,-80,-80,1179,1204,2383,5376
-20,-30,80,1183,1200,2383,5200
-160,-80,-110,1174,1209,2383,5482
-170,-20,-50,1159,1224,2383,5471
180,-10,-60,1157,1226,2383,5462
-180,-10,-60,1157,1226,2383,5462
-160,50,-150,1158,1225,2383,5142
-120,0,-110,1159,1225,2384,5342
-70,40,130,1139,1245,2384,5299
50,-60,110,1170,1214,2384,5493
-130,40,-100,1151,1233,2384,5250
-140,-30,-80,1178,1206,2384,5303
-100,-60,-50,1162,1222,2384,5511
-40,-80,0,1183,1201,2384,5188
0,40,100,1152,1233,2385,5425
-140,-50,-80,1143,1242,2385,5403
10,20,70,1195,1190,2385,5392
-80,-30,-20,1143,1242,2385,5179
-40,30,50,1156,1229,2385,5280
20,40,10,1156,1229,2385,5585
0,30,100,1190,1195,2385,5375
60,80,-40,1151,1234,2385,5342
-130,10,-60,1147,1238,2385,5493
-110,-40,-10,1173,1213,2386,5263
-20,-10,100,1177,1209,2386,5278
-170,-20,-60,1179,1207,2386,5370
-60,-80,-10,1168,1218,2386,5262
-60,40,70,1171,1215,2386,5221
-30,30,140,1151,1235,2386,5569
120,40,-80,1187,1199,2386,5501
0,-40,30,1130,1256,2386,5384
-180,30,-50,1177,1209,2386,5426
-70,40,-170,1159,1227,2386,5381
-80,40,150,1174,1212,2386,5343
180,30,-50,1177,1209,2386,5426
-70,-80,-20,1181,1206,2387,5241
140,70,-30,1190,1197,2387,5395
-20,70,130,1156,1231,2387,5330
-130,-60,-50,1180,1207,2387,5272
-150,50,-70,1159,1228,2387,5573
-40,-60,60,1152,1235,2387,5341
-170,30,-130,1173,1214,2387,5240
-70,50,100,1176,1211,2387,5144
-170,20,-50,1195,1192,2387,5355
170,70,-50,1182,1205,2387,5408
-140,-60,-60,1179,1208,2387,5337
-140,-10,-70,1188,1199,2387,5315
-90,50,130,1150,1237,2387,5160
-160,60,-160,1164,1224,2388,5218
-110,10,-130,1156,1232,2388,5451
110,50,-20,1166,1222,2388,5454
-120,10,-130,1165,1223,2388,5560
-130,20,-90,1147,1241,2388,5252
-150,-80,-60,1180,1208,2388,5460
140,30,-60,1190,1199,2389,5300
-60,-40,-20,1148,1241,2389,5262
-120,30,-120,1168,1221,2389,5257
-110,20,-120,1137,1252,2389,5420
-140,-70,-70,1184,1205,2389,5390
170,60,-50,1179,1210,2389,5508
-150,80,170,1154,1235,2389,5161
-10,-20,30,1183,1206,2389,5450
-180,10,-110,1155,1234,2389,5343
20,70,80,1163,1226,2389,5301
180,10,-110,1155,1234,2389,5343
-160,0,-120,1200,1190,2390,5317
170,0,-70,1173,1217,2390,5512
-70,40,160,1160,1230,2390,5370
-20,-20,90,1163,1228,2391,5306
-150,-80,-100,1189,1202,2391,5491
-130,-10,-70,1174,1217,2391,5367
-80,-60,-40,1155,1236,2391,5312
-50,30,60,1159,1232,2391,5195
-140,-60,-70,1162,1229,2391,5363
-30,60,140,1160,1231,2391,5432
-90,-60,0,1161,1231,2392,5380
-30,-10,90,1166,1226,2392,5145
90,50,-10,1174,1218,2392,5575
-80,70,100,1169,1223,2392,5228
-150,-40,-60,1176,1216,2392,5275
-120,-80,-70,1187,1205,2392,5367
-60,30,90,1166,1226,2392,5078
-140,20,-60,1168,1225,2393,5456
30,-40,90,1160,1233,2393,5504
-160,-30,-90,1190,1203,2393,5214
-110,-80,-60,1186,1207,2393,5345
-180,-80,-120,1180,1213,2393,5437
180,-80,-120,1180,1213,2393,5437
30,50,40,1194,1199,2393,5305
-40,0,30,1187,1206,2393,5191
40,-80,120,1185,1208,2393,5437
130,-80,-170,1179,1215,2394,5455
-140,-20,-60,1185,1209,2394,5211
-160,10,-90,1205,1189,2394,5332
-100,30,-160,1146,1248,2394,5340
-130,-10,-60,1160,1234,2394,5375
-100,40,180,1166,1228,2394,5367
-40,-20,10,1178,1216,2394,5100
-40,-70,60,1188,1206,2394,5460
-100,40,-180,1166,1228,2394,5367
30,-50,70,1165,1230,2395,5359
-80,-20,0,1160,1235,2395,5259
80,50,-20,1178,1217,2395,5551
-80,70,-160,1184,1211,2395,5388
0,-60,90,1178,1217,2395,5479
140,30,-100,1159,1236,2395,5324
150,30,-110,1178,1217,2395,5290
-150,0,-60,1167,1228,2395,5219
-60,40,80,1179,1216,2395,5303
-20,-60,80,1158,1237,2395,5380
-60,-50,40,1183,1213,2396,5219
-20,20,50,1190,1206,2396,5116
-150,10,-80,1163,1233,2396,5302
130,80,-20,1191,1205,2396,5493
-40,30,150,1152,1244,2396,5520
-10,10,110,1160,1236,2396,5304
-80,-80,-30,1180,1216,2396,5203
-50,20,80,1177,1219,2396,5290
30,60,60,1172,1224,2396,5323
-150,0,-90,1185,1211,2396,5336
-100,-80,-50,1193,1204,2397,5331
60,-70,120,1181,1216,2397,5467
-150,-30,-60,1193,1204,2397,5324
-130,-50,-70,1163,1234,2397,5552
-30,20,50,1176,1221,2397,5184
-50,-60,40,1180,1217,2397,5389
130,40,-90,1187,1210,2397,5318
-140,20,-80,1166,1231,2397,5381
-170,-70,-90,1193,1205,2398,5422
-140,50,-170,1141,1257,2398,5291
-150,-30,-100,1178,1220,2398,5156
170,40,-130,1185,1213,2398,5529
50,80,-30,1154,1244,2398,5403
-60,-20,10,1157,1241,2398,5119
60,50,10,1198,1200,2398,5480
60,50,-10,1183,1215,2398,5611
90,80,-70,1159,1239,2398,5472
-120,60,160,1175,1224,2399,5221
0,10,50,1185,1214,2399,5432
0,60,100,1159,1240,2399,5217
-140,-10,-40,1166,1233,2399,5552
-130,-30,-70,1174,1225,2399,5403
50,60,-20,1155,1244,2399,5392
-30,-70,70,1178,1221,2399,5534
-40,10,40,1183,1217,2400,5241
-100,20,-140,1167,1233,2400,5396
90,70,10,1212,1188,2400,5303
-40,80,60,1165,1235,2400,5318
-90,-80,-10,1166,1234,2400,5568
-120,-50,-60,1172,1228,2400,5433
-100,20,-130,1131,1269,2400,5356
-100,-60,-20,1163,1237,2400,5237
-50,-40,50,1171,1230,2401,5352
120,-80,-180,1182,1219,2401,5500
120,-80,180,1182,1219,2401,5500
10,40,60,1187,1214,2401,5420
-50,0,40,1156,1245,2401,5261
-140,-80,-90,1199,1202,2401,5444
40,-80,80,1170,1231,2401,5302
-140,-10,-100,1179,1222,2401,5288
140,20,-90,1188,1213,2401,5467
150,50,-120,1185,1216,2401,5285
-170,-20,-80,1198,1204,2402,5563
-180,50,-140,1185,1217,2402,5215
180,50,-140,1185,1217,2402,5215
-90,40,180,1171,1231,2402,5325
10,50,80,1184,1218,2402,5331
-90,40,-180,1171,1231,2402,5325
-20,-10,30,1167,1235,2402,5109
30,-80,120,1193,1209,2402,5695
-150,60,-80,1180,1223,2403,5422
-170,70,-160,1173,1230,2403,5105
-140,10,-130,1187,1216,2403,5388
170,0,-80,1185,1219,2404,5566
-110,-70,-50,1170,1234,2404,5359
-160,-30,-100,1186,1218,2404,5439
-60,-60,30,1181,1223,2404,5379
-50,-10,20,1172,1232,2404,5251
-40,-50,-10,1157,1247,2404,5268
-40,-10,80,1164,1240,2404,5274
40,-70,80,1171,1233,2404,5173
-40,50,40,1156,1248,2404,5464
-60,-60,-30,1154,1251,2405,5318
-150,-10,-80,1185,1220,2405,5210
-80,50,-160,1190,1215,2405,5314
-90,-80,-40,1184,1221,2405,5212
20,-60,50,1165,1240,2405,5486
-40,40,40,1171,1234,2405,5541
-140,-30,-50,1199,1207,2406,5320
0,30,30,1172,1234,2406,5314
160,50,-130,1175,1231,2406,5380
-20,20,60,1179,1228,2407,5245
-140,20,-50,1155,1252,2407,5413
130,30,-80,1174,1233,2407,5500
-50,30,100,1162,1245,2407,5286
-120,-60,-60,1173,1234,2407,5314
70,50,-10,1199,1208,2407,5556
-10,-30,30,1183,1224,2407,5362
80,-80,150,1192,1215,2407,5536
-150,0,-70,1196,1211,2407,5116
130,60,-100,1190,1217,2407,5376
100,80,-80,1173,1234,2407,5514
-70,-70,-40,1185,1222,2407,5376
-130,20,-100,1154,1253,2407,5228
0,-70,90,1169,1239,2408,5470
40,80,-20,1162,1246,2408,5342
130,30,-60,1190,1218,2408,5428
-20,50,130,1181,1227,2408,5376
-160,-10,-110,1179,1229,2408,5406
20,-30,90,1186,1222,2408,5513
20,-50,100,1200,1208,2408,5732
20,-10,80,1152,1256,2408,5513
-130,10,-130,1183,1226,2409,5490
-70,-80,10,1181,1228,2409,5473
-80,40,160,1180,1229,2409,5377
-150,-40,-70,1191,1218,2409,5300
-110,-20,-40,1186,1223,2409,5389
-130,-20,-70,1173,1236,2409,5434
-130,30,-110,1171,1238,2409,5253
-150,-10,-50,1188,1221,2409,5487
-40,20,60,1178,1231,2409,5237
-30,30,40,1181,1228,2409,5340
170,60,-140,1174,1236,2410,5203
-130,30,-100,1149,1261,2410,5190
-70,-70,-30,1183,1227,2410,5219
-30,80,50,1168,1242,2410,5310
-20,40,130,1163,1247,2410,5413
-50,-80,0,1170,1240,2410,5338
-170,-10,-90,1180,1230,2410,5505
-110,40,-130,1165,1245,2410,5286
-110,-80,-20,1180,1230,2410,5607
-120,-80,-30,1174,1236,2410,5655
-160,-20,-50,1188,1223,2411,5321
-150,50,-160,1163,1248,2411,5318
-180,-70,-100,1205,1206,2411,5456
180,-70,-100,1205,1206,2411,5456
-10,40,20,1184,1228,2412,5474
20,-10,70,1172,1240,2412,5350
110,-80,170,1189,1223,2412,5496
-130,10,-50,1151,1261,2412,5453
0,60,10,1171,1241,2412,5480
-110,-60,-40,1178,1234,2412,5369
20,40,30,1191,1222,2413,5305
-160,-20,-80,1192,1221,2413,5442
-130,0,-50,1173,1240,2413,5311
-100,-50,0,1166,1247,2413,5355
-50,40,60,1168,1245,2413,5317
120,50,-80,1202,1211,2413,5407
60,50,0,1193,1221,2414,5503
-180,-10,-70,1197,1217,2414,5480
170,30,-120,1202,1212,2414,5503
-80,60,-160,1198,1216,2414,5245
180,-10,-70,1197,1217,2414,5480
40,-60,90,1170,1244,2414,5475
110,80,-90,1170,1244,2414,5534
-160,-20,-110,1184,1230,2414,5505
-40,0,90,1162,1253,2415,5260
-40,-60,50,1200,1215,2415,5372
-150,40,-150,1168,1247,2415,5258
30,60,-10,1153,1262,2415,5486
-150,-10,-30,1182,1233,2415,5594
-130,-70,-60,1179,1236,2415,5504
-180,40,-130,1185,1230,2415,5387
180,40,-130,1185,1230,2415,5387
-100,-50,-40,1180,1236,2416,5445
-110,-70,-60,1162,1254,2416,5431
-40,60,50,1191,1225,2416,5568
-120,-50,-50,1191,1226,2417,5293
-140,30,-70,1142,1275,2417,5379
10,-20,90,1197,1220,2417,5513
-60,-70,-30,1201,1216,2417,5417
120,80,-100,1170,1247,2417,5498
-40,-70,-10,1196,1221,2417,5444
30,80,-10,1170,1247,2417,5427
30,-60,110,1206,1211,2417,5684
-10,-50,80,1189,1229,2418,5301
-50,10,90,1181,1237,2418,5342
-70,-50,-20,1179,1239,2418,5330
-130,20,-110,1173,1245,2418,5286
0,30,50,1198,1220,2418,5456
-150,-10,-70,1184,1234,2418,5291
-140,10,-50,1160,1258,2418,5436
-80,-60,10,1175,1243,2418,5490
140,20,-80,1197,1221,2418,5610
60,-70,130,1178,1240,2418,5581
80,60,10,1190,1230,2420,5676
-90,-20,-10,1171,1249,2420,5467
-150,-20,-60,1190,1230,2420,5375
40,70,-20,1161,1259,2420,5421
-140,0,-120,1194,1226,2420,5478
0,-50,90,1195,1225,2420,5533
40,-70,120,1188,1232,2420,5667
-40,30,70,1160,1260,2420,5435
-40,-30,0,1188,1233,2421,5371
-120,-60,-50,1170,1251,2421,5531
30,-80,110,1194,1227,2421,5574
-120,-80,-50,1193,1228,2421,5321
-30,-80,10,1200,1221,2421,5247
-170,10,-50,1190,1231,2421,5696
-160,-30,-60,1185,1237,2422,5434
-140,10,-90,1178,1244,2422,5384
-130,-40,-40,1202,1220,2422,5440
-140,20,-70,1160,1262,2422,5397
-100,70,130,1186,1236,2422,5320
-110,40,-170,1198,1224,2422,5546
70,-80,130,1199,1223,2422,5618
-180,30,-120,1204,1219,2423,5420
170,50,-50,1192,1231,2423,5427
180,30,-120,1204,1219,2423,5420
150,60,-40,1207,1216,2423,5500
100,70,-70,1173,1250,2423,5455
-160,80,-180,1169,1254,2423,5258
-120,-30,-30,1185,1238,2423,5456
-160,80,180,1169,1254,2423,5258
-50,0,50,1171,1252,2423,5306
-40,10,50,1192,1231,2423,5286
-150,-30,-70,1178,1245,2423,5485
-110,30,-150,1192,1232,2424,5548
-40,20,70,1169,1255,2424,5330
20,40,20,1200,1224,2424,5511
-30,30,70,1198,1226,2424,5320
-20,60,30,1200,1225,2425,5514
-40,-10,20,1182,1243,2425,5459
0,-10,40,1205,1220,2425,5517
-40,40,30,1182,1243,2425,5466
-10,-40,20,1180,1245,2425,5372
90,-80,150,1181,1244,2425,5522
-100,40,-140,1165,1260,2425,5449
-160,0,-90,1205,1220,2425,5479
-10,20,40,1187,1238,2425,5399
-90,30,-150,1157,1268,2425,5558
90,90,-70,1179,1247,2426,5464
-70,90,90,1179,1247,2426,5464
-130,90,150,1179,1247,2426,5464
-180,90,-160,1179,1247,2426,5464
0,90,20,1179,1247,2426,5464
110,90,-90,1179,1247,2426,5464
-60,-10,40,1172,1254,2426,5402
-120,90,140,1179,1247,2426,5464
30,90,-10,1179,1247,2426,5464
120,90,-100,1179,1247,2426,5464
140,90,-120,1179,1247,2426,5464
180,90,-160,1179,1247,2426,5464
-150,90,170,1179,1247,2426,5464
100,90,-80,1179,1247,2426,5464
-150,0,-50,1184,1242,2426,5591
-40,90,60,1179,1247,2426,5464
160,90,-140,1179,1247,2426,5464
-110,90,130,1179,1247,2426,5464
130,90,-110,1179,1247,2426,5464
-30,90,50,1179,1247,2426,5464
-160,90,180,1179,1247,2426,5464
-160,90,-180,1179,1247,2426,5464
-140,0,-100,1205,1221,2426,5359
-140,10,-70,1162,1264,2426,5304
-100,-80,-10,1178,1248,2426,5604
40,90,-20,1179,1247,2426,5464
20,90,0,1179,1247,2426,5464
-80,-80,0,1178,1248,2426,5540
60,90,-40,1179,1247,2426,5464
150,90,-130,1179,1247,2426,5464
80,-80,130,1188,1238,2426,5548
20,-80,110,1217,1209,2426,5774
-140,90,160,1179,1247,2426,5464
10,90,10,1179,1247,2426,5464
-100,90,120,1179,1247,2426,5464
-170,90,-170,1179,1247,2426,5464
-10,90,30,1179,1247,2426,5464
170,90,-150,1179,1247,2426,5464
80,90,-60,1179,1247,2426,5464
-80,90,100,1179,1247,2426,5464
-170,0,-110,1190,1236,2426,5584
-50,90,70,1179,1247,2426,5464
-90,90,110,1179,1247,2426,5464
70,90,-50,1179,1247,2426,5464
-60,90,80,1179,1247,2426,5464
50,90,-30,1179,1247,2426,5464
-20,90,40,1179,1247,2426,5464
100,-80,160,1188,1239,2427,5527
-140,0,-60,1187,1240,2427,5170
-50,0,60,1195,1232,2427,5382
100,70,0,1208,1219,2427,5338
-110,20,-140,1202,1225,2427,5549
30,-70,70,1185,1242,2427,5276
120,70,-90,1172,1255,2427,5383
-40,-80,10,1171,1256,2427,5372
-30,40,40,1202,1226,2428,5487
-30,10,110,1177,1251,2428,5533
-30,10,50,1180,1248,2428,5311
-50,-70,40,1205,1223,2428,5321
-120,10,-120,1183,1245,2428,5535
0,20,60,1201,1227,2428,5565
-150,10,-100,1216,1212,2428,5477
80,-80,140,1190,1238,2428,5561
-10,60,20,1182,1246,2428,5498
-170,-80,-110,1198,1230,2428,5493
-170,60,-150,1195,1234,2429,5304
-150,-20,-70,1192,1237,2429,5391
-50,-70,-20,1184,1245,2429,5425
-100,-60,-40,1174,1255,2429,5359
-80,-70,0,1178,1251,2429,5335
-60,-50,-20,1178,1251,2429,5255
-60,-90,20,1186,1244,2430,5541
-50,-90,30,1186,1244,2430,5541
10,-90,90,1186,1244,2430,5541
-120,-90,-40,1186,1244,2430,5541
150,-90,-130,1186,1244,2430,5541
140,-90,-140,1186,1244,2430,5541
110,-90,-170,1186,1244,2430,5541
100,-90,180,1186,1244,2430,5541
110,70,-80,1163,1267,2430,5427
-120,40,-130,1183,1247,2430,5292
0,-90,80,1186,1244,2430,5541
-130,-90,-50,1186,1244,2430,5541
50,-90,130,1186,1244,2430,5541
180,-90,-100,1186,1244,2430,5541
-90,-90,-10,1186,1244,2430,5541
120,-90,-160,1186,1244,2430,5541
160,-90,-120,1186,1244,2430,5541
-160,-90,-80,1186,1244,2430,5541
100,-90,-180,1186,1244,2430,5541
-10,-90,70,1186,1244,2430,5541
30,-90,110,1186,1244,2430,5541
-80,-90,0,1186,1244,2430,5541
20,-90,100,1186,1244,2430,5541
-180,-90,-100,1186,1244,2430,5541
80,-90,160,1186,1244,2430,5541
170,-90,-110,1186,1244,2430,5541
90,-90,170,1186,1244,2430,5541
-20,-90,60,1186,1244,2430,5541
-40,-90,40,1186,1244,2430,5541
-70,-90,10,1186,1244,2430,5541
130,-90,-150,1186,1244,2430,5541
70,-90,150,1186,1244,2430,5541
-100,-90,-20,1186,1244,2430,5541
-170,-90,-90,1186,1244,2430,5541
-140,-90,-60,1186,1244,2430,5541
-150,-90,-70,1186,1244,2430,5541
-110,-90,-30,1186,1244,2430,5541
60,-90,140,1186,1244,2430,5541
-30,-90,50,1186,1244,2430,5541
40,-90,120,1186,1244,2430,5541
-150,20,-130,1214,1217,2431,5302
-140,-80,-80,1181,1250,2431,5549
-50,60,60,1177,1254,2431,5508
-30,70,140,1184,1247,2431,5398
-140,-30,-90,1195,1236,2431,5550
20,-70,50,1173,1258,2431,5451
-20,80,130,1175,1256,2431,5418
-100,-70,-40,1179,1252,2431,5412
-170,20,-120,1195,1237,2432,5506
-90,-60,-40,1180,1252,2432,5549
-90,-80,0,1184,1248,2432,5645
-10,-10,40,1213,1219,2432,5528
-160,-20,-90,1203,1229,2432,5393
30,-60,70,1178,1254,2432,5483
30,-80,70,1187,1245,2432,5353
-150,-40,-80,1211,1222,2433,5426
-100,-60,-30,1183,1250,2433,5297
-140,-20,-100,1189,1244,2433,5451
-140,-40,-80,1186,1248,2434,5316
-160,20,-50,1187,1247,2434,5489
-150,-20,-80,1201,1233,2434,5377
-140,-20,-70,1193,1241,2434,5377
-50,-60,-20,1186,1248,2434,5258
-120,30,-150,1202,1232,2434,5527
-40,40,50,1186,1249,2435,5448
-160,-90,-70,1196,1239,2435,5840
170,-90,-100,1196,1239,2435,5840
20,-90,110,1196,1239,2435,5840
-160,-80,-100,1194,1241,2435,5487
-30,-90,60,1196,1239,2435,5840
70,-90,160,1196,1239,2435,5840
10,20,80,1197,1238,2435,5514
90,-90,-180,1196,1239,2435,5840
130,-90,-140,1196,1239,2435,5840
40,-90,130,1196,1239,2435,5840
60,-90,150,1196,1239,2435,5840
100,-90,-170,1196,1239,2435,5840
110,-90,-160,1196,1239,2435,5840
70,-80,140,1206,1229,2435,5653
-20,-90,70,1196,1239,2435,5840
0,-90,90,1196,1239,2435,5840
50,-90,140,1196,1239,2435,5840
-100,-40,0,1197,1238,2435,5349
-130,-90,-40,1196,1239,2435,5840
120,-90,-150,1196,1239,2435,5840
-50,-90,40,1196,1239,2435,5840
-50,-40,-10,1178,1257,2435,5384
-80,60,110,1169,1266,2435,5227
-110,-90,-20,1196,1239,2435,5840
180,-90,-90,1196,1239,2435,5840
-20,80,40,1171,1264,2435,5310
-140,-20,-90,1192,1243,2435,5461
140,-90,-130,1196,1239,2435,5840
-90,-90,0,1196,1239,2435,5840
-120,-90,-30,1196,1239,2435,5840
30,-90,120,1196,1239,2435,5840
150,-90,-120,1196,1239,2435,5840
-140,-90,-50,1196,1239,2435,5840
-40,-90,50,1196,1239,2435,5840
-70,-90,20,1196,1239,2435,5840
-170,-20,-70,1203,1232,2435,5532
-10,-90,80,1196,1239,2435,5840
-180,-90,-90,1196,1239,2435,5840
80,-90,170,1196,1239,2435,5840
-110,50,170,1178,1257,2435,5402
-100,-90,-10,1196,1239,2435,5840
-170,-90,-80,1196,1239,2435,5840
10,-90,100,1196,1239,2435,5840
-60,-90,30,1196,1239,2435,5840
160,-90,-110,1196,1239,2435,5840
-150,-90,-60,1196,1239,2435,5840
-80,-90,10,1196,1239,2435,5840
90,-90,180,1196,1239,2435,5840
-170,80,-170,1186,1250,2436,5311
-30,50,30,1186,1250,2436,5525
-120,20,-120,1180,1256,2436,5509
-110,40,-140,1178,1258,2436,5478
180,0,-100,1198,1238,2436,5296
-180,0,-100,1198,1238,2436,5296
-80,-80,10,1188,1248,2436,5686
-150,-80,-90,1197,1239,2436,5531
150,80,-130,1188,1249,2437,5341
-70,40,150,1203,1234,2437,5472
-100,-70,-30,1187,1250,2437,5522
-70,40,140,1181,1256,2437,5560
-60,-80,20,1202,1235,2437,5526
180,70,-150,1180,1258,2438,5286
-70,60,90,1169,1269,2438,5578
20,-80,100,1193,1245,2438,5603
-180,70,-150,1180,1258,2438,5286
100,50,-20,1202,1236,2438,5651
-140,30,-80,1161,1278,2439,5377
-140,0,-40,1193,1246,2439,5478
160,60,-130,1183,1256,2439,5473
-130,-50,-40,1197,1242,2439,5448
-30,-60,70,1176,1263,2439,5500
10,-10,50,1178,1262,2440,5629
-70,-80,20,1194,1246,2440,5712
30,-40,80,1184,1256,2440,5514
-20,-40,10,1192,1248,2440,5472
-160,20,-130,1196,1244,2440,5398
-160,10,-120,1201,1239,2440,5458
-30,-60,60,1201,1239,2440,5449
90,50,-20,1209,1231,2440,5449
-30,20,60,1186,1254,2440,5315
130,80,-110,1188,1252,2440,5512
-50,40,100,1181,1260,2441,5142
-60,40,130,1200,1241,2441,5565
20,-80,60,1196,1245,2441,5423
-50,30,70,1191,1250,2441,5375
60,-80,120,1195,1246,2441,5635
-160,-10,-90,1190,1251,2441,5438
50,60,30,1211,1230,2441,5492
10,40,40,1223,1218,2441,5364
-50,30,130,1196,1245,2441,5573
-140,-40,-60,1216,1225,2441,5540
170,20,-60,1197,1245,2442,5618
-20,30,70,1194,1248,2442,5242
-120,50,-180,1188,1254,2442,5499
-140,20,-90,1199,1243,2442,5419
-70,-70,10,1192,1250,2442,5380
-150,-30,-80,1228,1214,2442,5334
-130,20,-140,1220,1222,2442,5524
160,80,-140,1180,1262,2442,5379
-120,50,180,1188,1254,2442,5499
-110,-80,-40,1197,1245,2442,5419
20,80,0,1186,1256,2442,5485
-100,-40,-40,1216,1226,2442,5367
-40,30,80,1190,1252,2442,5200
-160,-20,-60,1205,1238,2443,5431
-80,-70,-10,1198,1245,2443,5482
10,-80,100,1212,1231,2443,5811
-70,-60,-30,1173,1270,2443,5424
-100,40,-170,1202,1241,2443,5537
-50,-50,-10,1194,1250,2444,5385
-130,-60,-60,1184,1260,2444,5528
-60,40,120,1166,1278,2444,5220
-40,10,60,1196,1248,2444,5491
160,30,-60,1204,1240,2444,5504
-30,20,130,1175,1269,2444,5505
-120,-30,-60,1199,1245,2444,5544
-150,10,-50,1200,1244,2444,5539
-40,-60,-10,1186,1259,2445,5375
-20,-80,20,1207,1238,2445,5309
-90,-50,-30,1201,1244,2445,5475
0,40,20,1204,1241,2445,5629
170,10,-100,1215,1230,2445,5581
-50,-80,30,1202,1243,2445,5588
-110,-60,-50,1185,1260,2445,5256
-130,50,-100,1173,1273,2446,5364
-40,30,60,1192,1254,2446,5313
-10,-10,100,1219,1227,2446,5556
-110,-50,-40,1204,1242,2446,5284
160,20,-70,1239,1207,2446,5591
-50,70,70,1189,1258,2447,5467
-150,10,-90,1198,1249,2447,5482
-90,-60,-30,1178,1269,2447,5442
-110,10,-120,1169,1278,2447,5527
-140,-10,-110,1194,1253,2447,5529
30,-50,100,1215,1233,2448,5667
-160,0,-100,1216,1232,2448,5464
-20,10,120,1171,1277,2448,5461
-160,0,-40,1181,1267,2448,5677
-130,-80,-70,1190,1258,2448,5560
-180,80,-160,1184,1264,2448,5317
180,80,-160,1184,1264,2448,5317
-130,-20,-60,1187,1261,2448,5431
-50,-80,40,1199,1249,2448,5790
0,-20,40,1211,1237,2448,5481
-50,30,110,1182,1267,2449,5237
-130,40,-160,1196,1253,2449,5631
-130,10,-120,1216,1233,2449,5551
-20,-70,10,1211,1238,2449,5494
130,30,-70,1205,1244,2449,5496
-50,30,80,1194,1255,2449,5461
-80,-30,-10,1192,1258,2450,5399
0,80,20,1185,1265,2450,5382
-100,60,140,1189,1261,2450,5427
-40,-20,70,1201,1249,2450,5329
-40,10,90,1193,1257,2450,5392
-110,60,150,1205,1245,2450,5380
170,80,-150,1192,1258,2450,5392
170,10,-60,1181,1270,2451,5777
-110,-30,-20,1222,1229,2451,5435
-160,0,-80,1213,1238,2451,5434
-100,50,-140,1199,1252,2451,5498
20,50,60,1186,1265,2451,5468
110,50,-60,1209,1242,2451,5589
-50,30,140,1195,1256,2451,5310
-150,10,-120,1217,1234,2451,5282
-120,-50,-30,1218,1233,2451,5580
-10,20,110,1206,1245,2451,5464
-170,30,-50,1200,1251,2451,5597
-30,60,40,1190,1262,2452,5712
-60,-50,-10,1199,1253,2452,5362
-90,-40,-30,1204,1248,2452,5373
-10,-80,30,1215,1237,2452,5364
-140,0,-110,1199,1253,2452,5577
-120,-80,-60,1194,1258,2452,5500
10,-70,40,1205,1247,2452,5578
140,80,-120,1187,1265,2452,5485
-50,40,160,1191,1261,2452,5598
-150,-30,-90,1202,1250,2452,5442
10,-80,50,1214,1238,2452,5400
-160,40,-140,1187,1265,2452,5394
-40,-80,40,1198,1255,2453,5629
-60,-30,40,1209,1244,2453,5517
-90,-60,-20,1197,1256,2453,5268
60,-70,110,1207,1246,2453,5695
-10,30,50,1218,1235,2453,5368
-100,50,160,1177,1276,2453,5602
-20,-30,20,1209,1244,2453,5611
-180,70,-60,1201,1252,2453,5619
-90,-70,-20,1196,1257,2453,5429
140,80,-30,1220,1233,2453,5595
180,70,-60,1201,1252,2453,5619
0,-80,40,1212,1241,2453,5337
-60,-80,30,1197,1256,2453,5766
-30,-70,0,1205,1248,2453,5413
-120,-70,-50,1193,1261,2454,5528
-140,-50,-70,1207,1247,2454,5340
-90,70,-150,1206,1248,2454,5530
-110,30,-130,1176,1279,2455,5521
-110,-80,-50,1191,1264,2455,5520
-140,-40,-70,1221,1235,2456,5521
-170,-10,-100,1207,1249,2456,5406
50,-70,110,1214,1242,2456,5812
-170,10,-120,1221,1235,2456,5484
-70,-20,10,1175,1281,2456,5310
-80,50,120,1199,1257,2456,5401
-100,30,-140,1177,1279,2456,5584
-30,20,70,1191,1265,2456,5366
120,-90,-180,1226,1231,2457,5461
100,-90,160,1226,1231,2457,5461
60,-90,120,1226,1231,2457,5461
-70,70,90,1191,1266,2457,5383
80,-90,140,1226,1231,2457,5461
-110,-90,-50,1226,1231,2457,5461
-60,-90,0,1226,1231,2457,5461
-90,-90,-30,1226,1231,2457,5461
-180,-90,-120,1226,1231,2457,5461
-140,-90,-80,1226,1231,2457,5461
-20,50,20,1201,1256,2457,5494
70,-90,130,1226,1231,2457,5461
-20,-10,40,1205,1252,2457,5440
-40,-90,20,1226,1231,2457,5461
40,-90,100,1226,1231,2457,5461
-120,-90,-60,1226,1231,2457,5461
160,-90,-140,1226,1231,2457,5461
50,-90,110,1226,1231,2457,5461
-20,-90,40,1226,1231,2457,5461
-50,-90,10,1226,1231,2457,5461
-160,-90,-100,1226,1231,2457,5461
-80,-90,-20,1226,1231,2457,5461
-70,-90,-10,1226,1231,2457,5461
-100,-90,-40,1226,1231,2457,5461
110,-90,170,1226,1231,2457,5461
130,-90,-170,1226,1231,2457,5461
-130,-90,-70,1226,1231,2457,5461
-150,-90,-90,1226,1231,2457,5461
-120,30,-140,1204,1253,2457,5735
140,-90,-160,1226,1231,2457,5461
0,-90,60,1226,1231,2457,5461
180,-90,-120,1226,1231,2457,5461
120,-90,180,1226,1231,2457,5461
0,30,60,1190,1267,2457,5383
20,-90,80,1226,1231,2457,5461
10,-90,70,1226,1231,2457,5461
-100,40,-150,1172,1285,2457,5583
-30,-90,30,1226,1231,2457,5461
90,-90,150,1226,1231,2457,5461
-170,-90,-110,1226,1231,2457,5461
170,-90,-130,1226,1231,2457,5461
30,-90,90,1226,1231,2457,5461
150,-90,-150,1226,1231,2457,5461
10,-50,40,1189,1268,2457,5539
-10,-90,50,1226,1231,2457,5461
-130,30,-150,1215,1242,2457,5459
-80,-20,20,1197,1261,2458,5623
-100,30,-150,1186,1272,2458,5670
70,60,-30,1199,1259,2458,5527
-80,-70,-30,1195,1263,2458,5453
50,-80,110,1209,1249,2458,5720
-150,-20,-90,1201,1257,2458,5371
-10,30,30,1227,1232,2459,5597
-60,-40,40,1214,1245,2459,5389
10,80,10,1191,1268,2459,5443
10,0,60,1180,1279,2459,5542
-160,-20,-100,1215,1245,2460,5498
-10,-60,80,1205,1255,2460,5589
30,-70,110,1223,1237,2460,5863
-90,50,-150,1200,1260,2460,5520
-150,30,-140,1195,1265,2460,5463
-10,-70,20,1224,1236,2460,5573
70,-80,120,1208,1252,2460,5619
-80,50,130,1186,1275,2461,5517
-130,-50,-60,1186,1275,2461,5460
-140,10,-100,1221,1240,2461,5485
-10,-30,90,1220,1241,2461,5527
-140,10,-60,1199,1262,2461,5543
-150,0,-120,1203,1259,2462,5536
-160,-10,-100,1217,1245,2462,5500
-70,-70,-20,1190,1272,2462,5359
-120,50,-120,1200,1262,2462,5379
-30,30,50,1208,1254,2462,5417
-90,40,-150,1181,1281,2462,5520
-30,0,40,1225,1237,2462,5323
-90,60,-150,1210,1252,2462,5350
-100,-70,-50,1178,1285,2463,5494
150,40,-110,1226,1237,2463,5444
-20,30,40,1218,1245,2463,5369
-150,30,-60,1204,1259,2463,5691
-30,-10,30,1203,1261,2464,5441
-140,-30,-60,1213,1251,2464,5417
60,-80,110,1215,1249,2464,5618
-40,-80,50,1204,1260,2464,5879
10,70,90,1180,1284,2464,5449
-120,40,-120,1205,1259,2464,5362
-100,-80,-40,1197,1267,2464,5499
100,60,-60,1213,1252,2465,5550
150,20,-100,1201,1264,2465,5536
-50,30,90,1202,1263,2465,5362
-90,-40,10,1209,1256,2465,5491
-150,-10,-90,1218,1247,2465,5534
-80,-50,-20,1201,1264,2465,5639
-20,-50,70,1195,1270,2465,5482
180,-10,-80,1245,1221,2466,5706
-130,40,-110,1193,1273,2466,5318
-110,50,-130,1198,1268,2466,5239
-60,-60,-20,1203,1263,2466,5520
-180,-10,-80,1245,1221,2466,5706
160,40,-120,1208,1259,2467,5633
-80,-80,-20,1199,1268,2467,5471
-30,-80,50,1203,1265,2468,5697
80,70,-50,1203,1265,2468,5717
-90,-70,-40,1190,1278,2468,5491
-10,-70,80,1195,1273,2468,5561
-50,20,90,1190,1278,2468,5496
-60,70,80,1210,1258,2468,5466
30,50,0,1213,1255,2468,5700
-40,0,40,1190,1278,2468,5464
120,50,-30,1209,1259,2468,5528
-110,-50,-20,1202,1266,2468,5611
30,-50,80,1212,1256,2468,5624
-160,-10,-60,1201,1268,2469,5555
110,70,-10,1222,1247,2469,5380
-60,40,150,1199,1270,2469,5492
-30,40,30,1198,1271,2469,5588
-90,-80,-30,1194,1275,2469,5505
-140,-30,-70,1226,1243,2469,5467
90,70,-60,1216,1253,2469,5620
-150,-10,-110,1192,1278,2470,5546
-30,-30,70,1217,1255,2472,5553
-60,40,90,1187,1285,2472,5644
-90,-70,-30,1194,1278,2472,5459
-10,80,30,1195,1277,2472,5360
20,-70,60,1217,1255,2472,5488
-70,-70,0,1191,1281,2472,5583
-90,-30,10,1206,1267,2473,5607
-130,-40,-70,1203,1270,2473,5448
-150,10,-70,1209,1264,2473,5494
0,-40,90,1232,1242,2474,5418
60,-80,130,1230,1244,2474,5738
-30,50,140,1195,1279,2474,5625
80,60,-40,1210,1264,2474,5605
100,50,-30,1223,1251,2474,5645
-10,30,60,1212,1262,2474,5347
-70,-80,-10,1208,1266,2474,5468
170,20,-110,1225,1249,2474,5582
-110,40,-160,1215,1260,2475,5676
-130,40,-120,1206,1269,2475,5415
-160,10,-80,1218,1257,2475,5498
-150,10,-60,1209,1266,2475,5425
0,-70,30,1220,1255,2475,5622
-90,-80,-20,1209,1266,2475,5578
-160,0,-110,1227,1248,2475,5508
-80,-60,-10,1202,1273,2475,5387
-100,-50,-30,1208,1268,2476,5510
10,40,50,1225,1251,2476,5575
0,-30,90,1230,1247,2477,5631
-120,20,-130,1194,1283,2477,5673
0,30,40,1208,1269,2477,5484
-80,-60,-30,1193,1284,2477,5571
-150,20,-50,1202,1275,2477,5720
-100,-80,-30,1210,1267,2477,5511
-170,0,-100,1229,1248,2477,5591
-90,-60,-10,1212,1265,2477,5419
0,0,50,1205,1272,2477,5629
10,-80,90,1203,1274,2477,5753
60,60,20,1219,1258,2477,5629
-40,40,90,1199,1278,2477,5352
-170,50,-140,1221,1257,2478,5299
-130,50,-170,1186,1292,2478,5627
-30,-50,0,1203,1275,2478,5500
20,-40,90,1215,1263,2478,5599
20,60,70,1213,1265,2478,5480
-60,40,170,1201,1277,2478,5624
-150,0,-40,1209,1269,2478,5689
-40,60,150,1215,1264,2479,5608
-60,-70,20,1220,1259,2479,5424
-110,-70,-40,1201,1278,2479,5531
10,-30,90,1233,1246,2479,5753
-110,-50,-30,1202,1277,2479,5502
-40,40,150,1213,1266,2479,5630
-50,50,60,1183,1296,2479,5601
40,-60,110,1227,1253,2480,5883
30,50,30,1241,1239,2480,5482
-60,-40,-10,1204,1277,2481,5499
-70,-20,30,1213,1268,2481,5611
-50,-20,20,1208,1273,2481,5264
-20,-80,30,1214,1267,2481,5535
140,50,-40,1214,1267,2481,5560
-30,-70,60,1217,1264,2481,5525
-90,70,120,1207,1274,2481,5540
-120,-90,-50,1218,1264,2482,5718
70,-90,140,1218,1264,2482,5718
-90,-90,-20,1218,1264,2482,5718
-180,-90,-110,1218,1264,2482,5718
-60,-90,10,1218,1264,2482,5718
-80,-90,-10,1218,1264,2482,5718
-100,-90,-30,1218,1264,2482,5718
-30,-90,40,1218,1264,2482,5718
10,-90,80,1218,1264,2482,5718
40,-90,110,1218,1264,2482,5718
-70,-90,0,1218,1264,2482,5718
-40,-90,30,1218,1264,2482,5718
60,-90,130,1218,1264,2482,5718
-160,-90,-90,1218,1264,2482,5718
150,-90,-140,1218,1264,2482,5718
-150,-90,-80,1218,1264,2482,5718
30,70,-10,1204,1278,2482,5478
-140,-90,-70,1218,1264,2482,5718
50,-90,120,1218,1264,2482,5718
-120,-40,-30,1237,1245,2482,5602
-50,30,120,1195,1287,2482,5673
140,-90,-150,1218,1264,2482,5718
110,-90,180,1218,1264,2482,5718
180,-90,-110,1218,1264,2482,5718
-10,-90,60,1218,1264,2482,5718
90,-90,160,1218,1264,2482,5718
-10,20,60,1207,1275,2482,5552
-100,60,-140,1237,1245,2482,5372
160,-90,-130,1218,1264,2482,5718
30,-90,100,1218,1264,2482,5718
100,-90,170,1218,1264,2482,5718
170,-90,-120,1218,1264,2482,5718
130,-90,-160,1218,1264,2482,5718
-130,-90,-60,1218,1264,2482,5718
-50,-90,20,1218,1264,2482,5718
-20,-90,50,1218,1264,2482,5718
-170,-90,-100,1218,1264,2482,5718
110,-90,-180,1218,1264,2482,5718
120,-90,-170,1218,1264,2482,5718
20,-90,90,1218,1264,2482,5718
0,-90,70,1218,1264,2482,5718
-110,-90,-40,1218,1264,2482,5718
80,-90,150,1218,1264,2482,5718
40,-60,100,1219,1264,2483,5839
-30,-80,20,1199,1284,2483,5486
180,20,-110,1217,1266,2483,5581
140,60,-110,1212,1271,2483,5632
-20,30,50,1208,1275,2483,5359
-160,0,-70,1213,1270,2483,5326
-180,20,-110,1217,1266,2483,5581
-40,-40,0,1215,1268,2483,5480
-100,50,-150,1187,1297,2484,5542
0,-80,90,1221,1263,2484,5882
10,-40,90,1218,1266,2484,5650
-60,40,100,1206,1279,2485,5430
-60,-20,40,1212,1273,2485,5542
50,-70,100,1237,1248,2485,5823
-170,10,-110,1222,1264,2486,5748
-100,-30,-10,1235,1251,2486,5585
-40,70,150,1221,1265,2486,5474
-80,-20,10,1205,1281,2486,5775
-30,30,60,1222,1265,2487,5364
-20,-70,70,1208,1279,2487,5643
-20,-80,60,1213,1274,2487,5758
-30,40,140,1218,1269,2487,5627
-70,-60,20,1212,1275,2487,5582
-40,30,140,1204,1283,2487,5662
10,-70,50,1220,1268,2488,5631
-50,-50,0,1222,1266,2488,5518
-70,40,170,1226,1262,2488,5675
-120,30,-130,1222,1267,2489,5724
-80,40,180,1210,1279,2489,5596
-80,40,-180,1210,1279,2489,5596
-30,-80,60,1218,1271,2489,5831
-10,-80,80,1217,1272,2489,5871
-140,-10,-30,1193,1297,2490,5800
-10,-40,80,1223,1267,2490,5512
120,60,-80,1227,1263,2490,5481
140,30,-70,1234,1257,2491,5674
40,-80,100,1216,1275,2491,5776
-160,10,-50,1230,1261,2491,5507
-80,40,-170,1210,1281,2491,5604
-10,-80,40,1229,1262,2491,5582
10,40,30,1218,1273,2491,5619
130,50,-90,1238,1253,2491,5648
-30,-30,10,1203,1289,2492,5726
-60,40,140,1203,1289,2492,5695
-50,-10,30,1203,1289,2492,5484
110,50,-30,1215,1277,2492,5694
-120,-30,-40,1216,1276,2492,5592
110,60,-70,1235,1257,2492,5492
-10,0,50,1221,1271,2492,5521
-60,-80,0,1224,1268,2492,5430
-150,20,-70,1227,1266,2493,5537
-120,-40,-50,1211,1282,2493,5509
-130,30,-120,1209,1284,2493,5585
-40,-70,50,1223,1270,2493,5431
0,-80,80,1202,1292,2494,5873
-130,-30,-60,1214,1280,2494,5646
-90,-30,-20,1198,1296,2494,5487
-70,50,120,1198,1296,2494,5530
-140,10,-110,1222,1273,2495,5720
30,-60,80,1211,1284,2495,5703
-90,40,-170,1221,1274,2495,5622
-30,80,140,1217,1278,2495,5563
-50,-60,30,1234,1261,2495,5583
-70,-30,0,1208,1287,2495,5457
-60,-10,30,1208,1287,2495,5570
-90,40,-160,1201,1295,2496,5586
50,50,0,1221,1275,2496,5787
-120,-40,-40,1229,1267,2496,5744
-120,40,-160,1240,1256,2496,5637
-80,50,140,1207,1289,2496,5660
-10,60,110,1213,1283,2496,5536
-100,-50,-20,1212,1285,2497,5558
-30,0,90,1205,1292,2497,5485
-10,40,30,1239,1258,2497,5631
-50,-30,0,1208,1289,2497,5453
-60,60,80,1200,1297,2497,5635
10,10,80,1208,1289,2497,5595
0,30,70,1243,1254,2497,5536
-80,-60,-20,1216,1281,2497,5633
90,60,-50,1221,1276,2497,5623
-50,40,70,1213,1285,2498,5610
-50,-80,10,1220,1278,2498,5425
-140,50,-90,1223,1275,2498,5458
-20,40,30,1230,1268,2498,5597
0,40,70,1228,1270,2498,5640
0,-10,90,1223,1275,2498,5676
-50,40,90,1210,1288,2498,5605
20,-30,60,1207,1292,2499,5543
-130,-40,-50,1246,1253,2499,5611
80,80,-50,1227,1272,2499,5706
150,60,-120,1222,1278,2500,5559
-160,-10,-70,1239,1261,2500,5680
-40,-80,20,1220,1280,2500,5508
-20,-40,70,1227,1273,2500,5533
-110,50,-150,1214,1286,2500,5650
-150,20,-100,1222,1278,2500,5575
-10,-80,70,1209,1291,2500,5831
-30,-80,30,1227,1274,2501,5501
150,70,-40,1255,1246,2501,5853
130,60,-30,1244,1257,2501,5611
20,-20,70,1207,1295,2502,5654
-50,-20,60,1225,1277,2502,5730
-80,40,-160,1205,1297,2502,5632
-110,60,-130,1236,1266,2502,5524
-70,40,-180,1211,1292,2503,5645
50,-80,100,1243,1260,2503,5668
0,40,80,1242,1261,2503,5476
-80,-60,0,1228,1275,2503,5535
-10,30,40,1221,1282,2503,5481
-70,40,180,1211,1292,2503,5645
-160,40,-60,1225,1278,2503,5786
-140,40,-150,1217,1286,2503,5597
-160,-20,-70,1235,1269,2504,5720
-100,40,-160,1225,1279,2504,5737
50,50,10,1244,1260,2504,5715
-40,20,110,1239,1265,2504,5523
-50,40,110,1204,1300,2504,5328
90,60,0,1229,1275,2504,5894
-90,60,130,1225,1279,2504,5569
-160,10,-110,1221,1283,2504,5698
-150,20,-80,1209,1296,2505,5641
-80,-80,-10,1224,1281,2505,5717
-150,-20,-100,1229,1276,2505,5502
20,-80,70,1228,1278,2506,5649
-140,-50,-60,1242,1264,2506,5642
-90,-50,-20,1265,1241,2506,5605
40,-80,90,1234,1272,2506,5692
120,40,-60,1237,1269,2506,5797
-40,-50,0,1235,1271,2506,5409
90,80,-60,1238,1269,2507,5670
-40,-10,30,1236,1271,2507,5723
-130,-30,-50,1235,1272,2507,5465
10,-60,40,1227,1280,2507,5671
120,40,-70,1223,1285,2508,5740
40,-70,90,1231,1277,2508,5722
10,50,10,1221,1287,2508,5582
50,-70,120,1223,1285,2508,5848
-110,50,-140,1223,1286,2509,5460
-120,-30,-50,1223,1286,2509,5657
-140,30,-90,1218,1291,2509,5691
-140,20,-100,1231,1278,2509,5722
140,40,-100,1244,1265,2509,5662
0,40,90,1238,1271,2509,5717
-110,-40,-40,1215,1294,2509,5506
0,-30,40,1223,1287,2510,5574
-30,30,80,1239,1271,2510,5496
-160,-10,-80,1237,1273,2510,5518
-80,-70,-20,1223,1287,2510,5662
-40,70,60,1202,1308,2510,5571
-80,-40,20,1211,1299,2510,5660
0,-80,50,1233,1277,2510,5577
-30,-50,60,1211,1299,2510,5508
-20,-20,30,1251,1260,2511,5743
-30,10,100,1214,1297,2511,5416
-10,0,100,1217,1294,2511,5643
60,60,-20,1220,1292,2512,5683
-30,20,120,1223,1289,2512,5827
-160,30,-130,1209,1303,2512,5668
-60,50,90,1228,1284,2512,5473
-60,-70,-10,1228,1284,2512,5393
-60,50,80,1232,1280,2512,5448
-150,0,-100,1247,1265,2512,5582
-70,-60,10,1251,1262,2513,5557
-60,-70,-20,1238,1275,2513,5474
-100,-30,-20,1223,1290,2513,5792
20,-50,60,1226,1287,2513,5748
170,70,-140,1212,1302,2514,5512
0,50,90,1243,1271,2514,5456
-120,-50,-40,1219,1295,2514,5573
160,20,-110,1256,1258,2514,5847
150,80,-40,1244,1270,2514,5707
-60,-20,20,1213,1302,2515,5612
-130,-40,-60,1215,1300,2515,5756
110,50,-50,1247,1268,2515,5831
-100,70,-140,1229,1286,2515,5691
-160,10,-100,1256,1259,2515,5652
160,20,-80,1228,1288,2516,5563
-70,50,110,1203,1313,2516,5610
-30,-40,10,1253,1263,2516,5648
-140,50,-160,1201,1315,2516,5767
20,-80,90,1245,1271,2516,5804
50,-80,120,1249,1267,2516,5764
-20,20,120,1203,1314,2517,5810
30,-80,80,1233,1284,2517,5700
-90,-30,-10,1211,1306,2517,5702
130,70,-100,1228,1289,2517,5488
20,70,0,1236,1281,2517,5558
-70,-30,30,1226,1291,2517,5685
10,-20,50,1232,1285,2517,5610
40,-80,110,1258,1259,2517,5812
-60,-60,20,1240,1277,2517,5526
-170,10,-100,1246,1272,2518,5665
10,0,70,1213,1305,2518,5745
20,-20,80,1202,1316,2518,5701
-70,-40,-10,1228,1290,2518,5519
-40,0,80,1237,1281,2518,5659
70,80,-40,1225,1293,2518,5716
-110,50,-170,1265,1253,2518,5659
-60,50,170,1249,1270,2519,5707
-40,40,70,1207,1312,2519,5689
10,40,20,1231,1288,2519,5806
-20,-80,70,1226,1293,2519,5889
-90,50,170,1243,1277,2520,5604
0,0,90,1223,1297,2520,5611
-40,10,70,1228,1292,2520,5705
-120,40,-150,1232,1288,2520,5772
-150,20,-90,1223,1297,2520,5450
110,50,-40,1241,1279,2520,5731
170,50,-130,1255,1265,2520,5634
-130,20,-120,1246,1275,2521,5748
170,30,-60,1239,1282,2521,5755
170,10,-80,1245,1276,2521,5630
-100,50,-180,1259,1262,2521,5517
-100,50,180,1259,1262,2521,5517
-70,-60,-20,1230,1291,2521,5618
-120,90,-130,1228,1294,2522,5601
-90,90,-160,1228,1294,2522,5601
170,90,-60,1228,1294,2522,5601
-180,90,-70,1228,1294,2522,5601
160,90,-50,1228,1294,2522,5601
130,90,-20,1228,1294,2522,5601
110,90,0,1228,1294,2522,5601
10,90,100,1228,1294,2522,5601
180,90,-70,1228,1294,2522,5601
-140,90,-110,1228,1294,2522,5601
-20,-80,40,1240,1282,2522,5663
-100,90,-150,1228,1294,2522,5601
80,90,30,1228,1294,2522,5601
120,90,-10,1228,1294,2522,5601
-30,90,140,1228,1294,2522,5601
-20,90,130,1228,1294,2522,5601
-170,90,-80,1228,1294,2522,5601
70,90,40,1228,1294,2522,5601
0,90,110,1228,1294,2522,5601
90,90,20,1228,1294,2522,5601
100,90,10,1228,1294,2522,5601
40,90,70,1228,1294,2522,5601
-10,90,120,1228,1294,2522,5601
-110,90,-140,1228,1294,2522,5601
-70,90,-180,1228,1294,2522,5601
50,90,60,1228,1294,2522,5601
-150,90,-100,1228,1294,2522,5601
-50,90,160,1228,1294,2522,5601
140,90,-30,1228,1294,2522,5601
20,90,90,1228,1294,2522,5601
-70,90,180,1228,1294,2522,5601
0,70,100,1217,1305,2522,5583
-50,-70,0,1229,1293,2522,5551
150,20,-80,1250,1272,2522,5816
-160,90,-90,1228,1294,2522,5601
-40,90,150,1228,1294,2522,5601
30,90,80,1228,1294,2522,5601
-80,90,-170,1228,1294,2522,5601
-60,90,170,1228,1294,2522,5601
60,90,50,1228,1294,2522,5601
-130,90,-120,1228,1294,2522,5601
-70,-30,10,1228,1294,2522,5752
30,-80,100,1248,1274,2522,5798
150,90,-40,1228,1294,2522,5601
160,20,-100,1242,1281,2523,5594
-20,-10,90,1249,1274,2523,5470
-60,-30,10,1230,1293,2523,5614
-50,-10,60,1250,1273,2523,5637
-80,50,160,1227,1296,2523,5674
-50,-50,40,1223,1301,2524,5598
-50,-60,-10,1245,1279,2524,5742
-90,-50,-10,1219,1305,2524,5656
-20,-60,70,1230,1294,2524,5701
180,10,-100,1249,1275,2524,5656
-170,-10,-50,1218,1306,2524,5844
-20,60,120,1231,1293,2524,5661
-20,0,100,1232,1292,2524,5665
-180,10,-100,1249,1275,2524,5656
-150,0,-110,1249,1276,2525,5684
-30,40,60,1217,1308,2525,5597
-170,50,-60,1245,1280,2525,5750
-150,10,-110,1241,1284,2525,5798
-90,50,150,1215,1310,2525,5748
-40,-50,50,1229,1297,2526,5722
-70,-40,30,1235,1291,2526,5640
-150,-10,-40,1222,1304,2526,5934
30,-50,90,1240,1286,2526,5801
10,50,70,1239,1287,2526,5686
-50,-70,30,1245,1281,2526,5447
-150,-10,-100,1242,1284,2526,5614
-160,10,-60,1235,1292,2527,5745
10,60,80,1211,1316,2527,5677
30,-80,90,1242,1285,2527,5848
20,-60,100,1252,1275,2527,5996
-40,80,150,1227,1301,2528,5736
-130,-50,-50,1238,1290,2528,5647
-50,40,80,1226,1302,2528,5688
10,-80,60,1247,1281,2528,5680
-30,10,60,1228,1300,2528,5600
-50,-10,50,1232,1297,2529,5663
-50,-10,40,1225,1304,2529,5707
-180,0,-70,1250,1279,2529,5857
-160,20,-60,1247,1282,2529,5878
-30,-60,0,1230,1299,2529,5573
-110,-30,-30,1244,1285,2529,5799
40,50,0,1222,1307,2529,5948
180,0,-70,1250,1279,2529,5857
-170,-10,-80,1247,1282,2529,5786
-100,-30,-30,1225,1304,2529,5618
-10,50,20,1246,1283,2529,5630
10,10,70,1229,1301,2530,5639
20,60,0,1232,1298,2530,5869
40,50,20,1272,1258,2530,5705
10,70,10,1240,1290,2530,5734
40,60,40,1257,1273,2530,5677
10,0,80,1225,1306,2531,5734
-40,0,50,1216,1315,2531,5576
-10,50,110,1234,1297,2531,5694
-170,40,-130,1253,1278,2531,5542
-70,50,180,1253,1278,2531,5793
-70,50,-180,1253,1278,2531,5793
-120,40,-140,1245,1287,2532,5896
-120,50,-130,1241,1291,2532,5623
-110,70,-130,1243,1289,2532,5793
-80,70,110,1218,1314,2532,5773
-20,-20,80,1243,1289,2532,5503
-170,-10,-70,1255,1277,2532,5745
0,-20,90,1254,1279,2533,5828
170,10,-70,1259,1274,2533,5763
160,50,-50,1252,1281,2533,5782
-120,60,170,1235,1298,2533,5821
-170,-10,-60,1243,1290,2533,5786
0,40,60,1251,1283,2534,5770
-50,70,160,1250,1284,2534,5564
-30,50,40,1228,1306,2534,5907
-50,50,160,1235,1299,2534,5753
20,-30,80,1229,1306,2535,5911
-170,0,-90,1257,1278,2535,5828
-140,10,-120,1238,1297,2535,5860
140,30,-90,1244,1291,2535,5699
-20,10,110,1209,1326,2535,5820
-50,-30,50,1235,1300,2535,5684
-80,-30,0,1232,1304,2536,5640
120,70,-20,1257,1279,2536,5670
-150,20,-60,1248,1288,2536,5743
-40,40,80,1233,1303,2536,5558
-10,-80,50,1249,1287,2536,5745
-20,40,70,1229,1307,2536,5488
0,-80,60,1250,1286,2536,5783
70,70,-40,1233,1303,2536,5815
-10,-30,80,1248,1288,2536,5801
-110,30,-140,1223,1314,2537,6011
-110,40,-150,1234,1303,2537,5815
-140,40,-90,1223,1314,2537,5649
-60,-70,10,1214,1324,2538,5731
-70,-80,0,1244,1294,2538,5782
-20,30,60,1241,1298,2539,5386
-70,-50,-10,1242,1297,2539,5896
-170,70,-70,1225,1314,2539,5797
-30,70,50,1238,1301,2539,5689
-10,-20,90,1274,1265,2539,5623
10,-50,90,1243,1297,2540,5733
-150,60,-160,1238,1302,2540,5637
-60,50,110,1225,1315,2540,5610
-10,40,60,1264,1277,2541,5513
20,50,10,1251,1290,2541,5900
20,-70,100,1255,1286,2541,5926
-70,-60,-10,1254,1287,2541,5825
-10,30,110,1237,1304,2541,5794
-80,60,120,1231,1310,2541,5649
0,-70,40,1249,1293,2542,5687
70,60,10,1255,1287,2542,5773
110,80,-80,1245,1297,2542,5779
160,70,-130,1228,1314,2542,5691
-100,-50,-10,1216,1326,2542,5640
-20,50,30,1254,1288,2542,5786
0,30,80,1265,1277,2542,5637
-180,70,-140,1242,1301,2543,5522
-160,20,-80,1261,1282,2543,5706
180,70,-140,1242,1301,2543,5522
-50,50,70,1222,1321,2543,5711
0,10,60,1251,1293,2544,5759
20,50,40,1259,1285,2544,5548
100,80,-70,1248,1296,2544,5728
-160,20,-120,1241,1303,2544,5728
-90,50,-160,1224,1320,2544,5625
-100,50,-160,1228,1316,2544,5767
-60,-40,30,1249,1296,2545,5752
-140,20,-110,1242,1303,2545,5753
130,60,-90,1248,1298,2546,5698
-110,20,-130,1221,1325,2546,5815
0,30,90,1247,1299,2546,5861
60,80,-30,1229,1317,2546,5805
-180,0,-90,1262,1284,2546,5766
180,0,-90,1262,1284,2546,5766
-110,60,160,1223,1323,2546,5771
-160,0,-60,1231,1315,2546,5821
-110,-30,-40,1221,1326,2547,5645
-70,50,130,1238,1309,2547,5618
0,-50,30,1231,1316,2547,5664
-70,-60,0,1233,1314,2547,5589
-50,-30,10,1205,1342,2547,5538
0,-80,70,1266,1281,2547,5790
-90,50,-170,1217,1330,2547,5857
-150,30,-80,1221,1326,2547,5611
-110,50,-160,1244,1303,2547,5688
-150,40,-70,1224,1323,2547,5996
-20,0,50,1248,1300,2548,5489
-50,50,110,1234,1314,2548,5589
-80,-50,0,1240,1308,2548,5815
-80,-30,20,1228,1321,2549,5769
-70,-20,20,1222,1327,2549,5771
-90,-50,0,1234,1315,2549,5739
-20,40,40,1251,1298,2549,5840
-40,40,60,1220,1329,2549,5841
-30,-20,20,1238,1311,2549,5730
-30,40,50,1258,1292,2550,5841
0,20,70,1256,1294,2550,5640
10,-70,90,1264,1286,2550,5931
-160,-10,-40,1242,1308,2550,5919
-180,0,-60,1239,1312,2551,5931
180,0,-60,1239,1312,2551,5931
20,-40,60,1237,1314,2551,5809
-80,-40,-20,1230,1321,2551,5578
-170,70,-150,1242,1309,2551,5601
-40,-70,40,1256,1295,2551,5629
-40,-70,10,1235,1316,2551,5627
-60,-20,30,1245,1306,2551,5731
-10,-40,30,1250,1301,2551,5600
-150,80,-180,1238,1313,2551,5587
-150,80,180,1238,1313,2551,5587
-40,90,70,1231,1321,2552,5650
180,90,-150,1231,1321,2552,5650
120,90,-90,1231,1321,2552,5650
-10,90,40,1231,1321,2552,5650
-160,90,-170,1231,1321,2552,5650
40,90,-10,1231,1321,2552,5650
-120,90,150,1231,1321,2552,5650
-110,90,140,1231,1321,2552,5650
-80,90,110,1231,1321,2552,5650
170,90,-140,1231,1321,2552,5650
150,90,-120,1231,1321,2552,5650
-150,20,-120,1261,1291,2552,5717
-140,90,170,1231,1321,2552,5650
-60,90,90,1231,1321,2552,5650
-130,90,160,1231,1321,2552,5650
0,90,30,1231,1321,2552,5650
-150,90,-180,1231,1321,2552,5650
140,90,-110,1231,1321,2552,5650
70,90,-40,1231,1321,2552,5650
60,90,-30,1231,1321,2552,5650
50,90,-20,1231,1321,2552,5650
100,90,-70,1231,1321,2552,5650
-150,90,180,1231,1321,2552,5650
-20,90,50,1231,1321,2552,5650
170,10,-90,1268,1284,2552,5782
-100,90,130,1231,1321,2552,5650
160,90,-130,1231,1321,2552,5650
-170,90,-160,1231,1321,2552,5650
20,90,10,1231,1321,2552,5650
10,90,20,1231,1321,2552,5650
90,90,-60,1231,1321,2552,5650
30,90,0,1231,1321,2552,5650
-30,90,60,1231,1321,2552,5650
-50,90,80,1231,1321,2552,5650
130,90,-100,1231,1321,2552,5650
80,90,-50,1231,1321,2552,5650
-180,90,-150,1231,1321,2552,5650
110,90,-80,1231,1321,2552,5650
-90,90,120,1231,1321,2552,5650
-70,90,100,1231,1321,2552,5650
-80,50,-170,1238,1315,2553,5776
-50,80,160,1231,1322,2553,5769
-40,-30,60,1246,1307,2553,5768
-120,50,-140,1236,1317,2553,5572
-90,-40,-20,1262,1291,2553,5755
-100,50,-170,1254,1299,2553,5839
-150,50,-150,1226,1328,2554,5838
-160,10,-70,1255,1299,2554,5854
-40,50,50,1214,1340,2554,5796
-130,50,-110,1231,1324,2555,5501
20,-60,60,1248,1308,2556,5907
-150,50,-80,1235,1321,2556,5914
-60,-40,0,1247,1309,2556,5659
-100,-40,-10,1257,1300,2557,5566
0,-10,50,1245,1312,2557,5761
-10,30,70,1252,1305,2557,5654
180,60,-140,1254,1303,2557,5538
10,-80,80,1271,1286,2557,5807
-180,60,-140,1254,1303,2557,5538
-110,-40,-20,1245,1312,2557,5650
-110,80,140,1212,1346,2558,5719
-120,70,-120,1252,1306,2558,5767
-160,20,-110,1259,1299,2558,5906
-50,60,160,1248,1310,2558,5845
-150,20,-110,1250,1309,2559,5925
-50,-70,20,1224,1335,2559,5815
-30,0,50,1254,1306,2560,5671
0,50,80,1256,1304,2560,5663
-20,20,70,1251,1309,2560,5693
10,-10,80,1230,1330,2560,5894
-50,-80,20,1254,1306,2560,5821
-70,60,100,1251,1310,2561,5604
-40,-60,40,1256,1305,2561,5740
150,20,-90,1258,1303,2561,5875
-60,-60,-10,1259,1302,2561,5728
10,-30,80,1271,1291,2562,5931
-160,0,-50,1248,1314,2562,5928
-60,-50,30,1243,1319,2562,5770
-140,80,170,1229,1333,2562,5537
-60,40,160,1252,1310,2562,5850
-10,70,30,1263,1299,2562,5707
10,-60,90,1276,1287,2563,5890
20,-50,80,1272,1291,2563,5889
-20,-40,20,1256,1307,2563,5637
-160,-10,-50,1259,1304,2563,5858
0,40,50,1268,1295,2563,5646
-180,30,-60,1271,1292,2563,5970
180,30,-60,1271,1292,2563,5970
-160,60,-150,1245,1319,2564,5686
-20,-80,50,1260,1304,2564,5805
-40,50,150,1255,1309,2564,5784
-80,60,-170,1273,1292,2565,5819
20,50,50,1269,1296,2565,5859
-170,10,-90,1277,1288,2565,5709
-60,50,100,1217,1348,2565,5794
-130,80,160,1227,1338,2565,5585
-80,-50,-10,1273,1292,2565,5716
0,20,90,1244,1321,2565,5921
-160,20,-100,1259,1306,2565,5854
-60,-80,10,1259,1306,2565,5809
-10,40,70,1278,1287,2565,5689
30,-60,100,1275,1291,2566,6088
-130,30,-130,1265,1301,2566,5959
-160,20,-70,1266,1300,2566,5686
180,0,-80,1271,1296,2567,5892
-180,0,-80,1271,1296,2567,5892
10,-80,70,1281,1286,2567,5870
100,60,-10,1268,1300,2568,5786
170,30,-110,1289,1279,2568,5906
-90,-30,0,1260,1308,2568,5935
-130,30,-140,1256,1313,2569,5901
-10,-10,90,1268,1301,2569,5772
-100,80,130,1218,1351,2569,5758
-150,30,-70,1247,1323,2570,5824
-50,-70,-10,1283,1287,2570,5763
-50,50,100,1264,1306,2570,5744
-140,70,-180,1252,1319,2571,5674
-30,-80,40,1274,1297,2571,5815
-20,70,40,1262,1309,2571,5691
-140,70,180,1252,1319,2571,5674
-160,80,-170,1246,1325,2571,5668
0,40,30,1289,1283,2572,5808
-130,70,-110,1254,1318,2572,5761
-60,50,120,1254,1318,2572,5608
-30,50,90,1251,1321,2572,5563
-140,70,-100,1253,1319,2572,5697
160,80,-130,1243,1330,2573,5850
80,60,-30,1264,1309,2573,5872
-10,-80,60,1272,1301,2573,5801
-30,-10,80,1259,1314,2573,5725
-70,-50,10,1268,1305,2573,5755
-160,70,-160,1244,1330,2574,5724
-70,-70,-10,1248,1326,2574,5888
-20,40,50,1265,1309,2574,5755
-160,70,-80,1263,1311,2574,5744
-70,-40,0,1258,1316,2574,5824
-80,-40,-10,1273,1301,2574,5705
-130,20,-130,1258,1316,2574,5910
-100,-40,-30,1272,1303,2575,5719
140,70,-110,1248,1327,2575,5796
-40,30,130,1250,1325,2575,5733
140,30,-80,1262,1313,2575,5853
-30,40,70,1248,1327,2575,5668
-60,70,170,1273,1302,2575,5670
-120,80,150,1229,1347,2576,5611
130,40,-80,1240,1336,2576,5834
-30,-70,50,1261,1315,2576,5845
-130,50,-130,1263,1313,2576,5644
10,-30,50,1249,1327,2576,5741
0,0,60,1261,1316,2577,5715
120,80,-90,1247,1330,2577,5832
-170,20,-110,1249,1328,2577,5780
150,40,-60,1265,1312,2577,5810
-100,50,170,1255,1322,2577,5810
40,60,-10,1245,1333,2578,5914
-180,80,-150,1243,1335,2578,5757
20,-80,80,1283,1295,2578,5828
-140,30,-100,1260,1318,2578,5754
-80,50,180,1250,1328,2578,5838
-70,50,150,1250,1328,2578,5732
-140,60,-170,1252,1326,2578,5866
-110,50,180,1259,1319,2578,5910
-80,50,-180,1250,1328,2578,5838
180,80,-150,1243,1335,2578,5757
-70,-50,20,1255,1323,2578,5868
-110,50,-180,1259,1319,2578,5910
-140,50,-120,1267,1311,2578,5616
0,70,20,1265,1314,2579,5782
-170,10,-60,1262,1317,2579,5919
-40,20,100,1244,1335,2579,5755
-40,-20,20,1251,1328,2579,5677
150,30,-70,1279,1300,2579,5929
130,50,-40,1250,1330,2580,5693
-20,40,60,1269,1311,2580,5514
-150,70,-90,1253,1327,2580,5675
-30,40,80,1236,1344,2580,5673
-150,30,-90,1241,1340,2581,5798
-150,70,-170,1258,1323,2581,5733
-20,-50,10,1243,1339,2582,5786
-10,10,100,1262,1320,2582,5793
-70,-50,0,1256,1326,2582,5803
-160,50,-140,1253,1329,2582,5664
60,70,-30,1242,1340,2582,5910
-20,10,60,1270,1313,2583,5697
-80,60,130,1244,1339,2583,5739
0,-50,80,1258,1325,2583,5629
-50,40,150,1266,1317,2583,6009
0,50,20,1256,1327,2583,5883
-170,20,-100,1279,1305,2584,5821
-10,40,50,1275,1309,2584,5371
-70,-40,20,1254,1330,2584,5869
-90,50,180,1258,1327,2585,5910
-90,50,-180,1258,1327,2585,5910
50,70,40,1265,1320,2585,5773
90,60,-40,1265,1320,2585,5811
-60,-30,30,1274,1311,2585,6010
160,30,-110,1281,1305,2586,5817
0,-60,80,1281,1305,2586,5727
-80,50,150,1255,1331,2586,5757
-130,50,-120,1272,1315,2587,5745
-80,50,170,1239,1348,2587,5915
-40,50,100,1258,1329,2587,5598
-90,50,160,1256,1332,2588,5741
-40,-80,30,1273,1315,2588,5854
-50,50,80,1256,1332,2588,5884
60,70,30,1284,1304,2588,5855
-30,-40,60,1254,1334,2588,5819
-170,0,-80,1279,1309,2588,5899
-140,30,-140,1279,1310,2589,5729
130,40,-60,1282,1307,2589,5803
10,50,60,1287,1302,2589,5845
20,-40,80,1270,1319,2589,6069
170,80,-140,1258,1331,2589,5829
0,10,90,1271,1318,2589,5826
-10,-20,40,1275,1314,2589,5876
-120,50,-150,1270,1319,2589,5760
-170,0,-50,1267,1322,2589,5860
-110,-40,-30,1256,1333,2589,5841
0,-60,30,1258,1332,2590,5780
-40,-10,70,1262,1328,2590,5872
-140,20,-130,1277,1313,2590,5793
-120,70,160,1270,1320,2590,5794
20,-50,90,1266,1324,2590,6057
0,-40,40,1237,1353,2590,5751
-50,-40,40,1280,1311,2591,5753
-40,-70,0,1282,1309,2591,5869
-90,80,120,1234,1357,2591,5841
-130,40,-130,1249,1342,2591,5793
150,70,-120,1253,1338,2591,5897
-40,-50,10,1261,1330,2591,5650
-30,-40,20,1291,1301,2592,5754
-100,60,150,1265,1327,2592,5909
-10,-70,30,1271,1321,2592,5781
30,-70,80,1263,1329,2592,5866
20,-60,70,1296,1296,2592,5924
-80,-50,10,1250,1343,2593,5817
150,50,-110,1282,1311,2593,5816
-40,50,90,1249,1344,2593,5824
-130,50,-160,1251,1342,2593,5736
0,-20,50,1265,1328,2593,5713
40,-70,110,1257,1336,2593,6107
10,-40,80,1289,1304,2593,6109
-50,50,90,1245,1349,2594,5863
170,70,-130,1272,1322,2594,5551
140,80,-110,1253,1341,2594,5869
-150,40,-140,1246,1348,2594,5841
-20,-70,30,1276,1319,2595,5808
-170,80,-160,1250,1345,2595,5754
-50,-40,0,1269,1326,2595,5764
-140,30,-120,1281,1315,2596,5878
-60,-50,20,1272,1324,2596,5816
50,80,-20,1258,1338,2596,5886
-140,50,-150,1265,1332,2597,5866
150,80,-120,1265,1332,2597,5940
160,30,-70,1303,1294,2597,5926
-70,60,120,1244,1353,2597,5863
0,40,40,1271,1327,2598,5651
160,80,-50,1279,1319,2598,5885
-40,-40,50,1271,1328,2599,5853
140,40,-60,1277,1322,2599,5934
120,50,-70,1292,1307,2599,5954
40,-70,100,1280,1319,2599,6131
-110,70,150,1261,1338,2599,5832
160,60,-50,1294,1306,2600,6007
-10,-30,40,1279,1321,2600,5698
-60,80,170,1251,1349,2600,5817
-40,50,60,1246,1354,2600,5920
-70,70,100,1252,1349,2601,5858
-50,40,140,1247,1354,2601,5945
-50,-40,10,1279,1322,2601,5718
0,-70,80,1290,1311,2601,5892
-60,50,130,1258,1343,2601,5728
-100,60,-150,1281,1320,2601,5701
-70,50,160,1252,1349,2601,5861
40,70,50,1257,1345,2602,5941
-160,30,-60,1277,1325,2602,5916
-100,60,-160,1290,1312,2602,5682
-40,0,60,1268,1334,2602,5956
-90,60,-160,1288,1314,2602,5824
-30,-70,10,1288,1314,2602,5970
40,50,10,1267,1336,2603,6015
-50,60,70,1236,1367,2603,5841
10,50,50,1281,1322,2603,5883
-10,50,100,1287,1316,2603,5792
-130,60,-180,1271,1333,2604,5941
-20,30,120,1277,1327,2604,5976
140,60,-100,1264,1340,2604,5897
-130,60,180,1271,1333,2604,5941
170,20,-100,1303,1301,2604,5899
-40,30,90,1264,1340,2604,5739
-30,-70,20,1276,1328,2604,5740
-30,-10,40,1271,1334,2605,5796
140,50,-100,1284,1321,2605,5747
-60,-60,0,1275,1330,2605,5982
-140,40,-100,1258,1347,2605,5749
-80,80,110,1247,1359,2606,5844
-160,30,-100,1303,1303,2606,5772
130,80,-100,1255,1352,2607,5835
150,50,-50,1284,1323,2607,5940
-130,70,170,1269,1338,2607,5779
-30,30,130,1262,1345,2607,6122
-60,-70,0,1260,1348,2608,5959
-120,50,-170,1273,1335,2608,5840
-60,-50,0,1276,1332,2608,6010
-70,50,140,1272,1336,2608,5765
-10,-60,20,1269,1340,2609,5854
-170,10,-70,1277,1332,2609,5877
-10,20,70,1267,1342,2609,5756
-10,30,80,1263,1346,2609,5756
-10,20,100,1285,1324,2609,5997
-20,-70,60,1286,1324,2610,5934
10,-10,60,1277,1333,2610,5958
-140,30,-130,1283,1327,2610,5900
0,10,70,1284,1326,2610,5799
-20,-70,20,1275,1335,2610,5881
130,40,-70,1294,1317,2611,5907
70,70,20,1292,1319,2611,5911
-70,-30,20,1258,1353,2611,5996
-160,20,-90,1291,1320,2611,5730
160,20,-90,1281,1330,2611,5926
10,-10,70,1253,1358,2611,6143
-20,-40,30,1290,1322,2612,5752
0,-40,80,1304,1308,2612,5928
-140,20,-120,1287,1325,2612,5927
-20,-60,10,1262,1350,2612,5871
-10,50,30,1266,1347,2613,5873
-40,20,80,1266,1347,2613,5776
-100,70,140,1260,1354,2614,5895
-60,60,170,1280,1335,2615,5977
-30,-50,10,1293,1322,2615,5705
30,50,10,1274,1342,2616,6167
180,20,-60,1294,1322,2616,6094
-180,20,-60,1294,1322,2616,6094
-20,-30,30,1284,1332,2616,5852
0,50,70,1295,1321,2616,5929
-90,60,-170,1285,1331,2616,5723
-130,60,-110,1296,1321,2617,6060
120,50,-40,1262,1355,2617,5914
170,20,-80,1292,1325,2617,5870
110,60,-20,1304,1313,2617,5883
-120,60,-120,1281,1337,2618,5717
-30,60,130,1272,1346,2618,5886
-40,20,90,1255,1363,2618,5756
-40,50,80,1244,1375,2619,5920
-40,40,100,1274,1345,2619,5737
0,-70,50,1287,1332,2619,6011
-10,-50,20,1275,1344,2619,5971
-170,20,-80,1291,1328,2619,5906
-10,-70,70,1288,1331,2619,5900
-10,40,80,1296,1323,2619,5980
-140,30,-110,1287,1332,2619,5968
-50,40,130,1275,1344,2619,6053
40,80,60,1254,1366,2620,5861
30,80,70,1261,1359,2620,5892
0,20,80,1295,1326,2621,5807
160,40,-60,1304,1317,2621,5909
10,-70,60,1275,1346,2621,5973
-10,-70,40,1283,1339,2622,5867
-70,80,180,1270,1352,2622,5964
-40,-70,30,1264,1358,2622,5845
100,60,-50,1300,1322,2622,5874
-10,70,110,1248,1374,2622,5847
-150,30,-110,1304,1318,2622,5936
-170,30,-60,1283,1339,2622,6054
-70,80,-180,1270,1352,2622,5964
10,-20,80,1286,1337,2623,6072
-20,60,40,1271,1352,2623,6023
60,80,40,1257,1366,2623,5911
-20,-30,70,1298,1325,2623,5803
-70,60,180,1288,1335,2623,5963
-70,60,-180,1288,1335,2623,5963
-40,0,70,1276,1348,2624,6061
-40,60,60,1256,1368,2624,5922
-170,20,-90,1317,1307,2624,5943
-60,50,140,1275,1349,2624,5842
160,50,-120,1284,1340,2624,5927
-70,80,100,1265,1360,2625,5885
-130,40,-140,1287,1338,2625,5952
0,60,90,1277,1349,2626,5724
-60,-40,10,1291,1335,2626,6043
-30,-20,30,1279,1348,2627,6004
-100,-40,-20,1286,1341,2627,6075
-50,-60,0,1296,1331,2627,5869
-20,40,80,1295,1332,2627,5801
-150,30,-100,1296,1331,2627,5805
-150,40,-80,1252,1376,2628,5922
-10,10,60,1284,1344,2628,5910
-10,40,110,1293,1335,2628,5925
20,-60,90,1307,1321,2628,6211
-170,20,-60,1298,1330,2628,6081
170,80,-60,1278,1350,2628,5977
-150,30,-120,1297,1331,2628,5819
160,60,-120,1297,1332,2629,5949
-170,0,-70,1302,1327,2629,6085
-160,50,-70,1287,1342,2629,6132
-90,60,140,1268,1361,2629,5877
-40,-60,0,1305,1324,2629,5956
10,60,10,1278,1351,2629,6030
20,80,80,1272,1357,2629,5936
20,-50,70,1290,1339,2629,6105
-50,-20,50,1293,1336,2629,6000
180,60,-60,1298,1332,2630,5881
-160,30,-120,1296,1334,2630,5815
-20,50,120,1275,1355,2630,6001
-180,60,-60,1298,1332,2630,5881
-110,60,-150,1297,1334,2631,5866
-40,-20,30,1264,1367,2631,5748
-170,10,-80,1294,1337,2631,5935
10,-40,50,1277,1354,2631,5834
110,70,-70,1278,1354,2632,5950
-30,20,110,1273,1359,2632,6055
-40,-10,40,1263,1369,2632,5942
-90,60,180,1278,1354,2632,6059
-90,60,-180,1278,1354,2632,6059
-150,30,-130,1289,1343,2632,5898
-70,60,110,1263,1370,2633,5896
50,80,50,1252,1381,2633,5868
0,50,60,1295,1338,2633,5914
150,30,-100,1302,1331,2633,5886
30,-60,90,1297,1336,2633,6051
170,40,-120,1309,1324,2633,5896
-170,0,-60,1275,1358,2633,6215
-50,-70,10,1266,1367,2633,5993
-160,40,-130,1274,1359,2633,5851
120,70,-80,1288,1346,2634,5901
-90,-40,0,1270,1364,2634,5939
-20,30,80,1272,1362,2634,5755
-20,50,40,1268,1366,2634,6000
160,70,-120,1272,1362,2634,5695
-50,-30,20,1289,1346,2635,6103
-40,-20,60,1275,1360,2635,6026
130,70,-30,1298,1337,2635,5905
-140,40,-120,1264,1371,2635,5924
-10,-10,50,1294,1342,2636,5993
50,60,-10,1294,1342,2636,6028
140,50,-50,1289,1347,2636,5986
-170,30,-120,1281,1355,2636,5909
-60,-60,10,1286,1350,2636,5826
140,40,-90,1280,1356,2636,5906
140,60,-40,1313,1323,2636,5990
30,-70,100,1308,1329,2637,6218
-60,-30,20,1292,1345,2637,6000
-10,-60,70,1299,1338,2637,5803
-80,60,140,1270,1367,2637,5803
30,70,60,1268,1369,2637,6046
-150,40,-90,1273,1365,2638,5866
-70,70,-180,1304,1334,2638,5852
-70,70,180,1304,1334,2638,5852
-140,50,-100,1283,1355,2638,5767
-70,60,150,1289,1349,2638,5904
120,50,-50,1292,1347,2639,5997
-60,50,150,1284,1355,2639,5914
-10,-50,70,1283,1356,2639,5796
-70,-40,10,1277,1362,2639,5931
-170,40,-60,1301,1339,2640,6196
-10,-20,80,1298,1342,2640,5856
-180,10,-90,1313,1327,2640,6027
180,10,-90,1313,1327,2640,6027
-80,-40,0,1269,1371,2640,5958
-20,20,110,1279,1362,2641,6071
-50,-50,10,1295,1346,2641,6039
-130,40,-150,1288,1354,2642,6037
40,80,-10,1270,1372,2642,5962
-80,60,170,1283,1359,2642,6073
170,40,-60,1323,1319,2642,5972
100,70,-60,1289,1354,2643,5934
10,-20,60,1294,1349,2643,6079
-80,70,-170,1310,1333,2643,5889
-140,40,-110,1292,1351,2643,5907
-90,60,160,1295,1349,2644,5666
0,-30,50,1291,1353,2644,5770
-120,60,-140,1290,1354,2644,5968
10,50,20,1299,1346,2645,6090
-70,50,170,1284,1361,2645,5934
20,-70,70,1299,1347,2646,5973
-140,60,-130,1303,1343,2646,5795
-60,60,110,1268,1378,2646,5923
0,80,100,1291,1355,2646,5882
-10,60,30,1292,1354,2646,6006
10,80,90,1294,1352,2646,5881
-150,40,-110,1304,1342,2646,5909
-120,60,180,1281,1365,2646,5893
-120,60,-180,1281,1365,2646,5893
-50,-50,30,1309,1338,2647,5940
170,60,-130,1302,1345,2647,5773
10,-50,80,1311,1336,2647,5987
180,40,-120,1310,1337,2647,5926
-180,40,-120,1310,1337,2647,5926
80,80,20,1281,1367,2648,5957
-20,50,80,1306,1342,2648,5792
-30,10,70,1293,1355,2648,5933
-40,10,80,1294,1354,2648,5891
90,80,10,1294,1354,2648,5993
-130,50,-140,1297,1352,2649,5913
-60,60,90,1288,1361,2649,5819
-10,0,90,1296,1353,2649,5977
-80,80,-170,1289,1360,2649,5969
-60,80,90,1270,1380,2650,5883
30,60,50,1307,1343,2650,6039
-110,60,-140,1303,1347,2650,5904
-30,50,50,1281,1370,2651,6063
-40,50,70,1281,1370,2651,5952
70,60,-20,1305,1346,2651,6152
150,60,-110,1310,1341,2651,5844
-10,-40,40,1297,1354,2651,5800
70,80,30,1273,1378,2651,5890
-80,-30,10,1275,1376,2651,6119
-100,60,170,1304,1347,2651,5639
180,10,-60,1278,1373,2651,6187
-180,10,-60,1278,1373,2651,6187
-160,30,-70,1312,1340,2652,6060
-40,-40,10,1311,1341,2652,5855
-100,60,-170,1287,1365,2652,5955
-130,70,-140,1316,1336,2652,5958
10,-50,50,1294,1359,2653,6024
-30,-20,70,1300,1353,2653,6000
-150,50,-110,1292,1362,2654,5885
-90,70,130,1268,1386,2654,6011
-70,60,140,1297,1357,2654,5909
-60,-40,20,1305,1350,2655,6032
-30,20,80,1293,1362,2655,5884
80,70,10,1324,1331,2655,5832
-10,40,90,1320,1335,2655,5771
-60,60,100,1275,1380,2655,5980
150,30,-80,1323,1333,2656,6185
-40,40,140,1287,1369,2656,6188
-10,80,110,1294,1362,2656,5972
-80,60,160,1300,1357,2657,5893
-140,50,-110,1300,1357,2657,5847
-40,-60,10,1304,1353,2657,6044
-40,-70,20,1269,1389,2658,5932
-110,60,170,1276,1382,2658,5873
-180,50,-130,1330,1328,2658,5874
180,50,-130,1330,1328,2658,5874
0,10,80,1278,1380,2658,6039
-130,60,-130,1282,1376,2658,5876
-50,60,110,1309,1350,2659,5996
130,50,-50,1284,1375,2659,6087
-40,30,120,1290,1369,2659,6007
-170,60,-140,1275,1385,2660,5855
-50,-20,40,1290,1370,2660,5978
-130,60,-140,1317,1343,2660,5815
-10,40,40,1303,1358,2661,5952
160,70,-50,1335,1326,2661,6163
20,-40,70,1300,1361,2661,6085
130,50,-80,1326,1335,2661,6082
20,70,70,1290,1372,2662,6103
160,30,-80,1328,1334,2662,6184
-10,40,100,1302,1360,2662,6133
-90,-40,-10,1286,1376,2662,6213
-140,60,-120,1309,1353,2662,5894
-120,60,-150,1311,1351,2662,5866
-140,40,-140,1303,1360,2663,6004
-80,60,180,1299,1364,2663,5892
-80,60,-180,1299,1364,2663,5892
-100,60,-180,1293,1371,2664,5839
-170,80,-80,1307,1357,2664,6018
20,50,30,1316,1348,2664,6026
-80,-40,10,1281,1383,2664,6162
-100,60,180,1293,1371,2664,5839
-110,60,-170,1293,1371,2664,5705
0,-20,80,1309,1355,2664,5996
20,60,60,1303,1361,2664,6145
180,50,-60,1311,1354,2665,6226
-20,10,100,1279,1386,2665,5975
-130,60,-170,1288,1377,2665,5910
-180,80,-70,1296,1369,2665,6058
-180,50,-60,1311,1354,2665,6226
180,80,-70,1296,1369,2665,6058
-10,60,100,1308,1357,2665,5925
130,70,-90,1304,1362,2666,5962
-90,60,150,1282,1384,2666,5842
50,70,-20,1287,1379,2666,5928
-20,-20,40,1313,1354,2667,6011
30,80,0,1289,1378,2667,6000
20,-30,70,1289,1378,2667,6175
-40,30,100,1299,1368,2667,5914
0,-30,80,1339,1328,2667,6133
-60,-50,10,1307,1360,2667,5937
-30,50,70,1263,1405,2668,5928
-50,50,120,1279,1389,2668,5945
-120,50,-160,1327,1341,2668,5955
-10,10,90,1320,1348,2668,5948
-20,0,90,1307,1361,2668,5985
100,80,0,1301,1367,2668,6082
-30,-70,40,1289,1380,2669,5961
-160,30,-110,1303,1366,2669,6061
-30,40,90,1300,1369,2669,5826
-20,-60,60,1300,1370,2670,6017
20,80,10,1290,1380,2670,6056
-60,60,130,1301,1369,2670,5905
10,-40,70,1340,1331,2671,6125
-40,-30,50,1296,1375,2671,6127
-30,-30,20,1325,1346,2671,5986
0,-50,70,1313,1358,2671,6019
-10,80,40,1289,1382,2671,6041
-30,-70,30,1282,1389,2671,5891
-30,60,50,1268,1404,2672,6047
140,70,-100,1305,1367,2672,5980
-30,-50,20,1311,1361,2672,5976
-150,50,-140,1305,1367,2672,5995
160,30,-100,1325,1348,2673,6000
180,10,-70,1295,1378,2673,6086
80,60,0,1311,1362,2673,6053
-180,10,-70,1295,1378,2673,6086
140,40,-80,1330,1344,2674,6105
-110,60,180,1305,1369,2674,5825
0,60,20,1307,1367,2674,6063
-110,60,-180,1305,1369,2674,5825
-80,60,150,1309,1366,2675,5802
-130,60,-160,1284,1391,2675,5957
-40,80,70,1292,1383,2675,6012
-30,50,80,1298,1377,2675,5948
-120,60,-170,1295,1380,2675,5920
-70,60,160,1307,1369,2676,6013
170,20,-90,1324,1352,2676,6099
10,-60,50,1319,1358,2677,6154
-30,10,90,1316,1361,2677,6102
-70,60,130,1302,1375,2677,5939
110,60,-60,1308,1369,2677,5947
-50,60,100,1293,1385,2678,6038
-50,80,80,1299,1380,2679,6000
-120,60,-130,1307,1372,2679,5907
-120,70,-150,1339,1340,2679,6034
-30,-60,50,1307,1372,2679,5989
180,20,-100,1324,1356,2680,6074
-180,20,-100,1324,1356,2680,6074
-50,40,120,1289,1392,2681,6131
-40,-40,20,1319,1362,2681,6035
-90,60,170,1308,1373,2681,5961
0,50,30,1330,1352,2682,6197
110,80,-10,1306,1376,2682,6139
-60,70,90,1282,1400,2682,6024
-20,80,50,1293,1389,2682,5994
-30,80,60,1296,1387,2683,6025
-40,30,110,1295,1388,2683,6166
-140,60,-100,1310,1373,2683,6089
-50,-20,30,1297,1386,2683,6033
150,70,-110,1296,1388,2684,5794
-160,30,-80,1314,1371,2685,6013
-70,60,170,1317,1368,2685,6033
-160,40,-70,1318,1368,2686,6332
-10,-40,70,1316,1370,2686,6107
30,50,20,1312,1374,2686,6273
-170,50,-130,1297,1390,2687,5877
-50,-60,20,1308,1379,2687,6169
-150,40,-130,1325,1362,2687,5870
-40,-10,50,1299,1389,2688,6017
-20,50,70,1315,1373,2688,5865
-40,-30,20,1282,1406,2688,6022
-20,80,120,1315,1373,2688,6029
-150,60,-90,1314,1374,2688,6113
-30,0,80,1305,1384,2689,5961
150,40,-100,1321,1368,2689,6014
-110,80,-140,1321,1368,2689,6118
-170,70,-140,1307,1383,2690,5961
-110,60,-160,1308,1382,2690,6017
180,20,-80,1323,1367,2690,6013
-180,20,-80,1323,1367,2690,6013
20,-70,90,1330,1360,2690,6317
-140,50,-130,1314,1376,2690,6035
-40,60,140,1306,1385,2691,6135
10,80,20,1296,1395,2691,6080
-10,50,60,1328,1363,2691,5858
-60,60,140,1325,1366,2691,5915
-140,60,-160,1287,1405,2692,6010
-140,50,-140,1316,1376,2692,5906
120,60,-30,1343,1350,2693,6097
-20,50,110,1308,1385,2693,5986
-50,60,120,1304,1389,2693,5982
-130,50,-150,1315,1378,2693,6044
10,-60,60,1333,1361,2694,6127
-40,60,110,1304,1390,2694,5824
-20,70,120,1292,1402,2694,6006
-20,-70,50,1318,1376,2694,6083
10,-50,70,1342,1352,2694,6078
-100,60,160,1290,1405,2695,5934
-20,-50,20,1309,1386,2695,5920
-10,50,70,1329,1366,2695,6056
0,0,80,1309,1387,2696,6228
0,80,30,1294,1402,2696,6112
-120,60,-160,1316,1380,2696,5710
30,60,0,1309,1387,2696,6180
0,-40,60,1317,1380,2697,6120
40,60,30,1333,1365,2698,6092
-140,70,-130,1321,1377,2698,5978
30,-70,90,1325,1373,2698,6310
10,-60,70,1341,1357,2698,6195
-120,80,-130,1326,1372,2698,6067
-40,60,100,1310,1388,2698,5949
-170,20,-70,1324,1376,2700,6057
180,40,-60,1334,1366,2700,6166
-180,40,-60,1334,1366,2700,6166
-30,40,130,1309,1392,2701,6299
10,-30,60,1306,1395,2701,6053
-160,80,-90,1325,1376,2701,5968
-130,60,-120,1327,1375,2702,6000
-50,-60,10,1321,1381,2702,6167
10,-70,70,1335,1367,2702,6280
-170,60,-70,1313,1389,2702,6109
-50,50,130,1347,1355,2702,6139
-90,70,-160,1323,1380,2703,5934
-170,30,-110,1326,1377,2703,6041
120,60,-70,1323,1381,2704,6179
-140,40,-130,1320,1384,2704,6194
-10,20,80,1314,1390,2704,6061
120,50,-60,1354,1350,2704,6278
-150,40,-100,1337,1368,2705,6083
90,70,0,1343,1362,2705,5881
-90,80,-160,1308,1397,2705,6027
40,70,-10,1314,1392,2706,6091
-40,-10,60,1316,1390,2706,6265
90,70,-50,1313,1393,2706,6134
0,-10,80,1326,1381,2707,6185
0,-40,50,1328,1379,2707,6090
10,50,40,1330,1377,2707,5984
150,30,-90,1315,1392,2707,6079
-20,50,50,1308,1399,2707,6314
20,-70,80,1327,1380,2707,6302
-30,30,90,1314,1394,2708,6020
-60,60,120,1325,1383,2708,6010
-130,80,-120,1313,1395,2708,6114
-30,-30,60,1327,1381,2708,6316
-100,80,-150,1321,1387,2708,6069
-20,-70,40,1307,1402,2709,5981
-20,50,60,1320,1390,2710,6099
10,-70,80,1331,1379,2710,6313
-40,60,90,1320,1390,2710,6135
-20,40,120,1340,1370,2710,6270
-130,60,-150,1310,1400,2710,5785
160,40,-110,1332,1379,2711,6194
-150,50,-90,1315,1396,2711,6173
-30,50,130,1305,1406,2711,6249
180,30,-110,1335,1377,2712,6160
10,70,80,1309,1403,2712,6105
-50,60,90,1293,1419,2712,6022
180,10,-80,1337,1375,2712,6391
-180,30,-110,1335,1377,2712,6160
-180,10,-80,1337,1375,2712,6391
-140,80,-110,1321,1392,2713,6086
120,80,-20,1327,1386,2713,6239
20,-60,80,1337,1377,2714,6141
-60,60,160,1339,1376,2715,6148
-10,-50,60,1326,1389,2715,6161
-50,70,80,1291,1424,2715,6073
-100,80,140,1302,1414,2716,6068
-150,80,-100,1329,1387,2716,6009
-80,70,120,1302,1414,2716,6119
100,60,-40,1343,1374,2717,6214
-50,-30,40,1327,1390,2717,6193
-160,40,-80,1308,1409,2717,6229
160,30,-90,1330,1388,2718,6026
0,-70,60,1324,1394,2718,6184
-10,-70,50,1315,1403,2718,6126
-60,50,160,1334,1384,2718,6140
-170,30,-100,1332,1387,2719,6177
-50,60,150,1322,1397,2719,6290
-50,50,150,1333,1386,2719,6261
-10,30,90,1321,1399,2720,6070
20,50,20,1320,1400,2720,6331
160,50,-60,1340,1380,2720,6236
-140,60,-150,1316,1405,2721,6075
20,60,10,1340,1381,2721,6195
-10,50,90,1326,1395,2721,6123
-160,30,-90,1325,1396,2721,6096
-140,60,-110,1339,1382,2721,6021
170,20,-70,1346,1375,2721,6306
10,-60,80,1344,1378,2722,6362
-110,70,-160,1353,1369,2722,6138
-170,30,-70,1337,1386,2723,6170
-20,-50,60,1321,1402,2723,6175
0,-40,70,1352,1372,2724,6147
-30,50,60,1317,1407,2724,6121
-160,70,-150,1325,1399,2724,6066
-50,60,130,1327,1397,2724,6037
-160,40,-120,1343,1381,2724,6020
-100,70,-170,1348,1376,2724,6101
-30,80,130,1334,1390,2724,6142
-130,70,-180,1336,1389,2725,6096
-10,0,60,1318,1407,2725,6289
-160,50,-130,1333,1392,2725,6021
-130,70,180,1336,1389,2725,6096
-40,40,130,1331,1394,2725,6248
0,50,50,1341,1385,2726,5972
10,60,70,1318,1408,2726,6229
10,-30,70,1338,1389,2727,6245
-30,-50,50,1324,1403,2727,6313
140,70,-40,1338,1389,2727,6246
-150,40,-120,1335,1392,2727,6267
-70,70,110,1314,1414,2728,6220
-40,-50,40,1339,1389,2728,6112
-170,40,-120,1325,1403,2728,6165
-160,60,-80,1340,1388,2728,6241
-110,70,160,1313,1416,2729,6032
-10,50,40,1336,1393,2729,6295
-170,30,-90,1356,1373,2729,6189
-30,-30,30,1332,1397,2729,6175
-60,60,150,1332,1397,2729,6114
0,0,70,1320,1410,2730,6182
-90,70,170,1348,1382,2730,5984
-30,0,60,1320,1410,2730,6345
0,70,90,1325,1405,2730,6122
-40,-30,10,1325,1406,2731,6042
-30,60,100,1339,1392,2731,5991
-20,-10,50,1332,1399,2731,6209
100,70,-10,1346,1385,2731,6001
-120,80,160,1323,1408,2731,6170
-20,-50,30,1351,1380,2731,6200
-120,70,170,1329,1403,2732,6075
50,60,20,1362,1370,2732,6107
-40,50,110,1325,1409,2734,6188
0,-70,70,1348,1386,2734,6134
-110,70,-140,1340,1394,2734,6131
130,60,-80,1334,1400,2734,6232
-150,50,-130,1360,1374,2734,6042
-50,60,80,1314,1421,2735,6089
-50,50,140,1341,1395,2736,6130
10,-40,60,1335,1402,2737,6267
-30,-60,10,1350,1388,2738,6172
30,60,40,1364,1375,2739,6162
-20,-40,60,1321,1418,2739,6312
0,-50,60,1358,1381,2739,6282
0,-60,70,1341,1398,2739,6120
-40,60,130,1330,1409,2739,6095
0,60,80,1338,1402,2740,6253
80,70,-40,1342,1398,2740,6258
-110,80,150,1328,1412,2740,6125
-10,20,90,1357,1383,2740,6321
90,60,-30,1346,1395,2741,6254
60,60,-10,1333,1408,2741,6474
-100,70,-150,1337,1404,2741,6143
140,40,-70,1347,1394,2741,6265
-150,60,-150,1332,1409,2741,6099
-30,70,130,1332,1409,2741,6060
-30,60,90,1327,1414,2741,6047
-20,-60,20,1356,1385,2741,6280
-50,-40,30,1356,1386,2742,6248
170,30,-70,1356,1386,2742,6268
-10,50,80,1364,1379,2743,6277
-140,70,-170,1357,1386,2743,6129
80,60,-20,1351,1392,2743,6432
-40,80,140,1346,1397,2743,6128
-90,80,130,1330,1414,2744,6144
-40,50,140,1349,1395,2744,6419
-20,20,100,1332,1412,2744,6107
180,20,-90,1362,1383,2745,6288
-180,20,-90,1362,1383,2745,6288
-120,70,-130,1346,1399,2745,6118
-10,-70,60,1351,1395,2746,6118
-150,60,-110,1348,1398,2746,6178
-70,70,150,1347,1399,2746,6145
-150,70,-160,1351,1396,2747,6112
-20,-10,80,1355,1392,2747,6141
40,70,40,1347,1400,2747,6140
-150,60,-120,1331,1416,2747,6271
10,-50,60,1362,1385,2747,6357
-140,60,-140,1336,1411,2747,6164
-80,70,160,1355,1393,2748,6112
-160,40,-90,1343,1405,2748,6192
40,60,0,1340,1409,2749,6419
-130,80,170,1334,1415,2749,6218
-40,60,80,1314,1435,2749,6174
60,60,10,1344,1406,2750,6269
-40,50,130,1322,1428,2750,6274
-10,-50,30,1345,1405,2750,6134
140,50,-90,1342,1408,2750,6155
170,70,-60,1367,1383,2750,6436
-20,60,110,1366,1384,2750,6079
50,70,30,1357,1394,2751,6182
-170,40,-110,1346,1405,2751,6390
-10,10,70,1322,1429,2751,6227
-30,-20,40,1335,1416,2751,6260
-100,70,180,1352,1400,2752,6041
-90,70,-180,1334,1418,2752,6086
-100,70,-180,1352,1400,2752,6041
-90,70,180,1334,1418,2752,6086
110,80,-70,1333,1420,2753,6289
-150,50,-120,1334,1419,2753,6240
-80,80,120,1329,1424,2753,6208
-70,70,120,1332,1422,2754,6078
0,-60,60,1346,1409,2755,6201
-150,80,-170,1361,1394,2755,6255
100,80,-60,1345,1410,2755,6306
-40,40,110,1323,1432,2755,6397
-100,70,150,1319,1436,2755,6017
180,20,-70,1362,1394,2756,6449
-10,50,50,1350,1406,2756,6213
-180,20,-70,1362,1394,2756,6449
-40,60,120,1345,1411,2756,6093
0,-50,40,1343,1414,2757,6137
-150,50,-100,1323,1434,2757,6201
-40,40,120,1340,1417,2757,6291
70,60,0,1343,1414,2757,6252
-160,40,-100,1355,1403,2758,6106
-10,-60,60,1361,1397,2758,6030
10,50,30,1348,1410,2758,6375
10,-20,70,1332,1427,2759,6452
-50,-40,20,1348,1411,2759,6349
-170,40,-70,1367,1393,2760,6477
-30,20,100,1346,1415,2761,6253
-50,-50,20,1363,1399,2762,6212
90,60,-10,1334,1428,2762,6542
-50,70,150,1356,1406,2762,6185
30,70,0,1340,1423,2763,6364
-20,50,100,1378,1385,2763,6151
-20,50,90,1382,1382,2764,6146
-60,70,110,1326,1438,2764,6067
-30,-40,30,1366,1398,2764,6242
-30,30,120,1334,1430,2764,6359
-90,70,140,1318,1447,2765,6160
-80,70,170,1347,1419,2766,6166
0,-10,60,1345,1421,2766,6071
-40,-50,20,1355,1411,2766,6400
-40,70,70,1322,1444,2766,6231
-30,60,110,1363,1403,2766,6267
-30,-10,50,1336,1431,2767,6261
150,60,-50,1384,1383,2767,6286
-10,-20,50,1348,1419,2767,6192
-30,-10,70,1328,1439,2767,6251
-60,70,130,1357,1410,2767,6302
-30,40,120,1366,1401,2767,6408
180,40,-110,1353,1415,2768,6259
-10,-30,70,1342,1426,2768,6277
-180,40,-110,1353,1415,2768,6259
-20,10,70,1323,1445,2768,6327
150,50,-60,1344,1425,2769,6301
-60,70,100,1324,1445,2769,6199
-170,30,-80,1366,1403,2769,6352
170,30,-80,1369,1401,2770,6334
170,50,-60,1367,1403,2770,6402
180,30,-70,1382,1388,2770,6408
-180,30,-70,1382,1388,2770,6408
-30,60,120,1362,1408,2770,6208
-20,-50,50,1341,1429,2770,6452
-140,80,-180,1351,1420,2771,6260
160,40,-70,1400,1371,2771,6348
170,50,-120,1355,1416,2771,6251
-180,60,-130,1341,1430,2771,6136
180,60,-130,1341,1430,2771,6136
-110,70,-170,1376,1395,2771,6011
-140,80,180,1351,1420,2771,6260
180,70,-130,1346,1426,2772,6144
-180,70,-130,1346,1426,2772,6144
-70,70,140,1352,1420,2772,6209
110,60,-50,1368,1405,2773,6365
170,40,-70,1373,1400,2773,6270
-130,70,-120,1343,1430,2773,6145
-90,70,150,1335,1439,2774,6189
-10,-10,80,1350,1425,2775,6284
-140,70,-110,1378,1397,2775,6296
90,80,-50,1352,1423,2775,6309
-30,20,90,1353,1422,2775,6370
150,40,-70,1366,1410,2776,6512
-50,70,100,1347,1429,2776,6192
-160,40,-110,1365,1411,2776,6326
-30,10,80,1339,1438,2777,6326
-60,70,120,1348,1429,2777,6223
-10,70,100,1354,1423,2777,6238
-20,40,90,1356,1422,2778,6345
10,60,20,1363,1415,2778,6307
-60,70,140,1360,1418,2778,6282
-20,40,100,1357,1422,2779,6320
-160,80,-160,1383,1396,2779,6328
-10,30,100,1347,1432,2779,6413
-160,50,-120,1362,1417,2779,6525
-100,70,170,1355,1424,2779,6160
-40,70,140,1358,1422,2780,6241
0,-30,60,1348,1432,2780,6276
180,30,-100,1360,1420,2780,6302
130,80,-30,1360,1420,2780,6400
-180,30,-100,1360,1420,2780,6302
170,30,-100,1371,1409,2780,6314
0,-50,50,1369,1412,2781,6496
-170,80,-150,1370,1411,2781,6366
-30,50,100,1367,1414,2781,6277
120,80,-80,1346,1435,2781,6314
-90,70,160,1367,1414,2781,6102
140,80,-100,1342,1440,2782,6393
-180,40,-70,1380,1402,2782,6328
180,40,-70,1380,1402,2782,6328
130,80,-90,1342,1440,2782,6308
170,60,-120,1359,1424,2783,6225
150,40,-90,1379,1404,2783,6234
-30,60,80,1349,1434,2783,6461
-60,70,160,1354,1430,2784,6317
170,30,-90,1378,1406,2784,6204
-20,0,60,1354,1430,2784,6353
140,60,-90,1380,1405,2785,6167
70,70,-30,1348,1437,2785,6377
-10,60,90,1375,1410,2785,6312
-20,20,80,1340,1445,2785,6253
-20,60,100,1366,1419,2785,6527
-130,70,-130,1362,1423,2785,6241
-160,60,-140,1343,1443,2786,6098
-50,80,150,1356,1430,2786,6174
-50,60,140,1357,1430,2787,6176
-80,70,140,1350,1437,2787,6168
-20,-20,70,1361,1426,2787,6347
-40,-30,30,1358,1430,2788,6443
-150,60,-140,1358,1431,2789,6243
-140,70,-120,1372,1417,2789,6238
-10,-60,30,1356,1433,2789,6434
-150,70,-120,1364,1425,2789,6257
-20,60,50,1348,1441,2789,6351
-70,70,160,1356,1433,2789,6290
-10,-60,50,1348,1442,2790,6258
0,-60,40,1362,1428,2790,6541
-30,-40,50,1371,1419,2790,6352
-10,-50,40,1366,1425,2791,6250
-50,70,120,1368,1423,2791,6256
-20,-30,40,1378,1413,2791,6335
0,-30,70,1367,1425,2792,6393
-70,70,130,1354,1438,2792,6163
-170,50,-70,1371,1422,2793,6628
-30,0,70,1357,1436,2793,6357
-20,-60,40,1363,1430,2793,6336
-10,60,40,1351,1442,2793,6382
20,70,10,1361,1433,2794,6412
-30,60,70,1352,1442,2794,6246
0,-60,50,1368,1426,2794,6352
-20,-60,50,1360,1434,2794,6484
-160,50,-110,1366,1430,2796,6254
170,40,-110,1398,1398,2796,6412
-60,80,100,1357,1440,2797,6363
-120,70,-140,1385,1413,2798,6292
-50,70,110,1357,1441,2798,6245
-30,-60,20,1374,1424,2798,6353
-160,50,-80,1356,1442,2798,6636
-30,60,60,1345,1453,2798,6267
-40,-60,30,1365,1434,2799,6342
-80,70,130,1346,1453,2799,6224
-80,70,150,1378,1421,2799,6105
-90,70,-170,1373,1426,2799,6254
110,70,-20,1378,1422,2800,6313
60,70,20,1398,1402,2800,6265
-30,30,100,1353,1447,2800,6294
-10,-40,50,1345,1455,2800,6408
-110,70,-150,1379,1421,2800,6330
0,-20,60,1357,1444,2801,6321
-30,-60,40,1347,1454,2801,6431
170,60,-60,1399,1402,2801,6436
-70,70,170,1367,1435,2802,6263
80,80,-40,1370,1433,2803,6456
-20,60,80,1348,1455,2803,6184
-40,-20,40,1353,1450,2803,6494
150,80,-110,1355,1449,2804,6422
-110,70,-180,1366,1438,2804,6240
-20,-30,60,1371,1433,2804,6531
-110,70,180,1366,1438,2804,6240
-20,10,90,1351,1454,2805,6325
0,60,30,1358,1447,2805,6445
0,50,40,1385,1422,2807,6264
-10,-40,60,1363,1444,2807,6479
-40,-40,40,1374,1434,2808,6362
-80,70,-180,1372,1436,2808,6281
-80,70,180,1372,1436,2808,6281
0,70,30,1376,1432,2808,6466
-10,-50,50,1387,1421,2808,6248
160,80,-120,1368,1441,2809,6417
140,70,-90,1358,1451,2809,6269
-120,70,-160,1396,1414,2810,6110
-30,50,110,1376,1434,2810,6432
-100,70,-160,1388,1422,2810,6333
-30,30,110,1364,1446,2810,6354
150,40,-80,1384,1427,2811,6379
130,50,-60,1388,1423,2811,6452
-20,-40,40,1376,1435,2811,6477
-20,30,110,1371,1440,2811,6469
30,70,50,1375,1437,2812,6276
-50,70,130,1365,1447,2812,6282
160,40,-100,1386,1426,2812,6304
50,60,0,1371,1441,2812,6649
-10,90,50,1364,1449,2813,6470
0,90,40,1364,1449,2813,6470
-150,90,-170,1364,1449,2813,6470
130,50,-70,1380,1433,2813,6390
180,90,-140,1364,1449,2813,6470
-50,90,90,1364,1449,2813,6470
-60,90,100,1364,1449,2813,6470
-110,90,150,1364,1449,2813,6470
-100,90,140,1364,1449,2813,6470
-30,90,70,1364,1449,2813,6470
-90,90,130,1364,1449,2813,6470
30,90,10,1364,1449,2813,6470
-20,90,60,1364,1449,2813,6470
-40,90,80,1364,1449,2813,6470
130,90,-90,1364,1449,2813,6470
-140,90,180,1364,1449,2813,6470
20,90,20,1364,1449,2813,6470
70,90,-30,1364,1449,2813,6470
170,90,-130,1364,1449,2813,6470
-70,90,110,1364,1449,2813,6470
-70,80,110,1356,1457,2813,6363
90,90,-50,1364,1449,2813,6470
-40,-60,20,1377,1436,2813,6342
110,90,-70,1364,1449,2813,6470
-160,90,-160,1364,1449,2813,6470
-140,90,-180,1364,1449,2813,6470
-180,90,-140,1364,1449,2813,6470
-120,90,160,1364,1449,2813,6470
-130,90,170,1364,1449,2813,6470
-80,90,120,1364,1449,2813,6470
60,90,-20,1364,1449,2813,6470
150,90,-110,1364,1449,2813,6470
40,90,0,1364,1449,2813,6470
80,90,-40,1364,1449,2813,6470
140,90,-100,1364,1449,2813,6470
100,90,-60,1364,1449,2813,6470
160,90,-120,1364,1449,2813,6470
50,90,-10,1364,1449,2813,6470
120,90,-80,1364,1449,2813,6470
-170,90,-150,1364,1449,2813,6470
10,90,30,1364,1449,2813,6470
130,60,-40,1379,1435,2814,6566
-30,40,100,1345,1470,2815,6451
-40,-20,50,1368,1447,2815,6473
-20,40,110,1372,1443,2815,6520
-170,40,-80,1398,1417,2815,6519
-40,50,120,1384,1431,2815,6353
-20,70,50,1345,1470,2815,6326
0,-10,70,1348,1467,2815,6331
180,80,-140,1391,1424,2815,6343
-60,80,160,1362,1453,2815,6175
-40,-40,30,1384,1431,2815,6462
-180,80,-140,1391,1424,2815,6343
-180,50,-120,1365,1451,2816,6376
-10,60,70,1380,1436,2816,6265
180,50,-120,1365,1451,2816,6376
-20,70,110,1376,1440,2816,6349
20,60,50,1383,1434,2817,6310
-40,60,70,1348,1469,2817,6268
160,70,-110,1384,1434,2818,6205
70,60,-10,1388,1430,2818,6660
-20,-30,50,1376,1442,2818,6570
150,70,-100,1364,1454,2818,6237
-30,40,110,1363,1456,2819,6208
-150,60,-130,1369,1450,2819,6524
150,50,-100,1372,1447,2819,6248
-50,-30,30,1377,1442,2819,6540
-30,-60,30,1358,1462,2820,6364
140,50,-60,1360,1460,2820,6462
-30,-40,40,1388,1432,2820,6456
-120,70,-170,1378,1442,2820,6260
-50,70,140,1375,1446,2821,6203
-50,70,90,1365,1456,2821,6255
180,70,-70,1404,1417,2821,6430
-180,70,-70,1404,1417,2821,6430
-120,70,-180,1353,1468,2821,6480
140,50,-80,1380,1441,2821,6410
150,70,-50,1402,1419,2821,6454
-120,70,180,1353,1468,2821,6480
-150,70,-100,1387,1434,2821,6429
-150,60,-100,1385,1437,2822,6260
-160,60,-110,1374,1449,2823,6559
130,70,-80,1371,1452,2823,6510
-60,70,150,1374,1449,2823,6224
-10,70,40,1363,1460,2823,6421
-20,-60,30,1395,1428,2823,6477
170,80,-130,1387,1436,2823,6403
-20,30,90,1353,1471,2824,6389
180,30,-80,1395,1429,2824,6401
-10,0,70,1375,1449,2824,6414
-40,70,120,1369,1455,2824,6360
-100,70,160,1359,1465,2824,6255
-180,30,-80,1395,1429,2824,6401
-20,60,90,1395,1429,2824,6343
-20,60,70,1363,1461,2824,6405
-100,80,-160,1366,1459,2825,6296
-130,70,-170,1362,1464,2826,6478
-40,70,130,1381,1446,2827,6231
-30,70,60,1344,1483,2827,6319
80,60,-10,1380,1447,2827,6556
-30,70,120,1383,1444,2827,6270
40,80,50,1385,1443,2828,6394
-10,10,80,1390,1438,2828,6334
-30,-20,60,1368,1460,2828,6455
60,70,-20,1369,1459,2828,6551
-80,90,180,1364,1465,2829,6393
10,90,90,1364,1465,2829,6393
-170,90,-90,1364,1465,2829,6393
60,90,40,1364,1465,2829,6393
-100,90,-160,1364,1465,2829,6393
-10,90,110,1364,1465,2829,6393
110,90,-10,1364,1465,2829,6393
-20,90,120,1364,1465,2829,6393
-120,90,-140,1364,1465,2829,6393
-30,50,120,1360,1469,2829,6267
-80,90,-180,1364,1465,2829,6393
-140,90,-120,1364,1465,2829,6393
20,90,80,1364,1465,2829,6393
-90,90,-170,1364,1465,2829,6393
0,90,100,1364,1465,2829,6393
-40,90,140,1364,1465,2829,6393
150,90,-50,1364,1465,2829,6393
140,90,-40,1364,1465,2829,6393
160,90,-60,1364,1465,2829,6393
-50,90,150,1364,1465,2829,6393
-30,90,130,1364,1465,2829,6393
180,90,-80,1364,1465,2829,6393
-110,90,-150,1364,1465,2829,6393
-180,90,-80,1364,1465,2829,6393
-60,90,160,1364,1465,2829,6393
-130,90,-130,1364,1465,2829,6393
120,90,-20,1364,1465,2829,6393
70,90,30,1364,1465,2829,6393
-160,90,-100,1364,1465,2829,6393
90,90,10,1364,1465,2829,6393
40,90,60,1364,1465,2829,6393
100,90,0,1364,1465,2829,6393
30,90,70,1364,1465,2829,6393
10,60,60,1388,1441,2829,6362
80,90,20,1364,1465,2829,6393
-70,90,170,1364,1465,2829,6393
-150,90,-110,1364,1465,2829,6393
50,90,50,1364,1465,2829,6393
170,90,-70,1364,1465,2829,6393
130,90,-30,1364,1465,2829,6393
10,70,20,1380,1449,2829,6442
-30,-30,40,1386,1444,2830,6552
-40,70,100,1383,1447,2830,6391
100,60,-20,1379,1451,2830,6692
-40,70,80,1375,1455,2830,6429
-40,-50,30,1389,1441,2830,6432
20,70,60,1383,1448,2831,6362
-110,70,170,1366,1465,2831,6413
70,80,-30,1385,1447,2832,6526
-160,50,-100,1393,1440,2833,6403
-170,40,-100,1397,1436,2833,6476
-50,80,90,1364,1469,2833,6395
-10,-10,60,1376,1458,2834,6338
-110,80,-150,1376,1458,2834,6295
-130,70,-150,1389,1445,2834,6160
-160,60,-130,1391,1444,2835,6391
-40,70,110,1391,1445,2836,6359
140,80,-40,1394,1444,2838,6517
110,60,-30,1380,1458,2838,6539
-150,70,-110,1412,1426,2838,6389
170,70,-120,1380,1459,2839,6238
-10,-30,50,1388,1451,2839,6537
160,40,-80,1414,1426,2840,6442
-30,-50,40,1387,1453,2840,6678
-160,70,-90,1391,1450,2841,6456
-180,30,-90,1397,1445,2842,6333
180,30,-90,1397,1445,2842,6333
-170,60,-130,1371,1473,2844,6407
160,50,-110,1378,1466,2844,6432
0,80,90,1382,1462,2844,6460
120,70,-70,1389,1455,2844,6518
-70,80,170,1380,1465,2845,6210
110,60,-40,1398,1449,2847,6689
-20,60,60,1393,1454,2847,6496
30,80,60,1380,1467,2847,6421
50,80,40,1398,1449,2847,6434
-170,70,-80,1415,1433,2848,6509
0,-20,70,1373,1476,2849,6458
170,40,-100,1427,1422,2849,6378
-90,80,-170,1379,1471,2850,6326
-40,80,80,1374,1478,2852,6405
-40,70,90,1378,1474,2852,6398
0,60,70,1398,1455,2853,6444
-30,70,110,1398,1456,2854,6475
70,70,10,1425,1430,2855,6424
-120,80,-140,1380,1475,2855,6313
0,70,80,1390,1465,2855,6482
60,80,-20,1390,1465,2855,6577
-20,-40,50,1378,1478,2856,6553
-10,-20,70,1398,1458,2856,6434
-100,80,180,1388,1468,2856,6319
110,70,-60,1402,1454,2856,6580
-100,80,-180,1388,1468,2856,6319
-10,0,80,1394,1462,2856,6438
120,60,-60,1410,1448,2858,6607
30,60,10,1383,1476,2859,6615
10,70,70,1406,1455,2861,6503
-90,80,180,1404,1458,2862,6405
-90,80,-180,1404,1458,2862,6405
0,60,60,1408,1454,2862,6295
-10,60,80,1419,1443,2862,6381
-170,40,-90,1403,1460,2863,6416
60,80,30,1409,1455,2864,6506
-100,80,-170,1404,1461,2865,6412
-160,60,-90,1421,1445,2866,6648
-80,80,180,1391,1475,2866,6285
-80,80,-180,1391,1475,2866,6285
-170,50,-110,1405,1462,2867,6678
-20,-50,40,1410,1457,2867,6541
-30,80,70,1373,1494,2867,6394
-10,-60,40,1415,1454,2869,6464
30,60,30,1413,1458,2871,6489
-110,80,-170,1392,1480,2872,6413
-140,70,-160,1365,1507,2872,6494
-150,70,-150,1392,1481,2873,6461
60,60,0,1415,1458,2873,6788
-110,80,-160,1406,1468,2874,6319
120,60,-50,1403,1471,2874,6763
160,60,-110,1406,1469,2875,6445
150,80,-50,1401,1474,2875,6607
-30,-30,50,1397,1478,2875,6586
-20,70,100,1409,1466,2875,6413
160,40,-90,1423,1453,2876,6421
-10,-20,60,1403,1473,2876,6660
-90,80,170,1411,1465,2876,6351
170,40,-90,1434,1442,2876,6642
10,80,80,1396,1481,2877,6418
50,70,-10,1400,1478,2878,6662
-160,50,-90,1411,1467,2878,6454
-170,50,-120,1398,1480,2878,6488
-160,70,-110,1406,1473,2879,6451
-160,70,-140,1410,1469,2879,6502
-80,80,170,1408,1471,2879,6501
50,80,-10,1406,1473,2879,6696
-80,80,160,1412,1468,2880,6324
100,70,-50,1395,1485,2880,6584
20,80,70,1389,1493,2882,6437
70,80,20,1417,1466,2883,6546
120,60,-40,1406,1478,2884,6724
-30,-10,60,1411,1473,2884,6580
-130,70,-160,1404,1480,2884,6447
-70,80,150,1418,1467,2885,6334
-30,70,100,1403,1482,2885,6585
120,70,-30,1417,1469,2886,6588
20,60,40,1403,1485,2888,6410
130,60,-70,1430,1459,2889,6742
90,80,0,1406,1483,2889,6559
-20,0,80,1394,1495,2889,6534
-180,50,-70,1420,1470,2890,6712
180,50,-70,1420,1470,2890,6712
-10,70,90,1416,1474,2890,6533
-20,20,90,1399,1491,2890,6504
80,80,10,1419,1472,2891,6520
-100,80,150,1401,1490,2891,6528
-170,50,-90,1426,1466,2892,6700
30,80,10,1403,1490,2893,6790
-130,80,-140,1410,1483,2893,6379
90,60,-20,1405,1488,2893,6863
-10,80,100,1407,1487,2894,6521
-10,-10,70,1417,1477,2894,6620
-40,-30,40,1416,1478,2894,6559
-20,-20,50,1408,1487,2895,6588
-70,80,160,1414,1481,2895,6515
-30,70,90,1405,1491,2896,6616
140,60,-50,1443,1453,2896,6659
-20,80,60,1389,1507,2896,6491
150,60,-100,1423,1473,2896,6457
-140,70,-140,1436,1461,2897,6441
40,80,0,1414,1483,2897,6752
-90,80,140,1407,1490,2897,6510
-150,80,-160,1412,1487,2899,6641
-70,80,120,1405,1494,2899,6518
-120,80,-150,1415,1485,2900,6302
-30,-50,30,1423,1477,2900,6617
-140,80,-170,1412,1488,2900,6641
-60,80,140,1414,1487,2901,6388
-130,80,-180,1410,1491,2901,6659
-10,-30,60,1401,1500,2901,6801
-130,80,180,1410,1491,2901,6659
-10,60,50,1417,1485,2902,6695
-140,80,-120,1401,1502,2903,6558
100,60,-30,1401,1502,2903,6818
40,60,20,1436,1468,2904,6655
-10,80,50,1406,1499,2905,6476
-140,80,-130,1416,1489,2905,6492
-160,70,-100,1421,1485,2906,6584
-160,60,-100,1416,1490,2906,6559
-60,80,110,1412,1494,2906,6598
-160,80,-150,1415,1492,2907,6663
80,70,-30,1422,1485,2907,6771
-50,80,100,1414,1493,2907,6619
-110,80,160,1408,1501,2909,6598
80,70,0,1440,1469,2909,6622
-60,80,150,1417,1492,2909,6482
-150,70,-140,1422,1487,2909,6681
-130,80,-130,1398,1511,2909,6439
160,80,-60,1407,1503,2910,6681
-20,10,80,1409,1501,2910,6632
-30,-20,50,1389,1521,2910,6712
100,80,-10,1427,1484,2911,6661
-20,80,110,1412,1499,2911,6551
170,50,-110,1413,1498,2911,6553
150,50,-90,1444,1467,2911,6521
-100,80,160,1434,1477,2911,6681
-120,80,-160,1409,1503,2912,6553
160,60,-60,1430,1483,2913,6720
-80,80,130,1412,1501,2913,6531
40,70,0,1423,1490,2913,6749
-180,60,-70,1441,1473,2914,6771
180,60,-70,1441,1473,2914,6771
180,40,-90,1422,1494,2916,6638
-180,40,-100,1407,1509,2916,6719
180,40,-100,1407,1509,2916,6719
-180,40,-90,1422,1494,2916,6638
50,60,10,1439,1478,2917,6788
90,70,-40,1418,1499,2917,6756
-20,30,100,1430,1487,2917,6574
180,40,-80,1450,1468,2918,6616
-180,40,-80,1450,1468,2918,6616
-30,70,70,1398,1520,2918,6560
170,80,-70,1410,1509,2919,6762
20,80,20,1414,1505,2919,6687
-170,80,-140,1416,1503,2919,6663
-170,50,-100,1423,1496,2919,6709
70,70,-20,1431,1488,2919,6964
-170,50,-80,1426,1494,2920,6613
-140,70,-150,1418,1502,2920,6599
160,50,-100,1432,1489,2921,6571
0,80,40,1413,1508,2921,6568
170,40,-80,1447,1475,2922,6519
-10,60,60,1412,1511,2923,6651
-50,80,130,1421,1502,2923,6472
140,50,-70,1430,1494,2924,6859
-30,70,80,1412,1512,2924,6645
-150,80,-120,1431,1495,2926,6595
-70,80,130,1443,1483,2926,6619
160,70,-60,1453,1474,2927,6702
-120,80,170,1416,1511,2927,6660
-50,80,140,1422,1505,2927,6611
-20,-20,60,1415,1513,2928,6628
170,80,-120,1428,1500,2928,6706
-180,60,-120,1437,1492,2929,6725
-40,80,120,1415,1514,2929,6547
180,60,-120,1437,1492,2929,6725
10,60,50,1434,1495,2929,6493
140,60,-80,1442,1488,2930,6933
40,60,10,1449,1482,2931,6792
-170,60,-80,1435,1496,2931,6746
-40,80,130,1414,1517,2931,6565
10,80,30,1418,1514,2932,6605
-80,80,150,1425,1507,2932,6677
-30,80,120,1412,1520,2932,6599
20,60,20,1426,1506,2932,6756
-90,80,160,1431,1502,2933,6644
30,60,20,1434,1499,2933,6832
-20,70,60,1425,1509,2934,6606
-80,80,140,1441,1493,2934,6632
-70,80,140,1432,1503,2935,6723
-160,70,-130,1421,1515,2936,6699
-20,70,90,1432,1505,2937,6609
0,70,70,1428,1509,2937,6623
-20,80,100,1419,1518,2937,6753
-150,70,-130,1448,1489,2937,6603
20,60,30,1445,1493,2938,6830
-20,70,80,1420,1518,2938,6747
130,60,-50,1439,1499,2938,6855
140,70,-80,1436,1503,2939,6739
-10,70,70,1426,1513,2939,6664
0,60,40,1436,1503,2939,6793
-170,70,-130,1426,1514,2940,6689
30,70,10,1448,1492,2940,6809
-130,80,-150,1421,1519,2940,6650
180,80,-130,1426,1515,2941,6715
-180,80,-130,1426,1515,2941,6715
-90,80,150,1438,1503,2941,6679
-20,-10,70,1422,1519,2941,6740
-110,80,170,1431,1510,2941,6783
-10,80,90,1433,1509,2942,6780
-180,80,-80,1405,1537,2942,6687
-30,80,110,1417,1525,2942,6672
180,80,-80,1405,1537,2942,6687
-160,80,-100,1417,1526,2943,6749
-170,80,-90,1405,1538,2943,6704
160,50,-70,1459,1484,2943,6668
140,80,-90,1437,1507,2944,6795
-160,60,-120,1430,1514,2944,6721
160,80,-110,1425,1520,2945,6645
120,80,-70,1429,1516,2945,6911
-60,80,130,1425,1522,2947,6725
150,80,-100,1432,1516,2948,6767
-160,70,-120,1444,1504,2948,6784
-60,80,120,1452,1498,2950,6630
-10,70,80,1443,1507,2950,6640
-150,80,-110,1423,1527,2950,6722
0,60,50,1453,1497,2950,6608
-100,80,170,1440,1511,2951,6656
130,80,-80,1436,1518,2954,6873
-20,-10,60,1425,1530,2955,6758
-100,90,150,1434,1524,2958,6888
10,90,40,1434,1524,2958,6888
150,90,-100,1434,1524,2958,6888
-80,90,130,1434,1524,2958,6888
60,90,-10,1434,1524,2958,6888
-150,90,-160,1434,1524,2958,6888
-160,90,-150,1434,1524,2958,6888
-40,90,90,1434,1524,2958,6888
130,90,-80,1434,1524,2958,6888
100,90,-50,1434,1524,2958,6888
-20,90,70,1434,1524,2958,6888
30,90,20,1434,1524,2958,6888
-140,90,-170,1434,1524,2958,6888
20,90,30,1434,1524,2958,6888
50,90,0,1434,1524,2958,6888
40,90,10,1434,1524,2958,6888
-170,60,-120,1443,1515,2958,6832
170,90,-120,1434,1524,2958,6888
110,90,-60,1434,1524,2958,6888
80,90,-30,1434,1524,2958,6888
90,90,-40,1434,1524,2958,6888
-10,90,60,1434,1524,2958,6888
-170,90,-140,1434,1524,2958,6888
-70,90,120,1434,1524,2958,6888
-50,90,100,1434,1524,2958,6888
-110,90,160,1434,1524,2958,6888
-130,90,-180,1434,1524,2958,6888
-90,90,140,1434,1524,2958,6888
120,90,-70,1434,1524,2958,6888
-130,90,180,1434,1524,2958,6888
-120,90,170,1434,1524,2958,6888
160,90,-110,1434,1524,2958,6888
-180,90,-130,1434,1524,2958,6888
-60,90,110,1434,1524,2958,6888
140,90,-90,1434,1524,2958,6888
-30,90,80,1434,1524,2958,6888
70,90,-20,1434,1524,2958,6888
0,90,50,1434,1524,2958,6888
180,90,-130,1434,1524,2958,6888
10,60,30,1451,1508,2959,6868
-50,80,120,1429,1531,2960,6837
110,80,-60,1431,1531,2962,6965
-120,80,-180,1437,1525,2962,6810
-120,80,180,1437,1525,2962,6810
150,70,-90,1448,1516,2964,6831
-160,80,-110,1461,1504,2965,6689
-160,80,-140,1432,1533,2965,6818
-170,80,-130,1430,1535,2965,6805
110,80,-20,1451,1515,2966,6772
30,70,40,1438,1528,2966,6790
100,80,-50,1426,1541,2967,7005
10,70,60,1447,1521,2968,6655
-20,0,70,1431,1537,2968,6826
-150,80,-130,1443,1525,2968,6812
170,70,-70,1480,1489,2969,6814
170,50,-80,1472,1497,2969,6847
-40,80,90,1435,1534,2969,6746
20,70,50,1429,1540,2969,6785
0,80,80,1456,1514,2970,6888
120,80,-30,1457,1513,2970,6810
-120,80,-170,1449,1523,2972,6694
150,50,-70,1479,1495,2974,6786
-40,80,100,1458,1516,2974,6812
-170,70,-90,1450,1524,2974,6773
150,60,-60,1456,1519,2975,7012
130,70,-40,1445,1531,2976,6963
-170,80,-100,1459,1518,2977,6750
-140,80,-140,1434,1543,2977,6824
-50,80,110,1467,1511,2978,6743
30,80,50,1465,1513,2978,6785
40,80,40,1470,1508,2978,6806
-130,80,-160,1458,1521,2979,6716
170,50,-90,1465,1515,2980,6734
170,50,-100,1458,1522,2980,6780
60,70,-10,1457,1524,2981,7077
-170,70,-100,1447,1534,2981,6756
-170,60,-100,1450,1531,2981,6866
10,60,40,1442,1539,2981,6777
170,50,-70,1459,1523,2982,6896
130,70,-70,1454,1528,2982,7007
-20,70,70,1435,1547,2982,6730
-110,80,-180,1452,1530,2982,6739
-10,70,50,1438,1544,2982,6906
-150,80,-150,1436,1546,2982,6884
-110,80,180,1452,1530,2982,6739
40,70,30,1471,1512,2983,6789
-140,80,-150,1460,1525,2985,6803
90,70,-10,1466,1519,2985,6869
150,50,-80,1473,1515,2988,6786
160,50,-80,1497,1491,2988,6739
-130,80,-170,1435,1554,2989,6850
-40,80,110,1440,1550,2990,6907
90,80,-40,1449,1542,2991,7068
-180,50,-100,1451,1541,2992,6938
180,50,-100,1451,1541,2992,6938
-170,60,-90,1464,1528,2992,6778
180,50,-90,1456,1537,2993,6959
-180,50,-90,1456,1537,2993,6959
180,80,-120,1442,1551,2993,6861
-170,70,-110,1462,1531,2993,6849
-180,80,-120,1442,1551,2993,6861
-160,80,-120,1448,1546,2994,6943
180,70,-120,1438,1556,2994,6804
-180,70,-120,1438,1556,2994,6804
80,80,-30,1457,1537,2994,7023
130,80,-40,1474,1520,2994,6858
-140,80,-160,1436,1562,2998,6902
-170,60,-110,1459,1539,2998,6871
-180,70,-80,1466,1532,2998,6902
180,70,-80,1466,1532,2998,6902
70,90,10,1454,1545,2999,6833
20,90,60,1454,1545,2999,6833
-70,90,150,1454,1545,2999,6833
-100,90,180,1454,1545,2999,6833
150,90,-70,1454,1545,2999,6833
100,90,-20,1454,1545,2999,6833
-50,90,130,1454,1545,2999,6833
-40,90,120,1454,1545,2999,6833
-80,90,160,1454,1545,2999,6833
-120,90,-160,1454,1545,2999,6833
80,90,0,1454,1545,2999,6833
110,90,-30,1454,1545,2999,6833
-110,90,-170,1454,1545,2999,6833
-100,90,-180,1454,1545,2999,6833
-140,90,-140,1454,1545,2999,6833
-20,90,100,1454,1545,2999,6833
-10,90,90,1454,1545,2999,6833
90,90,-10,1454,1545,2999,6833
-170,90,-110,1454,1545,2999,6833
10,90,70,1454,1545,2999,6833
-90,90,170,1454,1545,2999,6833
-180,90,-100,1454,1545,2999,6833
60,90,20,1454,1545,2999,6833
30,90,50,1454,1545,2999,6833
50,90,30,1454,1545,2999,6833
-130,90,-150,1454,1545,2999,6833
120,90,-40,1454,1545,2999,6833
0,90,80,1454,1545,2999,6833
160,90,-80,1454,1545,2999,6833
180,90,-100,1454,1545,2999,6833
170,90,-90,1454,1545,2999,6833
-160,90,-120,1454,1545,2999,6833
20,70,20,1469,1530,2999,6842
-150,90,-130,1454,1545,2999,6833
40,90,40,1454,1545,2999,6833
-30,90,110,1454,1545,2999,6833
140,90,-60,1454,1545,2999,6833
-60,90,140,1454,1545,2999,6833
130,90,-50,1454,1545,2999,6833
-170,80,-110,1462,1538,3000,6993
50,70,20,1473,1527,3000,6683
-30,80,80,1441,1559,3000,6890
-10,80,80,1451,1550,3001,6869
180,80,-90,1470,1531,3001,6761
-180,80,-90,1470,1531,3001,6761
-30,80,90,1466,1535,3001,6936
-180,60,-80,1490,1515,3005,7019
180,60,-80,1490,1515,3005,7019
180,80,-100,1469,1538,3007,7016
-180,80,-100,1469,1538,3007,7016
50,80,30,1482,1525,3007,6927
60,80,20,1486,1522,3008,6932
70,80,-20,1463,1546,3009,7043
-30,80,100,1450,1559,3009,6883
20,80,30,1464,1546,3010,6908
170,80,-110,1442,1569,3011,6862
-10,70,60,1445,1567,3012,6925
-170,70,-120,1461,1551,3012,6759
60,80,-10,1452,1560,3012,6967
170,70,-110,1461,1551,3012,6858
-180,70,-110,1452,1562,3014,7033
20,80,60,1483,1531,3014,6949
180,70,-110,1452,1562,3014,7033
60,70,10,1486,1529,3015,6809
10,80,70,1477,1538,3015,6917
-160,80,-130,1475,1540,3015,6821
160,70,-100,1476,1541,3017,6876
-150,80,-140,1475,1543,3018,6878
-90,90,-180,1461,1558,3019,6888
130,90,-40,1461,1558,3019,6888
60,90,30,1461,1558,3019,6888
150,90,-60,1461,1558,3019,6888
170,60,-70,1484,1535,3019,7066
-140,90,-130,1461,1558,3019,6888
-110,90,-160,1461,1558,3019,6888
170,90,-80,1461,1558,3019,6888
-20,90,110,1461,1558,3019,6888
90,90,0,1461,1558,3019,6888
-10,90,100,1461,1558,3019,6888
-60,90,150,1461,1558,3019,6888
-160,90,-110,1461,1558,3019,6888
100,90,-10,1461,1558,3019,6888
140,90,-50,1461,1558,3019,6888
30,90,60,1461,1558,3019,6888
-90,90,180,1461,1558,3019,6888
10,90,80,1461,1558,3019,6888
160,90,-70,1461,1558,3019,6888
40,90,50,1461,1558,3019,6888
-70,90,160,1461,1558,3019,6888
-100,90,-170,1461,1558,3019,6888
0,90,90,1461,1558,3019,6888
80,90,10,1461,1558,3019,6888
-180,90,-90,1461,1558,3019,6888
-130,90,-140,1461,1558,3019,6888
-30,90,120,1461,1558,3019,6888
-120,90,-150,1461,1558,3019,6888
-50,90,140,1461,1558,3019,6888
20,90,70,1461,1558,3019,6888
70,90,20,1461,1558,3019,6888
-150,90,-120,1461,1558,3019,6888
-170,90,-100,1461,1558,3019,6888
180,90,-90,1461,1558,3019,6888
110,90,-20,1461,1558,3019,6888
120,90,-30,1461,1558,3019,6888
50,90,40,1461,1558,3019,6888
-80,90,170,1461,1558,3019,6888
-40,90,130,1461,1558,3019,6888
10,80,40,1463,1557,3020,6934
-20,80,70,1453,1567,3020,6949
-180,50,-110,1459,1562,3021,7028
130,80,-70,1456,1565,3021,6819
180,50,-110,1459,1562,3021,7028
-20,80,90,1452,1570,3022,6842
-170,80,-120,1479,1543,3022,6838
140,80,-80,1435,1589,3024,6869
10,70,30,1462,1563,3025,6935
50,80,0,1461,1564,3025,6991
140,70,-50,1484,1541,3025,7069
140,60,-60,1486,1540,3026,7049
-180,50,-80,1479,1547,3026,6880
70,80,10,1498,1528,3026,6983
180,50,-80,1479,1547,3026,6880
0,80,50,1466,1561,3027,6960
-10,80,60,1465,1562,3027,6961
0,70,40,1459,1569,3028,7024
0,70,60,1488,1543,3031,6903
140,80,-50,1481,1550,3031,7032
150,60,-90,1495,1537,3032,6977
0,80,70,1478,1555,3033,6996
80,80,0,1492,1541,3033,6949
150,80,-90,1457,1577,3034,6843
120,80,-60,1470,1565,3035,6835
130,60,-60,1491,1545,3036,7120
170,80,-90,1490,1546,3036,7053
160,50,-90,1484,1553,3037,6904
150,70,-60,1492,1546,3038,7067
180,70,-90,1481,1558,3039,6988
180,80,-110,1487,1552,3039,6978
-180,70,-90,1481,1558,3039,6988
-180,80,-110,1487,1552,3039,6978
110,80,-50,1477,1563,3040,6938
30,80,20,1471,1571,3042,6989
170,60,-110,1480,1562,3042,6965
120,70,-60,1466,1576,3042,7201
160,60,-70,1494,1554,3048,7094
90,70,-30,1492,1557,3049,7082
80,70,-20,1501,1550,3051,7185
160,80,-100,1468,1586,3054,6836
160,80,-80,1495,1559,3054,7109
40,80,10,1486,1570,3056,7078
180,60,-100,1482,1576,3058,6952
-180,60,-100,1482,1576,3058,6952
110,70,-50,1488,1571,3059,7183
180,60,-110,1490,1569,3059,6981
-180,60,-110,1490,1569,3059,6981
130,70,-50,1491,1569,3060,7165
170,70,-100,1484,1576,3060,7086
100,70,-20,1497,1563,3060,7113
0,70,50,1477,1584,3061,7158
100,90,-30,1489,1573,3062,7028
0,90,70,1489,1573,3062,7028
50,90,20,1489,1573,3062,7028
-90,90,160,1489,1573,3062,7028
30,90,40,1489,1573,3062,7028
170,90,-100,1489,1573,3062,7028
-150,90,-140,1489,1573,3062,7028
-30,90,100,1489,1573,3062,7028
-40,90,110,1489,1573,3062,7028
70,90,0,1489,1573,3062,7028
-110,90,-180,1489,1573,3062,7028
-50,90,120,1489,1573,3062,7028
150,90,-80,1489,1573,3062,7028
60,90,10,1489,1573,3062,7028
110,90,-40,1489,1573,3062,7028
80,90,-10,1489,1573,3062,7028
-180,90,-110,1489,1573,3062,7028
-70,90,140,1489,1573,3062,7028
-10,90,80,1489,1573,3062,7028
20,90,50,1489,1573,3062,7028
-130,90,-160,1489,1573,3062,7028
-120,90,-170,1489,1573,3062,7028
140,90,-70,1489,1573,3062,7028
180,90,-110,1489,1573,3062,7028
-60,90,130,1489,1573,3062,7028
120,90,-50,1489,1573,3062,7028
10,90,60,1489,1573,3062,7028
-80,90,150,1489,1573,3062,7028
160,90,-90,1489,1573,3062,7028
-20,90,90,1489,1573,3062,7028
90,90,-20,1489,1573,3062,7028
40,90,30,1489,1573,3062,7028
-140,90,-150,1489,1573,3062,7028
-170,90,-120,1489,1573,3062,7028
-160,90,-130,1489,1573,3062,7028
-110,90,180,1489,1573,3062,7028
130,90,-60,1489,1573,3062,7028
-100,90,170,1489,1573,3062,7028
150,80,-80,1499,1565,3064,7152
100,70,-40,1492,1572,3064,7190
50,70,0,1509,1558,3067,7153
150,80,-60,1491,1577,3068,7118
40,70,10,1506,1563,3069,7178
160,70,-90,1514,1555,3069,7080
-20,80,80,1484,1587,3071,7113
160,80,-90,1500,1572,3072,7120
160,60,-100,1524,1549,3073,7005
170,80,-100,1497,1576,3073,6998
150,80,-70,1497,1576,3073,7187
170,80,-80,1487,1587,3074,6921
170,70,-80,1501,1573,3074,7065
160,80,-70,1504,1571,3075,6996
10,80,60,1495,1581,3076,7023
150,60,-70,1498,1579,3077,7028
120,70,-50,1468,1610,3078,7065
10,70,50,1492,1586,3078,7114
140,80,-70,1498,1581,3079,7190
110,70,-30,1504,1575,3079,7157
90,80,-10,1507,1572,3079,7002
150,70,-80,1512,1567,3079,7068
140,70,-70,1491,1593,3084,7109
70,70,0,1503,1582,3085,7125
140,60,-70,1518,1569,3087,7258
90,80,-30,1511,1576,3087,7171
-180,60,-90,1515,1573,3088,7210
180,60,-90,1515,1573,3088,7210
100,80,-20,1514,1574,3088,7027
100,80,-40,1511,1577,3088,7055
130,80,-60,1509,1580,3089,7193
110,70,-40,1500,1591,3091,7194
150,60,-80,1520,1574,3094,7190
180,70,-100,1523,1572,3095,7161
170,60,-80,1531,1564,3095,7154
-180,70,-100,1523,1572,3095,7161
170,60,-90,1500,1596,3096,7180
160,60,-90,1547,1550,3097,7057
30,70,20,1534,1563,3097,7198
180,90,-120,1515,1584,3099,7133
100,90,-40,1515,1584,3099,7133
160,90,-100,1515,1584,3099,7133
-40,90,100,1515,1584,3099,7133
40,90,20,1515,1584,3099,7133
-170,90,-130,1515,1584,3099,7133
-150,90,-150,1515,1584,3099,7133
130,90,-70,1515,1584,3099,7133
170,90,-110,1515,1584,3099,7133
50,90,10,1515,1584,3099,7133
-130,90,-170,1515,1584,3099,7133
-120,90,-180,1515,1584,3099,7133
-140,90,-160,1515,1584,3099,7133
30,90,30,1515,1584,3099,7133
-110,90,170,1515,1584,3099,7133
90,90,-30,1515,1584,3099,7133
20,90,40,1515,1584,3099,7133
70,90,-10,1515,1584,3099,7133
-180,90,-120,1515,1584,3099,7133
-90,90,150,1515,1584,3099,7133
-70,90,130,1515,1584,3099,7133
-100,90,160,1515,1584,3099,7133
-60,90,120,1515,1584,3099,7133
0,90,60,1515,1584,3099,7133
110,90,-50,1515,1584,3099,7133
60,90,0,1515,1584,3099,7133
10,90,50,1515,1584,3099,7133
-160,90,-140,1515,1584,3099,7133
150,90,-90,1515,1584,3099,7133
-120,90,180,1515,1584,3099,7133
-50,90,110,1515,1584,3099,7133
80,90,-20,1515,1584,3099,7133
-10,90,70,1515,1584,3099,7133
-30,90,90,1515,1584,3099,7133
-80,90,140,1515,1584,3099,7133
-20,90,80,1515,1584,3099,7133
140,90,-80,1515,1584,3099,7133
120,90,-60,1515,1584,3099,7133
110,80,-30,1527,1573,3100,7096
20,80,40,1503,1599,3102,7367
-10,80,70,1492,1611,3103,7231
20,80,50,1500,1603,3103,7096
120,70,-40,1514,1589,3103,7179
160,70,-70,1511,1593,3104,7210
10,80,50,1497,1607,3104,7362
80,80,-20,1522,1582,3104,7281
70,70,-10,1519,1586,3105,7294
130,70,-60,1500,1605,3105,7080
160,60,-80,1526,1580,3106,7196
50,80,10,1523,1583,3106,7286
60,70,0,1521,1587,3108,7230
20,70,40,1507,1605,3112,7259
70,80,-10,1530,1582,3112,7330
120,80,-50,1518,1595,3113,7293
40,80,20,1528,1585,3113,7347
0,80,60,1492,1623,3115,7355
10,70,40,1525,1593,3118,7265
140,70,-60,1523,1599,3122,7221
120,80,-40,1532,1590,3122,7175
100,70,-30,1520,1603,3123,7352
60,80,0,1538,1589,3127,7356
140,80,-60,1518,1610,3128,7278
30,80,40,1523,1607,3130,7183
130,80,-50,1527,1604,3131,7225
30,80,30,1525,1607,3132,7377
30,70,30,1535,1599,3134,7230
170,60,-100,1522,1617,3139,7066
20,70,30,1549,1595,3144,7281
40,80,30,1531,1615,3146,7314
40,70,20,1548,1598,3146,7151
50,70,10,1557,1596,3153,7193
110,80,-40,1531,1629,3160,7368
150,70,-70,1536,1624,3160,7370
160,70,-80,1529,1632,3161,7401
170,70,-90,1550,1611,3161,7391
70,80,0,1552,1616,3168,7341
80,70,-10,1547,1622,3169,7434
60,80,10,1545,1628,3173,7361
100,80,-30,1548,1627,3175,7424
50,80,20,1553,1624,3177,7344
80,80,-10,1549,1640,3189,7447
90,80,-20,1557,1635,3192,7412
90,70,-20,1548,1646,3194,7508
