alpha,beta,gamma,ENZ_CA,SUB_CA,TOT_CA,clashes
80,30,10,4,3,7,4
90,30,0,6,5,11,8
90,30,10,6,6,12,6
90,30,-10,9,11,20,31
90,20,-20,8,14,22,16
90,20,-10,11,11,22,15
80,30,0,10,12,22,13
90,20,0,12,11,23,22
80,30,20,14,10,24,21
80,20,10,14,13,27,28
80,20,20,16,13,29,36
100,20,-10,13,19,32,35
90,20,10,15,17,32,36
60,10,90,17,15,32,28
80,10,80,19,15,34,41
60,0,100,17,17,34,33
80,20,0,16,18,34,28
80,-40,140,17,18,35,52
90,20,20,18,17,35,39
80,-50,140,17,19,36,57
80,10,90,20,16,36,44
60,0,90,20,17,37,34
80,20,-20,19,18,37,45
50,10,100,18,19,37,37
100,20,0,18,19,37,35
60,0,110,16,21,37,42
80,30,-10,17,20,37,44
80,20,30,17,21,38,41
70,10,90,19,19,38,45
90,30,-20,14,24,38,44
90,20,-30,17,21,38,37
120,-20,-150,14,24,38,53
80,20,-10,20,19,39,39
80,30,-20,19,20,39,55
80,-30,150,16,23,39,41
70,0,100,18,21,39,42
70,10,100,20,19,39,55
90,-40,150,19,20,39,60
60,-10,130,20,20,40,52
80,30,30,20,21,41,44
100,30,0,21,20,41,41
100,20,-20,18,23,41,41
70,-30,140,22,19,41,61
70,10,80,23,18,41,40
50,0,110,20,21,41,41
60,-20,130,23,18,41,58
60,10,100,20,21,41,46
80,10,100,20,22,42,49
50,10,110,19,23,42,46
70,10,70,22,20,42,39
60,20,100,22,20,42,65
70,10,110,21,21,42,67
80,30,40,20,23,43,49
70,0,90,22,21,43,38
50,20,110,23,20,43,62
60,10,110,22,21,43,58
80,10,70,23,20,43,48
90,10,-20,22,21,43,54
80,20,40,21,22,43,53
90,30,20,22,21,43,34
120,10,-120,19,24,43,60
90,-50,140,21,23,44,60
120,-10,-130,21,23,44,81
60,20,90,25,19,44,48
60,-10,110,22,22,44,51
80,20,90,23,22,45,87
120,0,-120,21,24,45,65
50,10,90,20,25,45,49
50,0,100,21,24,45,51
110,20,-110,18,27,45,61
60,-20,120,23,23,46,67
60,-20,110,22,24,46,69
60,-30,130,24,22,46,80
110,-20,-140,19,27,46,93
70,20,0,23,23,46,76
90,20,30,23,23,46,51
120,-20,-140,16,30,46,77
70,0,80,24,22,46,44
70,0,70,24,22,46,59
70,20,90,23,23,46,75
60,-10,100,23,23,46,51
70,-40,130,23,23,46,70
70,20,40,22,24,46,55
50,0,80,23,24,47,65
60,-10,90,24,23,47,61
50,20,100,24,23,47,52
70,-40,140,24,24,48,75
60,-10,120,22,26,48,65
70,-50,130,23,25,48,70
80,10,50,27,21,48,45
60,10,80,24,24,48,50
80,-40,150,23,25,48,77
100,20,-100,20,28,48,81
70,30,-20,24,24,48,106
70,30,10,26,22,48,56
120,10,-110,19,29,48,59
110,-20,-150,20,28,48,83
70,-30,130,23,25,48,74
60,10,120,25,23,48,63
70,30,20,27,22,49,40
120,10,-80,24,25,49,90
70,30,40,25,24,49,54
120,10,-100,23,26,49,69
70,20,80,23,26,49,65
70,30,0,26,23,49,73
90,-50,150,22,27,49,76
70,0,110,24,25,49,55
120,0,-110,24,26,50,65
120,-20,-130,22,28,50,88
70,20,10,25,25,50,64
70,-30,150,28,22,50,58
80,20,60,25,25,50,66
80,20,50,26,24,50,66
110,0,-120,22,28,50,74
80,-30,140,24,26,50,65
90,-40,170,22,28,50,71
70,-10,120,27,24,51,64
80,20,80,27,24,51,90
70,0,120,25,26,51,66
60,-20,140,28,23,51,68
90,30,-30,20,31,51,64
60,-40,130,27,24,51,84
120,-10,-140,21,30,51,76
120,0,-130,28,23,51,65
60,0,120,24,27,51,58
50,-10,80,28,23,51,81
80,10,60,26,26,52,67
80,30,-30,25,27,52,78
110,10,-110,21,31,52,71
100,20,-30,23,29,52,68
110,-10,-140,23,29,52,84
100,20,10,24,28,52,54
70,30,-10,26,26,52,94
70,-20,120,27,25,52,76
70,-20,130,28,24,52,71
90,-40,140,24,28,52,64
130,-10,-130,21,31,52,81
60,0,80,26,26,52,61
80,20,-30,22,30,52,69
70,20,60,30,22,52,68
70,20,50,29,23,52,64
110,0,-130,28,25,53,75
60,0,130,25,28,53,63
60,10,70,24,29,53,60
110,-10,-120,26,27,53,89
110,-10,-130,24,29,53,89
70,10,40,30,23,53,67
70,10,50,28,25,53,60
90,20,-40,29,24,53,57
50,0,120,26,27,53,55
50,30,100,30,23,53,62
100,30,-10,27,26,53,62
120,-10,-120,25,28,53,90
50,-20,130,28,25,53,75
60,20,110,27,26,53,83
80,0,70,25,28,53,56
50,0,90,24,29,53,58
120,-30,-150,25,28,53,69
60,-30,120,26,28,54,87
120,10,-90,26,28,54,81
110,-30,-150,25,29,54,89
60,-10,140,26,28,54,70
80,-50,130,27,27,54,72
100,20,-50,29,25,54,60
90,10,80,29,26,55,58
110,20,-100,22,33,55,89
90,30,30,26,29,55,56
80,10,40,28,27,55,58
100,10,-10,28,27,55,79
60,-10,80,29,26,55,83
70,10,120,26,29,55,88
80,-40,160,26,29,55,81
70,30,30,27,28,55,63
70,20,70,30,25,55,67
70,20,100,26,29,55,90
70,10,60,30,25,55,62
80,20,70,25,30,55,81
130,-20,-150,24,32,56,64
80,-40,130,26,30,56,71
90,20,80,28,28,56,90
50,-10,110,25,31,56,68
60,10,60,28,28,56,72
70,30,50,26,30,56,75
50,0,70,24,32,56,73
80,-30,160,29,27,56,71
70,-10,80,28,28,56,93
80,0,90,26,30,56,60
100,20,-40,28,28,56,66
110,10,-100,23,33,56,86
40,0,70,30,27,57,86
90,10,10,31,26,57,71
90,10,-10,28,29,57,74
100,20,-90,26,31,57,92
60,0,70,27,30,57,71
110,-30,-160,27,30,57,87
100,10,-40,31,26,57,84
120,10,-70,30,27,57,105
120,0,-100,27,30,57,71
120,20,-110,26,31,57,69
80,0,80,29,28,57,60
50,-10,100,25,32,57,72
50,10,80,26,31,57,73
70,20,30,32,25,57,71
60,20,80,30,27,57,73
60,20,40,32,26,58,73
100,10,-100,24,34,58,90
70,-20,140,28,30,58,78
50,-20,120,28,30,58,83
50,30,90,32,26,58,70
50,-10,130,31,27,58,59
70,-10,100,29,29,58,63
130,-10,-140,25,33,58,84
70,-30,120,29,29,58,93
90,20,-60,34,24,58,70
100,10,-20,33,25,58,82
110,0,-110,27,32,59,87
110,10,-90,28,31,59,114
60,20,50,30,29,59,84
120,0,-80,28,31,59,79
110,20,-90,27,32,59,101
130,0,-130,25,34,59,82
70,20,-10,30,29,59,105
90,30,-40,29,30,59,69
60,-40,120,29,30,59,83
50,10,120,31,28,59,71
110,-20,-130,27,32,59,107
100,30,10,29,30,59,56
50,-10,90,28,31,59,78
120,20,-80,32,28,60,106
130,-20,-140,25,35,60,76
90,20,-50,33,27,60,69
60,10,50,32,28,60,87
120,20,-120,29,31,60,75
110,20,-80,31,29,60,114
50,-10,120,29,31,60,71
50,10,70,33,27,60,80
100,-30,-160,30,30,60,100
100,20,-60,33,27,60,79
120,-20,-120,27,34,61,107
60,30,80,33,28,61,75
110,20,-70,30,31,61,102
100,10,-30,34,27,61,91
60,-30,140,37,24,61,91
80,30,50,32,29,61,89
50,-20,110,27,34,61,80
110,-20,-160,28,33,61,90
40,0,80,30,31,61,83
40,-10,70,31,30,61,107
70,-10,130,30,31,61,84
50,20,90,31,30,61,72
70,20,110,30,32,62,96
70,-30,160,30,32,62,73
120,30,-80,33,29,62,94
90,20,40,27,35,62,80
70,-10,90,32,30,62,74
120,0,-70,28,34,62,103
70,30,60,33,29,62,99
50,-20,100,26,37,63,89
90,-30,-160,30,33,63,131
100,30,-20,35,28,63,79
100,-40,-180,32,31,63,84
70,-50,120,31,32,63,87
60,20,70,38,25,63,85
70,0,130,31,32,63,96
100,-50,150,31,32,63,88
100,-30,-150,30,33,63,121
60,20,60,32,31,63,97
60,0,60,33,30,63,96
90,10,0,31,32,63,84
110,0,-100,31,32,63,98
120,-10,-100,29,34,63,107
100,-40,180,32,31,63,84
90,10,-30,27,36,63,70
80,10,-20,29,34,63,75
80,10,10,34,29,63,75
110,10,-70,32,31,63,116
80,-30,130,29,35,64,85
120,20,-100,29,35,64,84
90,10,50,34,30,64,78
140,-10,-140,28,36,64,95
90,30,40,28,36,64,84
90,20,70,34,30,64,102
60,-20,100,33,31,64,81
90,10,70,32,32,64,74
70,20,20,33,31,64,77
60,-30,110,30,34,64,91
120,-20,-160,26,38,64,80
50,-10,70,32,32,64,108
110,10,-80,34,31,65,119
120,0,-90,30,35,65,88
80,20,100,30,35,65,94
110,0,-80,33,32,65,112
60,30,70,38,27,65,100
40,10,80,34,31,65,95
60,-10,70,32,33,65,119
90,10,20,35,31,66,86
40,10,110,31,35,66,91
100,20,-70,37,29,66,93
120,-10,-110,30,36,66,107
90,20,50,31,35,66,97
70,30,70,39,27,66,88
90,10,90,33,33,66,82
80,-20,130,37,29,66,79
70,30,90,31,35,66,102
110,0,-90,30,36,66,106
70,-50,140,35,31,66,96
70,-40,120,35,31,66,89
100,-20,-140,31,35,66,121
90,-30,150,31,35,66,75
130,10,-80,31,35,66,78
60,-20,90,33,33,66,107
60,30,100,34,32,66,98
90,-40,160,30,37,67,118
90,-40,-160,32,35,67,126
130,10,-90,31,36,67,78
100,20,20,31,36,67,75
60,30,0,34,33,67,134
40,10,70,36,31,67,98
70,-20,150,33,34,67,96
110,10,-120,30,37,67,101
120,20,-90,32,35,67,102
90,20,60,34,33,67,95
70,-10,110,31,36,67,83
100,30,-70,37,30,67,92
130,20,-120,30,38,68,82
100,-20,-150,30,38,68,128
70,-10,70,34,34,68,113
80,10,30,30,38,68,91
120,-30,-140,32,36,68,115
70,30,100,33,35,68,109
120,-10,-150,26,42,68,94
70,20,-20,33,35,68,117
50,-30,110,31,37,68,90
50,-30,120,33,35,68,92
60,-20,150,37,31,68,85
60,-20,80,37,31,68,132
70,30,80,34,35,69,94
110,-10,-110,33,36,69,106
50,10,60,35,34,69,93
40,10,90,33,36,69,95
40,-10,80,35,34,69,105
40,10,100,32,37,69,102
50,20,50,32,37,69,105
80,10,110,37,32,69,84
80,10,-10,36,33,69,79
60,30,90,38,31,69,81
110,-40,180,32,38,70,120
100,10,0,37,33,70,104
100,10,-50,35,35,70,100
130,-20,-130,29,41,70,85
60,30,40,36,34,70,72
80,30,80,32,38,70,120
140,0,-130,33,37,70,97
50,-20,80,33,37,70,124
60,10,40,36,34,70,106
50,0,60,35,35,70,101
110,-40,-180,32,38,70,120
90,10,40,33,37,70,91
50,20,70,40,31,71,116
110,-30,-140,29,42,71,139
50,0,130,37,34,71,77
50,20,40,36,35,71,111
110,30,-80,37,34,71,109
100,20,-110,31,40,71,104
100,30,-110,35,36,71,74
80,0,100,37,34,71,75
80,-50,150,31,40,71,117
110,10,-10,37,34,71,121
120,20,-70,38,33,71,116
60,20,30,37,34,71,110
130,10,-100,34,37,71,97
100,20,-80,37,35,72,112
100,10,-60,39,33,72,108
100,30,-90,37,35,72,102
110,-10,-100,32,40,72,122
100,10,-90,35,37,72,115
50,20,80,37,35,72,92
50,10,50,39,34,73,115
60,20,120,33,40,73,97
60,20,0,38,35,73,155
30,10,70,36,37,73,118
110,-30,-130,33,40,73,138
120,-30,-160,34,39,73,119
70,-20,110,36,37,73,98
50,-10,140,40,33,73,74
80,30,60,42,31,73,112
110,-10,-150,28,45,73,117
80,30,70,33,40,73,115
100,10,-80,37,36,73,114
70,-10,140,35,38,73,105
50,-10,60,37,37,74,148
90,30,70,34,40,74,134
50,20,60,35,39,74,107
60,10,130,36,38,74,104
100,-30,-140,35,39,74,151
80,30,-40,33,41,74,121
100,30,-80,35,39,74,105
90,30,-50,34,40,74,85
40,10,60,33,41,74,102
130,20,-90,37,37,74,100
130,0,-120,30,44,74,111
130,10,-120,31,43,74,97
120,-30,-130,34,40,74,125
90,-30,-170,38,36,74,128
110,-20,-120,36,39,75,125
80,30,90,37,38,75,123
60,30,20,36,39,75,106
80,10,20,39,36,75,95
100,-40,150,39,36,75,96
50,-20,70,37,38,75,150
90,-50,130,36,39,75,109
100,0,-20,39,36,75,136
100,-20,-160,36,39,75,129
100,-10,-120,35,40,75,129
100,10,-70,39,37,76,125
70,-40,150,37,39,76,125
110,30,-110,35,41,76,98
40,20,90,39,37,76,102
60,30,10,38,38,76,123
40,20,70,40,36,76,121
80,0,110,38,38,76,108
60,30,60,36,40,76,116
130,-10,-150,33,43,76,93
80,10,0,36,40,76,81
40,10,50,39,37,76,124
80,-50,120,39,37,76,124
40,0,60,35,41,76,116
90,30,60,38,38,76,136
70,0,60,36,40,76,118
100,-20,-130,33,44,77,147
90,-30,160,39,38,77,129
130,20,-100,36,41,77,102
90,-30,140,33,44,77,110
90,10,60,43,34,77,107
140,-10,-130,33,44,77,96
40,20,110,37,40,77,88
80,20,-40,38,39,77,127
80,-30,170,34,43,77,111
50,-20,90,36,41,77,116
90,-30,180,37,41,78,125
90,10,-50,42,36,78,102
90,-30,-180,37,41,78,125
100,30,30,34,44,78,104
130,-10,-120,32,46,78,117
90,10,-60,40,38,78,117
40,10,120,40,38,78,113
90,20,-70,40,38,78,115
60,-30,150,41,37,78,97
40,20,100,36,42,78,91
80,0,120,32,46,78,109
110,10,-20,39,39,78,125
40,30,100,35,43,78,84
130,20,-80,39,39,78,105
90,20,90,38,40,78,111
70,30,-30,39,39,78,125
120,30,-100,39,39,78,105
110,30,-100,40,39,79,109
100,30,-100,41,38,79,105
90,10,-40,40,39,79,110
60,-40,110,40,39,79,108
60,-20,70,36,43,79,169
80,-40,170,41,38,79,103
90,30,-60,42,37,79,92
90,30,-70,40,39,79,103
60,30,110,36,43,79,118
80,-20,150,35,44,79,103
60,-10,60,41,38,79,137
60,30,50,38,41,79,100
80,-20,140,36,43,79,96
110,30,-90,41,38,79,111
70,10,10,40,39,79,133
110,0,-70,40,40,80,137
40,0,90,38,42,80,104
90,10,30,35,45,80,98
90,0,70,34,46,80,109
60,-40,140,42,38,80,133
60,-50,120,41,39,80,113
50,30,110,41,39,80,100
50,30,70,43,37,80,119
60,30,-10,39,41,80,168
130,20,-110,41,39,80,105
50,20,120,39,41,80,109
80,40,40,41,40,81,98
60,20,10,41,40,81,142
100,30,20,41,40,81,95
100,30,-50,38,43,81,104
70,10,130,40,41,81,120
60,40,80,45,36,81,124
110,20,0,41,40,81,105
100,10,10,42,39,81,124
90,-40,130,39,42,81,115
110,-30,-170,41,40,81,119
120,30,-120,42,39,81,97
30,0,70,43,38,81,120
100,-10,-140,39,42,81,117
100,-10,-130,36,45,81,127
50,-30,100,35,47,82,111
80,-30,-170,39,43,82,142
110,10,0,44,38,82,126
50,30,80,44,38,82,121
50,-30,130,43,39,82,117
40,0,120,43,39,82,104
90,20,-100,37,45,82,109
110,-20,-110,38,44,82,155
100,-30,-180,38,44,82,152
100,10,-110,37,45,82,135
40,-20,70,38,44,82,148
100,0,-100,39,43,82,132
130,-20,-120,33,49,82,117
110,-10,-90,40,42,82,135
90,0,-10,42,40,82,140
130,10,-110,36,46,82,103
100,-30,180,38,44,82,152
130,0,-80,37,46,83,108
50,30,50,36,47,83,113
100,20,40,39,44,83,121
60,0,140,39,44,83,113
100,-10,-110,39,44,83,153
140,-20,-150,39,44,83,117
40,20,120,44,39,83,123
40,-10,60,40,43,83,142
110,30,-70,44,39,83,121
40,0,110,40,43,83,119
70,10,30,38,45,83,120
70,-50,110,43,40,83,139
100,-40,170,36,47,83,141
60,-30,100,41,42,83,142
80,-40,120,45,39,84,120
40,-10,90,39,45,84,143
110,10,-50,42,42,84,149
100,0,-10,44,40,84,159
60,20,20,37,47,84,144
90,-60,140,40,44,84,119
110,20,-60,40,44,84,154
100,0,-80,43,41,84,150
90,-60,150,41,43,84,121
50,10,130,44,40,84,102
90,-30,-150,40,44,84,172
90,20,-80,40,44,84,110
40,20,50,43,41,84,130
120,30,-110,44,40,84,117
60,10,30,39,45,84,142
40,0,50,42,42,84,162
100,-30,-170,37,47,84,115
60,40,90,45,40,85,113
50,-20,140,45,40,85,101
90,-40,-150,42,43,85,186
120,-20,-110,41,44,85,148
110,20,-20,44,41,85,123
70,-20,80,40,45,85,164
70,40,40,43,42,85,98
110,20,-10,42,43,85,96
100,20,30,38,47,85,108
100,0,-120,39,46,85,141
110,0,-10,44,41,85,152
60,-30,160,45,41,86,127
70,40,80,47,39,86,118
50,10,40,38,48,86,143
70,40,50,40,46,86,135
70,-40,160,44,42,86,114
130,-20,-160,40,46,86,123
110,-40,-170,41,45,86,131
100,30,-30,43,43,86,108
130,0,-90,42,44,86,124
130,10,-70,43,43,86,118
150,0,-130,40,46,86,122
80,-20,120,44,42,86,119
130,30,-100,46,41,87,117
50,-20,60,42,45,87,180
40,20,80,48,39,87,137
140,-10,-150,43,44,87,129
90,-40,180,44,43,87,117
90,-20,-160,40,47,87,161
80,-30,120,45,42,87,124
120,-10,-90,36,51,87,152
90,-40,-180,44,43,87,117
70,-40,110,46,41,87,143
110,20,-120,42,46,88,135
70,40,90,44,44,88,130
90,10,-70,47,41,88,148
120,-30,-170,41,47,88,123
90,30,50,47,41,88,144
100,0,-30,48,40,88,146
90,30,80,40,48,88,137
100,0,-90,43,45,88,149
150,-10,-130,38,50,88,125
100,-10,-100,44,44,88,163
40,20,60,41,47,88,128
70,40,60,47,42,89,127
90,20,-90,42,47,89,121
100,-40,160,45,44,89,163
100,20,50,43,46,89,141
50,0,140,43,46,89,91
70,10,0,45,44,89,151
110,0,-40,46,43,89,172
130,0,-70,41,48,89,117
100,-50,160,39,50,89,164
60,30,30,46,43,89,109
80,10,120,42,47,89,141
120,-30,-120,42,47,89,152
140,-10,-120,33,56,89,134
60,-50,110,42,47,89,129
110,10,-60,46,43,89,152
40,0,100,41,49,90,134
100,20,70,44,46,90,115
90,-30,130,47,43,90,128
50,40,90,48,42,90,116
100,30,-60,45,45,90,139
110,0,-20,46,44,90,162
80,-30,-160,45,45,90,185
80,0,60,42,48,90,150
140,-20,-140,37,53,90,123
70,10,-10,41,49,90,151
80,0,130,41,49,90,131
100,20,60,42,49,91,131
100,0,-110,39,52,91,156
100,30,-40,50,41,91,139
40,30,90,46,45,91,114
110,10,-40,46,45,91,159
80,-60,140,48,43,91,118
90,-20,-150,44,47,91,171
60,-10,150,44,47,91,121
100,0,-40,48,43,91,155
40,10,40,43,48,91,175
50,20,30,43,48,91,156
80,-10,70,42,49,91,148
40,30,110,44,47,91,102
50,0,50,45,46,91,171
70,40,70,50,41,91,138
70,-20,160,43,48,91,139
120,30,-90,50,41,91,129
110,20,-50,45,46,91,149
60,40,70,51,40,91,143
80,-10,90,48,43,91,140
100,10,20,48,44,92,121
70,20,120,44,48,92,127
80,-10,120,43,49,92,116
70,-30,110,50,42,92,143
70,-30,170,48,44,92,131
80,-30,-180,42,50,92,150
80,-40,-160,44,48,92,160
100,30,40,43,49,92,161
120,10,-10,49,43,92,182
120,-10,-80,44,48,92,140
130,0,-140,44,48,92,133
120,-40,-170,45,47,92,121
80,-30,180,42,50,92,150
140,0,-140,45,47,92,131
100,0,-70,51,41,92,162
100,-20,-120,41,51,92,169
80,-10,130,47,45,92,111
110,20,10,44,48,92,132
110,0,-60,47,45,92,166
80,20,110,43,50,93,143
130,30,-90,50,43,93,116
110,40,-80,51,42,93,121
100,0,-130,44,49,93,142
80,-40,-170,47,46,93,144
100,10,50,48,45,93,115
70,-30,-170,51,42,93,177
110,-10,-80,44,49,93,160
30,10,60,45,48,93,140
120,10,-130,42,51,93,137
60,0,50,44,49,93,173
140,10,-130,45,48,93,114
130,10,-130,45,49,94,128
50,10,30,43,51,94,180
90,-30,170,40,54,94,145
30,0,60,48,46,94,139
100,-40,-160,44,50,94,136
80,-10,80,44,50,94,148
70,0,140,46,48,94,156
130,0,-100,46,49,95,134
100,-20,-110,43,52,95,164
90,-20,-140,45,50,95,184
130,0,-110,42,53,95,127
40,-20,60,47,48,95,170
130,-30,-160,45,50,95,168
80,10,-30,43,52,95,138
150,0,-140,51,44,95,140
60,-40,100,51,45,96,168
100,20,80,51,45,96,120
140,-20,-130,39,57,96,128
30,-10,70,48,48,96,140
100,-10,-90,47,49,96,179
40,20,40,45,51,96,155
120,0,-60,44,52,96,150
70,-10,60,43,53,96,175
100,-50,140,48,48,96,129
120,40,-80,55,42,97,124
30,-10,60,49,48,97,160
100,-60,150,49,48,97,136
40,10,130,50,47,97,149
50,30,40,48,49,97,147
130,30,-80,48,49,97,135
100,-10,-150,43,54,97,143
70,-40,-170,49,48,97,162
50,40,100,50,47,97,140
80,0,50,50,47,97,170
90,0,80,47,50,97,117
130,-30,-150,45,53,98,147
130,-30,-120,44,54,98,159
90,0,60,45,53,98,202
110,-30,-120,47,51,98,192
100,-20,-100,48,50,98,190
60,20,-10,44,54,98,184
80,-60,130,50,48,98,137
80,40,0,49,49,98,117
40,-10,50,48,50,98,195
110,10,-30,46,52,98,168
80,30,100,43,55,98,158
40,0,130,51,47,98,144
90,-20,-130,45,53,98,194
120,-10,-70,45,53,98,170
110,10,10,52,47,99,174
100,0,0,53,46,99,166
30,0,50,50,49,99,174
60,-20,160,51,48,99,149
120,-40,-180,46,53,99,193
120,-40,180,46,53,99,193
80,40,50,44,55,99,141
90,30,-80,45,55,100,122
70,0,50,48,52,100,181
60,-20,60,46,54,100,204
90,40,40,46,54,100,131
60,-50,130,50,50,100,155
100,0,-60,52,48,100,174
50,-40,120,50,50,100,139
80,40,60,53,47,100,149
90,10,100,50,50,100,139
120,0,-140,51,49,100,142
80,-10,110,52,49,101,157
110,0,-50,50,51,101,185
70,-20,90,56,45,101,165
110,20,20,48,53,101,170
120,0,-20,51,50,101,181
40,-10,120,48,53,101,131
90,10,-80,55,46,101,157
100,-40,-150,42,59,101,179
70,10,20,49,52,101,164
120,30,-70,54,47,101,158
90,-50,160,47,54,101,194
110,-20,-100,43,58,101,169
150,-10,-140,49,53,102,145
50,-10,150,51,51,102,121
30,10,50,47,55,102,168
110,40,-90,56,46,102,165
50,-40,110,51,51,102,129
80,40,80,50,52,102,132
100,40,-80,51,51,102,150
50,30,60,46,56,102,156
50,-20,150,51,51,102,130
100,0,-50,50,52,102,174
80,30,-50,52,50,102,175
90,30,-90,50,52,102,141
130,20,-70,51,51,102,154
40,-20,80,51,51,102,165
70,30,110,51,51,102,156
100,-30,-130,50,53,103,200
110,-10,-60,54,49,103,204
120,10,0,53,50,103,200
40,-10,130,53,50,103,146
110,-40,-140,47,56,103,211
110,20,-30,50,53,103,164
70,-20,100,54,49,103,152
50,-30,70,46,57,103,168
80,-10,100,52,51,103,164
120,10,-60,50,53,103,191
80,0,40,47,56,103,133
100,10,30,50,53,103,153
90,-60,130,49,55,104,171
100,-30,170,45,59,104,224
90,-40,-170,47,57,104,167
90,0,-20,52,52,104,157
90,30,90,47,57,104,171
90,-20,-120,51,53,104,208
110,-10,-70,57,47,104,196
130,-10,-110,46,58,104,166
100,-40,-140,52,52,104,196
100,10,60,54,50,104,168
110,-40,-150,51,53,104,151
90,10,-90,51,53,104,144
110,0,-30,53,52,105,178
90,-20,-110,52,53,105,219
40,30,70,55,50,105,148
50,-40,130,54,51,105,185
100,10,40,51,54,105,148
110,-30,180,49,56,105,213
110,-30,-180,49,56,105,213
70,0,40,53,52,105,161
60,40,60,53,52,105,150
100,30,70,46,59,105,159
70,20,-30,45,60,105,187
70,-10,150,49,56,105,183
60,40,100,51,54,105,135
80,40,-10,50,55,105,139
120,40,-90,61,44,105,149
120,0,-50,52,53,105,201
90,40,30,55,51,106,146
90,-30,-140,51,55,106,207
60,40,50,51,55,106,150
120,-20,-100,49,57,106,179
80,40,70,57,49,106,152
100,-40,140,48,58,106,144
80,-10,140,52,54,106,164
130,30,-110,53,53,106,131
90,-10,-110,50,56,106,213
90,-10,-120,50,56,106,207
100,-20,-170,50,56,106,166
80,20,-50,54,53,107,172
60,30,-20,50,57,107,191
100,-40,-130,56,51,107,215
30,0,80,48,59,107,167
40,-10,110,48,59,107,152
100,-40,-170,45,62,107,174
130,-30,-130,45,62,107,164
50,40,80,55,52,107,170
120,0,-10,55,52,107,198
100,-60,140,51,56,107,172
90,0,50,51,56,107,167
70,-20,70,50,57,107,206
140,-20,-120,39,68,107,149
110,-20,-90,48,59,107,189
110,30,-120,53,54,107,120
40,30,80,53,54,107,173
90,20,100,52,56,108,157
50,-40,100,50,58,108,145
100,30,80,49,59,108,160
100,-30,-120,48,60,108,223
110,-40,-130,54,54,108,183
50,30,0,51,57,108,219
80,-20,-130,51,57,108,219
80,-40,-150,53,55,108,219
90,-40,-140,54,54,108,215
80,-60,120,52,56,108,164
110,30,-60,48,61,109,210
80,-20,160,52,57,109,170
90,-10,-130,50,59,109,201
70,40,-20,58,51,109,167
110,0,0,52,57,109,187
60,-50,100,57,52,109,172
110,0,-140,61,48,109,181
90,-30,-130,53,56,109,229
110,30,10,53,56,109,142
110,30,-10,56,53,109,130
30,10,80,55,54,109,173
90,30,-100,55,54,109,118
30,20,70,52,58,110,151
130,-10,-70,51,59,110,186
130,-30,-140,50,60,110,154
40,-20,90,51,59,110,204
110,-20,-170,47,63,110,160
100,-30,140,54,56,110,184
30,-20,60,52,58,110,197
110,-40,-160,50,60,110,193
120,-10,-60,53,57,110,199
50,20,130,57,53,110,149
70,-30,-160,58,52,110,216
100,30,60,51,59,110,174
150,10,-130,53,57,110,146
120,40,-100,60,51,111,176
70,-30,-180,56,55,111,179
50,-30,80,53,58,111,188
60,-30,70,50,61,111,203
50,-30,90,52,59,111,184
70,-30,180,56,55,111,179
60,20,130,55,56,111,164
70,40,0,53,58,111,164
80,40,10,50,61,111,146
110,20,-40,64,47,111,177
40,30,50,55,56,111,180
90,40,-70,57,55,112,167
110,40,-100,58,54,112,166
80,-30,-150,57,55,112,219
90,40,-10,60,52,112,152
70,-20,170,56,56,112,192
80,40,90,54,58,112,160
90,0,90,53,59,112,155
60,0,150,52,61,113,185
110,-30,-110,48,65,113,219
70,40,100,54,59,113,146
120,0,-40,57,56,113,194
90,0,40,51,62,113,172
100,30,50,56,57,113,194
140,10,-120,53,60,113,172
110,-10,-50,59,54,113,211
60,0,40,51,62,113,226
90,10,-100,54,59,113,171
90,40,50,57,56,113,182
100,-30,150,54,60,114,176
100,10,70,54,60,114,150
70,-60,120,57,57,114,169
40,-20,110,53,61,114,165
90,-30,-120,55,59,114,217
120,-20,-70,56,58,114,229
130,0,-60,50,64,114,186
90,-10,-100,56,58,114,234
80,40,-40,55,59,114,186
40,-10,100,55,59,114,159
130,30,-120,55,59,114,134
130,-10,-80,49,66,115,181
90,0,-30,56,59,115,180
80,40,-30,55,60,115,191
60,10,140,52,63,115,165
60,10,10,57,58,115,229
100,-30,-100,55,60,115,221
110,-10,-30,60,55,115,208
100,-30,160,58,57,115,214
120,10,-20,57,58,115,223
100,-30,-110,54,61,115,212
70,-60,130,55,60,115,171
90,0,-50,64,51,115,180
30,20,50,55,60,115,182
110,-50,160,59,57,116,185
70,40,-30,57,59,116,191
50,-10,50,53,63,116,230
50,30,10,55,61,116,221
100,-60,160,57,59,116,166
30,-10,50,58,58,116,213
110,30,0,57,59,116,149
90,-20,-100,57,59,116,245
50,10,140,61,55,116,134
30,-20,70,56,60,116,179
110,-20,-80,56,60,116,216
90,-20,150,57,60,117,172
130,-40,-160,53,64,117,203
80,-40,-180,54,63,117,201
80,30,-60,60,57,117,172
70,-60,110,59,58,117,182
90,0,-60,66,51,117,197
80,-20,-160,55,62,117,207
130,-40,-170,56,61,117,172
120,20,-60,51,66,117,243
110,-40,170,48,69,117,238
80,-40,180,54,63,117,201
40,0,140,57,61,118,164
40,-10,140,55,63,118,178
100,10,80,58,60,118,167
80,40,20,54,64,118,180
80,-20,-140,57,61,118,240
90,-20,-170,53,65,118,209
120,-10,-30,61,57,118,217
100,-20,-90,58,60,118,228
90,0,0,57,61,118,181
50,20,20,50,68,118,223
40,30,120,64,54,118,162
120,-20,-80,54,64,118,217
120,-20,-170,59,59,118,184
80,-30,-130,62,57,119,223
70,-40,-160,58,61,119,217
90,-20,130,59,60,119,154
50,-30,60,57,62,119,219
90,-20,140,60,59,119,156
40,-20,50,58,61,119,231
60,-30,-170,62,57,119,207
40,-30,70,60,59,119,187
100,-10,-80,63,56,119,226
70,10,140,55,64,119,186
60,40,-20,55,65,120,214
80,40,-20,59,61,120,162
120,-10,-50,62,58,120,220
100,10,-120,57,63,120,211
90,-50,120,61,59,120,192
90,-40,-130,60,60,120,265
60,-30,90,59,61,120,211
140,0,-120,50,70,120,183
120,-30,-70,60,60,120,255
50,-30,140,59,61,120,169
80,-10,60,53,68,121,243
80,-60,110,59,62,121,207
120,-10,-40,63,58,121,222
80,-40,-140,60,61,121,246
120,20,0,62,59,121,232
90,40,80,59,62,121,195
110,20,30,58,63,121,197
130,-20,-60,61,60,121,247
80,-20,-150,57,64,121,225
100,-50,170,56,65,121,230
50,40,70,62,59,121,175
130,-30,-170,61,60,121,176
130,-10,-90,54,67,121,229
40,40,100,62,60,122,163
120,40,-110,63,59,122,173
90,40,20,57,65,122,192
80,20,-60,62,60,122,164
100,40,-70,63,59,122,169
100,-10,-70,63,59,122,227
130,-20,-110,55,67,122,230
110,-30,-80,62,60,122,237
130,-10,-60,62,61,123,214
80,-60,150,55,68,123,186
100,-40,-120,62,61,123,266
70,40,-10,62,61,123,183
100,40,-90,65,58,123,195
80,-50,160,60,63,123,256
60,-30,-180,64,59,123,203
60,-30,180,64,59,123,203
100,-10,-40,65,58,123,228
130,40,-100,65,58,123,188
130,-10,-100,61,62,123,217
110,20,60,60,63,123,160
110,-50,150,63,60,123,165
90,0,-40,66,57,123,185
90,0,-70,66,57,123,206
100,-10,-160,52,71,123,216
120,-40,-160,52,71,123,231
60,-40,150,56,67,123,193
120,-10,-20,65,58,123,208
60,0,30,53,70,123,210
90,40,0,62,61,123,171
120,10,-50,57,66,123,211
70,-50,150,56,67,123,224
60,40,110,61,62,123,180
120,-40,-130,60,64,124,207
90,-10,-140,57,67,124,203
50,20,0,57,67,124,240
30,-10,80,56,68,124,193
40,-20,100,57,67,124,198
40,10,30,56,68,124,238
120,0,-30,59,65,124,241
90,-40,120,62,62,124,215
30,20,80,60,64,124,214
60,-10,160,61,63,124,203
40,-30,60,61,63,124,203
110,-60,160,62,62,124,185
110,-40,-120,62,63,125,245
80,-30,-120,64,61,125,245
80,40,30,65,60,125,174
120,-20,-90,54,71,125,235
80,-30,-140,61,64,125,239
110,40,-70,65,60,125,186
40,10,140,58,67,125,182
110,40,-110,64,61,125,180
110,-10,-20,63,62,125,217
70,0,30,59,66,125,209
50,-20,160,64,62,126,199
80,-50,110,62,64,126,207
60,10,0,64,62,126,251
50,0,40,56,70,126,263
90,0,-90,59,67,126,215
90,40,10,58,68,126,177
80,-20,-170,60,66,126,231
140,-40,-160,63,63,126,194
80,-10,-120,59,67,126,273
40,20,30,57,69,126,210
110,-30,-100,56,70,126,239
70,-20,60,58,68,126,261
130,10,-60,55,71,126,223
90,40,-80,64,62,126,204
80,-20,-110,61,66,127,283
70,-40,170,65,62,127,210
90,40,70,65,62,127,184
100,-50,130,64,63,127,201
120,0,0,68,59,127,222
130,40,-90,67,60,127,172
80,-20,170,61,67,128,232
90,-50,170,65,63,128,227
60,-20,170,69,59,128,222
70,-30,-140,67,61,128,236
50,30,120,59,69,128,177
90,0,-100,61,67,128,235
50,-30,150,63,65,128,201
80,-20,-120,61,67,128,265
110,10,20,64,64,128,218
90,-10,-90,59,69,128,280
100,-50,-180,61,67,128,221
110,20,40,59,69,128,187
100,-50,180,61,67,128,221
140,30,-120,63,65,128,172
140,30,-110,61,67,128,199
110,20,50,62,66,128,178
40,-20,130,66,62,128,202
50,0,150,62,67,129,155
60,40,-10,61,68,129,226
110,-10,-40,68,61,129,216
60,10,20,59,70,129,240
70,-30,100,65,64,129,234
90,-30,-110,63,66,129,240
40,-10,150,57,72,129,222
70,-60,140,60,69,129,192
60,-50,140,63,66,129,215
140,-30,-160,63,66,129,216
50,-50,100,63,66,129,178
110,-20,-70,60,69,129,257
90,0,-80,69,60,129,203
120,10,-40,67,62,129,242
110,10,-130,58,72,130,225
110,-50,-180,63,67,130,212
60,-30,170,69,61,130,206
110,-50,180,63,67,130,212
80,-40,110,65,65,130,247
70,20,130,58,72,130,208
120,-20,-60,66,64,130,255
140,20,-130,60,70,130,162
140,20,-120,60,70,130,172
60,-30,80,60,70,130,214
90,0,-120,61,70,131,215
60,-60,100,68,63,131,206
110,-60,150,64,67,131,220
130,10,0,72,59,131,271
80,-20,180,60,71,131,222
40,40,90,65,66,131,212
100,-30,-90,67,64,131,254
130,-10,-40,72,59,131,265
100,-10,-60,69,62,131,234
60,30,120,61,70,131,189
80,-40,-130,71,60,131,255
70,-20,-130,63,68,131,260
110,30,-20,71,60,131,195
50,30,20,56,75,131,209
130,40,-110,68,63,131,186
80,-40,-120,67,64,131,246
80,-20,-180,60,71,131,222
120,20,-10,67,64,131,205
90,-40,-120,70,61,131,252
120,-40,-120,56,75,131,216
60,-10,50,60,72,132,285
50,40,110,65,67,132,185
50,30,30,65,67,132,216
60,-20,180,71,61,132,233
60,-20,-180,71,61,132,233
50,20,10,61,71,132,273
70,-30,-150,64,68,132,253
140,-20,-160,63,69,132,216
80,0,-10,67,65,132,187
100,-10,-50,72,60,132,238
30,10,90,60,72,132,187
90,40,-20,68,64,132,198
110,-10,-160,51,81,132,212
80,0,30,62,70,132,232
130,40,-120,67,65,132,188
130,-20,-70,63,69,132,259
40,20,130,67,66,133,204
110,-30,-90,63,70,133,257
120,-30,-110,61,72,133,255
90,0,-110,62,71,133,244
30,-30,60,66,67,133,220
100,-40,130,67,66,133,212
40,-30,80,67,66,133,220
110,-40,-80,67,66,133,291
90,-60,120,67,66,133,217
90,40,60,70,63,133,210
130,20,-130,65,68,133,187
120,10,10,67,67,134,229
100,-10,-30,72,62,134,236
70,-20,-180,62,72,134,226
80,10,-90,62,72,134,201
130,10,-10,70,64,134,246
70,-10,160,64,70,134,231
50,-20,50,59,75,134,254
70,-20,180,62,72,134,226
130,0,-10,69,65,134,240
70,-20,-140,63,71,134,254
70,-30,-130,69,65,134,255
120,20,10,66,68,134,240
90,-10,-150,62,72,134,217
40,-20,120,62,72,134,198
50,-30,-180,70,65,135,243
70,-40,-150,73,62,135,245
120,-30,-60,70,65,135,308
80,-10,-110,65,70,135,300
60,-30,-160,74,61,135,248
90,0,20,65,70,135,204
100,0,20,69,66,135,218
50,-30,180,70,65,135,243
50,-30,160,66,70,136,228
100,-60,130,67,69,136,222
40,30,60,58,78,136,244
140,20,-100,64,72,136,215
50,-50,120,61,75,136,216
70,-40,-140,73,63,136,249
100,40,-100,68,68,136,184
50,30,-10,61,75,136,247
90,40,-50,63,73,136,208
120,-20,-50,72,65,137,278
80,0,20,64,73,137,223
80,0,10,65,72,137,186
70,-40,100,67,70,137,266
120,10,-30,66,71,137,294
130,-30,-60,68,69,137,295
30,-20,50,66,72,138,247
40,-30,90,70,68,138,257
60,40,40,71,67,138,176
40,0,40,65,73,138,268
110,-20,-60,69,69,138,286
110,-40,160,66,72,138,233
60,-40,-170,62,76,138,236
80,-20,100,73,66,139,257
110,30,20,68,71,139,214
100,-20,180,59,80,139,282
90,0,10,68,71,139,200
80,-20,90,69,70,139,246
120,40,-120,72,67,139,213
90,20,-110,63,76,139,194
70,-60,100,69,70,139,223
80,-20,110,70,69,139,243
100,40,-60,63,76,139,249
80,40,100,66,73,139,217
100,-20,-180,59,80,139,282
100,-40,-110,70,69,139,275
90,0,100,72,67,139,195
100,-20,-80,66,74,140,284
110,-40,150,70,70,140,212
70,-20,-150,70,70,140,269
80,10,-40,67,73,140,221
70,40,20,64,76,140,210
120,-10,-10,67,73,140,241
140,30,-100,68,72,140,211
90,-20,-90,66,74,140,304
30,10,40,67,73,140,259
110,50,-80,69,71,140,234
140,-30,-150,64,76,140,276
90,10,-110,66,74,140,252
110,-10,-10,72,68,140,241
60,-40,160,73,67,140,227
100,20,90,69,72,141,250
70,40,10,72,69,141,194
50,-10,160,69,72,141,219
80,-10,150,62,79,141,226
90,-20,160,71,70,141,262
150,20,-130,74,67,141,206
70,-40,-130,74,67,141,240
110,50,-90,74,67,141,242
70,-30,-120,72,69,141,279
90,40,-40,72,70,142,218
150,-10,-150,74,68,142,192
100,-30,-80,73,69,142,311
60,-30,-140,73,69,142,265
110,0,10,72,70,142,260
90,40,90,67,75,142,224
90,-10,130,65,77,142,204
80,10,-50,69,73,142,192
90,-40,-110,76,66,142,270
130,-10,-30,72,70,142,262
70,-30,90,69,73,142,292
50,10,20,64,79,143,316
100,40,30,70,73,143,177
120,-30,-80,70,73,143,273
50,40,-10,68,75,143,263
120,-10,-160,59,85,144,236
70,-40,180,69,75,144,239
80,20,-90,69,75,144,204
30,20,60,69,75,144,218
90,30,100,65,79,144,250
70,-50,100,71,73,144,235
90,-20,-180,64,80,144,271
80,20,120,70,74,144,216
70,-20,-170,72,72,144,265
110,-30,170,61,83,144,288
70,-40,-180,69,75,144,239
100,-40,-90,73,71,144,289
70,40,30,72,72,144,220
70,-20,-160,71,73,144,273
120,-40,-140,63,81,144,286
130,-20,-50,75,69,144,305
80,-30,110,70,74,144,268
90,-20,180,64,80,144,271
130,-10,-20,73,72,145,270
100,40,20,72,73,145,211
70,-20,-120,69,76,145,297
90,40,-60,70,75,145,230
30,10,120,77,68,145,220
130,0,-40,71,74,145,260
80,10,-60,76,69,145,209
30,20,90,68,77,145,207
90,0,30,69,76,145,235
100,50,-80,71,74,145,251
110,30,70,68,77,145,206
90,-30,-100,72,73,145,291
80,20,-70,68,77,145,196
110,10,60,73,72,145,233
80,30,110,71,74,145,246
110,-30,-70,72,73,145,314
60,-60,110,75,70,145,213
110,-50,170,66,79,145,258
80,40,-50,71,75,146,246
120,-30,-180,70,76,146,266
100,0,50,69,77,146,225
70,-30,80,71,75,146,270
130,0,-50,63,83,146,242
130,-20,-40,81,65,146,319
50,-30,-170,77,69,146,263
50,-40,90,75,71,146,236
60,40,0,70,76,146,248
120,-30,180,70,76,146,266
80,20,-80,69,77,146,205
130,-30,-50,76,70,146,321
120,-20,-40,75,71,146,285
150,-20,-150,70,76,146,257
100,-40,-100,77,70,147,286
40,40,80,71,76,147,264
60,-30,-150,78,69,147,261
80,0,140,70,77,147,218
50,-50,90,74,73,147,249
110,10,50,70,77,147,226
70,40,110,77,70,147,206
100,-40,-80,75,72,147,344
110,-40,-70,78,70,148,316
20,-10,50,71,77,148,247
80,-10,-130,71,77,148,303
110,-50,-170,72,76,148,251
110,30,30,71,77,148,233
120,-40,-70,73,75,148,307
40,-20,140,70,78,148,244
110,-60,170,71,77,148,236
60,-40,90,73,75,148,275
80,10,130,69,79,148,195
40,40,110,71,77,148,209
100,0,10,75,73,148,258
40,-30,50,76,73,149,259
110,10,30,75,74,149,234
120,40,-70,79,70,149,215
40,-20,150,66,83,149,274
90,-10,-160,73,76,149,262
140,20,-90,72,77,149,196
110,20,70,76,73,149,203
90,-60,160,74,75,149,253
130,-10,-50,73,76,149,284
70,10,-20,71,78,149,233
40,0,150,71,78,149,217
80,-30,-110,74,75,149,312
120,-40,-150,72,78,150,266
100,-10,-20,73,77,150,244
50,0,30,66,84,150,287
110,30,-50,71,79,150,292
70,0,20,69,81,150,287
120,-20,-30,81,69,150,283
70,-10,50,67,83,150,319
90,-10,-80,69,81,150,296
30,20,100,67,83,150,210
30,20,120,73,77,150,213
80,10,-80,73,78,151,241
90,-30,120,73,78,151,261
60,-40,-180,77,74,151,236
120,10,20,74,77,151,270
120,-50,-170,72,79,151,256
30,-20,80,71,80,151,245
90,-30,-90,76,75,151,335
70,0,150,68,83,151,271
60,-40,180,77,74,151,236
140,20,-110,73,78,151,230
110,-40,-110,74,78,152,303
50,-40,70,75,77,152,263
140,10,-90,71,81,152,201
70,30,-40,75,77,152,281
50,40,60,70,82,152,266
90,-20,170,63,89,152,302
100,0,-140,74,78,152,277
120,-30,-50,77,75,152,355
80,-20,-100,76,77,153,362
70,30,120,67,86,153,254
120,50,-90,79,74,153,246
30,10,130,74,79,153,241
30,30,100,76,78,154,225
100,-10,-10,75,79,154,263
130,0,-20,85,69,154,264
90,-40,-100,81,73,154,309
130,-10,-10,76,78,154,276
60,-50,90,74,80,154,258
90,40,-30,71,83,154,222
110,-20,-50,81,73,154,290
100,40,10,70,84,154,247
80,0,-90,70,84,154,277
130,30,-70,76,78,154,232
50,-40,80,81,73,154,254
140,40,-110,82,72,154,239
130,20,0,84,70,154,298
160,0,-140,76,79,155,235
110,30,60,73,82,155,243
50,20,140,74,81,155,212
60,-20,-170,83,72,155,293
150,10,-120,72,83,155,281
140,20,-80,74,81,155,216
100,-20,-70,76,79,155,321
20,-10,60,77,78,155,241
70,40,-40,76,80,156,270
50,30,130,76,80,156,235
40,-30,100,73,83,156,266
140,30,-130,82,74,156,209
130,10,-50,73,83,156,287
60,-30,-130,79,77,156,317
100,40,40,74,82,156,241
130,-20,-80,68,88,156,296
110,10,40,75,81,156,262
30,-30,70,77,79,156,254
90,-70,130,76,80,156,249
140,-30,-120,65,91,156,251
30,0,40,75,81,156,310
70,0,10,72,84,156,286
30,0,90,69,87,156,236
90,-50,-180,75,82,157,290
130,0,0,78,79,157,288
150,-20,-140,74,83,157,248
110,-30,-60,79,78,157,352
50,-20,180,82,75,157,290
120,50,-100,80,77,157,256
50,-20,-180,82,75,157,290
20,0,50,79,78,157,261
90,-50,180,75,82,157,290
80,-50,170,72,85,157,297
80,-40,-110,84,73,157,303
80,30,-70,75,82,157,227
60,-40,-150,84,73,157,284
60,-40,-160,77,80,157,290
90,-50,-130,77,80,157,324
110,-20,-30,83,74,157,287
110,-50,140,79,78,157,242
60,-10,170,83,75,158,276
100,40,80,74,84,158,260
120,-30,-90,73,85,158,307
120,-40,-60,81,77,158,320
20,0,60,77,81,158,232
70,-40,-120,84,75,159,308
60,-30,60,67,92,159,303
30,-10,90,76,83,159,287
50,40,0,78,81,159,304
130,20,-10,84,75,159,310
80,-10,50,76,83,159,322
40,20,20,70,89,159,321
80,40,-60,83,76,159,273
30,20,40,77,83,160,268
40,-30,110,79,81,160,221
80,-70,120,75,85,160,251
100,-70,140,81,79,160,259
60,-40,-140,83,77,160,272
130,20,-60,75,85,160,293
130,-30,-110,67,93,160,274
80,-10,-140,69,91,160,321
120,20,-20,79,82,161,281
80,-30,100,83,78,161,344
100,40,70,80,81,161,277
110,-60,140,80,81,161,251
90,-10,-60,82,79,161,307
30,10,140,84,77,161,286
120,0,10,76,85,161,287
110,0,20,81,80,161,276
30,-10,40,76,85,161,334
90,-10,80,73,88,161,284
100,-50,-80,84,77,161,314
120,20,-130,73,88,161,284
140,30,-90,80,81,161,246
90,-40,-90,82,79,161,354
110,30,40,79,82,161,276
150,0,-120,68,94,162,240
100,40,-50,75,87,162,316
40,-30,130,77,85,162,264
50,-30,-160,86,76,162,275
80,-50,-140,80,82,162,302
110,-40,-90,85,77,162,332
80,-20,80,76,86,162,292
30,-30,50,80,82,162,268
100,40,-10,81,81,162,242
100,30,90,76,86,162,274
130,10,10,83,80,163,310
40,-40,80,83,80,163,301
100,0,60,74,89,163,272
40,-20,160,78,85,163,272
100,50,-90,86,77,163,291
60,-20,-130,79,84,163,325
30,20,130,80,83,163,240
30,30,110,76,87,163,246
80,0,0,75,89,164,244
150,-10,-120,64,100,164,231
90,-10,90,81,83,164,291
110,30,-30,85,79,164,299
110,30,50,73,91,164,246
70,-10,40,76,88,164,343
130,-30,-40,83,81,164,378
130,-10,-160,78,86,164,302
80,30,-80,78,86,164,246
120,30,-60,72,93,165,346
50,40,50,79,86,165,250
140,0,-90,79,86,165,303
130,-20,-30,84,81,165,333
120,30,-10,78,87,165,252
50,-50,110,85,80,165,243
120,-60,160,80,85,165,288
140,-20,-40,86,79,165,350
30,30,120,80,85,165,246
80,10,-70,82,83,165,256
150,-20,-120,69,96,165,270
60,-20,-160,88,77,165,319
60,30,130,74,91,165,267
60,40,-30,81,84,165,276
70,-50,-140,85,80,165,328
60,-20,50,76,89,165,348
80,-50,-130,88,78,166,305
30,0,110,88,78,166,281
60,0,160,74,92,166,269
120,20,-50,80,86,166,336
60,-60,130,81,85,166,273
80,10,-100,77,89,166,281
60,-60,120,78,88,166,237
30,0,120,86,80,166,274
140,10,-100,75,91,166,291
90,-20,-80,78,88,166,351
90,-50,-140,80,86,166,309
90,-10,-70,84,82,166,302
80,20,-100,85,81,166,235
110,50,-100,84,82,166,288
30,-40,60,81,85,166,271
110,-20,-40,87,80,167,307
80,-50,-160,81,86,167,325
60,-20,-140,80,87,167,306
100,-50,-120,83,84,167,348
50,10,10,78,89,167,367
90,0,130,74,93,167,248
140,10,-80,76,91,167,243
50,10,150,78,89,167,256
50,-50,130,84,83,167,272
60,-40,80,80,87,167,309
100,20,-120,72,96,168,284
50,-10,-180,81,87,168,317
50,-10,180,81,87,168,317
80,-30,-100,83,85,168,349
130,-20,-20,86,82,168,340
70,-40,-110,90,78,168,340
120,20,20,85,83,168,292
90,-10,-50,81,87,168,301
150,-20,-130,73,95,168,259
130,-40,-60,84,84,168,337
50,0,160,81,87,168,285
140,-30,-140,82,86,168,286
70,50,70,91,77,168,289
100,-50,-170,80,88,168,309
130,0,-30,87,82,169,331
100,40,50,86,83,169,273
70,-20,-110,85,84,169,347
90,-20,120,85,84,169,279
140,40,-100,84,85,169,244
40,20,10,79,90,169,371
120,-20,-20,88,81,169,296
80,-10,-100,82,87,169,354
90,-10,120,80,89,169,286
40,-40,70,92,77,169,266
20,-10,40,83,86,169,356
140,10,-70,76,93,169,253
130,50,-110,87,82,169,279
100,-30,130,86,83,169,269
130,50,-100,82,87,169,275
130,-40,-120,77,92,169,299
130,-40,-150,75,94,169,374
60,10,150,82,88,170,264
50,-40,60,84,86,170,291
110,-40,-100,87,83,170,326
110,40,-60,76,94,170,333
80,-10,-90,81,89,170,348
90,-50,-120,90,80,170,300
50,-30,-150,91,79,170,300
50,-10,170,88,82,170,290
70,-40,90,83,87,170,342
120,-40,170,76,95,171,314
80,0,-20,77,94,171,261
40,-10,40,79,92,171,364
30,30,90,82,89,171,274
70,50,60,82,89,171,288
60,-20,-150,86,85,171,324
100,-30,-70,81,90,171,369
40,-10,160,83,88,171,293
100,10,90,85,86,171,270
50,-20,170,87,84,171,282
40,30,10,83,88,171,325
80,0,-80,83,88,171,304
40,30,40,82,89,171,294
50,-40,140,82,89,171,293
50,-60,90,92,79,171,276
60,-60,90,82,89,171,270
30,-10,150,86,85,171,325
20,0,40,84,87,171,357
60,-40,-130,85,86,171,311
70,-50,-130,95,76,171,310
140,10,-140,84,87,171,271
120,-30,-100,74,97,171,310
110,-40,-60,89,83,172,371
60,40,10,89,83,172,272
100,-40,-70,89,83,172,378
150,10,-140,83,89,172,245
110,-20,-180,74,98,172,293
130,-30,-70,83,89,172,327
90,-30,-80,84,88,172,385
110,-20,180,74,98,172,293
50,-10,40,75,97,172,385
50,40,120,85,87,172,255
60,-10,40,76,96,172,381
30,10,110,92,80,172,298
130,-20,-90,84,88,172,330
120,-50,-160,76,96,172,296
30,20,110,82,90,172,276
30,0,130,91,81,172,266
100,40,0,82,90,172,250
110,-40,140,83,89,172,271
140,10,-110,89,83,172,284
110,-50,-120,82,90,172,345
120,20,30,87,86,173,309
140,-20,-30,91,82,173,375
20,-20,60,83,90,173,289
20,0,70,83,90,173,267
80,-20,70,84,89,173,332
100,-70,150,86,88,174,250
30,10,30,82,92,174,366
20,-20,50,88,86,174,288
90,-10,50,78,96,174,326
50,-20,-170,90,84,174,322
140,40,-120,86,88,174,237
130,30,-130,90,84,174,243
40,30,0,89,85,174,309
80,-30,90,90,84,174,346
160,0,-130,82,92,174,259
140,0,-110,84,90,174,319
120,-60,150,85,89,174,283
40,10,20,76,98,174,371
160,-10,-140,82,92,174,280
80,-40,-100,92,83,175,359
50,-40,-170,85,90,175,337
140,-40,-170,88,87,175,285
140,-10,-110,81,94,175,314
120,50,-110,87,88,175,284
80,0,-100,82,93,175,337
100,-50,-130,84,91,175,328
80,-10,160,88,87,175,314
140,-40,-150,76,99,175,335
40,0,30,78,97,175,377
90,-10,70,76,99,175,300
40,30,130,86,89,175,274
90,10,110,81,94,175,255
110,-20,-20,87,88,175,306
90,-50,-150,85,90,175,319
80,40,-70,89,86,175,281
70,-50,-150,83,92,175,348
50,-30,170,89,86,175,320
140,-30,-130,77,98,175,290
60,20,140,83,92,175,266
100,40,60,82,93,175,293
130,10,-20,93,83,176,346
120,-40,-110,81,95,176,342
120,-40,-80,90,86,176,352
120,-50,-180,81,95,176,320
120,-50,180,81,95,176,320
80,-70,110,83,93,176,279
70,-70,110,83,93,176,270
90,-70,120,81,95,176,278
90,0,120,79,97,176,299
30,-20,40,84,92,176,340
90,-10,140,87,89,176,300
140,-30,-30,90,86,176,386
140,-10,-40,89,88,177,341
60,50,100,87,90,177,299
30,30,80,85,92,177,281
30,0,140,96,81,177,297
140,10,0,91,86,177,341
80,-20,-90,91,86,177,381
80,-10,40,84,93,177,350
70,-30,-110,92,85,177,334
50,-30,50,82,95,177,315
60,40,120,94,83,177,270
140,-20,-110,74,103,177,293
140,-20,-50,84,94,178,378
60,-10,-180,90,88,178,339
40,-40,60,82,96,178,282
40,-30,-180,89,89,178,306
60,-10,180,90,88,178,339
60,0,20,79,99,178,358
100,-20,170,80,98,178,365
80,-50,-150,81,97,178,341
40,-30,180,89,89,178,306
90,-10,-40,91,87,178,310
60,-40,170,89,89,178,336
110,-50,-80,93,85,178,316
110,20,80,81,98,179,291
130,-50,-160,84,95,179,309
30,-40,70,89,90,179,306
100,50,-70,85,94,179,303
90,-10,60,77,102,179,346
80,-10,-80,86,93,179,347
90,0,-130,86,93,179,282
60,-40,70,87,92,179,313
70,50,90,89,90,179,277
120,-50,160,86,93,179,292
140,-30,-110,83,96,179,318
120,-50,170,81,98,179,330
100,-10,-170,80,99,179,305
140,0,-80,85,94,179,315
60,30,-30,84,95,179,328
100,-20,-40,91,89,180,341
130,-40,-130,85,95,180,339
100,0,40,89,91,180,282
100,0,30,86,94,180,327
120,30,10,83,97,180,277
20,-20,40,88,92,180,347
120,-10,0,86,94,180,303
40,-20,180,88,92,180,311
110,-30,160,89,91,180,341
110,-10,-170,76,104,180,299
80,-50,-120,100,80,180,315
120,-60,170,90,90,180,265
40,20,140,87,93,180,265
40,-20,-180,88,92,180,311
60,20,-20,89,92,181,318
100,-50,-140,86,95,181,310
40,-40,90,98,83,181,321
130,10,20,91,90,181,333
80,0,-70,96,85,181,338
110,30,-40,91,90,181,328
90,0,110,84,97,181,281
110,-70,150,94,87,181,292
120,10,30,85,96,181,307
70,50,100,93,89,182,284
40,40,120,92,90,182,277
110,50,-70,95,87,182,290
110,30,80,90,92,182,283
30,20,140,98,84,182,319
80,-40,100,91,91,182,369
60,-50,-140,98,84,182,325
100,-50,-110,91,91,182,336
50,-30,-140,89,93,182,317
110,-50,-70,93,89,182,331
80,50,60,92,90,182,291
20,10,50,92,91,183,290
60,-30,-120,96,87,183,361
60,50,80,94,89,183,306
50,-50,80,94,89,183,326
30,10,100,84,99,183,309
60,-50,-150,91,92,183,362
50,0,20,81,102,183,379
30,-30,80,93,90,183,316
150,-30,-150,89,94,183,364
70,-50,-160,86,97,183,375
40,-30,120,92,91,183,288
130,-40,-110,85,98,183,326
30,-20,90,85,99,184,349
80,0,-60,99,85,184,299
80,0,-110,87,97,184,373
100,-20,-50,95,89,184,346
60,50,70,93,91,184,308
50,-20,-160,94,90,184,355
100,-20,140,88,96,184,284
50,-40,-150,99,85,184,299
30,0,100,85,99,184,345
70,-30,70,83,101,184,337
70,-20,50,83,101,184,439
40,-40,100,89,95,184,270
80,-10,-150,81,103,184,345
40,-40,50,94,91,185,333
100,-20,-60,95,90,185,355
120,0,20,93,92,185,312
100,-50,-90,96,89,185,337
80,-50,-100,97,88,185,349
90,-50,-90,95,90,185,356
130,-40,-50,97,88,185,374
130,-50,-170,87,98,185,321
60,50,90,92,93,185,312
50,-40,-140,91,94,185,324
90,50,-80,97,88,185,311
110,-70,140,85,100,185,298
80,50,90,92,93,185,299
100,-70,130,86,99,185,294
120,30,0,90,95,185,296
120,50,-80,93,93,186,273
140,0,-60,89,97,186,304
120,0,-150,85,101,186,347
140,-30,-40,95,91,186,362
80,50,80,96,90,186,290
70,-10,170,93,93,186,326
40,10,150,92,95,187,288
20,-30,50,94,93,187,331
70,-10,30,84,103,187,376
90,-70,140,89,98,187,273
70,30,-50,93,94,187,333
140,-10,-60,84,103,187,347
70,-50,160,88,99,187,347
70,0,0,91,96,187,347
30,-10,140,93,94,187,340
80,10,140,88,99,187,269
20,10,70,96,91,187,287
30,-30,40,89,98,187,363
130,-20,-100,86,101,187,344
140,10,-60,89,98,187,298
20,-10,70,98,90,188,308
70,-70,100,88,100,188,302
70,50,80,98,90,188,297
80,-50,-110,98,90,188,360
80,-10,-170,99,89,188,353
90,40,100,86,102,188,323
50,50,100,93,95,188,318
90,-50,-110,102,87,189,347
80,0,-120,96,93,189,350
120,-50,-70,93,96,189,353
90,-10,100,92,97,189,302
40,-20,170,90,99,189,342
80,50,50,88,101,189,303
100,0,80,81,108,189,322
130,-10,0,91,98,189,300
80,50,100,93,97,190,333
120,20,-40,100,90,190,365
80,40,110,91,99,190,327
100,40,-20,90,100,190,328
130,20,10,91,99,190,357
50,50,90,100,90,190,324
40,30,20,88,102,190,340
140,-10,-50,89,101,190,396
40,-50,80,99,91,190,354
90,-40,-80,100,90,190,395
50,-30,-130,97,93,190,377
60,-50,-160,92,98,190,414
130,40,-80,98,92,190,257
70,20,-40,89,101,190,371
140,-10,-80,91,99,190,374
140,-10,-30,101,89,190,363
30,-40,50,91,100,191,347
130,0,-150,93,98,191,323
50,-40,-180,97,94,191,318
100,-50,-150,91,100,191,351
160,10,-140,95,96,191,274
80,50,70,98,93,191,322
140,-10,-10,94,97,191,365
40,-10,180,89,102,191,325
40,-10,-180,89,102,191,325
50,-40,180,97,94,191,318
70,-50,-120,99,92,191,346
40,-10,170,96,95,191,305
100,-60,170,89,102,191,366
140,50,-110,95,97,192,293
110,0,-150,88,104,192,389
130,-40,-180,89,103,192,342
60,-20,-120,102,90,192,360
130,-40,180,89,103,192,342
100,40,-30,97,95,192,354
40,-20,40,88,104,192,372
110,-50,-140,89,103,192,359
80,-10,-160,95,97,192,323
140,0,-70,87,106,193,317
40,40,0,94,99,193,345
130,-30,-30,102,91,193,422
30,20,30,89,104,193,387
110,60,-90,94,99,193,362
150,30,-130,100,93,193,281
120,-20,-10,96,97,193,329
60,10,-10,88,105,193,350
60,0,10,94,99,193,403
30,-20,150,100,93,193,382
50,-40,-160,97,96,193,351
90,-50,-100,104,89,193,336
120,-30,-40,104,90,194,395
60,-40,-120,99,95,194,360
140,40,-130,101,93,194,282
110,40,20,89,105,194,294
120,-50,-60,100,94,194,347
40,-20,-170,96,98,194,342
90,-10,-170,94,100,194,344
90,50,-70,98,96,194,335
140,-30,-50,96,98,194,379
110,40,10,94,100,194,305
140,20,-70,84,110,194,307
140,-20,-60,87,107,194,378
130,10,-140,90,104,194,342
90,-20,-70,95,99,194,379
90,-30,110,93,102,195,411
40,-30,150,93,102,195,361
100,40,-40,97,98,195,361
110,-10,0,99,96,195,333
120,20,-30,98,97,195,376
90,-10,110,98,97,195,341
120,-40,-50,96,99,195,385
70,-50,-170,92,103,195,352
110,40,30,88,107,195,307
140,0,-10,98,98,196,335
70,-40,80,94,102,196,364
80,-50,180,89,107,196,409
50,20,-10,89,107,196,352
90,40,-90,96,100,196,288
140,0,-150,101,95,196,328
80,-50,-180,89,107,196,409
70,-50,-110,102,94,196,363
140,-10,-20,103,94,197,406
70,-50,90,98,99,197,393
80,-20,-80,100,97,197,398
100,0,70,86,111,197,328
130,50,-120,102,95,197,297
130,-30,-80,95,103,198,407
80,-10,170,97,101,198,418
30,40,110,95,103,198,313
110,-30,-50,103,95,198,395
90,10,-120,98,100,198,363
80,-20,60,91,107,198,396
70,-40,-100,104,95,199,395
70,40,-50,97,102,199,380
90,-10,-20,94,105,199,343
90,0,140,90,109,199,347
30,30,130,105,94,199,317
140,50,-120,101,98,199,326
130,0,10,97,102,199,339
50,-60,80,100,99,199,349
50,30,140,95,104,199,334
100,-20,160,103,96,199,358
150,30,-120,99,100,199,329
70,-10,-120,102,97,199,373
100,-20,150,102,98,200,352
110,-50,-160,87,113,200,383
80,-30,80,96,104,200,415
70,50,110,99,101,200,324
60,-40,-110,103,97,200,373
160,10,-130,96,104,200,281
50,-20,-150,99,101,200,387
30,10,20,92,108,200,424
20,10,40,99,102,201,387
90,-10,180,96,105,201,436
90,-10,-180,96,105,201,436
40,-50,70,100,101,201,343
150,20,-120,101,100,201,334
50,-50,70,96,105,201,397
70,20,140,98,103,201,356
30,-10,160,105,96,201,378
80,-70,130,99,103,202,307
140,-20,-20,100,102,202,433
100,60,-80,98,104,202,357
50,-40,150,98,104,202,351
140,0,-50,92,110,202,378
100,40,90,91,111,202,345
130,0,20,97,105,202,377
110,-50,-130,98,104,202,367
90,-20,110,99,103,202,384
80,-30,-90,103,99,202,399
40,-30,140,93,109,202,335
40,20,0,98,104,202,380
60,40,20,98,104,202,284
160,-10,-130,91,112,203,282
90,50,-60,98,105,203,407
100,10,-130,99,104,203,327
90,-50,-160,96,107,203,352
70,-10,-110,99,104,203,408
40,-30,-170,109,94,203,350
70,20,-50,104,99,203,377
70,0,160,95,108,203,368
60,-50,-130,104,99,203,344
130,-20,-10,102,101,203,370
40,0,160,100,103,203,338
80,-40,-90,107,96,203,402
30,0,150,95,108,203,360
60,50,110,102,101,203,316
80,0,-30,96,107,203,317
110,-30,150,98,105,203,375
100,40,-110,103,100,203,278
100,-30,-60,100,103,203,444
90,-50,-170,92,111,203,382
70,-20,-100,100,104,204,415
60,-50,80,93,111,204,391
60,-10,30,90,114,204,444
50,-10,-170,99,105,204,402
70,-50,170,97,107,204,396
70,-10,-140,94,111,205,375
30,-50,60,103,102,205,337
100,-40,-60,103,102,205,433
40,-40,130,101,104,205,345
50,0,170,103,102,205,373
20,10,60,98,107,205,308
90,50,80,98,107,205,369
70,30,130,96,109,205,378
80,0,-50,103,102,205,340
90,-10,-10,99,106,205,326
90,50,40,93,112,205,359
120,10,40,101,105,206,360
130,-20,-170,96,110,206,331
140,0,-100,102,104,206,414
120,-70,160,101,105,206,323
70,50,50,98,108,206,349
130,-60,170,99,107,206,378
150,-20,-30,106,100,206,410
120,-70,150,99,107,206,337
130,-40,-140,95,111,206,423
90,-10,40,93,113,206,391
90,-10,150,101,105,206,376
150,-40,-160,99,107,206,298
30,30,60,94,113,207,374
30,20,20,91,116,207,420
120,60,-100,102,105,207,379
30,0,30,98,109,207,483
120,-60,180,97,110,207,359
100,-10,0,105,102,207,391
90,-10,-30,101,106,207,343
120,-60,-180,97,110,207,359
130,10,-30,102,105,207,422
80,-10,-70,101,106,207,408
120,30,20,102,105,207,363
80,20,130,91,116,207,344
130,-50,-180,99,108,207,390
150,-40,-150,93,114,207,309
130,-50,180,99,108,207,390
140,0,0,107,100,207,365
50,10,0,99,109,208,391
50,20,150,98,110,208,351
130,10,-40,105,103,208,385
30,-10,100,99,109,208,403
100,50,-60,100,108,208,411
90,50,90,104,104,208,380
50,-40,-130,107,101,208,365
110,-40,-50,105,103,208,445
60,-50,-170,100,108,208,383
120,20,40,98,110,208,340
110,20,-130,97,112,209,381
40,40,70,104,105,209,320
90,-30,-70,105,104,209,433
110,-50,-60,112,97,209,414
50,-50,-140,109,100,209,373
70,-10,-130,99,110,209,359
110,-70,160,108,101,209,273
100,-20,130,100,109,209,360
110,-50,-110,106,103,209,415
80,-50,-90,107,102,209,388
80,-50,-170,103,106,209,364
30,40,100,106,103,209,324
60,-50,150,100,109,209,338
90,-50,-80,110,99,209,400
100,-50,-70,109,100,209,395
100,-50,-100,109,101,210,390
90,-40,110,105,105,210,393
70,-50,-100,109,101,210,398
90,20,110,102,108,210,332
50,40,10,96,114,210,378
100,-50,-160,97,113,210,412
50,-50,-150,108,102,210,368
60,50,-30,104,106,210,390
140,-10,-90,100,111,211,425
140,20,0,107,104,211,394
90,50,50,101,110,211,330
140,10,10,107,104,211,380
20,-30,40,102,109,211,381
120,-40,160,101,110,211,385
50,-60,100,106,105,211,343
60,0,170,102,109,211,386
120,-30,-30,102,109,211,414
130,-60,180,103,109,212,339
60,-70,100,104,108,212,350
20,-40,50,106,106,212,376
30,30,50,110,102,212,349
130,-60,-180,103,109,212,339
140,10,-10,109,103,212,379
90,50,60,111,101,212,356
90,-40,-70,109,103,212,436
70,10,-30,103,109,212,342
70,50,-40,102,111,213,410
40,-30,-160,111,102,213,352
110,-20,-10,103,110,213,356
80,-50,100,105,108,213,400
70,-30,-100,108,105,213,419
50,50,110,105,108,213,348
50,50,80,106,107,213,375
70,-60,-130,102,111,213,434
110,10,70,99,114,213,382
70,-10,-170,107,106,213,424
120,20,50,109,105,214,308
30,-20,160,107,107,214,381
70,-30,60,93,121,214,409
30,30,70,112,102,214,360
140,-10,-70,94,120,214,385
60,-10,-170,111,103,214,419
120,-50,150,107,107,214,328
30,-10,120,112,102,214,349
30,-10,130,107,107,214,358
140,-30,-20,109,105,214,441
70,10,150,102,112,214,432
90,-20,-60,107,107,214,416
110,40,-50,105,109,214,472
70,50,-30,101,113,214,405
90,50,70,111,104,215,372
80,-10,30,102,113,215,419
130,10,30,110,105,215,383
110,40,70,109,106,215,378
30,30,140,104,111,215,357
110,-30,-40,107,108,215,422
70,40,120,104,111,215,340
10,-10,40,111,104,215,421
20,-10,30,103,112,215,436
50,-20,40,97,118,215,449
80,-30,-80,112,103,215,419
60,-30,-110,108,107,215,396
70,-10,-160,104,112,216,383
110,60,-80,107,109,216,357
90,30,-110,102,114,216,285
110,40,-10,104,112,216,339
120,-40,-100,101,115,216,429
20,-30,60,115,101,216,338
140,-10,0,108,108,216,395
120,30,30,98,119,217,381
130,50,-90,107,110,217,345
140,10,20,105,112,217,389
10,-20,40,110,107,217,423
130,-70,160,105,112,217,365
110,40,60,99,118,217,397
40,30,140,103,114,217,337
70,-10,180,103,114,217,417
30,10,150,107,110,217,371
70,-10,-180,103,114,217,417
50,-40,160,111,106,217,404
120,30,-50,105,113,218,477
110,-50,-90,112,106,218,411
60,-70,90,104,114,218,348
100,-20,-30,107,111,218,399
130,-40,-40,110,108,218,425
80,50,-70,111,107,218,398
140,0,10,105,113,218,405
140,-10,-100,99,119,218,462
30,-50,70,104,114,218,406
40,-20,-160,111,107,218,401
80,-60,-120,113,105,218,426
80,-10,-180,108,111,219,447
80,0,150,101,118,219,421
60,-50,-120,107,112,219,380
140,20,10,105,114,219,442
80,-10,180,108,111,219,447
130,-30,-20,105,115,220,454
60,30,140,106,114,220,389
150,-20,-110,98,122,220,443
110,40,40,105,115,220,400
40,-60,70,109,111,220,407
120,10,-140,103,117,220,378
140,-20,-10,113,107,220,455
40,30,30,105,115,220,355
10,-20,50,111,109,220,419
80,-40,90,107,113,220,430
120,30,-20,107,113,220,408
140,0,-20,111,110,221,428
40,-60,80,109,112,221,394
80,50,-40,108,113,221,414
100,60,-70,111,110,221,391
110,-60,-180,105,116,221,461
130,20,20,108,113,221,409
70,-30,-90,115,106,221,434
140,-40,-50,108,113,221,406
120,-50,-130,105,116,221,427
110,-60,180,105,116,221,461
110,-10,10,116,105,221,411
40,-50,90,110,111,221,346
40,20,150,106,116,222,351
30,-10,170,110,112,222,396
130,-50,-50,112,110,222,413
130,-50,-60,115,107,222,377
40,50,100,121,101,222,369
60,-20,-110,114,108,222,418
60,50,60,108,115,223,398
40,40,130,113,110,223,372
160,20,-130,109,114,223,374
150,40,-120,107,116,223,352
40,-10,-170,107,116,223,403
110,40,0,105,118,223,325
130,30,0,104,119,223,397
120,60,-90,106,117,223,405
120,-40,-40,112,111,223,471
40,40,60,101,122,223,423
70,-70,120,108,115,223,343
30,40,90,110,114,224,435
80,30,120,105,119,224,386
150,-30,-160,110,114,224,330
30,-40,40,111,113,224,430
30,-10,110,114,110,224,398
150,-30,-140,104,120,224,469
50,40,130,110,114,224,359
80,-10,-60,109,115,224,433
60,50,-20,109,115,224,439
90,-20,-50,114,110,224,426
90,-10,160,115,109,224,457
110,-30,140,113,111,224,338
150,-10,-110,102,123,225,440
40,-30,160,113,112,225,390
120,-50,-120,102,123,225,412
50,-20,-140,109,116,225,420
140,20,-60,103,122,225,414
20,0,30,105,120,225,482
90,-20,100,106,119,225,421
140,-50,-160,109,116,225,401
80,50,40,104,121,225,345
90,-20,80,109,116,225,450
80,-40,-80,117,108,225,432
50,-40,170,110,115,225,431
60,-30,50,102,123,225,442
60,40,30,101,124,225,373
130,20,-50,107,118,225,456
120,-50,-110,105,120,225,422
120,30,60,113,113,226,377
30,-40,80,110,116,226,415
40,0,20,98,128,226,484
130,-50,170,105,121,226,417
30,-20,140,104,122,226,412
90,-50,110,112,114,226,426
140,30,-80,103,123,226,332
80,-20,-70,105,121,226,437
30,40,120,107,119,226,358
120,20,60,111,115,226,322
120,-40,-90,112,114,226,458
10,0,40,113,113,226,421
40,-50,60,107,119,226,425
50,-50,-160,111,116,227,442
90,10,120,103,124,227,383
130,30,10,104,123,227,417
50,-10,30,99,128,227,490
140,0,-30,115,112,227,462
140,0,-40,107,120,227,421
140,-10,-160,102,125,227,397
110,40,50,111,116,227,413
80,-60,-130,111,117,228,455
100,-30,-50,116,112,228,456
150,0,-150,116,112,228,387
80,50,-50,105,123,228,405
150,40,-130,115,113,228,359
50,-40,-120,114,114,228,440
60,-40,60,108,120,228,402
40,50,110,110,118,228,391
130,-40,-70,113,115,228,438
50,50,70,115,113,228,411
120,-50,-50,124,104,228,451
60,-50,70,117,111,228,408
70,-50,180,105,124,229,437
70,-50,-180,105,124,229,437
100,50,80,111,118,229,452
130,-30,-100,100,129,229,480
70,-10,-100,111,118,229,465
50,-30,-120,116,113,229,419
110,-50,-150,111,118,229,488
80,50,110,115,114,229,417
130,60,-110,118,111,229,415
50,-50,-170,106,123,229,468
20,20,50,113,116,229,401
110,50,-110,115,115,230,387
20,-20,70,113,117,230,363
80,50,-60,112,118,230,447
150,0,-110,109,121,230,440
30,30,10,116,114,230,445
140,-30,-170,110,120,230,392
90,-60,-90,112,118,230,406
130,-20,0,115,115,230,388
60,-60,-140,115,116,231,436
90,50,-50,111,120,231,471
40,-40,-140,117,114,231,427
40,-30,-150,118,113,231,406
100,60,-90,113,118,231,396
100,-60,-110,114,117,231,453
100,-10,180,106,125,231,421
110,0,30,116,115,231,412
40,-30,170,114,117,231,432
10,-30,40,113,118,231,482
100,-10,-180,106,125,231,421
100,50,70,111,120,231,448
90,-60,-110,122,110,232,449
110,-50,-100,107,125,232,450
80,-60,160,115,117,232,435
110,40,80,119,113,232,378
90,-30,100,114,118,232,482
120,10,50,109,123,232,394
60,50,120,120,112,232,386
130,-40,-30,116,116,232,478
130,30,-60,109,123,232,434
40,0,170,113,119,232,386
90,50,100,111,121,232,443
40,10,10,114,118,232,487
100,0,-150,103,130,233,461
50,-20,-130,117,116,233,412
160,-20,-140,110,123,233,469
140,-30,-60,105,128,233,427
10,-10,50,116,117,233,414
30,20,10,117,116,233,460
110,60,-100,116,117,233,386
40,-40,110,111,122,233,401
150,-30,-30,122,112,234,428
50,-40,50,109,125,234,413
60,40,130,115,119,234,378
70,-60,90,107,127,234,406
70,0,-90,115,119,234,430
80,-60,100,112,122,234,422
150,10,-110,114,120,234,433
70,-20,-90,118,116,234,458
30,-50,50,111,124,235,465
50,40,-20,114,121,235,380
110,40,-120,114,121,235,344
140,-40,-40,119,116,235,455
110,0,50,107,128,235,404
20,10,80,117,118,235,434
80,-20,50,102,133,235,497
40,-40,120,112,123,235,355
130,-60,160,113,122,235,377
130,20,-20,114,121,235,483
20,-20,30,118,118,236,457
40,-30,40,112,124,236,442
150,-20,-20,123,113,236,461
150,-30,-20,120,116,236,430
50,0,180,119,117,236,444
50,0,-180,119,117,236,444
60,-20,40,102,134,236,538
140,-20,-80,118,118,236,472
60,-60,80,114,122,236,432
40,0,-180,120,117,237,430
50,-50,140,108,129,237,399
40,0,180,120,117,237,430
80,10,-110,114,123,237,421
120,-10,10,119,118,237,443
140,10,-50,104,133,237,411
20,-40,40,117,120,237,445
70,-10,-90,116,121,237,473
100,-60,-80,112,125,237,406
150,50,-120,118,119,237,380
30,20,150,114,123,237,416
20,-40,60,123,114,237,383
90,-60,-130,110,127,237,478
90,-60,170,114,124,238,499
90,-60,-120,116,122,238,457
100,50,40,107,131,238,397
30,-20,170,114,124,238,425
90,-70,150,119,119,238,343
30,0,160,116,122,238,427
80,-60,-100,121,117,238,417
120,-60,-170,115,123,238,519
30,-20,180,112,127,239,384
40,40,10,113,126,239,465
20,10,30,113,126,239,505
30,-20,-180,112,127,239,384
120,-10,-170,106,133,239,408
50,10,160,115,124,239,429
120,-50,-80,123,116,239,459
50,-70,80,119,120,239,402
130,-70,170,117,122,239,392
130,30,-10,117,122,239,427
30,-10,30,115,124,239,515
160,-30,-150,107,133,240,387
120,30,50,119,121,240,416
100,-20,-20,119,121,240,388
140,-40,-110,113,127,240,491
110,10,80,109,131,240,444
100,50,-100,123,117,240,407
90,0,-140,110,130,240,435
40,-10,30,114,126,240,556
50,-50,-130,120,120,240,397
130,20,30,120,120,240,445
80,-60,-140,114,126,240,496
100,-50,120,119,121,240,419
30,-60,60,120,120,240,400
80,-60,-110,116,124,240,428
120,30,40,118,122,240,433
80,-30,-70,120,121,241,469
120,-50,-140,116,125,241,509
70,-60,-110,121,120,241,425
40,-40,-170,122,119,241,454
70,-10,-150,116,125,241,438
130,-30,-90,116,125,241,469
140,20,-10,126,115,241,448
90,60,-80,118,123,241,441
100,0,90,109,132,241,375
80,30,-90,122,119,241,360
130,40,-130,123,118,241,369
60,-10,-160,125,116,241,450
40,-30,-140,120,122,242,441
20,-50,60,120,122,242,406
140,-20,-70,112,130,242,453
40,-40,-130,122,120,242,447
120,-20,180,109,133,242,436
100,-60,120,120,122,242,413
60,20,150,118,124,242,417
120,-20,-180,109,133,242,436
140,-20,-100,109,133,242,534
120,60,-110,118,125,243,411
70,40,-60,122,121,243,445
140,60,-120,123,120,243,437
90,-30,-60,122,121,243,468
140,-40,-120,112,131,243,514
150,20,-140,111,132,243,394
60,-50,-110,123,120,243,426
110,-30,-30,119,124,243,446
120,-30,-20,122,121,243,472
100,-10,10,115,128,243,444
120,50,-120,128,115,243,431
50,-50,60,124,119,243,441
50,50,-10,118,125,243,474
160,-20,-150,114,129,243,435
60,-60,-130,125,119,244,449
120,40,-60,119,125,244,473
70,50,-20,118,126,244,456
100,-60,180,117,127,244,504
100,-60,-180,117,127,244,504
110,0,40,117,127,244,452
100,-40,120,122,122,244,459
110,-20,170,121,123,244,486
90,-60,110,117,127,244,434
100,-60,-120,118,126,244,497
50,-60,120,118,126,244,399
150,20,-110,116,129,245,467
90,-60,-100,117,128,245,466
140,-40,-140,107,138,245,548
70,-60,-120,122,123,245,423
100,20,100,123,122,245,440
70,-60,150,126,119,245,412
10,-10,30,125,120,245,457
90,-10,30,111,134,245,462
90,-20,90,116,129,245,457
70,-50,80,124,121,245,464
140,-60,180,120,126,246,454
100,-50,-60,132,114,246,451
20,-50,50,125,121,246,401
140,-60,-180,120,126,246,454
100,50,50,118,128,246,452
140,50,-130,123,123,246,416
70,-60,-140,116,130,246,487
80,0,-40,124,123,247,456
40,-40,180,120,127,247,442
50,50,120,123,124,247,404
70,30,-60,126,121,247,425
150,-30,-120,107,140,247,515
40,-40,-180,120,127,247,442
120,-20,0,122,126,248,398
140,-40,-20,126,122,248,469
50,50,-20,118,130,248,444
100,50,60,122,126,248,467
70,50,-50,118,130,248,472
40,40,-10,124,124,248,450
150,-10,0,126,122,248,486
130,-60,-170,123,125,248,497
110,-40,-40,121,127,248,503
40,-40,-160,125,123,248,404
120,0,30,124,124,248,426
90,-50,-70,133,115,248,478
40,50,90,123,125,248,428
140,50,-100,122,127,249,412
120,-70,170,132,117,249,352
40,10,160,116,133,249,411
120,-40,-30,122,127,249,504
80,50,-30,120,129,249,463
40,-50,-150,132,117,249,439
100,-10,50,112,137,249,462
60,-50,180,124,125,249,444
60,-50,160,116,133,249,535
60,-50,-180,124,125,249,444
20,0,80,125,124,249,413
80,-70,140,120,129,249,362
90,60,-70,122,127,249,443
70,-40,70,122,128,250,440
150,-10,-40,123,127,250,519
90,-60,-140,121,129,250,493
50,40,40,126,124,250,414
150,-30,-130,116,134,250,551
90,10,130,115,135,250,395
20,20,70,131,119,250,389
120,-50,-150,113,137,250,522
100,-60,-100,128,123,251,519
140,20,20,126,125,251,501
110,-60,-70,118,133,251,418
90,-10,170,120,131,251,495
150,30,-110,125,126,251,428
70,-40,-90,133,118,251,483
140,-40,-30,128,123,251,451
40,-50,50,125,126,251,495
120,30,-130,123,129,252,407
120,-30,170,126,126,252,495
10,-30,50,124,128,252,454
100,50,30,117,135,252,427
90,-60,-80,124,128,252,428
50,-70,90,123,129,252,447
90,-20,70,120,132,252,509
80,-10,20,121,131,252,469
20,20,80,123,129,252,460
140,-40,-130,115,138,253,557
40,-40,-150,136,117,253,425
40,-30,-130,129,124,253,421
80,-30,70,118,135,253,513
140,40,-90,120,133,253,396
30,40,80,120,133,253,457
140,-50,-170,123,130,253,465
90,-10,0,122,131,253,423
130,60,-100,128,126,254,460
140,-50,-50,129,125,254,445
100,-80,130,122,132,254,428
20,20,140,133,121,254,452
140,-30,-100,116,138,254,555
150,0,0,126,128,254,471
90,-80,120,122,132,254,416
100,-10,140,124,130,254,419
40,30,150,123,131,254,441
70,0,170,120,135,255,515
70,0,-10,117,138,255,440
110,-60,-170,125,130,255,520
150,-20,-40,127,128,255,494
80,40,-80,127,128,255,419
30,30,20,125,130,255,496
150,40,-110,125,130,255,409
40,40,50,126,129,255,403
100,30,-120,120,135,255,359
120,-60,-60,122,133,255,428
90,50,30,122,134,256,417
40,-40,140,121,135,256,452
60,10,160,117,139,256,489
60,-30,-100,127,129,256,505
50,0,10,111,145,256,561
150,50,-130,130,127,257,480
60,-60,-120,125,132,257,428
40,30,-10,119,138,257,460
110,40,-20,116,141,257,465
100,-10,80,124,133,257,496
90,60,-60,121,136,257,501
70,-60,-160,124,133,257,501
10,-30,30,122,135,257,511
120,40,20,122,135,257,420
80,-60,-150,124,133,257,498
10,0,30,130,127,257,512
130,-50,-150,116,141,257,481
100,30,100,123,134,257,440
130,-40,-80,124,133,257,508
150,-30,-110,119,138,257,519
50,40,20,124,134,258,426
140,-60,-170,125,133,258,423
150,-10,-100,120,138,258,506
100,-70,160,131,127,258,412
70,-20,40,123,135,258,551
30,0,170,128,130,258,475
20,20,20,123,135,258,504
150,-20,-100,127,132,259,516
60,0,0,125,134,259,506
110,10,-140,126,133,259,474
40,50,120,132,127,259,465
130,-40,-20,128,131,259,519
50,-60,70,131,128,259,479
20,20,130,134,125,259,480
50,40,140,125,134,259,456
10,-10,60,126,133,259,459
30,-20,30,124,135,259,525
50,-10,-160,133,127,260,509
10,-40,40,128,132,260,533
90,-10,10,123,137,260,481
70,50,-10,127,133,260,490
50,-50,-120,136,124,260,476
50,-60,110,127,133,260,412
100,-60,-70,130,130,260,442
40,-70,70,130,130,260,471
130,-30,180,117,143,260,448
40,50,80,132,128,260,478
90,50,-40,131,129,260,519
130,-30,-180,117,143,260,448
140,-20,0,136,125,261,512
110,-80,140,128,133,261,440
40,-50,-160,133,128,261,482
110,-50,-50,136,125,261,487
100,50,90,128,133,261,505
110,0,60,120,141,261,461
30,0,20,124,137,261,547
160,10,-120,116,145,261,473
20,0,160,127,134,261,503
60,-70,110,129,132,261,442
120,40,10,119,142,261,444
130,-10,10,129,132,261,452
90,30,110,123,138,261,465
40,-20,-150,133,129,262,497
140,-70,170,128,134,262,427
130,-50,-40,134,128,262,522
80,60,90,128,134,262,474
100,10,100,135,127,262,465
150,-40,-140,116,147,263,528
60,-60,140,130,133,263,467
160,-10,-150,125,138,263,388
130,30,20,126,137,263,506
110,-60,130,127,136,263,424
20,-30,70,126,137,263,460
10,-20,30,134,129,263,512
60,-10,-140,129,134,263,476
60,-40,-100,135,128,263,504
120,30,-30,129,134,263,551
30,-30,90,130,134,264,504
140,10,-20,129,135,264,520
30,-10,180,133,131,264,439
140,-50,-150,124,140,264,462
30,10,160,128,136,264,503
40,40,140,124,140,264,435
70,50,120,134,130,264,459
70,-60,-150,124,140,264,522
70,-10,20,118,146,264,560
30,-20,-170,134,130,264,461
30,40,130,132,132,264,441
20,20,40,123,141,264,501
80,-80,110,132,132,264,429
30,-20,110,127,137,264,487
140,0,20,128,136,264,449
30,-10,-180,133,131,264,439
150,-20,-50,122,143,265,514
80,-50,-80,140,125,265,510
50,30,-20,125,140,265,543
100,-10,60,119,146,265,513
80,0,160,126,139,265,524
20,10,160,128,137,265,501
60,50,-10,126,139,265,501
110,-50,130,128,137,265,443
150,10,0,136,130,266,471
80,-40,80,129,137,266,515
50,-60,-140,131,135,266,491
150,-10,-20,141,125,266,552
80,0,-130,127,139,266,512
120,-80,150,132,134,266,471
80,60,80,137,129,266,475
80,-60,-90,128,139,267,447
60,-50,170,123,144,267,521
20,-30,30,132,135,267,504
30,-20,100,123,144,267,538
70,60,100,130,137,267,485
70,10,-90,127,140,267,457
140,-30,-70,129,139,268,549
120,10,60,119,149,268,428
160,20,-140,128,140,268,389
150,-20,-160,126,142,268,406
60,-60,-150,133,135,268,521
130,10,40,132,136,268,478
140,20,-140,127,141,268,455
50,-30,40,122,146,268,556
50,30,150,130,139,269,484
120,-50,-40,140,129,269,523
20,10,20,125,144,269,531
20,-10,160,137,132,269,498
30,50,110,140,129,269,460
130,-40,-100,119,151,270,531
120,40,30,131,139,270,502
150,-20,0,139,131,270,532
20,-40,70,139,131,270,459
70,-20,-80,139,131,270,534
20,0,150,142,128,270,506
120,-50,-100,126,144,270,557
0,-20,40,134,136,270,532
130,-50,-70,138,132,270,494
150,-60,-170,136,134,270,478
70,30,140,136,135,271,498
50,10,170,134,137,271,542
50,-50,180,125,146,271,500
150,-10,-10,145,126,271,521
150,-10,-30,136,135,271,520
100,50,-50,129,142,271,571
90,50,-90,139,132,271,478
140,-40,-60,131,140,271,535
80,-20,40,128,143,271,591
50,-50,-180,125,146,271,500
80,50,-20,132,139,271,532
60,40,-40,134,137,271,511
140,10,30,134,138,272,498
70,40,130,133,139,272,524
140,30,0,139,133,272,522
160,0,-120,124,148,272,544
30,-30,150,134,138,272,520
100,-60,-90,135,137,272,482
130,20,-30,128,144,272,596
110,-60,-80,138,134,272,475
140,-40,-100,134,138,272,553
70,0,-110,132,140,272,531
70,50,40,132,140,272,458
70,-30,-80,144,128,272,515
30,40,140,128,144,272,489
10,0,50,132,140,272,497
130,-50,-120,123,149,272,547
60,-60,-160,129,143,272,548
90,40,-100,135,138,273,391
130,0,30,138,135,273,476
30,30,150,128,145,273,481
40,-50,120,141,132,273,458
90,-40,-60,140,133,273,528
40,-40,170,125,148,273,503
30,-30,180,131,142,273,465
160,-20,-130,129,144,273,533
20,-10,150,133,140,273,492
110,-70,130,131,142,273,435
110,50,40,126,147,273,531
70,0,-20,124,149,273,503
110,-60,-60,134,139,273,476
30,-30,-180,131,142,273,465
80,-40,-70,144,129,273,510
30,40,0,139,135,274,526
120,-40,150,131,143,274,510
40,-60,60,130,144,274,489
60,0,-180,131,143,274,546
60,0,180,131,143,274,546
70,0,-100,132,142,274,533
40,-50,-140,136,138,274,487
100,-10,130,124,150,274,478
70,-10,-80,135,139,274,531
140,30,-70,120,154,274,501
100,40,100,127,147,274,492
70,60,80,137,137,274,546
20,20,60,133,142,275,474
130,-30,-10,135,140,275,543
80,20,140,132,143,275,482
100,-60,-130,125,150,275,537
150,-20,-10,135,140,275,539
120,30,70,144,131,275,415
130,-50,-110,130,145,275,553
130,-50,160,138,137,275,515
130,40,-70,135,141,276,469
100,-70,120,138,138,276,455
100,-30,120,132,144,276,528
50,-60,-150,145,131,276,500
80,40,120,130,146,276,503
30,30,40,133,143,276,504
130,30,-20,131,145,276,575
10,0,60,134,142,276,444
40,20,160,131,145,276,472
140,-10,10,134,142,276,470
50,50,60,129,148,277,529
40,10,170,138,139,277,499
130,-60,-50,137,140,277,476
100,-40,-50,139,138,277,529
70,60,110,143,134,277,557
60,20,-30,128,149,277,528
60,-10,-150,143,135,278,532
100,-30,-40,138,140,278,544
40,-50,-130,148,130,278,495
110,40,-40,133,145,278,585
120,-60,-70,136,142,278,464
140,-60,-160,138,140,278,580
40,-40,40,129,149,278,505
150,-10,-50,131,147,278,536
90,-60,180,133,145,278,512
90,50,-30,133,145,278,594
50,-40,-110,143,135,278,520
150,-30,-100,133,145,278,556
120,40,40,135,143,278,579
20,10,90,138,140,278,453
30,-20,130,135,143,278,475
90,-60,-180,133,145,278,512
20,-10,80,144,135,279,456
60,60,110,144,135,279,533
90,-40,100,136,143,279,534
140,30,10,134,145,279,554
130,-50,-130,131,148,279,580
140,-50,-40,142,137,279,516
30,0,180,140,139,279,501
80,-60,170,127,152,279,560
140,-50,180,132,147,279,491
140,-50,-180,132,147,279,491
120,30,-40,136,143,279,582
20,10,150,147,132,279,518
30,0,-180,140,139,279,501
120,40,-10,137,143,280,445
100,-20,120,133,147,280,544
70,60,90,142,138,280,481
130,60,-120,133,147,280,484
140,-20,-90,129,151,280,557
20,30,110,138,142,280,463
60,50,130,140,140,280,501
120,-50,-90,133,147,280,589
150,-40,-20,140,140,280,497
30,20,160,140,141,281,506
100,-10,20,134,147,281,545
60,40,140,139,142,281,509
20,20,30,140,141,281,570
70,-80,100,140,141,281,460
140,-60,170,129,152,281,517
110,-10,20,135,147,282,545
70,10,-50,138,144,282,525
120,20,70,129,153,282,487
80,60,-50,135,147,282,588
100,-60,-140,131,151,282,528
150,-40,-30,140,142,282,558
110,30,90,139,143,282,455
70,-40,-80,145,138,283,549
90,-10,20,137,146,283,458
30,-30,160,145,138,283,571
40,50,130,144,139,283,511
60,60,90,145,138,283,518
70,60,-40,133,150,283,610
80,-10,10,128,155,283,558
120,40,0,132,151,283,435
30,-30,-170,150,133,283,513
100,-10,70,124,159,283,528
130,-80,160,141,142,283,487
20,20,150,146,137,283,549
80,60,-70,138,145,283,543
80,60,-60,144,139,283,570
130,-50,-30,144,139,283,526
100,-80,140,142,142,284,464
30,-50,40,143,141,284,554
90,-20,-40,136,148,284,478
40,-60,90,137,147,284,489
30,40,10,147,137,284,519
60,50,50,132,153,285,488
90,-60,-150,136,149,285,522
70,-70,130,143,142,285,421
70,-60,-100,136,149,285,487
20,20,90,143,142,285,483
110,50,60,144,141,285,557
130,-50,-140,127,158,285,633
160,0,-150,135,151,286,494
150,-40,-120,135,151,286,656
110,50,50,138,148,286,603
90,-70,110,136,150,286,471
20,10,140,144,142,286,511
120,-10,20,141,145,286,516
110,-70,170,146,140,286,481
20,10,120,141,145,286,474
20,30,130,145,141,286,509
110,-40,130,141,145,286,509
70,20,-60,140,146,286,486
90,-30,-50,141,145,286,569
110,-60,-100,139,148,287,546
110,-60,-110,131,156,287,561
160,-30,-140,129,158,287,538
150,20,0,144,143,287,524
30,-10,-170,150,137,287,497
80,10,150,137,150,287,539
90,40,110,133,154,287,545
40,50,-10,149,138,287,526
150,0,-100,133,154,287,553
120,40,70,145,142,287,482
150,-30,-40,135,152,287,571
150,20,10,146,141,287,548
30,-30,170,147,140,287,532
60,10,-20,136,151,287,547
130,-60,-160,143,144,287,609
90,60,80,141,146,287,541
30,50,120,136,151,287,537
20,20,160,135,152,287,550
80,-10,-50,142,145,287,552
130,30,30,143,145,288,569
80,60,60,141,147,288,596
60,-10,-130,143,145,288,533
110,50,70,139,149,288,558
110,-60,-120,137,151,288,586
0,-30,30,142,146,288,578
10,-40,50,150,138,288,550
40,-50,100,140,149,289,512
50,50,130,146,143,289,482
70,-50,-90,153,136,289,525
40,-20,30,139,150,289,630
60,-20,-100,148,141,289,557
30,-60,70,140,150,290,551
30,-70,60,142,148,290,514
110,-10,180,138,152,290,518
70,50,-60,145,145,290,547
150,10,10,134,156,290,508
160,30,-130,148,142,290,475
50,-60,-130,140,150,290,479
110,40,-30,129,161,290,586
140,-70,180,142,148,290,482
80,60,70,141,149,290,572
50,60,100,147,143,290,566
140,-70,-180,142,148,290,482
90,-80,130,146,144,290,465
50,-20,-120,150,140,290,490
10,10,40,139,151,290,571
110,-10,-180,138,152,290,518
70,60,70,145,145,290,586
60,50,-40,141,149,290,525
110,-80,150,146,145,291,487
80,60,100,147,144,291,578
30,-30,140,140,151,291,508
150,-30,-10,148,143,291,518
90,-30,90,136,155,291,568
60,-10,-120,151,140,291,519
100,-10,40,135,156,291,553
150,-10,-60,141,151,292,591
150,0,10,144,148,292,521
60,60,100,146,146,292,519
80,-50,-70,152,140,292,578
60,60,-30,139,153,292,614
100,-60,-170,133,159,292,578
140,60,-110,146,147,293,492
60,30,150,147,146,293,566
100,-10,90,136,157,293,559
140,-30,-10,148,145,293,559
30,30,0,148,145,293,543
20,-40,30,140,153,293,620
80,50,-10,144,149,293,561
50,-30,-110,149,145,294,512
110,50,-60,145,149,294,555
50,20,160,144,150,294,574
80,30,130,140,154,294,539
140,-30,-80,137,157,294,559
80,-70,-100,146,148,294,510
130,-10,20,151,143,294,534
160,-30,-20,147,147,294,546
40,-20,-140,144,150,294,556
40,-40,150,144,150,294,563
120,-50,-30,154,140,294,529
60,-80,90,149,145,294,496
20,20,100,145,149,294,483
120,-70,180,153,141,294,503
30,-20,120,145,149,294,526
80,-20,-60,142,152,294,581
120,-70,-180,153,141,294,503
80,20,-110,143,151,294,478
50,-60,-120,145,149,294,531
60,-10,20,137,157,294,610
130,-40,-90,138,157,295,654
50,-20,30,142,153,295,652
130,20,40,145,150,295,522
30,-40,-150,161,134,295,566
90,-20,60,130,165,295,610
40,-40,-120,151,144,295,546
130,20,-40,151,144,295,586
110,-60,-90,150,145,295,612
110,0,-160,140,155,295,586
20,-20,150,151,144,295,553
30,-30,-150,156,139,295,560
120,40,60,138,157,295,548
80,-60,-160,139,156,295,579
10,10,30,142,153,295,592
120,-30,-10,143,152,295,535
140,10,-40,137,158,295,616
110,50,30,137,159,296,507
40,-40,160,150,146,296,587
90,10,140,135,161,296,453
160,-40,-150,136,160,296,462
150,-40,-130,136,160,296,689
160,-10,-120,130,166,296,546
40,40,150,147,149,296,532
50,60,120,158,138,296,600
30,10,10,142,154,296,626
80,-10,0,134,162,296,539
130,-50,-100,142,154,296,611
40,-70,80,142,154,296,535
20,30,150,147,149,296,548
80,-70,100,144,153,297,501
140,-40,-70,143,154,297,592
140,-80,170,147,150,297,503
20,0,20,140,157,297,650
100,-10,30,132,165,297,571
40,50,0,147,150,297,580
120,-60,140,138,160,298,496
50,60,110,146,152,298,563
70,-70,90,145,153,298,500
110,50,80,150,148,298,575
10,-40,30,144,155,299,586
10,-20,60,143,156,299,545
60,60,80,147,152,299,595
40,-10,-160,144,155,299,555
90,-50,-60,159,140,299,572
140,-50,-30,147,153,300,583
150,50,-110,140,160,300,479
60,-60,-110,145,155,300,506
110,20,90,141,159,300,483
100,0,100,142,158,300,533
150,0,-80,149,151,300,634
20,-60,50,149,151,300,480
30,-30,-140,153,147,300,564
90,-70,-90,147,153,300,525
80,-80,120,149,151,300,484
90,60,70,151,149,300,543
50,-50,-110,155,146,301,568
70,-60,160,145,156,301,633
20,-50,40,145,156,301,566
20,30,90,148,153,301,575
30,10,170,153,148,301,545
70,0,-180,143,158,301,635
70,0,180,143,158,301,635
90,70,-70,154,148,302,561
110,-20,0,143,159,302,540
20,30,80,144,158,302,521
60,-70,80,150,152,302,528
70,10,-40,142,160,302,601
90,60,90,153,149,302,580
130,-40,170,138,164,302,549
70,0,-80,143,159,302,540
20,30,100,150,152,302,486
150,-70,-180,144,158,302,529
30,-40,-160,157,145,302,543
150,-70,180,144,158,302,529
50,60,90,149,153,302,583
100,-10,120,143,159,302,531
30,50,100,155,148,303,524
110,-60,-130,136,167,303,554
50,40,150,151,152,303,558
90,60,60,146,157,303,593
110,0,70,138,165,303,622
30,30,160,152,151,303,566
120,0,40,142,161,303,576
90,50,-20,142,161,303,608
150,0,-60,140,163,303,565
110,40,90,142,162,304,518
150,-40,-10,157,147,304,536
20,10,130,152,152,304,569
150,60,-130,149,155,304,548
90,-20,50,144,160,304,652
120,40,50,143,161,304,566
160,20,-120,153,151,304,559
120,0,-160,144,161,305,583
30,-20,-160,151,154,305,563
150,0,-50,134,171,305,595
20,20,120,155,150,305,504
40,30,160,150,155,305,562
30,-50,80,155,150,305,621
150,0,-10,151,154,305,575
130,-50,-20,157,148,305,542
120,50,-70,148,157,305,478
160,40,-130,148,157,305,555
130,40,20,145,160,305,592
0,-20,30,151,154,305,576
60,60,120,155,150,305,578
0,-10,40,151,154,305,556
150,30,-100,140,165,305,553
120,50,30,149,157,306,577
100,70,-80,153,153,306,545
50,-10,20,135,171,306,647
20,30,140,153,153,306,544
110,70,-90,153,153,306,553
80,0,170,154,152,306,610
40,-50,-170,155,151,306,548
140,-50,-20,161,145,306,560
80,-70,-120,147,160,307,604
90,-30,80,141,166,307,606
90,60,50,152,155,307,622
20,30,70,156,151,307,581
70,-80,110,151,156,307,511
150,-30,-50,145,162,307,585
20,-20,80,158,149,307,534
60,-50,-100,154,154,308,594
50,50,140,160,148,308,559
30,-60,50,147,161,308,546
80,0,180,148,160,308,648
150,-50,-160,152,156,308,586
130,-60,-60,148,160,308,545
60,-10,-110,159,149,308,543
120,-70,140,147,161,308,490
140,20,-20,145,163,308,643
40,-50,130,144,164,308,566
30,30,30,143,165,308,572
80,0,-180,148,160,308,648
90,0,150,149,159,308,606
20,0,170,154,154,308,548
10,10,50,153,155,308,630
10,-50,40,155,154,309,568
20,0,140,158,151,309,576
120,-60,-50,158,151,309,529
20,30,160,148,161,309,566
20,-20,-180,153,156,309,565
40,-60,-150,156,153,309,556
20,-20,180,153,156,309,565
120,70,-100,155,155,310,582
40,60,110,156,154,310,608
150,-60,-160,150,160,310,521
130,40,10,143,167,310,563
50,-70,70,152,158,310,547
40,10,180,158,152,310,568
40,-50,-120,153,157,310,615
80,30,-100,154,156,310,481
140,30,20,149,161,310,643
40,10,-180,158,152,310,568
60,30,-40,154,156,310,590
40,-50,110,156,154,310,588
20,0,90,151,159,310,552
100,50,-40,148,162,310,650
110,-50,-40,160,150,310,581
50,50,0,144,166,310,607
30,-30,130,145,165,310,532
70,-70,-110,155,155,310,523
140,20,30,152,159,311,570
100,-20,-10,143,168,311,516
130,-70,180,163,148,311,470
130,-70,-180,163,148,311,470
160,-30,-10,153,158,311,524
70,-30,50,138,173,311,630
150,-40,-40,155,156,311,588
0,-30,40,160,151,311,589
170,-10,-140,152,159,311,555
20,-30,80,151,160,311,540
80,-30,60,148,163,311,608
140,-50,-130,148,164,312,685
50,-60,130,153,159,312,550
50,-60,-160,150,162,312,578
150,10,-80,148,164,312,633
60,-20,30,139,173,312,701
140,30,-10,158,154,312,557
80,-50,90,148,164,312,590
100,-60,-150,148,165,313,652
30,-40,-170,165,148,313,573
80,-70,-130,154,159,313,608
30,-30,100,149,164,313,652
50,60,-20,152,161,313,631
140,-40,-10,155,158,313,610
30,40,150,149,164,313,557
90,50,110,156,157,313,576
150,-10,-70,151,162,313,669
80,-60,-80,155,158,313,586
70,-20,30,147,166,313,671
30,-30,-160,162,152,314,534
40,-50,-180,154,160,314,615
90,-30,70,150,164,314,649
40,50,140,156,158,314,560
90,0,-150,144,170,314,606
50,50,-30,154,160,314,570
90,-20,40,152,162,314,633
100,-70,-80,152,162,314,532
40,-50,180,154,160,314,615
100,-50,-50,163,151,314,586
120,40,-20,154,160,314,655
150,20,-100,154,160,314,620
150,10,-100,154,160,314,611
150,-40,-110,142,172,314,737
130,-50,-80,156,158,314,649
150,-50,-150,156,158,314,584
100,0,-160,155,159,314,623
90,-60,-70,156,159,315,588
50,-50,150,146,169,315,626
130,50,-130,166,149,315,555
0,-10,30,163,152,315,594
120,-80,160,155,160,315,525
70,-70,-120,153,162,315,591
100,-10,170,146,169,315,601
70,-70,-130,158,157,315,593
60,-60,-170,153,162,315,603
120,-60,-160,151,164,315,607
60,60,70,155,160,315,612
70,60,-50,153,162,315,626
70,10,160,154,161,315,655
140,10,-30,157,159,316,637
20,10,100,153,163,316,630
150,0,-70,146,170,316,644
60,-50,60,154,162,316,591
60,-70,-130,155,161,316,599
30,-40,180,151,165,316,600
150,10,20,145,171,316,539
110,50,20,152,164,316,576
30,-40,-180,151,165,316,600
60,-70,-140,163,154,317,589
30,-40,-140,168,149,317,565
100,60,50,153,164,317,646
100,-60,-60,161,156,317,585
140,-30,0,157,160,317,627
100,50,100,160,157,317,591
40,60,120,159,158,317,607
30,-30,30,146,171,317,629
90,20,120,151,166,317,565
130,40,30,157,161,318,657
80,60,110,165,153,318,601
100,60,70,159,159,318,604
100,-10,150,161,157,318,582
140,-50,-120,145,173,318,688
60,-40,-90,165,153,318,629
90,60,100,164,154,318,629
150,0,-40,151,168,319,656
70,20,150,160,159,319,543
80,-10,-20,150,169,319,607
130,20,-140,151,168,319,567
150,-10,10,161,158,319,585
50,-50,170,153,167,320,613
100,-70,170,162,158,320,613
50,-50,160,156,164,320,665
20,-20,160,156,164,320,593
40,0,-170,164,156,320,574
80,50,-80,165,155,320,609
30,50,130,153,167,320,604
160,-60,-160,162,158,320,521
70,-50,-80,165,155,320,630
170,10,-140,150,170,320,500
90,-70,-110,157,163,320,623
90,-60,-170,139,181,320,726
50,-80,80,161,159,320,538
170,0,-140,151,169,320,518
70,10,-80,156,164,320,582
50,40,30,143,178,321,592
140,-50,-100,148,173,321,669
20,40,110,154,167,321,511
120,-60,-80,159,162,321,664
60,-30,40,144,177,321,693
130,-70,-170,162,159,321,578
150,-50,-40,160,161,321,582
80,50,30,157,164,321,554
100,60,80,161,160,321,636
80,-60,180,144,178,322,670
80,-60,-180,144,178,322,670
90,-70,160,163,159,322,622
30,10,-180,163,159,322,563
30,10,180,163,159,322,563
30,-50,-150,172,150,322,584
30,-50,-160,176,146,322,596
80,-70,-110,154,168,322,569
120,-60,-110,153,169,322,695
50,-60,-170,151,171,322,591
20,-10,170,160,162,322,542
150,-50,-170,158,164,322,598
100,0,120,152,170,322,571
140,-50,-60,156,166,322,595
130,30,40,159,163,322,623
160,-20,-120,145,178,323,642
30,-40,90,163,160,323,687
160,-30,-130,150,173,323,711
20,20,110,153,170,323,617
90,-70,-100,155,168,323,583
150,20,-90,160,163,323,608
150,0,-90,154,169,323,706
70,-40,60,150,173,323,643
140,-60,-40,155,168,323,575
40,10,0,157,166,323,653
40,-60,-140,160,163,323,556
100,-40,-40,159,165,324,634
150,-20,10,168,156,324,604
110,60,-70,167,157,324,567
40,-10,20,145,179,324,690
160,0,-110,152,172,324,613
150,-40,-100,154,170,324,671
90,-40,-50,159,165,324,647
80,10,-120,164,160,324,623
70,-60,-170,156,168,324,674
40,40,20,159,166,325,580
70,-10,10,159,166,325,618
130,20,50,159,166,325,575
140,-50,-110,147,178,325,722
160,-30,-120,157,168,325,725
60,-70,120,163,162,325,512
100,60,60,165,160,325,642
110,-70,-180,158,167,325,610
140,-50,-140,151,174,325,660
20,40,120,161,164,325,576
110,-70,180,158,167,325,610
150,-20,-60,159,167,326,633
130,-60,-40,164,162,326,591
150,-60,180,144,182,326,610
30,-50,-140,173,153,326,578
70,60,60,159,167,326,627
40,-60,-160,172,154,326,618
90,10,-130,156,170,326,572
10,-50,50,163,163,326,581
150,-60,-180,144,182,326,610
110,-60,-50,165,161,326,615
100,-70,-90,155,172,327,631
70,50,130,161,166,327,604
70,10,-100,163,164,327,582
160,-40,-20,163,164,327,635
160,-20,-10,165,163,328,600
30,50,90,158,170,328,597
170,-20,-140,162,166,328,646
20,10,110,159,169,328,625
20,-10,180,168,160,328,562
120,-30,160,159,169,328,590
130,10,50,159,169,328,598
100,-20,110,163,165,328,661
20,-10,-180,168,160,328,562
60,60,-40,154,175,329,606
130,30,-50,165,164,329,718
150,-50,-20,164,165,329,656
50,0,0,146,183,329,676
110,60,40,157,172,329,665
80,-10,-40,163,166,329,610
150,0,20,158,171,329,598
160,-40,-10,173,156,329,616
150,10,-10,161,168,329,628
150,-50,-30,172,158,330,584
120,60,-80,164,166,330,563
70,60,120,167,163,330,623
30,50,0,168,162,330,634
80,70,-60,166,164,330,629
140,-20,-170,161,169,330,566
60,10,170,161,169,330,640
140,0,30,158,172,330,612
40,-30,-120,159,171,330,593
120,40,-50,164,166,330,723
70,-60,-90,168,163,331,622
80,-70,150,161,170,331,645
120,-50,140,156,175,331,582
50,0,-170,164,167,331,637
70,0,-120,160,171,331,613
60,-30,-90,177,154,331,651
90,-70,-120,164,167,331,635
50,40,-30,160,171,331,610
70,10,-70,161,170,331,587
110,-30,-20,164,167,331,639
30,40,60,161,170,331,657
80,-30,-60,162,170,332,627
130,-30,0,162,170,332,602
20,0,180,176,156,332,552
20,0,-180,176,156,332,552
30,50,140,166,166,332,629
160,-40,-120,162,170,332,692
50,-50,50,165,167,332,597
130,70,-110,163,169,332,630
150,10,-90,162,170,332,690
120,-60,-90,165,167,332,692
20,30,120,166,166,332,600
150,-20,-70,162,170,332,673
140,-30,-90,148,185,333,768
30,40,70,161,172,333,629
80,-10,-10,156,177,333,610
150,-80,-180,163,170,333,559
140,60,-130,163,170,333,598
150,-80,180,163,170,333,559
60,50,0,156,177,333,606
110,-70,-70,165,168,333,561
40,-70,60,164,169,333,594
150,10,-60,148,185,333,594
120,-70,-170,156,178,334,645
120,-70,-60,160,174,334,608
100,50,20,158,176,334,598
110,-60,-160,149,185,334,727
70,50,0,163,171,334,634
110,-60,-140,151,183,334,689
80,50,120,170,164,334,585
40,-80,70,168,166,334,575
140,-60,-30,173,161,334,634
70,-60,170,153,181,334,666
160,-20,-20,169,165,334,571
90,50,-10,154,181,335,660
60,-80,100,167,168,335,565
20,0,110,161,174,335,623
60,-60,160,155,180,335,714
40,-60,-130,169,166,335,611
110,70,-100,168,167,335,588
40,60,100,161,174,335,622
160,-40,-140,160,176,336,610
70,-50,70,166,170,336,653
50,-70,100,169,167,336,598
80,60,50,159,177,336,694
130,50,-80,161,175,336,631
140,-40,180,154,183,337,647
40,40,40,159,178,337,675
120,50,40,166,171,337,685
60,-40,50,162,175,337,633
40,60,130,179,158,337,648
100,-10,100,159,178,337,685
140,-40,-180,154,183,337,647
60,-70,-120,175,163,338,547
120,70,-110,170,168,338,603
20,10,170,174,164,338,602
100,-30,110,166,172,338,656
120,-60,-120,157,181,338,658
100,60,90,174,164,338,701
100,-80,120,162,176,338,544
120,-60,-40,167,171,338,657
90,-60,-160,157,181,338,724
20,40,130,171,168,339,585
70,10,-60,168,171,339,631
0,-40,30,175,164,339,641
100,50,-30,152,187,339,732
40,40,160,174,165,339,657
140,40,-80,149,190,339,632
30,20,170,169,170,339,598
160,30,-140,167,172,339,533
150,20,20,169,170,339,586
90,20,-120,158,181,339,611
40,0,10,156,183,339,716
20,-70,50,168,172,340,600
100,0,130,157,183,340,545
150,30,10,166,174,340,659
140,-60,-50,162,178,340,622
110,-70,-80,165,175,340,656
30,-50,-170,182,158,340,639
110,-20,160,167,173,340,612
160,-10,-110,158,182,340,672
130,-80,170,167,173,340,578
60,-60,-100,168,173,341,636
140,20,-50,164,177,341,662
10,10,60,173,168,341,573
70,40,140,173,168,341,647
50,-10,-150,172,169,341,647
140,10,40,174,167,341,688
50,-70,-140,170,171,341,631
100,-10,110,178,163,341,672
150,-30,0,170,171,341,635
120,-60,-100,155,186,341,692
130,40,0,161,180,341,590
150,0,-20,176,166,342,659
20,30,10,169,173,342,673
20,30,60,170,172,342,656
130,-50,-90,161,181,342,755
80,0,-140,163,179,342,678
80,60,-40,165,177,342,751
10,10,20,169,173,342,621
100,60,-60,177,165,342,668
30,40,160,174,168,342,614
70,60,-30,163,179,342,769
40,50,150,170,172,342,632
120,-60,-130,159,183,342,718
40,50,70,164,178,342,655
40,20,170,161,181,342,657
150,-50,-10,175,167,342,629
50,10,-10,166,177,343,704
100,70,-90,167,176,343,614
80,50,0,164,179,343,634
150,30,-140,179,164,343,541
90,-80,110,168,175,343,555
100,60,40,172,171,343,657
80,-40,70,150,193,343,676
70,-70,-140,167,176,343,639
150,-20,-90,157,186,343,721
150,-60,-30,172,171,343,668
70,0,-70,179,165,344,628
130,-10,-170,155,189,344,596
30,-30,120,180,164,344,654
50,-60,-110,175,169,344,631
160,-20,0,172,172,344,648
80,-60,-170,157,187,344,795
30,-10,20,169,175,344,748
20,40,160,168,176,344,671
140,-20,10,167,177,344,595
20,-60,60,166,178,344,639
110,-10,30,172,172,344,658
50,60,80,170,174,344,633
120,10,70,157,187,344,712
100,-10,160,179,166,345,662
140,-70,-160,168,177,345,634
160,-50,-10,177,168,345,726
120,50,50,173,172,345,715
20,40,150,172,173,345,643
20,40,140,171,174,345,648
60,-50,-90,183,162,345,681
20,0,100,164,181,345,705
30,-60,-150,178,168,346,629
160,50,-130,182,164,346,604
130,30,50,174,172,346,635
30,0,-170,175,171,346,643
80,-20,-50,164,182,346,678
160,-10,0,178,168,346,607
90,60,-50,173,174,347,708
110,-20,150,167,180,347,624
150,-70,-170,175,172,347,594
50,20,-20,161,186,347,687
60,60,130,176,171,347,652
50,-70,-130,177,170,347,601
50,60,130,180,167,347,633
50,50,50,159,188,347,646
60,50,140,171,176,347,636
150,10,-70,151,196,347,634
150,-50,-120,160,188,348,765
100,-70,180,169,179,348,678
100,-70,-180,169,179,348,678
50,-70,-150,178,170,348,643
90,-70,170,170,178,348,657
60,60,-20,158,190,348,742
20,-20,170,172,177,349,624
120,-40,-20,181,168,349,657
20,-50,70,175,174,349,635
70,30,-70,167,182,349,645
40,60,-20,168,181,349,664
150,60,-120,168,181,349,568
140,-50,-10,174,175,349,625
10,-60,40,174,175,349,569
20,20,170,175,174,349,583
160,-60,-150,168,182,350,617
80,-40,-60,180,170,350,616
150,-40,-50,169,181,350,590
130,30,-30,167,183,350,733
50,60,-30,158,192,350,621
30,-70,70,169,181,350,618
20,0,130,161,189,350,647
160,0,0,187,163,350,639
100,-70,-70,166,184,350,633
20,30,170,181,169,350,641
120,-70,-50,170,181,351,681
100,-60,-160,150,201,351,816
30,-40,-130,175,176,351,623
130,-70,150,161,190,351,581
100,-20,80,166,185,351,674
110,-10,60,161,190,351,741
90,-20,-30,166,185,351,720
120,50,20,160,192,352,656
50,10,180,175,177,352,685
20,10,-180,184,168,352,592
50,10,-180,175,177,352,685
20,10,180,184,168,352,592
150,-10,-90,160,192,352,723
100,10,110,169,183,352,678
40,60,-10,171,181,352,703
70,20,-70,169,183,352,591
150,30,0,173,180,353,676
20,40,100,170,183,353,615
110,-40,-30,175,178,353,673
80,-20,30,158,195,353,693
120,50,60,166,187,353,707
130,60,-90,166,187,353,684
10,20,170,181,172,353,669
90,-70,-130,173,180,353,731
120,40,-30,156,197,353,755
150,-10,-80,172,181,353,708
110,-70,-60,170,183,353,656
110,-30,130,172,181,353,671
70,70,90,182,171,353,676
110,0,80,160,193,353,675
20,-60,40,171,183,354,644
150,20,-70,157,197,354,598
140,-70,-170,183,171,354,604
30,-30,110,169,185,354,670
100,50,-20,156,199,355,735
150,-40,-170,169,186,355,580
20,-20,90,165,190,355,686
150,-40,0,178,177,355,683
130,0,-160,170,185,355,673
150,-30,-90,168,187,355,783
110,60,70,173,182,355,732
100,-30,-30,168,187,355,630
140,40,10,170,185,355,699
0,0,30,175,180,355,656
20,0,120,173,182,355,684
90,-70,-80,171,185,356,639
10,-30,60,178,178,356,670
60,0,-170,176,180,356,751
30,-60,80,168,188,356,677
150,-60,-20,183,173,356,698
30,-80,60,176,180,356,635
130,0,40,178,178,356,713
20,30,20,180,176,356,701
60,70,100,188,168,356,698
40,-30,30,166,190,356,761
60,-70,-110,175,181,356,654
20,-10,100,165,191,356,680
90,70,-80,170,186,356,643
110,-80,130,166,190,356,554
120,0,50,170,186,356,644
160,-70,-170,175,182,357,624
70,-10,-70,179,178,357,688
90,0,-170,166,191,357,702
100,10,-140,176,181,357,724
130,-60,-70,170,187,357,709
100,-20,70,165,192,357,730
90,-50,100,165,192,357,743
120,30,80,181,176,357,553
80,-70,-90,173,184,357,623
150,0,-30,173,184,357,720
110,50,90,177,180,357,665
80,70,80,180,177,357,688
160,-40,-130,171,186,357,722
70,-60,180,160,198,358,801
60,50,40,171,187,358,634
70,-60,-180,160,198,358,801
160,50,-140,180,178,358,678
150,-60,-150,173,185,358,729
150,10,30,174,184,358,656
100,-70,-100,172,186,358,680
40,20,-10,167,191,358,730
20,-10,90,167,191,358,711
140,30,-140,179,179,358,625
20,-20,-170,195,163,358,651
130,-70,-40,174,184,358,723
120,70,-90,174,184,358,696
0,-10,50,169,190,359,633
40,-60,100,176,183,359,736
10,20,30,178,181,359,712
130,-60,-30,178,181,359,693
80,-80,100,174,185,359,578
100,20,-130,172,187,359,610
130,70,-120,183,176,359,627
120,-80,140,163,196,359,582
150,40,-100,166,193,359,577
150,10,-50,164,195,359,726
100,-20,100,173,187,360,770
110,-60,-150,163,197,360,788
60,-60,150,178,182,360,686
140,30,30,179,181,360,721
50,60,140,184,176,360,672
130,-20,10,173,187,360,626
30,-10,-160,181,179,360,694
30,60,130,174,186,360,716
140,-40,-80,174,186,360,784
70,-70,-100,174,186,360,666
70,60,-60,173,187,360,657
140,-10,20,176,185,361,667
10,10,160,183,178,361,682
150,50,-140,182,179,361,670
80,-70,-140,177,184,361,730
110,-10,50,175,186,361,702
110,-20,140,179,182,361,583
20,-30,-170,186,175,361,697
160,-20,10,179,182,361,659
0,0,40,178,183,361,698
70,40,-70,178,183,361,712
70,70,-50,175,186,361,692
110,60,50,180,181,361,730
40,-50,170,174,187,361,702
110,70,-80,179,182,361,660
160,-40,0,186,176,362,638
20,40,90,180,182,362,664
30,50,150,187,175,362,690
100,-40,110,168,194,362,714
170,20,-140,164,198,362,569
130,20,60,176,186,362,625
130,-70,-50,171,191,362,656
120,40,80,178,184,362,615
110,60,60,182,180,362,689
140,40,20,175,187,362,764
150,10,-150,180,182,362,610
20,-10,140,184,179,363,672
160,-20,-110,166,197,363,796
110,-20,10,177,186,363,650
30,60,120,177,186,363,717
110,50,-50,175,188,363,736
90,0,-160,176,187,363,698
140,-40,-90,168,195,363,796
160,-20,-30,168,195,363,698
160,30,-120,181,182,363,669
160,-20,-100,175,188,363,717
50,70,110,190,173,363,725
160,-50,-160,180,183,363,690
50,60,-10,170,193,363,775
20,30,50,177,187,364,663
50,-40,-100,179,185,364,675
90,70,70,177,187,364,723
10,0,20,177,187,364,699
130,-60,150,170,194,364,617
60,20,160,182,182,364,733
120,40,-130,189,175,364,642
50,-10,-140,178,186,364,695
30,30,170,184,180,364,652
30,-60,-140,186,178,364,669
130,30,60,186,179,365,657
90,0,-180,176,189,365,704
40,-60,-120,190,175,365,690
120,50,70,178,187,365,715
160,40,-140,180,185,365,656
90,0,180,176,189,365,704
20,-30,180,187,178,365,682
20,-30,-180,187,178,365,682
40,-50,40,177,188,365,694
50,-70,-120,188,177,365,688
150,-10,-160,171,194,365,623
110,-10,70,168,197,365,770
130,40,40,188,177,365,747
170,-60,-150,184,181,365,600
160,60,-140,178,188,366,694
50,-50,-100,185,181,366,669
160,-80,-170,183,183,366,609
130,50,30,180,186,366,744
90,-40,90,179,187,366,759
150,20,-10,179,187,366,682
100,0,110,176,190,366,668
160,0,10,188,178,366,644
160,-10,-20,188,179,367,723
100,-20,0,169,198,367,731
40,-60,-170,182,185,367,683
30,-50,-180,179,188,367,697
30,-50,180,179,188,367,697
30,-70,50,179,188,367,657
130,-40,-10,186,181,367,729
60,-60,70,177,190,367,707
150,40,-140,185,182,367,630
50,30,160,183,184,367,669
70,-70,140,177,190,367,658
140,-50,-70,190,178,368,740
60,-60,-180,177,191,368,817
130,-60,-130,169,199,368,804
120,-60,-140,171,197,368,785
60,70,90,189,179,368,743
30,-50,-130,182,186,368,695
90,50,20,168,200,368,653
130,-60,-110,174,194,368,763
140,20,40,182,186,368,719
120,-20,10,179,189,368,721
110,10,90,172,196,368,678
10,10,70,175,193,368,652
60,-60,180,177,191,368,817
140,50,-90,167,202,369,730
140,10,-150,173,196,369,610
60,-10,10,176,193,369,773
40,-70,-140,185,184,369,664
20,-80,50,183,186,369,671
10,0,70,182,187,369,716
100,-70,-60,185,184,369,731
160,-10,-100,177,192,369,708
60,60,60,179,190,369,694
100,0,-170,169,200,369,703
100,-70,-110,176,193,369,705
110,-70,-50,182,187,369,742
50,-60,60,182,187,369,701
10,30,160,192,178,370,667
50,-80,90,177,193,370,658
20,50,120,180,190,370,691
40,-70,-150,188,182,370,664
150,30,-90,176,194,370,700
80,70,90,189,181,370,690
70,70,100,188,182,370,699
170,-30,-140,178,192,370,676
70,20,-80,176,194,370,723
120,-70,-70,183,187,370,689
80,0,-170,181,189,370,771
20,-40,-160,197,173,370,738
160,-60,-170,170,200,370,651
160,-30,0,179,192,371,647
150,20,-80,166,205,371,718
140,-60,-20,179,192,371,728
20,-40,80,189,182,371,707
20,-40,-150,193,178,371,715
30,-40,30,178,193,371,721
30,-40,110,184,187,371,791
150,-50,-140,178,193,371,788
140,70,-120,185,186,371,681
10,-50,30,182,189,371,736
90,50,10,178,193,371,695
50,-20,-110,187,185,372,670
110,-70,-170,178,194,372,749
160,-30,-160,188,184,372,602
20,-30,150,185,187,372,744
110,-70,-90,181,191,372,724
20,50,130,173,199,372,731
140,-80,180,184,188,372,655
30,-40,120,183,189,372,679
140,-80,-180,184,188,372,655
20,-10,20,189,184,373,749
30,60,140,198,175,373,763
40,60,140,191,182,373,712
30,-60,-160,194,179,373,694
80,-70,160,178,195,373,734
30,-40,170,185,188,373,658
100,-20,50,177,196,373,764
40,-20,-130,184,189,373,646
20,40,80,185,188,373,660
90,-60,-60,188,185,373,727
150,-30,-60,177,197,374,713
130,40,-10,182,192,374,672
40,-40,-110,189,185,374,626
120,0,60,167,207,374,713
10,20,160,185,189,374,704
30,50,80,186,188,374,714
60,70,-40,180,194,374,717
110,0,-170,174,201,375,749
130,10,-150,174,201,375,671
120,20,-140,176,199,375,693
70,-70,-150,183,192,375,741
80,50,10,173,202,375,759
50,-60,180,187,188,375,761
-10,-20,30,194,181,375,707
140,30,-20,175,200,375,733
0,-40,40,187,188,375,673
50,-60,-180,187,188,375,761
30,-40,130,184,191,375,676
80,-10,-30,177,198,375,752
160,-40,-160,185,190,375,611
60,-70,-150,188,187,375,721
150,-20,-80,178,197,375,829
130,-80,150,172,203,375,624
160,-10,10,193,183,376,674
140,-50,170,168,208,376,709
60,-10,-100,192,184,376,739
60,-20,-90,189,187,376,727
140,30,-60,179,197,376,699
70,-80,90,181,195,376,625
20,-30,170,189,188,377,711
20,-10,-170,192,185,377,672
100,70,-70,186,191,377,712
170,10,-130,183,194,377,676
70,0,-170,181,196,377,779
120,40,-40,173,204,377,836
120,-70,-40,185,192,377,743
120,20,80,164,213,377,662
40,-50,-110,188,189,377,710
70,-30,-70,191,187,378,751
120,60,40,189,189,378,818
150,-50,-130,181,197,378,752
100,-70,-120,178,200,378,789
130,40,-60,186,192,378,705
100,-60,-50,197,181,378,718
140,-70,160,179,199,378,632
90,20,130,182,196,378,651
140,60,-100,179,199,378,708
10,20,20,180,198,378,710
60,70,110,191,187,378,727
150,30,20,189,190,379,745
30,-20,-150,192,187,379,712
30,50,160,187,192,379,732
160,10,-110,182,197,379,717
150,-40,-90,185,194,379,791
20,10,10,180,199,379,771
0,-50,30,190,189,379,708
120,-60,-150,169,210,379,888
130,50,20,184,195,379,730
80,-60,-70,198,181,379,748
40,-60,50,185,194,379,772
160,10,0,197,183,380,676
20,20,10,186,194,380,719
70,-60,-80,196,184,380,745
20,40,10,191,189,380,744
60,40,-50,186,194,380,696
30,0,10,181,199,380,761
170,0,-130,184,197,381,675
130,-70,-160,174,207,381,704
10,0,160,184,197,381,740
50,50,150,190,191,381,738
160,-30,-100,182,199,381,781
60,0,-10,170,211,381,814
160,-10,-10,192,189,381,762
90,-70,-70,190,191,381,745
50,70,100,194,187,381,776
20,-40,-170,203,178,381,732
10,10,170,191,190,381,703
120,60,30,184,198,382,752
50,-30,30,186,196,382,821
130,-60,-100,176,206,382,837
70,50,30,180,202,382,778
90,0,160,187,195,382,826
70,-10,0,169,213,382,738
40,50,-20,187,195,382,675
160,-50,-20,194,188,382,698
40,60,90,185,197,382,740
160,-10,-30,190,192,382,762
80,70,-70,182,200,382,663
90,70,-60,185,198,383,747
30,-40,100,175,208,383,768
110,60,80,194,189,383,793
150,-10,20,188,195,383,811
100,60,-100,192,191,383,700
160,-30,-30,184,199,383,768
90,-70,-140,183,200,383,759
150,-50,-110,178,205,383,841
20,-30,160,188,196,384,789
120,-10,30,193,191,384,757
110,-60,-40,195,189,384,706
100,50,10,181,203,384,723
80,-80,130,191,193,384,696
160,-50,-150,186,198,384,778
80,-70,-150,182,202,384,757
0,-20,50,194,190,384,706
90,60,-90,191,193,384,712
70,0,-30,182,202,384,702
130,-60,-150,189,196,385,838
70,-20,-70,189,196,385,773
130,40,50,193,192,385,746
110,30,-130,192,193,385,705
60,-60,170,178,207,385,835
80,50,20,176,209,385,723
30,40,50,192,193,385,695
100,70,60,198,187,385,783
20,40,170,195,190,385,715
70,20,-90,182,203,385,647
100,-20,60,169,216,385,808
40,-70,-130,202,183,385,750
40,40,30,184,201,385,766
10,-40,60,189,197,386,743
130,30,-40,184,202,386,820
90,70,80,200,186,386,733
20,50,140,194,192,386,787
160,10,-150,187,199,386,674
20,-20,140,182,204,386,710
40,-50,140,185,201,386,729
50,70,120,200,186,386,749
20,-30,-150,203,183,386,764
140,-60,-150,192,194,386,766
70,70,80,200,186,386,756
160,-40,-110,190,197,387,826
40,-60,110,189,198,387,732
60,-60,-90,192,195,387,748
80,0,-160,180,207,387,786
20,-40,180,190,197,387,758
30,20,-180,190,197,387,723
30,20,180,190,197,387,723
140,-70,-30,194,193,387,770
20,-40,-180,190,197,387,758
150,-60,-40,187,200,387,726
60,40,150,197,190,387,712
160,40,-120,194,193,387,711
150,0,30,192,195,387,759
150,-50,0,202,185,387,701
80,0,-150,182,206,388,797
20,-50,30,194,194,388,750
100,-20,90,174,214,388,798
20,20,180,194,194,388,667
150,20,-60,167,221,388,747
40,-70,90,188,200,388,764
20,20,-180,194,194,388,667
30,-40,150,184,204,388,833
10,-10,160,191,197,388,794
50,60,70,191,197,388,759
70,60,-20,183,205,388,847
70,50,10,182,206,388,763
160,-50,0,195,193,388,732
60,50,-50,184,204,388,710
160,-30,-110,179,210,389,872
90,-20,-20,186,203,389,686
20,50,150,197,192,389,769
10,30,150,193,196,389,723
140,-50,-90,186,203,389,864
160,-40,-30,198,191,389,768
30,-40,160,196,193,389,777
50,-40,40,186,203,389,723
80,70,100,195,194,389,784
80,-60,90,181,208,389,825
70,0,-130,178,211,389,755
90,-80,140,189,201,390,702
60,50,10,194,196,390,782
100,20,110,188,202,390,739
20,-50,-150,204,186,390,700
130,40,60,189,201,390,725
130,-60,-80,200,191,391,802
30,60,-10,190,201,391,781
90,70,60,199,192,391,835
80,40,-90,198,193,391,702
150,20,30,183,208,391,737
20,-10,110,193,198,391,757
80,70,-50,191,200,391,790
30,60,110,191,200,391,718
150,-30,-70,187,204,391,840
10,-50,60,197,194,391,714
130,-70,-30,193,199,392,790
80,-70,-80,191,201,392,768
140,-70,-40,188,204,392,716
170,-20,-150,184,208,392,682
50,70,-30,195,197,392,751
10,20,40,189,204,393,820
160,-50,-120,181,212,393,836
50,-30,-100,201,192,393,747
90,0,170,190,203,393,815
0,-50,40,197,196,393,775
50,-70,110,188,205,393,695
60,-70,130,190,203,393,708
10,40,160,193,200,393,770
20,-50,-160,211,182,393,738
10,-40,20,189,204,393,786
70,-60,80,189,204,393,797
100,50,-10,190,203,393,745
50,-60,-100,195,198,393,748
20,-30,90,191,202,393,799
110,-10,40,177,216,393,757
120,-60,-30,206,187,393,738
100,0,140,179,214,393,623
30,-30,-130,198,195,393,686
80,70,70,201,193,394,803
130,50,40,195,199,394,851
90,50,0,188,206,394,756
100,-70,-130,192,202,394,800
170,-30,-10,207,187,394,706
170,-30,-130,181,213,394,801
60,70,120,206,189,395,795
30,-70,-160,206,189,395,729
30,-70,-150,208,187,395,753
130,-60,-120,175,220,395,848
130,-60,-140,192,203,395,860
-10,-30,30,201,194,395,713
80,-50,80,188,207,395,835
20,-20,20,190,205,395,814
70,70,110,206,190,396,777
150,-50,-50,186,210,396,752
90,30,120,193,203,396,732
130,-70,-60,191,206,397,730
100,70,70,202,195,397,786
10,-60,50,193,204,397,684
120,-40,140,195,202,397,756
70,-80,120,197,200,397,724
40,-80,80,192,205,397,781
110,50,10,190,207,397,751
20,50,110,190,207,397,690
140,20,-30,180,217,397,808
70,10,170,193,205,398,815
60,-80,80,191,207,398,661
0,0,50,201,197,398,745
160,-60,-20,194,204,398,793
160,10,10,203,195,398,688
110,60,-110,197,201,398,704
150,-60,-10,194,204,398,804
140,-60,-120,191,207,398,832
150,-30,10,190,208,398,748
70,-30,40,183,215,398,818
50,-60,140,199,199,398,746
40,50,60,188,211,399,775
100,50,0,192,207,399,845
110,50,-30,174,225,399,863
150,-50,-100,186,213,399,804
10,-80,40,195,204,399,699
40,70,120,204,195,399,788
90,-50,-50,204,195,399,714
70,60,50,192,207,399,740
20,-30,-160,213,187,400,772
40,-50,150,196,204,400,861
40,-60,120,192,208,400,757
150,-40,-60,184,216,400,783
80,40,130,197,203,400,750
0,-40,20,201,199,400,725
30,-40,140,193,207,400,770
130,70,-100,199,201,400,764
20,-40,-140,203,197,400,764
170,-80,-160,199,202,401,670
140,-80,160,186,215,401,657
30,20,0,194,207,401,770
30,-50,90,188,213,401,743
170,-60,-160,190,211,401,675
10,-20,20,202,199,401,766
160,-60,-10,203,198,401,787
90,60,40,190,211,401,806
20,-60,-160,208,193,401,766
100,-20,10,188,213,401,774
10,30,170,202,199,401,711
20,60,130,190,211,401,801
50,70,130,214,188,402,812
10,20,60,197,205,402,730
150,10,-20,188,214,402,823
130,40,-20,202,200,402,762
80,-30,50,183,219,402,881
20,-70,60,190,213,403,741
170,-10,-150,191,212,403,757
160,20,-110,195,208,403,842
40,60,150,205,198,403,749
10,-10,70,206,197,403,768
20,0,-170,205,198,403,767
110,-70,-100,193,210,403,774
130,-60,-90,190,213,403,864
20,-20,-160,208,195,403,819
20,60,140,204,199,403,806
10,20,50,196,207,403,782
0,-60,30,196,207,403,702
120,60,50,204,199,403,835
10,-10,20,201,202,403,756
170,-20,-130,183,221,404,806
160,-40,-90,190,214,404,833
130,-60,-20,211,193,404,781
30,40,170,204,200,404,758
0,-30,20,202,202,404,770
100,10,120,182,222,404,784
140,40,30,207,197,404,833
70,-40,-70,205,199,404,754
30,60,0,200,204,404,812
110,-70,-110,191,214,405,830
90,-70,-180,182,223,405,835
160,0,-100,194,211,405,834
90,-70,180,182,223,405,835
60,-70,-160,195,210,405,801
160,20,10,208,198,406,794
70,70,-40,204,202,406,820
10,-60,30,197,209,406,802
170,-10,-130,195,211,406,742
20,-10,130,192,214,406,795
20,-20,100,191,215,406,793
150,-70,-160,216,190,406,738
140,-70,-20,199,207,406,838
40,70,110,204,203,407,830
0,10,30,202,205,407,754
10,10,150,211,196,407,785
120,0,70,187,220,407,844
140,30,40,204,203,407,815
150,-30,-80,189,218,407,905
110,-30,-10,194,213,407,737
90,-30,60,189,218,407,905
100,-50,-40,201,206,407,774
140,70,-130,199,208,407,724
100,70,80,209,199,408,846
40,-60,180,202,206,408,786
120,10,-150,197,211,408,725
90,-20,30,185,223,408,813
40,70,130,205,203,408,791
120,-20,170,189,219,408,802
20,30,40,185,223,408,775
40,-60,-180,202,206,408,786
20,-50,-170,214,194,408,806
40,-70,-160,208,200,408,779
140,-50,-80,197,211,408,857
150,-80,-170,200,209,409,746
70,0,-50,191,218,409,836
70,-70,150,197,212,409,810
160,20,0,208,201,409,737
10,20,150,205,204,409,798
80,-50,-60,209,200,409,727
140,-60,-60,191,218,409,827
110,50,-40,183,226,409,894
20,50,160,209,200,409,784
140,40,0,199,210,409,803
110,-70,-120,195,214,409,859
10,-30,20,200,209,409,827
50,-80,70,199,211,410,697
80,60,-30,197,213,410,858
30,-60,-170,207,203,410,810
120,-70,-80,209,201,410,810
40,-50,160,194,216,410,857
40,30,170,206,204,410,832
70,-70,-90,198,212,410,789
20,-70,40,202,208,410,752
160,-50,-30,212,198,410,792
90,70,90,210,201,411,835
130,-10,30,202,209,411,848
50,20,170,206,205,411,839
100,-30,100,201,210,411,886
30,60,150,210,201,411,797
50,-20,20,186,225,411,917
20,-60,-150,211,200,411,739
140,-60,-100,192,219,411,799
10,20,70,197,214,411,733
140,40,-140,213,198,411,815
50,-70,-160,204,207,411,803
10,-70,40,204,207,411,715
100,70,50,211,201,412,888
40,70,-20,205,207,412,812
140,50,20,209,203,412,872
150,30,-80,181,231,412,763
110,50,-20,191,221,412,893
150,70,-130,207,205,412,777
30,-50,-120,211,201,412,778
160,0,-90,194,219,413,838
50,-60,150,202,211,413,836
60,-80,110,197,216,413,770
10,40,170,216,197,413,788
90,60,-40,206,207,413,872
20,50,100,195,218,413,814
160,-30,10,205,208,413,781
50,50,10,201,212,413,862
170,-30,-150,195,219,414,660
100,60,100,207,207,414,799
70,50,20,189,225,414,788
170,-40,-10,214,200,414,781
70,0,-60,201,213,414,768
170,20,-130,199,216,415,747
20,30,30,190,225,415,823
170,30,-140,199,216,415,738
130,10,60,187,228,415,750
90,-80,-80,210,206,416,866
120,60,60,214,202,416,843
100,-80,150,202,214,416,725
30,-20,-140,207,209,416,780
40,50,160,212,204,416,824
70,0,-140,197,219,416,821
170,-40,0,215,201,416,795
80,-70,170,194,223,417,800
130,-20,180,195,222,417,810
40,-10,-150,209,208,417,790
70,30,150,202,215,417,770
140,-60,-110,197,220,417,906
120,-30,0,200,217,417,703
130,-20,-180,195,222,417,810
150,-60,-120,197,220,417,889
170,0,-150,194,223,417,734
150,-70,-150,192,225,417,753
130,60,30,212,205,417,918
20,40,70,195,222,417,791
60,60,-10,208,210,418,899
120,-70,-90,211,207,418,874
120,60,-120,207,211,418,781
170,-30,-120,199,219,418,813
170,-30,0,206,212,418,754
160,-70,-160,210,208,418,775
140,-60,-10,211,207,418,825
50,-60,160,192,226,418,903
150,-40,-70,201,217,418,882
140,-60,-130,201,217,418,873
160,-30,-40,198,221,419,900
30,40,-10,198,221,419,802
160,50,-120,202,217,419,709
70,-80,-100,213,206,419,880
10,0,170,209,210,419,775
20,50,10,215,205,420,852
30,40,20,193,227,420,764
60,-70,-100,209,211,420,799
150,40,10,204,216,420,845
140,0,-160,198,222,420,758
30,60,100,196,224,420,803
90,60,110,213,207,420,790
160,-50,-110,201,219,420,854
110,-50,-30,205,215,420,756
20,60,150,218,202,420,869
140,40,-70,204,216,420,834
170,-50,-150,211,209,420,809
0,-20,20,214,207,421,783
140,-30,10,200,221,421,800
140,-40,0,209,212,421,856
70,70,-60,203,218,421,745
120,60,70,213,208,421,850
90,40,-110,208,213,421,643
40,60,80,211,210,421,799
30,-60,-130,217,205,422,817
40,40,-20,206,216,422,850
150,-50,-180,200,222,422,810
140,0,40,205,217,422,889
120,50,-60,211,211,422,793
150,-50,-90,196,226,422,864
150,-50,180,200,222,422,810
30,10,-170,211,211,422,756
50,-70,-110,213,209,422,825
30,-70,-140,216,207,423,824
110,70,60,216,207,423,847
160,-10,-40,191,232,423,758
170,-40,-120,194,229,423,848
40,-20,20,201,222,423,933
160,60,-130,214,209,423,736
30,50,10,204,219,423,861
40,-70,-120,222,201,423,826
70,60,130,218,205,423,796
80,-80,-90,216,207,423,879
10,40,150,214,209,423,809
60,20,-40,198,225,423,846
80,60,120,217,206,423,771
150,-30,-170,210,213,423,768
60,60,-50,202,221,423,789
140,20,-40,206,218,424,854
10,0,150,220,204,424,811
150,60,-140,219,205,424,765
20,30,180,227,197,424,757
110,-80,-70,212,212,424,820
20,30,-180,227,197,424,757
140,-70,-50,206,218,424,801
70,50,-70,211,213,424,814
40,-80,60,209,215,424,752
70,-70,-160,202,222,424,831
90,-60,100,210,214,424,853
110,70,50,222,203,425,876
30,-20,20,202,223,425,938
110,60,30,214,211,425,805
30,-50,170,208,217,425,870
30,-40,-120,211,214,425,777
60,-20,20,191,234,425,880
40,70,140,225,201,426,861
50,-80,-120,215,211,426,880
20,-50,-180,222,204,426,851
20,-50,180,222,204,426,851
100,-80,-70,211,215,426,883
60,70,80,207,219,426,862
100,-50,110,206,220,426,856
170,-50,0,216,210,426,843
20,-40,170,217,209,426,816
70,-20,20,190,237,427,886
60,-10,-90,206,221,427,824
30,-80,70,209,218,427,865
160,0,-10,218,209,427,885
100,-80,-80,210,217,427,816
50,30,-30,202,225,427,796
40,60,0,201,226,427,887
90,-30,-40,201,226,427,888
60,10,180,214,213,427,878
140,70,-110,211,216,427,794
60,10,-180,214,213,427,878
120,-80,-60,215,212,427,823
30,70,-10,206,221,427,827
150,-70,-30,210,218,428,826
160,-60,0,216,212,428,876
170,-20,-10,221,207,428,811
160,-40,-100,203,225,428,882
130,50,50,212,216,428,899
20,-10,120,210,218,428,872
20,-60,-170,222,206,428,900
120,-70,-160,198,231,429,861
160,-10,-80,196,233,429,848
50,70,90,209,220,429,819
20,60,120,215,214,429,810
150,30,-10,207,222,429,800
60,-80,-110,217,212,429,868
60,30,-50,207,222,429,800
100,-20,40,201,228,429,830
150,60,-110,206,224,430,778
100,-70,-170,195,235,430,893
60,70,-30,215,215,430,880
160,-40,10,205,225,430,759
150,-70,-20,214,216,430,866
10,-40,-170,217,213,430,937
-180,-80,-150,209,222,431,726
10,-10,150,213,218,431,842
90,-40,80,204,227,431,885
180,-80,-150,209,222,431,726
30,70,140,216,215,431,864
70,70,70,216,215,431,873
10,-30,-170,223,208,431,899
130,-80,-50,218,213,431,840
80,10,160,204,227,431,917
150,40,-90,202,230,432,830
50,-10,-130,215,217,432,861
140,50,30,224,208,432,971
90,-20,-10,199,233,432,897
20,50,90,224,208,432,810
110,-20,130,200,232,432,824
80,60,40,207,226,433,843
70,0,-160,208,225,433,829
130,60,40,231,202,433,960
80,-30,-50,192,241,433,843
60,10,-30,203,230,433,827
100,50,-110,215,218,433,734
40,20,-180,218,215,433,924
40,20,180,218,215,433,924
80,30,140,210,223,433,783
110,70,70,228,206,434,899
0,-80,30,214,220,434,752
90,-80,-90,216,218,434,796
150,-70,-10,210,224,434,878
150,-60,-110,214,220,434,931
40,0,-160,214,220,434,848
120,-30,150,204,230,434,757
50,-70,120,213,221,434,817
20,10,-170,220,214,434,809
30,-60,-180,217,218,435,822
130,40,-30,203,232,435,934
110,10,-150,209,226,435,828
170,-50,-10,227,208,435,809
140,-60,-140,208,227,435,1032
30,-60,180,217,218,435,822
110,50,-120,218,217,435,743
170,-20,10,218,217,435,800
30,-60,40,211,224,435,913
150,50,-100,193,242,435,786
80,70,110,223,212,435,881
150,-80,170,206,229,435,713
100,60,-50,217,218,435,908
60,-30,30,198,237,435,968
130,50,60,218,217,435,872
160,0,20,213,223,436,821
90,-70,-150,202,234,436,933
10,20,180,218,218,436,801
40,-60,-110,216,220,436,798
120,-10,40,201,235,436,843
10,20,-180,218,218,436,801
50,0,-160,212,224,436,874
30,50,-10,214,223,437,876
80,-70,-70,224,213,437,904
10,30,140,219,218,437,829
140,20,50,221,216,437,859
120,-50,-20,221,216,437,827
60,50,20,200,237,437,862
150,30,-70,193,244,437,777
60,-70,-170,211,227,438,891
30,70,130,218,220,438,866
10,30,80,218,220,438,820
70,70,120,225,213,438,854
140,30,50,213,225,438,868
20,50,170,222,216,438,821
30,-50,110,206,232,438,885
90,-70,-60,229,209,438,893
60,-70,140,215,223,438,874
20,-20,130,214,224,438,890
160,10,-100,208,230,438,932
110,0,90,210,228,438,904
160,-60,-30,211,227,438,886
50,-80,100,207,232,439,832
20,-70,-170,228,211,439,863
90,10,150,217,222,439,875
120,50,80,215,225,440,821
20,-90,50,211,229,440,749
-110,-90,-80,211,229,440,749
80,-90,110,211,229,440,749
110,-90,140,211,229,440,749
-40,-90,-10,211,229,440,749
-10,-90,20,211,229,440,749
-50,-90,-20,211,229,440,749
-100,-90,-70,211,229,440,749
150,40,20,220,220,440,909
-60,-90,-30,211,229,440,749
30,-90,60,211,229,440,749
170,-60,0,224,216,440,916
40,-30,-110,217,223,440,775
70,-70,170,204,236,440,997
170,-90,-160,211,229,440,749
100,-90,130,211,229,440,749
0,-90,30,211,229,440,749
0,-50,20,221,219,440,904
-130,-90,-100,211,229,440,749
-80,-90,-50,211,229,440,749
-70,-90,-40,211,229,440,749
150,-90,-180,211,229,440,749
80,60,-20,206,234,440,934
130,-90,160,211,229,440,749
-20,-90,10,211,229,440,749
120,-90,150,211,229,440,749
-140,-90,-110,211,229,440,749
50,-90,80,211,229,440,749
150,-40,-80,207,233,440,956
180,-90,-150,211,229,440,749
-150,-90,-120,211,229,440,749
90,-90,120,211,229,440,749
20,-30,20,212,228,440,924
160,-10,-90,208,232,440,903
-120,-90,-90,211,229,440,749
-170,-90,-140,211,229,440,749
10,-90,40,211,229,440,749
30,40,40,204,236,440,888
70,-90,100,211,229,440,749
-160,-90,-130,211,229,440,749
-30,-90,0,211,229,440,749
150,-90,180,211,229,440,749
160,-90,-170,211,229,440,749
-180,-90,-150,211,229,440,749
120,-70,-110,212,228,440,909
130,-40,160,205,235,440,759
-90,-90,-60,211,229,440,749
40,-80,-130,226,214,440,887
40,-90,70,211,229,440,749
140,-90,170,211,229,440,749
60,-90,90,211,229,440,749
40,50,10,207,234,441,901
70,-70,160,208,233,441,797
20,-30,-140,217,224,441,826
110,-10,80,201,240,441,846
10,-70,30,220,221,441,823
10,-10,-180,229,212,441,804
100,-70,-140,210,231,441,904
170,-40,10,227,214,441,843
80,-40,60,203,238,441,921
10,-10,180,229,212,441,804
100,-30,90,206,236,442,974
10,20,80,218,224,442,802
60,70,130,230,212,442,873
160,-20,-40,210,232,442,841
100,30,110,215,227,442,802
160,-30,-90,213,229,442,905
70,10,-110,209,233,442,828
170,-30,10,222,220,442,819
110,20,100,216,226,442,814
150,-50,-60,219,223,442,881
170,-40,-150,214,228,442,829
110,-80,-60,218,224,442,897
50,-10,10,205,238,443,982
20,-50,-140,222,221,443,813
160,-50,-140,219,224,443,978
130,0,50,209,234,443,856
70,-50,-70,226,217,443,842
20,-30,140,216,227,443,855
20,-70,-160,236,207,443,843
80,-80,-100,223,220,443,815
120,10,80,193,250,443,869
160,70,-140,222,221,443,866
30,60,90,221,222,443,818
110,50,0,207,237,444,942
10,-20,-170,229,215,444,890
30,50,170,230,214,444,885
10,10,-180,225,219,444,795
50,-60,170,210,234,444,967
10,10,180,225,219,444,795
160,-20,-90,209,235,444,925
30,-50,100,210,234,444,926
50,70,-20,220,224,444,935
160,-10,20,221,223,444,865
50,-70,-170,215,229,444,852
130,-30,170,209,235,444,866
160,30,10,217,228,445,901
50,50,40,200,245,445,836
130,-10,40,216,229,445,926
140,30,-30,212,233,445,912
20,-20,110,225,220,445,942
150,10,-40,211,234,445,889
70,-80,-120,219,226,445,884
160,-40,-40,219,226,445,832
100,-70,-150,214,231,445,998
130,50,-70,226,219,445,884
160,10,20,208,238,446,818
10,-20,180,232,214,446,834
90,70,100,236,210,446,918
10,-20,-180,232,214,446,834
70,-70,-80,222,224,446,909
140,40,40,215,231,446,941
120,70,50,228,218,446,915
30,-50,120,210,236,446,903
120,50,10,214,232,446,842
80,-30,40,203,243,446,988
60,50,30,204,242,446,935
120,-70,-100,212,234,446,940
10,-30,180,221,226,447,908
140,-30,-180,210,237,447,896
30,-70,80,208,239,447,869
170,-70,-160,219,228,447,806
100,-30,80,204,243,447,949
-10,-30,20,221,226,447,822
140,-30,180,210,237,447,896
10,-30,-180,221,226,447,908
160,10,-90,223,224,447,887
70,0,-40,208,239,447,864
170,-40,-140,216,231,447,875
10,-60,-160,237,210,447,848
10,-10,170,222,225,447,827
110,-70,-150,216,231,447,989
20,-60,70,215,232,447,949
130,-70,-70,228,220,448,924
110,-80,160,221,227,448,786
30,-50,30,222,226,448,847
10,50,150,226,222,448,905
60,0,-160,217,231,448,881
140,-60,-90,207,241,448,996
30,70,120,220,228,448,883
170,40,-140,221,227,448,845
130,50,10,208,240,448,881
100,-70,-50,229,219,448,921
110,-70,-140,215,234,449,978
-10,-40,20,230,219,449,814
60,-10,0,205,244,449,930
80,-70,-180,211,239,450,989
30,60,160,224,226,450,847
80,-70,180,211,239,450,989
100,10,130,213,237,450,726
10,0,180,235,215,450,772
80,70,60,220,230,450,929
120,-80,-50,221,229,450,925
10,0,-180,235,215,450,772
90,-80,-100,224,226,450,909
0,10,20,215,235,450,816
90,-70,-160,216,235,451,1034
110,-70,-160,210,241,451,963
160,-60,-110,221,230,451,946
40,50,50,216,235,451,876
20,-70,-150,235,216,451,918
10,30,70,223,228,451,799
10,50,160,229,222,451,892
80,-70,-160,213,238,451,983
30,-80,50,222,229,451,799
70,-80,-110,227,224,451,836
130,30,-140,223,228,451,815
150,-20,20,226,225,451,884
130,-80,-40,222,230,452,937
150,30,30,225,227,452,890
160,30,-110,233,220,453,974
10,-20,150,225,228,453,874
100,-20,30,204,249,453,927
50,40,160,231,222,453,849
80,-80,-110,226,227,453,890
70,30,-80,222,231,453,825
110,-10,170,215,238,453,875
10,-40,-160,236,217,453,899
150,20,-20,214,239,453,914
60,-80,-130,227,226,453,891
110,30,100,226,227,453,869
80,20,150,230,223,453,828
40,-40,30,224,229,453,902
140,-80,-40,225,228,453,893
20,50,80,228,226,454,864
170,60,-150,226,228,454,864
170,-50,10,230,224,454,900
70,-40,50,212,242,454,990
0,-10,20,230,224,454,901
50,70,140,237,217,454,879
10,60,150,222,232,454,955
140,-70,-150,203,251,454,881
160,-10,-50,217,238,455,859
20,50,0,231,224,455,925
40,10,-170,232,223,455,870
10,20,140,221,234,455,882
30,50,70,214,241,455,930
120,-70,-140,220,235,455,979
90,70,50,225,230,455,974
70,0,-150,219,236,455,964
20,-80,60,224,231,455,935
10,-50,-170,235,220,455,979
10,-40,180,231,225,456,927
110,50,-10,222,234,456,908
100,70,90,239,217,456,965
170,-20,0,240,216,456,852
120,70,60,236,220,456,993
80,-20,20,218,238,456,1002
10,-40,-180,231,225,456,927
110,-70,-130,214,242,456,944
100,-70,-160,221,235,456,1020
140,30,-50,229,227,456,967
10,-60,-170,229,227,456,915
170,-30,-20,227,230,457,891
130,60,50,241,216,457,970
160,-20,-80,223,234,457,898
170,-40,-110,218,239,457,934
0,-60,40,230,227,457,812
60,60,140,237,220,457,887
90,40,120,220,237,457,874
10,-40,70,230,227,457,876
-10,-60,20,230,227,457,855
30,40,30,212,246,458,914
90,80,-70,235,223,458,832
100,-30,-20,224,234,458,865
0,0,60,225,233,458,884
160,30,0,228,230,458,871
160,0,-40,217,241,458,917
20,40,20,222,236,458,914
150,-70,-40,221,238,459,857
10,10,80,228,231,459,907
30,-70,-130,235,224,459,897
60,60,50,225,234,459,917
140,-20,20,222,237,459,939
80,60,-80,224,235,459,853
10,-20,70,232,227,459,880
160,-80,-160,224,235,459,829
120,70,40,243,216,459,958
0,10,50,228,231,459,853
110,60,90,240,220,460,903
170,50,-140,232,228,460,891
130,40,-50,219,241,460,947
140,10,50,220,240,460,895
10,60,160,236,224,460,952
60,50,150,234,226,460,914
120,-10,180,208,252,460,846
120,-70,-120,213,247,460,954
120,-10,-180,208,252,460,846
70,-10,-60,217,243,460,897
160,0,-80,221,239,460,921
160,10,-10,227,233,460,909
100,0,180,216,245,461,910
100,40,110,225,236,461,889
100,0,-180,216,245,461,910
20,-30,110,223,238,461,929
10,-50,-160,237,224,461,878
0,-10,60,231,230,461,935
120,-70,-150,226,235,461,1050
-10,-80,20,231,230,461,812
160,20,20,223,238,461,848
130,-20,20,218,243,461,842
60,70,-50,227,234,461,832
120,-20,20,214,247,461,861
90,60,-30,216,245,461,967
110,-70,-40,234,227,461,951
100,-60,110,218,243,461,903
70,60,-10,224,238,462,938
140,60,20,232,230,462,994
10,-40,-150,235,227,462,871
160,-50,-90,220,242,462,912
110,70,40,233,229,462,979
20,70,150,231,231,462,934
10,-70,50,222,240,462,938
130,40,70,233,229,462,814
30,-60,90,218,244,462,907
150,70,-120,234,228,462,862
60,-70,160,212,250,462,1066
140,50,40,237,225,462,1011
10,40,80,219,243,462,874
160,-20,-160,222,240,462,773
60,0,-100,235,227,462,912
90,-50,90,226,236,462,1028
130,60,-130,231,231,462,907
70,50,140,235,228,463,906
20,-30,100,224,239,463,960
130,-70,-140,225,238,463,1038
40,-70,-170,240,223,463,921
10,50,170,249,214,463,883
70,20,-100,233,230,463,806
40,-60,130,215,248,463,885
40,-20,-120,233,230,463,827
30,-80,-140,241,222,463,942
140,-60,-70,237,226,463,993
100,80,-80,246,217,463,797
170,-60,-140,216,247,463,801
170,-60,-10,231,233,464,972
40,0,0,208,256,464,920
160,-20,-50,230,234,464,867
100,40,-120,228,236,464,779
0,-30,50,236,228,464,879
110,-10,90,225,239,464,962
20,-50,80,223,241,464,972
30,-50,160,223,241,464,988
-10,-10,30,230,234,464,894
60,-80,-120,234,231,465,886
110,80,-90,243,222,465,808
130,-70,-110,217,248,465,985
10,60,140,231,234,465,940
0,10,40,219,246,465,946
10,-20,160,227,238,465,955
40,-60,170,231,234,465,962
140,-70,-130,221,244,465,1050
-170,-80,-140,223,242,465,791
150,-60,-130,222,243,465,1034
90,-70,-170,221,244,465,986
150,-60,-50,219,246,465,917
130,60,60,234,232,466,965
180,-60,-140,232,234,466,853
60,-40,-80,228,238,466,963
-180,-60,-140,232,234,466,853
90,-80,-70,226,240,466,947
60,-50,50,213,253,466,918
30,-50,130,229,237,466,905
150,-60,-90,217,249,466,884
20,-80,40,234,232,466,854
100,60,30,216,250,466,968
60,-70,150,229,238,467,897
170,-20,-120,223,244,467,1015
10,-30,-160,238,229,467,984
50,60,150,233,234,467,951
140,-60,-80,226,241,467,1011
20,-40,90,216,251,467,1003
20,-40,150,225,242,467,1013
20,0,10,225,242,467,945
170,-10,10,231,236,467,839
120,80,-100,237,230,467,848
50,-80,-140,237,230,467,906
130,-50,-10,235,233,468,932
40,-60,140,235,233,468,914
20,-60,-140,230,238,468,929
70,-50,60,212,256,468,933
10,40,140,242,226,468,943
150,-60,-100,212,257,469,962
150,-60,-140,232,237,469,1024
20,60,160,237,232,469,903
160,-70,-140,217,252,469,904
20,-40,160,228,241,469,1013
160,-50,10,237,232,469,870
60,0,-110,237,232,469,933
10,-20,170,239,230,469,918
160,-80,180,220,250,470,767
20,60,0,232,238,470,906
50,50,20,212,258,470,965
160,-80,-180,220,250,470,767
80,-80,-80,233,237,470,948
160,-70,-150,242,228,470,859
160,-10,-70,224,246,470,974
130,-70,-130,227,243,470,1004
160,-50,-130,230,240,470,1014
160,-20,-70,226,244,470,954
100,-30,70,220,250,470,960
150,10,40,232,238,470,915
0,20,30,227,244,471,845
110,20,-140,228,243,471,914
40,-80,90,222,249,471,919
160,-70,-10,232,239,471,989
50,-80,-130,236,235,471,928
0,-60,20,235,236,471,964
150,-70,170,223,248,471,784
160,-60,-120,226,245,471,1042
140,60,30,244,227,471,1029
150,-60,0,234,237,471,923
90,50,-100,229,242,471,887
70,-70,-170,216,255,471,1032
10,-10,-170,238,233,471,901
130,-70,-80,237,234,471,994
60,80,100,234,238,472,983
90,-20,10,217,255,472,976
170,0,-120,222,250,472,966
10,10,140,229,243,472,947
10,30,-180,242,230,472,840
50,-80,-110,241,231,472,967
20,70,140,232,240,472,959
100,-80,-90,241,231,472,928
130,-50,150,227,245,472,878
50,80,120,240,232,472,1039
10,30,180,242,230,472,840
160,-20,20,229,244,473,871
30,70,150,248,225,473,934
70,80,90,234,239,473,979
0,-70,30,233,240,473,840
80,80,80,235,238,473,988
80,80,-60,242,231,473,864
80,30,-110,239,234,473,739
100,-40,100,230,243,473,1017
-10,-40,30,247,226,473,873
140,-80,-30,228,245,473,976
100,-80,-60,234,239,473,974
160,-70,-20,234,239,473,934
150,-50,-70,231,242,473,1012
170,0,10,242,232,474,840
90,20,140,218,256,474,803
10,0,80,228,246,474,969
10,-30,-150,240,234,474,968
80,80,90,240,234,474,1019
80,-70,-170,229,245,474,1040
40,60,160,246,228,474,1000
60,-70,-90,237,237,474,925
-180,-90,-160,227,248,475,798
10,50,140,237,238,475,952
30,-70,-170,234,241,475,970
10,10,-170,244,231,475,932
180,-90,-160,227,248,475,798
-10,-90,10,227,248,475,798
100,-90,120,227,248,475,798
110,-40,120,224,251,475,832
30,-90,50,227,248,475,798
110,-90,130,227,248,475,798
10,-90,30,227,248,475,798
10,20,130,226,249,475,916
20,-90,40,227,248,475,798
0,-90,20,227,248,475,798
-170,-90,-150,227,248,475,798
30,-30,20,234,241,475,1036
-90,-90,-70,227,248,475,798
30,-60,-120,246,229,475,865
40,-90,60,227,248,475,798
-20,-90,0,227,248,475,798
90,80,70,239,236,475,973
-30,-90,-10,227,248,475,798
-110,-90,-90,227,248,475,798
-100,-90,-80,227,248,475,798
90,-20,0,228,247,475,902
70,-90,90,227,248,475,798
-40,-90,-20,227,248,475,798
120,-90,140,227,248,475,798
120,-70,-130,235,240,475,980
130,70,40,242,233,475,988
130,-70,-100,222,253,475,973
130,-90,150,227,248,475,798
160,-90,-180,227,248,475,798
80,-90,100,227,248,475,798
-160,-90,-140,227,248,475,798
-130,-90,-110,227,248,475,798
-150,-90,-130,227,248,475,798
90,-90,110,227,248,475,798
150,-90,170,227,248,475,798
-80,-90,-60,227,248,475,798
130,80,-110,242,233,475,907
170,-90,-170,227,248,475,798
140,-90,160,227,248,475,798
50,-90,70,227,248,475,798
-60,-90,-40,227,248,475,798
160,-90,180,227,248,475,798
150,-80,-30,238,237,475,935
-140,-90,-120,227,248,475,798
70,-80,-90,235,240,475,961
40,-70,100,229,246,475,933
60,-90,80,227,248,475,798
-120,-90,-100,227,248,475,798
-70,-90,-50,227,248,475,798
150,-70,-120,221,254,475,1088
-50,-90,-30,227,248,475,798
110,-20,60,233,243,476,923
110,60,-60,244,232,476,921
40,-10,10,227,249,476,1023
140,40,50,235,241,476,985
70,80,100,244,232,476,1004
60,0,-120,234,242,476,948
110,70,80,251,225,476,1004
130,-30,10,231,245,476,880
120,-80,170,233,243,476,841
50,-70,130,228,248,476,941
130,40,-40,222,255,477,1031
20,-20,120,224,253,477,912
10,-80,50,230,247,477,967
20,60,170,245,232,477,958
10,30,20,232,245,477,939
40,-80,-140,241,236,477,972
60,80,110,241,236,477,1023
-10,-50,20,236,242,478,917
90,-40,70,220,258,478,1020
170,-70,-150,238,240,478,953
20,-60,180,239,239,478,963
20,-50,170,241,237,478,925
130,-70,-150,220,258,478,999
20,-60,-180,239,239,478,963
150,20,40,235,243,478,902
-10,-20,40,242,236,478,880
110,-20,20,228,250,478,1002
120,50,-30,221,257,478,1053
30,-60,170,237,241,478,975
90,30,-120,229,249,478,923
120,0,-170,228,250,478,894
10,0,-170,239,240,479,923
30,30,180,240,239,479,929
170,-60,10,247,232,479,973
130,30,70,240,239,479,834
30,30,-180,240,239,479,929
120,60,-70,234,245,479,912
50,60,60,233,246,479,997
10,-50,-180,244,235,479,1063
10,-50,180,244,235,479,1063
50,60,0,237,242,479,998
170,-50,-110,228,251,479,982
0,40,160,244,235,479,946
160,0,-20,237,243,480,931
90,80,80,241,239,480,1011
90,-30,40,227,253,480,1056
150,10,-30,230,250,480,948
110,-80,-50,241,239,480,980
60,-80,-100,240,240,480,962
100,70,40,238,242,480,991
110,-30,120,232,248,480,864
150,50,20,244,236,480,1075
150,70,-140,241,240,481,863
30,-30,-120,232,249,481,891
10,30,30,235,246,481,1046
160,-60,-140,228,253,481,946
40,-80,-120,246,235,481,979
130,60,20,245,236,481,923
10,40,-180,253,228,481,872
10,40,180,253,228,481,872
170,30,-130,243,238,481,931
110,10,100,229,252,481,921
120,-70,-30,248,233,481,971
20,60,110,240,242,482,888
150,40,30,242,240,482,1097
170,-40,-20,245,237,482,950
50,80,110,241,241,482,1036
100,0,150,226,256,482,935
10,-30,70,236,246,482,969
150,40,0,236,246,482,951
10,-50,-150,241,241,482,897
140,-60,160,229,253,482,851
40,70,100,237,245,482,919
90,-20,20,223,259,482,1012
160,-50,-40,228,254,482,935
100,80,60,244,238,482,1005
40,-60,150,230,252,482,1031
140,50,10,239,243,482,972
0,0,20,248,234,482,862
150,-50,-80,238,244,482,1093
100,10,-150,218,265,483,940
20,70,0,230,253,483,941
110,-20,120,228,255,483,932
160,-70,0,239,244,483,976
60,-30,-80,231,252,483,955
90,-30,50,225,258,483,1039
10,-70,-170,250,233,483,908
-10,-20,20,240,243,483,936
160,20,-100,228,255,483,1016
160,-50,-100,235,248,483,996
10,-50,20,228,255,483,967
80,10,-130,230,254,484,956
160,-30,-80,237,247,484,1054
170,-30,-100,222,262,484,1034
40,30,-20,236,248,484,1026
80,-20,-40,229,255,484,989
80,-80,-120,238,246,484,945
170,50,-150,242,242,484,934
140,50,-80,217,267,484,988
50,-70,-100,244,240,484,948
0,20,170,246,238,484,935
90,-60,-50,247,237,484,938
110,-50,120,225,259,484,878
30,-50,140,225,259,484,1018
80,80,100,257,227,484,1026
20,-40,100,233,251,484,1031
20,40,60,240,244,484,934
120,-80,-70,251,233,484,963
20,-80,-150,256,228,484,1009
120,-10,60,222,263,485,989
70,20,160,241,244,485,977
170,-30,-90,229,256,485,976
40,-80,-150,245,240,485,939
110,-20,50,236,249,485,1026
160,-50,-80,236,249,485,1049
160,20,-10,232,253,485,911
40,-70,-180,242,244,486,969
100,-20,20,227,259,486,1067
40,-70,180,242,244,486,969
160,-20,-60,234,252,486,972
120,-80,-40,240,246,486,994
80,-70,90,240,246,486,953
50,50,160,251,235,486,966
120,-10,50,224,262,486,999
90,60,-20,237,250,487,1059
0,30,170,252,235,487,921
20,70,130,240,247,487,969
70,80,110,255,232,487,1014
170,-10,0,249,238,487,939
50,-10,-120,238,249,487,888
60,0,-90,238,249,487,917
120,50,-40,225,262,487,1067
60,80,120,256,232,488,1004
100,-60,-40,243,245,488,896
20,-10,-160,250,238,488,954
120,50,0,237,251,488,1000
70,-70,80,247,241,488,1020
160,-30,-70,233,255,488,1003
170,-10,-120,225,263,488,1035
20,-70,-140,254,234,488,988
160,-40,-80,236,252,488,1062
160,0,-50,217,271,488,978
170,-40,-130,228,261,489,996
30,0,-160,244,245,489,929
40,70,150,251,238,489,945
60,80,90,244,245,489,1044
10,30,60,245,244,489,922
10,-80,30,243,246,489,886
110,-80,-80,250,240,490,942
170,-80,-170,231,259,490,814
70,-10,-50,233,257,490,974
130,60,-80,234,256,490,981
110,-60,120,223,267,490,880
90,-70,100,246,244,490,937
40,-70,110,231,259,490,1017
170,10,-150,234,256,490,833
90,-80,-110,240,250,490,978
0,40,170,254,236,490,945
170,10,-120,230,260,490,933
180,-50,10,246,245,491,1003
110,-20,70,221,270,491,996
10,30,90,247,244,491,1012
170,-50,-160,254,237,491,929
-180,-50,10,246,245,491,1003
130,-70,-20,252,239,491,1022
140,40,-10,241,250,491,952
70,80,-50,250,241,491,905
10,40,90,253,238,491,988
0,10,60,249,242,491,1003
30,-80,-130,250,241,491,1010
70,-30,30,224,267,491,1081
160,-30,-50,236,255,491,976
140,-10,30,230,261,491,949
150,40,-80,212,279,491,997
20,-70,70,239,253,492,997
120,70,30,252,240,492,1050
30,-80,-150,248,244,492,1043
70,-10,-10,224,268,492,1018
120,70,70,250,242,492,1033
120,50,-50,234,258,492,988
160,-50,-170,240,252,492,919
20,-40,20,244,249,493,999
90,80,90,254,239,493,1048
70,80,80,252,241,493,1051
20,-30,130,242,251,493,943
170,-20,-20,242,251,493,934
170,-30,-110,239,254,493,1116
100,-80,-100,239,254,493,1007
90,10,-140,232,261,493,1021
170,-60,-110,244,249,493,1124
70,70,60,243,250,493,1019
170,70,-150,244,249,493,991
70,-80,-130,245,249,494,930
160,-10,-60,240,254,494,983
110,-70,120,228,266,494,893
180,-10,-140,239,255,494,908
140,-70,-60,248,246,494,997
110,0,100,240,254,494,1002
160,-70,-120,230,264,494,1107
70,-70,-180,230,264,494,1089
30,70,110,249,245,494,993
70,-70,180,230,264,494,1089
150,-80,-20,241,253,494,1028
-180,-10,-140,239,255,494,908
40,70,-10,252,242,494,1037
10,-70,-160,262,232,494,1024
80,80,-70,251,244,495,884
20,-50,-130,250,245,495,1008
60,80,-40,257,238,495,941
160,20,-60,227,268,495,973
40,80,130,254,241,495,1078
0,-60,-170,253,242,495,968
110,80,50,250,245,495,1034
40,-10,-140,245,251,496,930
170,40,-130,245,251,496,984
0,-70,20,243,253,496,939
80,80,70,255,241,496,1069
60,-80,-140,252,244,496,923
100,80,70,248,248,496,1031
20,-80,-140,252,244,496,1036
80,10,170,239,257,496,1028
170,-20,-100,221,275,496,1024
180,-40,0,248,248,496,986
-180,-40,0,248,248,496,986
10,-30,170,241,256,497,974
60,0,-20,217,280,497,1002
30,-50,150,234,263,497,1061
130,-70,-90,233,264,497,1036
160,-40,-50,234,263,497,1006
80,-50,70,235,263,498,1056
10,70,150,240,258,498,1052
20,60,10,247,251,498,1016
110,-60,-30,253,245,498,947
50,-70,180,242,256,498,1019
10,20,90,240,258,498,1043
20,40,180,253,245,498,900
20,70,160,256,242,498,988
40,80,120,247,251,498,1063
160,-80,-20,249,249,498,992
50,-70,-180,242,256,498,1019
20,40,-180,253,245,498,900
130,70,50,253,245,498,1056
40,60,70,246,252,498,1017
140,80,-120,250,248,498,966
170,-50,-20,238,260,498,997
30,10,0,230,268,498,1022
130,-80,-60,259,239,498,985
170,0,-90,227,271,498,991
170,60,-140,255,244,499,912
60,-70,70,248,251,499,1075
-10,-10,40,255,244,499,907
140,-70,-100,227,272,499,998
150,20,-50,234,265,499,1028
30,-80,-160,243,256,499,958
140,-70,-120,243,256,499,1040
20,-20,-150,257,242,499,1017
60,30,160,249,250,499,918
130,50,70,253,246,499,976
140,60,40,263,236,499,1072
120,-40,-10,248,252,500,1004
0,-40,-180,254,246,500,1102
170,-80,-150,243,257,500,931
90,80,-80,254,246,500,922
20,-60,30,249,251,500,1086
0,-40,180,254,246,500,1102
40,50,20,237,263,500,1089
10,-60,60,254,246,500,976
110,-20,90,241,259,500,1066
10,-50,70,254,246,500,952
10,0,140,238,263,501,1038
160,10,-50,221,280,501,985
110,-40,-20,236,265,501,965
100,80,80,257,244,501,1059
160,-30,-60,237,264,501,1016
90,-90,130,237,265,502,940
160,-90,-160,237,265,502,940
-20,-90,20,237,265,502,940
160,10,-80,247,255,502,1088
130,-90,170,237,265,502,940
20,-90,60,237,265,502,940
60,-20,-80,240,262,502,992
-120,-90,-80,237,265,502,940
-60,-90,-20,237,265,502,940
-150,-90,-110,237,265,502,940
120,-90,160,237,265,502,940
70,-90,110,237,265,502,940
100,-90,140,237,265,502,940
170,-90,-150,237,265,502,940
-140,-90,-100,237,265,502,940
-50,-90,-10,237,265,502,940
150,-70,-130,243,259,502,1094
-40,-90,0,237,265,502,940
-70,-90,-30,237,265,502,940
-110,-90,-70,237,265,502,940
70,10,-180,229,273,502,999
-130,-90,-90,237,265,502,940
-80,-90,-40,237,265,502,940
-100,-90,-60,237,265,502,940
70,10,180,229,273,502,999
-30,-90,10,237,265,502,940
150,-90,-170,237,265,502,940
-170,-90,-130,237,265,502,940
160,30,20,247,255,502,1011
30,-60,110,247,255,502,1006
-160,-90,-120,237,265,502,940
140,-90,-180,237,265,502,940
50,-90,90,237,265,502,940
80,-90,120,237,265,502,940
180,-90,-140,237,265,502,940
10,-90,50,237,265,502,940
170,-10,-80,246,256,502,986
140,-90,180,237,265,502,940
70,-20,-60,242,260,502,1027
0,-90,40,237,265,502,940
30,-90,70,237,265,502,940
40,-90,80,237,265,502,940
-10,-90,30,237,265,502,940
-180,-90,-140,237,265,502,940
-90,-90,-50,237,265,502,940
0,10,170,246,256,502,975
10,10,90,238,264,502,1051
110,-90,150,237,265,502,940
60,-90,100,237,265,502,940
-180,-60,-150,253,250,503,849
120,60,80,261,242,503,996
150,-40,10,247,256,503,993
130,70,30,262,241,503,1050
170,-40,-90,229,274,503,996
30,60,80,253,250,503,973
130,-80,-30,248,255,503,1021
140,-10,-170,245,258,503,947
180,-60,-150,253,250,503,849
60,-40,40,240,264,504,1055
170,10,-90,230,274,504,920
100,60,-40,246,258,504,1012
50,50,30,227,277,504,1066
120,80,40,255,249,504,1079
90,70,-50,259,245,504,1054
40,-70,-110,249,256,505,979
40,40,170,256,249,505,1020
130,-70,-120,247,258,505,1071
110,40,100,238,267,505,1009
40,-60,160,239,266,505,1071
10,-20,-160,258,247,505,1068
10,-40,170,245,260,505,1016
30,-80,80,236,269,505,988
10,20,100,243,262,505,1049
0,20,180,258,248,506,963
10,-10,140,263,243,506,1048
20,-40,-130,246,260,506,1002
0,50,170,251,255,506,1013
0,20,-180,258,248,506,963
10,-80,-160,262,244,506,1083
80,50,130,253,253,506,990
150,-60,-80,250,257,507,1126
120,50,-20,243,264,507,1089
70,60,40,242,265,507,971
170,-70,0,252,255,507,1110
100,-40,90,247,260,507,1076
60,-50,-80,252,255,507,1003
20,40,0,245,262,507,1011
-160,-80,-130,250,257,507,863
70,80,-60,257,250,507,908
130,-80,-180,250,258,508,932
10,-60,-180,260,248,508,1088
170,-20,-80,244,264,508,1084
50,80,100,249,259,508,1042
160,0,-60,242,266,508,1014
110,80,60,256,252,508,1028
130,-80,180,250,258,508,932
10,-60,180,260,248,508,1088
50,-50,40,239,269,508,1020
140,40,-60,242,266,508,1073
30,50,60,243,266,509,1071
100,60,-30,237,272,509,1085
0,-80,20,254,255,509,931
160,30,-90,238,271,509,1052
80,-20,10,234,275,509,1114
60,20,170,249,260,509,1051
30,80,140,261,248,509,1123
160,40,-110,244,265,509,1046
60,20,-50,242,267,509,975
160,20,-90,250,260,510,1132
0,-30,-170,258,252,510,1087
160,0,-30,247,263,510,1034
150,30,-60,235,275,510,1037
160,10,-60,231,279,510,1050
20,20,-170,256,254,510,956
110,-20,40,240,270,510,1080
30,70,160,264,246,510,1009
110,-20,80,248,262,510,1057
160,-40,-60,245,266,511,1039
80,-80,140,250,261,511,992
30,80,130,253,258,511,1092
0,-40,-170,265,246,511,1038
90,50,120,252,259,511,1007
160,0,30,255,256,511,996
100,-70,110,248,263,511,926
110,-80,-90,250,261,511,1044
160,60,-120,250,261,511,910
100,80,-90,261,250,511,935
150,-70,-140,231,280,511,1098
120,0,80,237,274,511,1081
160,-70,-30,253,258,511,988
20,-50,90,246,265,511,1132
10,70,160,262,250,512,1049
10,10,130,242,270,512,955
150,60,20,258,254,512,1134
140,-70,-140,244,268,512,1101
130,10,70,241,271,512,1011
100,-80,-50,264,248,512,1088
160,20,-70,238,274,512,1080
20,-40,140,242,270,512,1072
10,-70,-180,257,255,512,991
10,50,-180,266,246,512,975
150,-60,-60,257,255,512,1102
80,-80,-70,260,252,512,1062
50,-80,-150,255,257,512,967
10,50,180,266,246,512,975
10,-70,180,257,255,512,991
170,10,-110,254,259,513,1062
-180,-20,-140,251,262,513,923
160,20,30,244,269,513,932
10,50,130,256,257,513,1004
170,10,-100,247,266,513,1033
170,-50,-120,241,272,513,1112
160,-60,-100,252,261,513,1101
10,30,50,251,262,513,1050
160,10,30,251,262,513,900
80,-30,30,230,283,513,1135
60,-10,-80,240,273,513,1086
180,-20,-140,251,262,513,923
-20,-80,10,261,252,513,910
80,70,50,252,261,513,1028
10,-40,80,252,262,514,1064
140,70,30,264,250,514,1085
10,10,10,251,263,514,946
150,0,-160,249,265,514,938
130,20,70,251,263,514,990
-180,10,-140,251,263,514,951
140,-70,-70,253,261,514,1068
160,-60,10,248,266,514,1023
180,10,-140,251,263,514,951
170,-70,-10,253,261,514,1060
100,-80,160,254,260,514,1049
110,80,70,262,252,514,1089
50,80,130,263,251,514,1041
160,40,10,252,262,514,1059
80,60,-10,242,272,514,1107
0,-40,-160,277,238,515,990
20,-30,120,246,269,515,1059
110,-80,-40,263,252,515,1097
50,70,-40,249,266,515,1003
160,-80,-10,245,270,515,1062
90,80,60,260,255,515,1091
170,20,-90,241,274,515,993
130,70,60,262,253,515,1123
0,-50,-170,272,243,515,1019
160,-70,-110,252,263,515,1118
-180,-40,10,257,259,516,1023
10,-10,110,249,267,516,1070
0,20,60,257,259,516,983
0,-80,40,245,271,516,1003
170,-60,-20,255,261,516,1012
180,-40,10,257,259,516,1023
150,30,40,250,266,516,1008
-180,-60,10,261,255,516,1076
90,-80,150,252,264,516,1002
0,-50,50,249,267,516,1018
180,-60,10,261,255,516,1076
130,80,30,263,253,516,1133
140,50,50,258,258,516,1071
30,-60,100,246,270,516,1054
50,80,-30,263,253,516,976
50,50,-40,246,271,517,1016
30,-70,180,256,261,517,1048
90,-80,-60,267,250,517,1074
10,60,170,263,254,517,1029
50,-70,140,252,265,517,1005
80,-40,-50,251,266,517,1031
140,-70,-90,246,271,517,1047
20,40,30,237,280,517,1093
140,-70,-110,250,267,517,1143
120,-10,70,242,275,517,1007
70,-80,-80,261,256,517,1084
140,-70,-10,265,252,517,1068
30,-70,-180,256,261,517,1048
140,-80,-50,264,254,518,1031
170,-10,-10,264,254,518,1031
50,-20,-100,263,255,518,999
110,-10,120,253,265,518,1017
-10,-50,30,264,254,518,980
10,20,-170,272,246,518,969
10,30,130,256,262,518,981
90,-40,-40,244,274,518,993
170,20,-120,242,276,518,1018
30,-60,120,238,280,518,1048
110,-80,170,258,260,518,1090
150,50,30,269,249,518,1118
60,-60,60,251,268,519,1150
0,50,160,265,254,519,1048
60,-70,180,243,276,519,1115
60,-70,-180,243,276,519,1115
10,-10,80,250,269,519,1048
170,-10,20,255,264,519,942
120,-60,130,230,289,519,967
140,-70,-80,251,268,519,1130
20,-50,120,251,268,519,1059
170,-50,-140,264,255,519,1147
90,60,30,251,268,519,1034
50,-70,150,246,273,519,1158
170,-80,-10,261,259,520,1062
100,70,-60,255,265,520,1017
170,-20,-90,247,273,520,1163
0,-70,180,265,255,520,994
50,10,-20,227,293,520,1084
10,-80,-150,265,255,520,1058
0,-70,-180,265,255,520,994
40,50,40,244,276,520,1067
140,-80,-20,259,261,520,1059
140,60,-90,243,277,520,1061
160,20,-80,240,280,520,1035
110,-20,30,253,268,521,984
70,-60,70,251,270,521,1197
20,40,50,257,264,521,1003
80,80,110,268,253,521,1126
180,-70,-150,257,264,521,971
150,60,30,272,249,521,1134
-180,-70,-150,257,264,521,971
140,-50,0,249,272,521,988
170,0,-100,254,267,521,1092
30,60,170,270,251,521,1075
90,70,110,267,255,522,1075
50,10,-170,251,271,522,1044
160,-60,-80,245,277,522,1086
170,-20,-110,243,279,522,1150
20,-70,180,262,260,522,1128
140,30,-40,251,271,522,1154
170,0,0,269,253,522,971
130,50,-60,250,272,522,1145
180,-80,-160,251,271,522,887
20,-70,-180,262,260,522,1128
120,80,50,266,256,522,1058
120,-80,-80,255,267,522,1082
170,-70,-140,262,260,522,1001
130,0,60,229,293,522,1008
-180,-80,-160,251,271,522,887
70,70,-30,261,261,522,1148
150,50,-90,231,291,522,1023
180,-50,0,272,251,523,1000
20,60,100,264,259,523,988
-180,-50,0,272,251,523,1000
170,-10,-110,233,290,523,1081
60,70,70,251,272,523,1058
110,-80,180,247,276,523,1113
120,-80,-30,263,260,523,1123
20,70,120,263,260,523,1059
120,60,20,253,270,523,978
110,-80,-180,247,276,523,1113
100,-80,170,249,274,523,1087
50,60,-40,240,283,523,1019
40,-70,120,249,275,524,1044
100,-40,-30,256,268,524,1128
100,70,100,274,250,524,1092
10,40,70,260,264,524,1072
-180,0,-140,256,268,524,996
110,-10,110,243,281,524,1078
70,-30,-60,251,273,524,1056
10,-30,160,260,264,524,1097
20,-80,-160,265,259,524,1090
20,-60,-130,274,250,524,1026
50,-70,60,255,269,524,1115
180,0,-140,256,268,524,996
30,-10,-150,256,269,525,1009
140,70,40,269,256,525,1113
150,30,-20,247,278,525,1033
140,50,-140,255,270,525,919
40,80,140,271,254,525,1069
20,-40,120,263,262,525,1132
160,-40,-70,258,267,525,1118
0,-40,50,265,261,526,1042
60,60,0,254,272,526,1101
50,-40,-90,256,270,526,1122
170,20,-100,249,277,526,1055
60,-70,170,248,278,526,1127
20,-40,110,246,280,526,1088
20,60,90,258,268,526,983
120,50,-10,249,277,526,1116
150,40,40,262,264,526,1138
110,-20,110,247,279,526,1114
80,-60,-60,275,251,526,998
150,-10,30,257,269,526,1060
20,50,70,260,266,526,1151
10,0,110,257,269,526,1086
150,40,-70,246,280,526,1039
140,60,50,267,259,526,1129
-90,-90,100,261,266,527,1077
20,-90,-150,261,266,527,1077
-140,-90,50,261,266,527,1077
-50,-90,140,261,266,527,1077
-110,-90,80,261,266,527,1077
10,-90,-160,261,266,527,1077
0,-90,-170,261,266,527,1077
10,60,130,270,257,527,943
70,-90,-100,261,266,527,1077
80,-90,-90,261,266,527,1077
120,-80,180,262,265,527,1111
100,-90,-70,261,266,527,1077
-180,-90,10,261,266,527,1077
170,-90,0,261,266,527,1077
180,-90,10,261,266,527,1077
20,-80,-170,261,266,527,1017
50,-90,-120,261,266,527,1077
120,-80,-180,262,265,527,1111
120,-90,-50,261,266,527,1077
-20,-90,170,261,266,527,1077
-160,-90,30,261,266,527,1077
-170,-90,20,261,266,527,1077
130,-90,-40,261,266,527,1077
-70,-90,120,261,266,527,1077
-150,-90,40,261,266,527,1077
-30,-90,160,261,266,527,1077
-130,-90,60,261,266,527,1077
90,-90,-80,261,266,527,1077
150,-90,-20,261,266,527,1077
-60,-90,130,261,266,527,1077
-80,-90,110,261,266,527,1077
110,-90,-60,261,266,527,1077
20,-40,130,248,279,527,1109
30,-90,-140,261,266,527,1077
-10,-90,-180,261,266,527,1077
40,-90,-130,261,266,527,1077
110,80,-100,261,266,527,948
0,-30,-180,259,268,527,1048
-120,-90,70,261,266,527,1077
160,-90,-10,261,266,527,1077
10,30,110,253,274,527,1024
60,-90,-110,261,266,527,1077
-100,-90,90,261,266,527,1077
40,-30,20,252,275,527,1162
-10,-90,180,261,266,527,1077
140,-90,-30,261,266,527,1077
0,-30,180,259,268,527,1048
170,20,-110,251,276,527,1098
-40,-90,150,261,266,527,1077
130,-80,-170,260,268,528,1127
20,-60,170,257,271,528,1052
120,80,60,269,259,528,1132
90,-30,-30,251,277,528,970
150,50,10,262,266,528,1127
10,-70,-150,275,253,528,1102
10,-30,150,265,263,528,1101
10,30,100,256,272,528,1106
0,60,160,250,278,528,1127
-10,-80,10,263,265,528,975
170,-70,-110,244,284,528,1116
120,-70,130,241,287,528,992
150,-70,-110,257,271,528,1081
110,60,-50,265,264,529,1108
70,60,-70,262,267,529,934
170,0,-80,256,273,529,1036
160,70,-130,266,263,529,1018
10,-80,-170,265,264,529,1128
170,-10,-90,259,270,529,1179
110,70,30,264,265,529,1059
30,50,20,243,286,529,1124
90,80,100,270,259,529,1154
100,20,120,238,291,529,1041
0,-70,40,262,267,529,1049
0,30,180,273,257,530,1012
80,70,120,272,258,530,1048
0,30,-180,273,257,530,1012
140,40,-20,259,271,530,1079
70,-80,130,254,276,530,1050
10,20,120,260,270,530,1034
120,70,-80,257,273,530,1052
180,-30,0,282,248,530,997
20,-50,100,255,275,530,1153
170,-30,-70,260,270,530,1093
80,70,-40,270,260,530,1124
170,-40,-80,258,272,530,1126
10,-60,-150,264,266,530,1017
-180,-30,0,282,248,530,997
160,0,-70,250,280,530,1123
100,0,170,258,273,531,1108
130,70,-90,260,271,531,1087
170,-20,20,262,269,531,954
10,40,20,257,274,531,1134
100,50,110,265,266,531,1084
10,40,130,265,266,531,1104
70,80,120,272,259,531,1127
30,60,10,256,275,531,1131
50,-60,50,261,270,531,1154
160,10,-70,249,282,531,1073
120,-80,-170,248,283,531,1129
110,-10,100,265,266,531,1088
30,-70,90,252,280,532,1106
60,0,-150,263,269,532,1166
150,60,-100,244,288,532,1023
10,-30,80,267,265,532,1061
0,30,160,261,271,532,1020
30,70,0,267,265,532,1177
170,30,-120,249,283,532,1123
140,80,20,270,262,532,1165
170,0,-110,255,277,532,1074
0,0,170,264,268,532,1081
0,-80,-170,276,256,532,1176
60,80,-50,271,261,532,940
-180,20,-140,243,290,533,933
150,-20,-170,258,275,533,1021
10,50,90,259,274,533,992
40,70,90,257,276,533,1093
150,80,-130,271,262,533,1025
180,20,-140,243,290,533,933
30,-10,10,266,268,534,1134
10,70,140,264,270,534,1064
80,-80,150,263,271,534,1102
160,-70,180,261,273,534,934
160,-70,-180,261,273,534,934
10,-10,90,259,275,534,1172
90,-80,160,257,277,534,1121
60,70,-20,253,281,534,1166
10,20,110,260,274,534,1056
130,50,0,257,277,534,1082
40,80,110,261,274,535,1106
10,-30,100,253,282,535,1126
170,-30,20,258,277,535,1006
130,80,40,273,262,535,1108
20,-60,80,261,274,535,1134
120,-60,-20,270,265,535,986
10,10,120,258,277,535,969
170,10,0,276,259,535,954
130,-40,0,259,276,535,1116
0,-70,-170,272,263,535,1088
160,-30,20,256,279,535,1013
150,-80,-10,269,266,535,1101
0,10,180,273,263,536,1017
70,60,0,246,290,536,1186
10,-40,90,267,269,536,1129
80,60,0,255,281,536,1244
40,-80,-160,263,273,536,1038
50,0,-10,244,292,536,1071
0,10,-180,273,263,536,1017
170,-80,0,261,275,536,1119
30,30,-10,257,279,536,1091
140,-40,170,247,289,536,1055
10,-70,60,271,265,536,1125
-10,-70,20,267,270,537,979
20,-50,160,259,278,537,1138
170,-70,10,278,259,537,1107
170,-30,-30,263,274,537,1071
30,-70,-120,269,268,537,1016
110,-80,-150,247,290,537,1186
40,80,-20,280,257,537,995
180,-50,-140,273,264,537,1073
90,-80,-120,255,282,537,1056
-180,-50,-140,273,264,537,1073
120,-50,130,248,289,537,1002
60,-80,-90,272,265,537,1087
100,-30,60,260,278,538,1112
150,-60,170,261,277,538,1073
50,30,170,271,267,538,1069
20,40,40,250,288,538,1163
100,-80,-160,248,290,538,1194
10,30,40,253,285,538,1138
170,10,10,274,264,538,977
10,70,170,274,264,538,1083
170,-10,-100,255,283,538,1155
120,80,-110,268,270,538,979
100,80,50,271,267,538,1144
100,-80,-110,255,283,538,1073
70,70,130,274,264,538,1044
10,40,120,266,273,539,1027
110,70,90,279,260,539,1177
160,-60,-40,245,294,539,1107
30,-70,170,274,265,539,1121
40,50,30,250,289,539,1202
60,0,-140,265,274,539,1036
10,-20,80,259,280,539,1126
20,80,140,267,272,539,1153
60,40,-60,272,267,539,1047
0,60,170,271,269,540,1133
20,-50,110,263,277,540,1124
20,80,150,275,265,540,1146
60,80,130,274,266,540,1138
160,-60,-130,258,282,540,1188
180,-30,-140,250,290,540,1069
-180,-30,-140,250,290,540,1069
150,-70,-50,264,276,540,1122
100,80,90,279,261,540,1179
170,-60,-100,266,274,540,1112
50,-30,20,252,288,540,1232
10,0,90,262,278,540,1114
160,30,-100,264,277,541,1193
180,0,-130,255,286,541,1190
170,-40,-100,272,269,541,1207
10,0,120,261,280,541,986
80,-80,-130,258,283,541,1087
0,20,50,267,274,541,1127
20,-50,130,247,294,541,1061
-180,0,-130,255,286,541,1190
130,70,20,277,264,541,1119
30,50,50,253,289,542,1169
170,-30,-80,267,275,542,1178
10,60,-180,279,263,542,1061
0,70,160,264,278,542,1180
10,60,180,279,263,542,1061
110,-10,150,260,282,542,1050
0,-50,-160,280,262,542,1048
140,70,20,273,269,542,1171
0,-60,180,278,264,542,1106
110,70,-70,267,275,542,1042
0,-60,-180,278,264,542,1106
60,-80,120,256,286,542,1055
50,20,-180,273,270,543,1143
120,30,90,259,284,543,1058
10,-10,100,265,278,543,1157
50,20,180,273,270,543,1143
20,-80,70,261,282,543,1060
0,20,160,265,278,543,1077
100,60,-10,255,288,543,1224
110,-10,160,263,280,543,1100
180,70,-160,270,274,544,1087
10,60,10,270,274,544,1133
150,-80,-40,269,275,544,1092
140,-80,-170,269,275,544,1064
70,-10,-20,251,293,544,1046
140,70,-100,264,280,544,1097
110,-30,0,259,285,544,1055
-180,70,-160,270,274,544,1087
130,80,-120,270,274,544,1022
10,10,110,260,284,544,1066
0,60,150,274,270,544,1125
80,-20,0,238,306,544,1140
170,0,20,270,274,544,1060
100,10,140,259,286,545,1025
20,50,180,286,259,545,1028
160,70,-150,269,276,545,1011
90,-50,80,258,287,545,1200
-180,-20,-130,262,283,545,1036
180,-20,-130,262,283,545,1036
180,-40,-10,273,272,545,1126
70,-60,-70,274,271,545,1044
10,10,100,257,288,545,1095
100,-50,100,263,282,545,1201
20,50,-180,286,259,545,1028
120,-20,160,256,289,545,1047
-180,-40,-10,273,272,545,1126
170,-20,-70,270,275,545,1075
90,60,0,254,291,545,1186
140,40,60,269,276,545,1076
90,30,130,254,291,545,1066
50,-70,160,257,288,545,1222
50,-10,-110,272,273,545,1040
60,70,140,276,270,546,1056
10,50,80,270,276,546,1054
160,40,-100,254,292,546,1192
60,10,-170,255,291,546,1156
110,-80,-170,263,283,546,1158
40,10,-10,264,282,546,1142
30,-60,130,260,286,546,1017
10,-40,-140,270,276,546,1123
120,-30,140,253,293,546,1073
130,-80,-160,253,293,546,1188
100,-80,-120,262,284,546,1141
170,-70,-130,249,298,547,1155
70,20,-110,266,281,547,969
50,-70,170,265,282,547,1197
0,0,160,271,276,547,1091
160,20,-150,273,274,547,1032
10,-20,100,268,279,547,1184
20,-50,20,264,283,547,1061
170,-50,-100,267,280,547,1164
170,30,-100,255,292,547,1086
120,-80,-160,262,286,548,1185
180,-30,10,266,282,548,1035
-180,-30,10,266,282,548,1035
0,10,70,272,276,548,1020
140,80,30,279,269,548,1156
150,-70,-90,250,298,548,1091
110,-80,-100,258,290,548,1076
10,-50,170,270,278,548,1105
50,-80,-100,276,272,548,1103
110,-10,130,256,292,548,1005
10,-30,90,263,285,548,1171
0,0,180,269,280,549,1067
0,0,-180,269,280,549,1067
0,20,40,271,278,549,1161
120,60,-60,279,270,549,1176
110,80,80,281,268,549,1182
140,-80,-160,263,286,549,1165
60,30,-60,268,281,549,1059
160,50,-150,266,283,549,1048
110,-80,-160,263,286,549,1175
160,30,-70,247,302,549,1082
100,-30,-10,261,288,549,1070
-10,-50,10,275,274,549,1083
150,-70,0,277,272,549,1135
10,-20,90,267,282,549,1149
10,0,100,268,281,549,1152
70,-80,-140,266,283,549,1126
100,-80,-170,258,291,549,1133
150,-60,-70,272,277,549,1186
0,-30,-160,286,264,550,1136
70,30,-90,261,289,550,1080
50,80,140,277,273,550,1158
-30,-80,0,278,272,550,987
130,60,70,282,268,550,1141
10,-20,140,268,282,550,1128
80,40,-100,249,301,550,903
130,-80,-20,276,274,550,1158
180,-70,10,279,271,550,1223
180,-80,-140,268,282,550,1054
-180,-80,-140,268,282,550,1054
10,30,120,267,283,550,1101
-180,-70,10,279,271,550,1223
20,-50,140,261,290,551,1182
90,-80,-170,257,294,551,1194
-20,-30,20,280,271,551,1012
180,-60,20,279,272,551,1137
50,20,-30,255,296,551,1107
-180,-60,20,279,272,551,1137
0,50,180,287,264,551,1100
150,50,40,273,278,551,1191
10,-30,140,265,286,551,1171
160,80,-140,275,276,551,1077
170,50,-130,278,273,551,1061
160,-70,-130,248,303,551,1242
0,-10,160,269,282,551,1140
30,-20,-130,266,285,551,1087
150,-70,-100,272,279,551,1193
100,-40,80,270,281,551,1107
30,80,150,285,266,551,1146
0,50,-180,287,264,551,1100
60,0,-80,256,295,551,1161
50,70,150,288,263,551,1093
160,60,-150,286,265,551,1015
40,60,10,266,286,552,1224
80,-60,80,275,277,552,1226
90,-80,180,263,289,552,1128
0,-10,180,278,274,552,1090
0,-10,-180,278,274,552,1090
0,20,70,277,275,552,1121
90,-80,-180,263,289,552,1128
0,10,160,269,283,552,1141
160,-80,0,275,277,552,1152
-180,-40,20,278,274,552,1081
160,30,-80,256,296,552,1180
-180,-60,0,272,280,552,1148
180,-40,20,278,274,552,1081
130,50,-50,267,285,552,1285
180,-60,0,272,280,552,1148
160,-60,-90,265,288,553,1139
70,-80,140,274,279,553,1125
80,60,30,266,287,553,1117
50,-50,-90,273,280,553,1083
10,-10,130,265,288,553,1124
130,-80,-140,264,289,553,1144
-10,-60,30,274,279,553,1036
10,-50,80,269,284,553,1163
90,-80,-130,272,282,554,1156
30,-60,140,264,290,554,1205
80,-40,50,261,293,554,1203
120,20,90,249,305,554,1169
150,70,20,280,274,554,1221
150,0,40,263,291,554,1136
130,80,50,281,273,554,1163
50,70,80,264,290,554,1076
70,10,-120,270,284,554,1102
0,30,80,269,286,555,1049
10,-80,-180,272,283,555,1071
10,-80,180,272,283,555,1071
80,-80,170,271,284,555,1144
170,-60,-120,258,297,555,1205
-150,-80,-120,268,287,555,949
0,40,-180,284,271,555,1058
0,40,180,284,271,555,1058
170,-50,-80,255,300,555,1125
40,-70,140,272,283,555,1210
110,60,20,265,290,555,1138
110,-10,140,265,290,555,1019
90,60,-10,257,299,556,1252
0,-50,-180,287,269,556,1183
-10,-80,30,263,293,556,1108
100,0,160,268,288,556,1124
-10,-70,180,284,272,556,1190
-180,-50,-110,262,294,556,1232
160,40,20,276,280,556,1197
-10,0,30,275,281,556,1118
-10,-70,-180,284,272,556,1190
-20,-60,10,281,275,556,1080
120,80,70,279,277,556,1215
40,80,150,281,275,556,1146
0,0,70,280,276,556,1123
140,70,50,280,276,556,1189
0,-50,180,287,269,556,1183
170,-40,-30,273,283,556,1108
110,-30,110,272,284,556,1215
-180,-50,-150,285,271,556,987
180,-50,-110,262,294,556,1232
180,-50,-150,285,271,556,987
120,-80,-150,265,292,557,1155
40,-60,40,273,284,557,1200
150,-70,-80,265,292,557,1132
10,40,110,268,289,557,1081
150,-80,-120,268,289,557,1144
0,40,80,276,281,557,1069
130,40,-140,281,276,557,1051
30,80,-10,288,269,557,1082
70,40,150,280,277,557,1036
0,-60,50,290,267,557,1073
10,0,130,276,281,557,1138
-170,-80,-150,266,291,557,945
110,-20,100,264,294,558,1191
-180,-50,20,278,280,558,1096
0,-60,-160,284,274,558,1138
170,-40,20,289,269,558,997
100,70,-100,273,285,558,1068
40,-50,-100,273,285,558,1096
140,80,-130,275,283,558,1060
150,70,-110,281,277,558,1116
-20,-80,0,278,280,558,1013
150,80,10,286,272,558,1219
180,-50,20,278,280,558,1096
150,50,-80,269,290,559,1146
60,-60,-80,279,280,559,1060
10,-40,140,264,295,559,1188
160,50,-110,252,307,559,1061
80,-80,-140,277,282,559,1181
70,60,10,259,300,559,1216
120,50,-130,276,283,559,939
90,20,-130,275,284,559,1053
0,-20,-170,286,273,559,1097
-10,-30,40,286,273,559,1102
50,-10,0,253,306,559,1200
130,-80,-70,269,291,560,1150
10,70,130,277,283,560,1131
90,10,-150,262,298,560,1166
60,60,40,257,303,560,1142
90,-80,170,271,289,560,1197
10,50,120,279,281,560,1054
170,10,20,285,275,560,1129
170,10,-80,264,296,560,1090
10,80,160,287,273,560,1188
120,-80,-140,259,301,560,1217
20,70,170,290,270,560,1107
20,50,20,269,291,560,1211
110,80,40,282,278,560,1203
150,60,40,287,274,561,1218
150,80,20,282,279,561,1203
30,70,100,273,288,561,1108
70,-20,10,262,299,561,1314
140,20,60,269,292,561,1126
80,-80,-180,269,292,561,1219
0,-80,180,280,281,561,1194
40,-80,-110,282,279,561,1113
100,-80,-180,269,292,561,1195
-180,-30,-10,288,273,561,1130
10,-10,120,277,284,561,1202
180,-60,-100,277,284,561,1251
-180,-60,-100,277,284,561,1251
140,0,50,265,296,561,1201
80,-80,180,269,292,561,1219
10,40,100,277,284,561,1138
100,-80,180,269,292,561,1195
0,-80,-180,280,281,561,1194
30,-80,-170,272,289,561,1153
140,30,60,286,275,561,1094
130,50,-40,264,297,561,1261
180,-30,-10,288,273,561,1130
0,-40,170,279,283,562,1165
10,70,10,277,285,562,1139
50,60,50,268,294,562,1118
60,50,-60,275,287,562,1108
0,70,170,287,275,562,1180
130,-80,-150,264,298,562,1205
180,-70,-140,281,281,562,1174
110,-80,-110,270,292,562,1146
-180,-70,-140,281,281,562,1174
-180,-30,-130,264,298,562,1113
110,60,-40,266,296,562,1241
180,-30,-130,264,298,562,1113
160,-50,-50,260,302,562,1123
140,-80,-130,269,293,562,1155
120,-80,-90,263,300,563,1112
30,80,120,275,288,563,1177
30,-70,100,267,296,563,1197
70,60,30,266,297,563,1227
100,-30,50,276,287,563,1125
0,20,80,280,283,563,1186
180,-80,0,279,284,563,1138
120,40,90,269,294,563,1059
40,60,60,275,288,563,1226
150,-30,20,278,285,563,1140
-180,-80,0,279,284,563,1138
180,-70,0,279,284,563,1183
-180,-70,0,279,284,563,1183
30,20,-170,287,277,564,1138
60,-80,-150,273,291,564,1161
180,-50,-100,275,289,564,1213
20,-50,150,274,290,564,1229
-10,-80,-180,284,280,564,1225
-10,0,40,280,284,564,1057
170,40,-150,277,287,564,1079
-180,-50,-100,275,289,564,1213
-10,-80,180,284,280,564,1225
-10,10,30,285,279,564,1083
160,30,-10,274,290,564,1054
50,70,-10,271,293,564,1186
20,-70,-130,285,279,564,1086
160,-70,-100,292,272,564,1173
30,-70,110,266,298,564,1212
150,20,-150,274,290,564,1109
0,-80,-160,284,280,564,1139
0,0,-170,285,280,565,1128
50,80,-40,283,282,565,1030
50,-80,110,260,305,565,1125
-10,-10,20,273,292,565,1145
40,50,170,295,270,565,1121
120,10,90,270,295,565,1193
90,-90,-70,283,283,566,1147
150,-90,-10,283,283,566,1147
-180,-20,0,290,276,566,1114
180,-90,20,283,283,566,1147
50,-90,-110,283,283,566,1147
-180,-60,-110,262,304,566,1263
170,-90,10,283,283,566,1147
-20,-90,-180,283,283,566,1147
110,-30,90,274,292,566,1120
-100,-90,100,283,283,566,1147
-150,-90,50,283,283,566,1147
160,-50,-70,275,291,566,1234
110,-90,-50,283,283,566,1147
-130,-90,70,283,283,566,1147
180,-20,0,290,276,566,1114
-180,-90,20,283,283,566,1147
-120,-90,80,283,283,566,1147
-80,-90,120,283,283,566,1147
-10,-90,-170,283,283,566,1147
160,-90,0,283,283,566,1147
-60,-90,140,283,283,566,1147
80,-90,-80,283,283,566,1147
130,-90,-30,283,283,566,1147
140,-90,-20,283,283,566,1147
-90,-90,110,283,283,566,1147
100,-80,110,269,297,566,1032
-110,-90,90,283,283,566,1147
-140,-90,60,283,283,566,1147
40,-90,-120,283,283,566,1147
-10,-40,10,273,293,566,1094
170,-70,-20,289,277,566,1084
60,-90,-100,283,283,566,1147
-70,-90,130,283,283,566,1147
-30,-90,170,283,283,566,1147
0,-90,-160,283,283,566,1147
180,-60,-110,262,304,566,1263
10,-90,-150,283,283,566,1147
70,-90,-90,283,283,566,1147
120,-90,-40,283,283,566,1147
-160,-90,40,283,283,566,1147
20,-90,-140,283,283,566,1147
-170,-90,30,283,283,566,1147
-10,-10,50,280,286,566,1119
-50,-90,150,283,283,566,1147
30,-60,160,278,288,566,1208
100,-90,-60,283,283,566,1147
-20,-90,180,283,283,566,1147
30,-90,-130,283,283,566,1147
-40,-90,160,283,283,566,1147
60,-80,130,276,290,566,1151
40,-70,130,274,293,567,1158
40,70,160,292,275,567,1164
170,-50,-130,278,289,567,1279
180,-40,-110,269,298,567,1214
0,-10,170,286,281,567,1192
20,-30,-130,276,291,567,1134
170,-70,-100,277,290,567,1231
20,-60,100,279,288,567,1194
-180,-40,-110,269,298,567,1214
-10,-60,180,291,277,568,1159
70,10,-170,254,314,568,1233
170,80,-150,288,280,568,1144
170,-80,10,280,288,568,1226
-10,-60,-180,291,277,568,1159
150,20,-30,270,298,568,1192
10,80,150,284,284,568,1219
20,-60,90,265,303,568,1272
-180,-80,10,281,287,568,1186
60,0,-130,273,295,568,1168
140,-80,-150,263,305,568,1242
140,50,-70,275,293,568,1220
180,-80,10,281,287,568,1186
20,80,160,292,276,568,1187
100,-80,-150,271,298,569,1260
140,40,-30,271,298,569,1234
180,20,-110,284,285,569,1197
10,-40,100,272,297,569,1195
140,-10,40,273,296,569,1175
140,-80,-140,267,302,569,1207
130,80,60,286,283,569,1244
50,-40,30,280,289,569,1210
150,-70,-60,275,294,569,1231
10,-20,110,268,301,569,1182
120,80,-90,288,281,569,1124
40,-70,170,280,289,569,1198
140,50,60,288,281,569,1205
60,-20,10,272,297,569,1289
-180,20,-110,284,285,569,1197
-60,-90,120,280,290,570,1224
150,-90,-30,280,290,570,1224
20,-90,-160,280,290,570,1224
-10,-90,170,280,290,570,1224
80,-90,-100,280,290,570,1224
-20,-90,160,280,290,570,1224
30,-90,-150,280,290,570,1224
-40,-90,140,280,290,570,1224
80,20,-120,285,285,570,1116
-170,-90,10,280,290,570,1224
120,-90,-60,280,290,570,1224
-70,-90,110,280,290,570,1224
0,-90,180,280,290,570,1224
-30,-90,150,280,290,570,1224
60,-90,-120,280,290,570,1224
130,-90,-50,280,290,570,1224
10,-90,-170,280,290,570,1224
50,-30,-90,278,292,570,1204
40,-90,-140,280,290,570,1224
-110,-90,70,280,290,570,1224
80,-80,90,271,299,570,1085
-140,-90,40,280,290,570,1224
160,-90,-20,280,290,570,1224
70,-90,-110,280,290,570,1224
140,-90,-40,280,290,570,1224
-160,-90,20,280,290,570,1224
-50,-90,130,280,290,570,1224
140,40,-50,271,299,570,1300
100,-90,-80,280,290,570,1224
-120,-90,60,280,290,570,1224
0,20,20,286,284,570,1074
180,-60,-130,273,297,570,1116
170,-90,-10,280,290,570,1224
-80,-90,100,280,290,570,1224
50,-90,-130,280,290,570,1224
0,10,-170,293,277,570,1174
-180,-90,0,280,290,570,1224
180,-90,0,280,290,570,1224
-90,-90,90,280,290,570,1224
10,30,-170,296,274,570,1062
180,-10,-130,276,294,570,1186
-150,-90,30,280,290,570,1224
-180,-10,-130,276,294,570,1186
-130,-90,50,280,290,570,1224
110,-90,-70,280,290,570,1224
-180,-60,-130,273,297,570,1116
-100,-90,80,280,290,570,1224
90,-90,-90,280,290,570,1224
0,-90,-180,280,290,570,1224
70,-80,80,275,296,571,1094
110,-30,100,280,291,571,1226
90,10,160,272,299,571,1182
120,-20,40,263,308,571,1185
150,20,-40,282,289,571,1171
0,-20,60,282,289,571,1213
130,-60,-10,278,293,571,1055
180,10,-90,287,285,572,1114
160,-80,-110,275,297,572,1168
150,70,30,289,283,572,1191
160,-60,-50,272,300,572,1205
170,-50,-30,272,300,572,1174
130,-10,50,279,293,572,1223
80,-80,160,272,300,572,1226
0,-50,170,288,284,572,1267
160,-50,-60,275,297,572,1227
90,70,40,286,286,572,1131
70,-10,-30,275,297,572,1240
-180,10,-90,287,285,572,1114
140,20,-150,288,284,572,1160
20,60,80,286,286,572,1161
30,80,160,292,280,572,1187
30,-80,-120,290,283,573,1125
110,70,-110,280,293,573,1129
0,30,70,277,296,573,1104
30,50,30,273,300,573,1298
140,60,-140,290,283,573,1110
10,40,60,285,288,573,1221
100,60,-20,262,311,573,1229
0,-70,-160,298,275,573,1224
160,-80,-30,281,292,573,1167
10,50,100,289,284,573,1180
80,-20,-30,267,307,574,1222
30,-60,150,269,305,574,1301
130,-80,-130,268,306,574,1261
160,30,30,286,288,574,1113
170,20,0,296,278,574,1026
140,50,0,282,292,574,1156
0,20,-170,288,286,574,1183
150,-80,-150,278,297,575,1247
0,-10,-170,294,281,575,1159
170,20,10,291,284,575,1083
170,20,-150,283,292,575,1073
10,-60,170,288,287,575,1226
70,-40,-60,275,300,575,1162
180,0,-90,281,295,576,1134
10,-40,130,272,304,576,1206
170,30,-90,279,297,576,1028
20,50,60,280,296,576,1255
40,-70,50,292,284,576,1218
150,40,-10,279,297,576,1179
-10,-60,10,287,289,576,1164
140,-80,-10,285,291,576,1214
50,-60,-90,292,284,576,1111
120,70,80,297,279,576,1258
180,10,-100,277,299,576,1165
110,0,110,269,307,576,1148
-10,-80,170,287,289,576,1256
100,80,-70,292,284,576,1127
70,40,-80,285,291,576,1030
0,-80,170,285,291,576,1159
-180,10,-100,277,299,576,1165
160,-70,-90,287,289,576,1262
60,60,10,258,318,576,1243
80,50,-90,284,292,576,1077
-180,0,-90,281,295,576,1134
170,-60,-130,270,306,576,1233
90,-80,100,277,300,577,1055
110,80,-80,291,286,577,1118
50,60,10,281,296,577,1245
70,-80,160,281,296,577,1193
10,-80,60,280,297,577,1158
-140,-80,-110,278,299,577,1008
20,-60,110,284,293,577,1192
180,10,-130,267,310,577,1201
140,40,-40,268,309,577,1311
180,-70,-100,270,307,577,1175
-180,-70,-100,270,307,577,1175
160,60,20,292,285,577,1241
-180,10,-130,267,310,577,1201
170,30,10,283,294,577,1218
0,40,90,286,291,577,1118
120,0,90,280,297,577,1209
40,-60,-100,290,287,577,1121
-170,-80,10,280,298,578,1196
10,-70,170,291,287,578,1290
120,-80,-130,282,296,578,1244
30,50,40,277,301,578,1339
110,60,-20,270,308,578,1296
-10,-80,-170,290,288,578,1206
20,-70,80,271,307,578,1275
110,60,-30,273,305,578,1297
60,60,20,271,307,578,1253
70,-80,170,279,299,578,1233
-180,-70,20,302,277,579,1246
30,60,70,295,284,579,1235
0,30,150,283,296,579,1142
120,-80,-100,278,301,579,1180
20,-80,-130,286,293,579,1136
130,80,-100,296,283,579,1156
40,-50,30,275,304,579,1177
10,80,170,297,282,579,1194
110,-80,120,276,303,579,1020
140,-80,-60,281,298,579,1222
180,-70,20,302,277,579,1246
130,50,-30,273,306,579,1334
160,70,10,291,288,579,1225
20,80,130,285,294,579,1208
160,40,-90,264,315,579,1211
150,-70,-70,283,296,579,1284
100,30,-130,283,296,579,1124
180,-30,-120,266,314,580,1139
60,-80,70,284,296,580,1142
150,80,-140,288,292,580,1098
160,50,10,288,292,580,1275
90,80,-60,295,285,580,1134
120,-30,10,276,304,580,1194
-180,-30,-120,266,314,580,1139
150,-80,-130,268,312,580,1181
120,-20,30,286,295,581,1228
160,80,10,291,290,581,1274
50,-80,120,273,308,581,1199
50,40,-40,274,307,581,1210
70,-10,-40,270,311,581,1203
90,-80,-160,281,300,581,1281
0,80,170,301,280,581,1253
140,80,40,293,288,581,1212
0,70,150,287,295,582,1190
60,-80,170,282,300,582,1289
-180,-20,10,299,283,582,1117
30,40,180,298,284,582,1188
110,-80,-140,282,300,582,1273
-170,-50,20,297,285,582,1165
160,-10,-160,271,311,582,1069
10,-50,-140,297,285,582,1180
60,-80,160,285,297,582,1232
30,40,-180,298,284,582,1188
180,-20,10,299,283,582,1117
160,-70,10,290,292,582,1244
10,50,10,283,299,582,1196
170,70,-140,289,293,582,1132
-10,-70,10,287,295,582,1113
-160,-80,-140,280,302,582,1006
60,60,30,280,302,582,1310
70,-80,-150,287,295,582,1223
60,10,-100,288,294,582,1094
90,70,-90,287,295,582,1060
100,60,20,286,296,582,1188
160,40,30,294,289,583,1235
10,-80,-140,288,295,583,1194
90,60,20,278,305,583,1237
-20,-80,170,293,290,583,1263
50,-20,10,277,306,583,1273
50,-80,-160,284,299,583,1227
140,80,50,292,291,583,1248
90,-40,60,282,301,583,1215
120,-40,130,266,318,584,1079
90,-80,-140,279,305,584,1262
100,-80,-130,274,310,584,1218
130,-70,140,274,310,584,1098
150,20,50,299,285,584,1174
170,-60,20,287,297,584,1146
10,50,20,281,303,584,1239
170,-60,-90,294,290,584,1271
10,-20,120,276,308,584,1230
50,70,70,289,295,584,1274
40,-40,-100,292,292,584,1116
0,60,-180,305,279,584,1162
60,40,160,296,288,584,1157
110,40,-130,293,291,584,1139
0,-70,170,291,293,584,1120
0,60,180,305,279,584,1162
70,-40,40,279,306,585,1360
30,-70,130,287,298,585,1302
10,-60,70,277,308,585,1222
-20,-80,20,281,304,585,1172
-10,-70,170,303,282,585,1149
80,10,180,271,314,585,1134
170,-50,20,281,304,585,1112
60,10,-40,264,321,585,1212
-180,50,-150,298,287,585,1257
-10,-70,30,289,296,585,1126
0,50,150,292,293,585,1241
180,50,-150,298,287,585,1257
110,0,120,281,304,585,1045
80,70,-30,293,292,585,1277
80,10,-180,271,314,585,1134
10,-60,-140,305,281,586,1226
-180,60,-150,289,297,586,1172
140,60,60,303,283,586,1242
0,10,80,285,301,586,1259
120,10,-160,277,309,586,1152
-180,-10,-90,275,311,586,1242
10,-20,130,300,286,586,1319
160,10,-40,282,304,586,1218
70,-80,-180,284,302,586,1283
140,-80,-120,276,310,586,1268
130,50,-10,286,300,586,1283
180,60,-150,289,297,586,1172
70,-80,180,284,302,586,1283
-40,-80,-10,288,298,586,1079
20,-60,120,285,301,586,1168
150,70,40,291,295,586,1271
80,60,10,266,320,586,1219
110,-30,80,281,305,586,1212
0,-20,-180,288,298,586,1185
170,-60,-70,282,304,586,1247
180,-10,-90,275,311,586,1242
170,-40,-70,289,297,586,1232
0,-20,180,288,298,586,1185
170,-20,-30,286,301,587,1139
30,70,170,295,292,587,1247
110,50,100,291,296,587,1123
130,0,70,261,326,587,1099
150,60,10,287,300,587,1195
80,-80,-170,284,304,588,1250
-170,-70,20,298,290,588,1258
180,-50,-10,296,292,588,1212
170,-10,-20,286,302,588,1122
-180,80,-160,295,293,588,1207
-180,-40,-120,269,319,588,1246
-180,-50,-10,296,292,588,1212
180,-40,-120,269,319,588,1246
180,80,-160,295,293,588,1207
0,30,60,294,294,588,1167
20,0,-160,297,292,589,1160
180,60,-160,302,287,589,1097
40,-80,110,279,310,589,1233
70,-80,150,279,310,589,1283
60,-80,150,287,302,589,1238
80,-20,-20,269,320,589,1176
10,60,120,286,303,589,1123
160,20,-20,279,310,589,1215
150,40,50,295,294,589,1194
-180,60,-160,302,287,589,1097
150,70,10,289,300,589,1263
120,60,-50,290,299,589,1327
130,-80,-80,274,316,590,1199
0,30,-170,303,287,590,1178
40,70,-30,282,308,590,1125
20,30,0,291,299,590,1131
80,-80,-150,285,305,590,1280
30,-40,20,290,300,590,1269
140,-60,0,287,303,590,1111
70,60,20,274,316,590,1251
150,-80,-110,285,305,590,1295
10,-40,160,281,309,590,1250
160,-60,-70,293,297,590,1259
170,-70,-170,292,298,590,1098
170,40,-100,275,315,590,1091
150,-80,-160,287,303,590,1199
180,-20,-90,285,306,591,1214
-180,-20,-90,285,306,591,1214
-180,-30,-90,278,313,591,1157
80,80,-50,300,291,591,1138
160,-80,-120,280,311,591,1178
-10,0,50,300,291,591,1226
140,80,-110,301,290,591,1209
170,-70,-120,270,321,591,1267
160,50,20,293,298,591,1295
110,10,-160,277,314,591,1210
110,-80,-130,293,298,591,1326
100,-80,-140,294,297,591,1308
180,-30,-90,278,313,591,1157
130,60,-70,288,304,592,1291
-180,20,-100,298,294,592,1110
110,-80,-120,279,313,592,1201
180,20,-100,298,294,592,1110
-180,-20,20,289,303,592,1102
160,-70,-40,287,305,592,1265
180,-20,20,289,303,592,1102
20,-80,-180,283,310,593,1238
10,20,10,292,301,593,1177
170,40,-120,290,303,593,1253
20,-80,180,283,310,593,1238
170,-60,-30,275,318,593,1282
170,-50,-90,294,299,593,1242
90,70,-40,306,287,593,1265
0,50,90,286,307,593,1117
160,40,-80,272,321,593,1186
-10,-60,170,299,294,593,1263
40,-70,150,283,310,593,1343
150,30,-30,271,322,593,1277
120,-80,-110,276,317,593,1203
50,-80,150,295,299,594,1249
0,-40,10,284,310,594,1136
20,-60,160,288,306,594,1273
20,80,170,300,294,594,1246
-170,-60,20,304,290,594,1208
120,80,30,297,297,594,1245
80,-20,-10,271,323,594,1245
150,-80,0,305,289,594,1235
-30,-80,-10,299,295,594,1073
10,-30,110,278,316,594,1210
130,-80,-120,293,301,594,1247
40,-20,-110,308,286,594,1124
30,-60,-110,297,297,594,1101
170,-30,-60,292,302,594,1241
40,-80,100,272,323,595,1216
150,50,50,302,293,595,1289
150,-50,10,297,298,595,1107
160,50,30,293,302,595,1301
40,-80,140,290,305,595,1264
20,-10,10,298,297,595,1314
-20,-70,10,292,303,595,1133
180,30,-120,279,317,596,1329
-170,-80,20,295,301,596,1227
10,30,10,290,306,596,1190
130,-80,-90,286,310,596,1206
-180,30,-120,279,317,596,1329
140,60,10,299,297,596,1213
-10,-50,-170,305,291,596,1260
60,-80,-160,297,299,596,1236
160,40,-150,290,306,596,1231
130,-80,-100,276,320,596,1247
0,80,160,296,300,596,1279
160,10,-20,293,303,596,1224
160,40,0,297,299,596,1162
0,30,30,281,315,596,1254
180,-80,20,295,301,596,1304
160,80,0,299,297,596,1255
-180,-80,20,295,301,596,1304
70,70,-20,290,306,596,1274
130,0,-170,286,310,596,1135
160,-70,-70,287,309,596,1308
-170,-80,-130,289,308,597,1197
-180,-70,-130,289,308,597,1224
50,60,40,280,317,597,1331
10,-40,120,296,301,597,1317
80,70,-80,293,304,597,1080
-180,-30,20,301,296,597,1086
180,-30,20,301,296,597,1086
180,-70,-130,289,308,597,1224
60,70,60,293,304,597,1328
10,-50,90,291,306,597,1239
20,-70,170,292,305,597,1213
0,40,150,297,300,597,1170
20,-70,100,282,315,597,1250
170,20,20,296,301,597,1197
10,-60,20,294,303,597,1319
80,-50,60,286,312,598,1321
170,-50,-70,288,310,598,1297
0,-20,170,297,301,598,1223
0,30,90,295,303,598,1297
150,30,50,291,307,598,1211
160,70,-120,303,295,598,1160
130,40,80,289,309,598,1107
120,-20,50,290,308,598,1293
150,-80,-140,280,318,598,1314
10,0,10,294,305,599,1254
180,-20,-100,288,311,599,1220
-20,-20,30,294,305,599,1143
120,-80,130,275,324,599,1088
120,-80,-120,297,302,599,1319
170,-60,-80,291,308,599,1302
170,20,-80,287,312,599,1141
0,-60,170,308,291,599,1270
-180,-20,-100,288,311,599,1220
160,-60,180,288,311,599,1212
180,30,-110,287,312,599,1180
10,-10,-160,303,296,599,1263
160,-60,-180,288,311,599,1212
10,70,180,310,289,599,1201
-180,30,-110,287,312,599,1180
40,80,-30,298,301,599,1117
10,70,-180,310,289,599,1201
150,-40,-180,284,316,600,1176
40,-70,160,289,311,600,1325
80,60,20,280,320,600,1256
150,-40,180,284,316,600,1176
40,-20,10,290,310,600,1366
70,-80,-160,294,306,600,1297
-180,-20,-120,291,309,600,1299
10,-40,150,289,311,600,1264
130,50,-20,288,312,600,1352
180,-20,-120,291,309,600,1299
30,-80,100,281,319,600,1278
20,80,0,308,292,600,1180
-10,-30,-170,307,294,601,1222
80,80,120,301,300,601,1316
-10,-40,-170,306,295,601,1177
160,60,-110,263,338,601,1157
-170,-60,-130,278,323,601,1223
-20,-80,160,298,303,601,1299
180,-10,10,293,308,601,1156
0,0,150,304,297,601,1302
0,-70,50,311,290,601,1246
-180,-10,10,293,308,601,1156
90,-80,-150,298,303,601,1297
90,-60,90,302,299,601,1328
0,40,-170,305,296,601,1241
180,-10,-80,287,314,601,1190
-20,-70,170,309,292,601,1305
150,-80,-50,289,312,601,1316
-180,-10,-80,287,314,601,1190
180,-20,-70,292,310,602,1250
-180,0,-80,308,294,602,1241
30,-70,120,286,316,602,1262
-180,-20,-70,292,310,602,1250
-10,0,20,308,294,602,1197
120,-10,90,291,311,602,1255
60,-30,20,279,323,602,1321
180,0,-80,308,294,602,1241
70,-50,50,285,318,603,1287
120,70,20,302,301,603,1223
160,-40,-170,289,314,603,1191
30,-50,-110,307,296,603,1065
-10,70,170,297,306,603,1304
160,70,20,299,304,603,1249
180,-40,-100,305,298,603,1296
90,-30,30,276,327,603,1225
80,-80,-160,293,310,603,1278
160,50,-100,282,321,603,1194
-180,-40,-100,305,298,603,1296
60,-10,-10,280,323,603,1239
-170,-40,10,312,291,603,1189
40,70,80,298,306,604,1241
160,-10,30,305,299,604,1227
160,60,10,302,302,604,1278
180,-40,-140,299,305,604,1294
170,-80,-110,285,319,604,1199
-180,-40,-140,299,305,604,1294
-20,-20,20,293,311,604,1162
-20,-50,10,308,296,604,1185
160,-60,-60,297,307,604,1374
150,80,30,304,300,604,1246
120,30,-140,300,304,604,1246
-20,-80,180,303,301,604,1264
170,-80,-100,291,313,604,1219
-170,-70,-140,291,313,604,1133
-20,-80,-180,303,301,604,1264
0,-80,-150,299,305,604,1240
70,80,-40,311,294,605,1230
60,10,-80,288,317,605,1291
160,-80,-140,291,314,605,1285
100,-70,-40,308,297,605,1220
70,80,130,305,300,605,1311
30,70,90,301,304,605,1181
160,-80,-100,297,308,605,1312
120,70,-120,290,315,605,1162
10,-70,-140,311,294,605,1209
-20,-40,10,316,289,605,1124
150,80,-120,308,298,606,1234
-10,-50,-180,311,295,606,1248
130,-80,-110,302,304,606,1319
70,-20,-50,284,322,606,1219
150,80,40,305,301,606,1295
-10,-50,180,311,295,606,1248
170,80,0,302,304,606,1307
-160,-80,30,305,301,606,1233
-30,-80,160,302,304,606,1293
0,80,180,314,293,607,1273
60,20,-60,281,326,607,1157
-170,70,-170,297,310,607,1178
160,30,-150,303,304,607,1235
140,-80,-110,310,297,607,1291
170,-10,-70,290,317,607,1267
40,60,50,288,319,607,1306
10,80,140,294,313,607,1269
110,-70,-30,310,297,607,1203
30,60,60,296,311,607,1311
0,80,-180,314,293,607,1273
100,10,-160,290,317,607,1285
-140,90,-60,306,302,608,1308
160,90,0,306,302,608,1308
10,90,150,306,302,608,1308
130,90,30,306,302,608,1308
70,90,90,306,302,608,1308
-50,90,-150,306,302,608,1308
30,90,130,306,302,608,1308
80,90,80,306,302,608,1308
110,0,180,274,334,608,1229
110,90,50,306,302,608,1308
150,90,10,306,302,608,1308
-180,90,-20,306,302,608,1308
180,90,-20,306,302,608,1308
-150,90,-50,306,302,608,1308
-80,90,-120,306,302,608,1308
70,-20,0,282,326,608,1288
170,-80,-20,292,316,608,1254
-90,90,-110,306,302,608,1308
-120,90,-80,306,302,608,1308
-110,90,-90,306,302,608,1308
180,-60,-10,305,303,608,1203
-100,90,-100,306,302,608,1308
170,30,0,302,306,608,1229
-30,90,-170,306,302,608,1308
-180,-60,-10,305,303,608,1203
120,-70,-20,313,295,608,1171
-130,90,-70,306,302,608,1308
-160,90,-40,306,302,608,1308
90,90,70,306,302,608,1308
0,90,160,306,302,608,1308
-170,90,-30,306,302,608,1308
170,90,-10,306,302,608,1308
100,-30,40,292,316,608,1292
40,90,120,306,302,608,1308
140,90,20,306,302,608,1308
40,70,0,292,316,608,1279
-10,90,170,306,302,608,1308
90,-50,-40,307,301,608,1238
-20,90,180,306,302,608,1308
100,90,60,306,302,608,1308
-40,90,-160,306,302,608,1308
-160,-80,20,298,310,608,1261
50,90,110,306,302,608,1308
120,90,40,306,302,608,1308
-20,90,-180,306,302,608,1308
-60,90,-140,306,302,608,1308
-70,90,-130,306,302,608,1308
20,90,140,306,302,608,1308
90,80,110,303,305,608,1329
110,0,-180,274,334,608,1229
60,90,100,306,302,608,1308
180,-30,-110,291,318,609,1253
-60,-90,110,300,309,609,1284
-50,-90,120,300,309,609,1284
-150,-90,20,300,309,609,1284
-100,-90,70,300,309,609,1284
160,-90,-30,300,309,609,1284
-120,-90,50,300,309,609,1284
-130,-90,40,300,309,609,1284
80,10,-140,295,314,609,1316
180,-90,-10,300,309,609,1284
60,-20,-70,291,318,609,1294
170,-90,-20,300,309,609,1284
130,70,70,310,299,609,1282
-80,-90,90,300,309,609,1284
-180,-90,-10,300,309,609,1284
50,-90,-140,300,309,609,1284
150,-90,-40,300,309,609,1284
-10,-90,160,300,309,609,1284
-70,-90,100,300,309,609,1284
40,-90,-150,300,309,609,1284
100,-90,-90,300,309,609,1284
30,-80,90,280,329,609,1267
60,10,-90,298,311,609,1123
30,-80,130,301,308,609,1284
10,-90,180,300,309,609,1284
60,-90,-130,300,309,609,1284
-40,-90,130,300,309,609,1284
80,-90,-110,300,309,609,1284
20,-90,-170,300,309,609,1284
120,-90,-70,300,309,609,1284
-160,-90,10,300,309,609,1284
70,-90,-120,300,309,609,1284
-140,-90,30,300,309,609,1284
-110,-90,60,300,309,609,1284
10,-90,-180,300,309,609,1284
130,-90,-60,300,309,609,1284
-180,-30,-110,291,318,609,1253
-170,-90,0,300,309,609,1284
110,-90,-80,300,309,609,1284
-90,-90,80,300,309,609,1284
-30,-90,140,300,309,609,1284
70,-70,-70,299,310,609,1226
90,-90,-100,300,309,609,1284
0,-90,170,300,309,609,1284
140,-90,-50,300,309,609,1284
-150,-80,-130,291,318,609,1065
-20,-90,150,300,309,609,1284
30,-90,-160,300,309,609,1284
-30,-80,150,307,303,610,1353
50,-80,140,294,316,610,1274
0,70,-180,312,298,610,1219
140,-40,10,290,320,610,1294
150,50,0,297,313,610,1224
40,30,180,297,313,610,1305
0,70,180,312,298,610,1219
130,-60,140,290,320,610,1196
40,30,-180,297,313,610,1305
30,-40,-110,316,294,610,1097
10,60,90,292,319,611,1226
20,-70,90,295,316,611,1314
110,10,110,274,337,611,1233
170,-40,-60,297,314,611,1243
60,10,-50,287,324,611,1189
60,0,-70,298,313,611,1281
140,60,-80,293,318,611,1274
-180,-10,-100,297,315,612,1259
-160,90,-30,310,302,612,1281
130,90,40,310,302,612,1281
-20,90,-170,310,302,612,1281
100,90,70,310,302,612,1281
-130,90,-60,310,302,612,1281
120,90,50,310,302,612,1281
-40,90,-150,310,302,612,1281
20,70,110,297,315,612,1158
100,60,10,288,324,612,1274
0,-40,-150,316,296,612,1180
10,50,110,297,315,612,1153
-30,90,-160,310,302,612,1281
10,40,30,284,328,612,1339
80,90,90,310,302,612,1281
20,90,150,310,302,612,1281
10,90,160,310,302,612,1281
70,90,100,310,302,612,1281
-180,90,-10,310,302,612,1281
180,90,-10,310,302,612,1281
180,-10,-100,297,315,612,1259
-70,90,-120,310,302,612,1281
50,90,120,310,302,612,1281
-110,90,-80,310,302,612,1281
-90,90,-100,310,302,612,1281
160,90,10,310,302,612,1281
-140,90,-50,310,302,612,1281
150,30,-50,290,322,612,1333
-120,90,-70,310,302,612,1281
140,90,30,310,302,612,1281
-100,90,-90,310,302,612,1281
170,90,0,310,302,612,1281
60,80,140,308,304,612,1335
-10,90,-180,310,302,612,1281
-40,-80,-20,307,305,612,1100
110,90,60,310,302,612,1281
150,90,20,310,302,612,1281
10,-50,120,297,315,612,1227
60,90,110,310,302,612,1281
-150,90,-40,310,302,612,1281
40,90,130,310,302,612,1281
0,90,170,310,302,612,1281
-170,90,-20,310,302,612,1281
-80,90,-110,310,302,612,1281
-50,90,-140,310,302,612,1281
90,90,80,310,302,612,1281
-60,90,-130,310,302,612,1281
50,-80,160,303,309,612,1327
30,90,140,310,302,612,1281
-10,90,180,310,302,612,1281
150,60,-90,281,332,613,1278
-10,-40,-180,312,301,613,1228
60,60,-60,304,309,613,1197
-10,-40,180,312,301,613,1228
-10,10,50,303,310,613,1212
170,0,-70,287,326,613,1249
60,80,80,308,306,614,1242
-170,-70,10,302,312,614,1309
120,-10,80,293,321,614,1322
-10,50,170,311,303,614,1249
-10,-60,-170,311,303,614,1261
-170,-60,-140,305,309,614,1142
170,30,-110,286,328,614,1261
120,60,-40,302,312,614,1405
140,-80,-80,294,320,614,1285
80,60,130,300,314,614,1223
10,50,70,311,304,615,1285
-180,-20,-110,299,316,615,1367
160,80,-150,307,308,615,1167
50,0,-150,281,334,615,1320
-10,-20,50,308,307,615,1298
90,-70,-50,312,303,615,1210
-180,-40,-130,296,319,615,1331
170,40,10,308,307,615,1286
180,-20,-110,299,316,615,1367
140,-50,160,292,323,615,1233
30,-20,10,300,315,615,1423
100,80,100,300,315,615,1343
20,30,-170,307,308,615,1223
180,-40,-130,296,319,615,1331
50,-80,60,308,308,616,1199
-180,-70,-120,289,327,616,1321
40,-10,-130,297,319,616,1246
50,-80,-170,303,313,616,1286
180,-70,-120,289,327,616,1321
160,80,20,308,308,616,1287
-10,50,-180,322,294,616,1185
-10,50,180,322,294,616,1185
20,-80,120,311,305,616,1259
20,60,-180,318,298,616,1209
90,60,10,288,328,616,1201
-10,-70,-170,320,296,616,1323
20,60,180,318,298,616,1209
160,-80,-40,296,320,616,1391
140,-20,180,304,313,617,1223
80,10,-170,279,338,617,1276
-180,-80,-90,293,324,617,1290
-170,-80,30,304,313,617,1321
140,-20,-180,304,313,617,1223
60,-80,140,295,322,617,1339
20,-20,-140,297,320,617,1204
-30,-80,10,298,319,617,1234
160,70,30,309,308,617,1342
90,60,120,307,310,617,1246
140,-30,20,299,318,617,1268
-10,-30,180,308,309,617,1248
0,-60,60,314,303,617,1275
-10,-30,-180,308,309,617,1248
10,-50,100,295,322,617,1301
50,80,90,311,306,617,1281
80,40,140,303,314,617,1212
0,-30,140,305,312,617,1311
-180,0,-100,300,317,617,1257
0,50,-170,326,291,617,1226
180,0,-100,300,317,617,1257
180,-80,-90,293,324,617,1290
-10,80,-180,322,296,618,1315
180,-20,-10,323,295,618,1189
-50,-80,-20,297,321,618,1155
50,60,20,286,332,618,1327
130,-80,140,282,336,618,1138
-180,-20,-10,323,295,618,1189
-180,-70,-10,316,302,618,1208
-10,80,180,322,296,618,1315
50,80,150,317,301,618,1330
-180,-70,-110,284,334,618,1272
180,-70,-110,284,334,618,1272
180,-70,-10,316,302,618,1208
-10,-80,160,302,316,618,1256
40,60,-30,280,338,618,1164
170,-30,-40,290,328,618,1259
180,-50,-120,293,326,619,1360
-10,40,-180,321,298,619,1257
-170,-60,-100,290,329,619,1313
30,80,110,306,313,619,1316
120,50,90,316,303,619,1147
40,-80,-170,301,318,619,1311
150,-80,-100,316,303,619,1330
-10,40,180,321,298,619,1257
0,-50,10,298,321,619,1243
10,-70,70,293,326,619,1357
140,-80,-70,289,330,619,1263
-180,-50,-120,293,326,619,1360
0,-80,50,297,322,619,1255
20,-80,80,289,331,620,1313
40,-80,130,304,316,620,1298
170,70,-160,302,318,620,1173
40,-80,150,300,320,620,1343
70,-80,-170,300,320,620,1312
100,70,-50,309,311,620,1330
-20,-40,20,318,302,620,1182
130,30,80,287,333,620,1121
130,80,20,315,305,620,1320
-130,-80,-100,293,327,620,1126
-170,80,-170,311,309,620,1271
-170,-40,20,310,310,620,1247
60,-80,-170,302,318,620,1314
70,60,140,306,314,620,1253
140,70,10,317,303,620,1252
60,-30,-70,297,323,620,1243
170,-30,-160,308,312,620,1106
-180,30,-100,301,320,621,1189
60,-90,110,299,322,621,1275
180,30,-100,301,320,621,1189
-180,10,-110,301,320,621,1333
-70,-90,-20,299,322,621,1275
-170,-70,30,321,300,621,1338
-10,-90,40,299,322,621,1275
160,-80,-150,298,323,621,1321
-130,-90,-80,299,322,621,1275
160,-80,10,318,303,621,1306
110,-90,160,299,322,621,1275
130,-90,-180,299,322,621,1275
20,-90,70,299,322,621,1275
20,50,50,300,321,621,1335
-80,-90,-30,299,322,621,1275
150,-90,-160,299,322,621,1275
-150,-90,-100,299,322,621,1275
-120,-90,-70,299,322,621,1275
50,-10,-100,297,324,621,1238
-170,-50,10,317,304,621,1252
-170,-90,-120,299,322,621,1275
50,60,30,292,329,621,1323
30,-60,30,305,316,621,1333
-180,-90,-130,299,322,621,1275
180,-90,-130,299,322,621,1275
130,-90,180,299,322,621,1275
10,-90,60,299,322,621,1275
120,-90,170,299,322,621,1275
70,-90,120,299,322,621,1275
-110,-90,-60,299,322,621,1275
-40,-90,10,299,322,621,1275
-10,-70,40,313,308,621,1339
-140,-90,-90,299,322,621,1275
40,-90,90,299,322,621,1275
-20,-70,160,314,307,621,1282
90,-90,140,299,322,621,1275
-30,-90,20,299,322,621,1275
-10,60,170,309,312,621,1304
-160,-90,-110,299,322,621,1275
100,-90,150,299,322,621,1275
30,-90,80,299,322,621,1275
-90,-90,-40,299,322,621,1275
80,-90,130,299,322,621,1275
0,-90,50,299,322,621,1275
180,10,-110,301,320,621,1333
50,-90,100,299,322,621,1275
-50,-90,0,299,322,621,1275
-60,-90,-10,299,322,621,1275
170,-90,-140,299,322,621,1275
-100,-90,-50,299,322,621,1275
0,-20,-160,316,305,621,1313
-20,-90,30,299,322,621,1275
10,60,100,294,327,621,1182
140,-90,-170,299,322,621,1275
160,-90,-150,299,322,621,1275
-180,-60,-120,294,328,622,1336
180,-20,-80,298,324,622,1233
20,-60,130,298,324,622,1352
-150,-80,40,314,308,622,1264
20,70,10,307,315,622,1322
-180,-20,-80,298,324,622,1233
-10,80,-170,322,300,622,1297
30,-70,40,315,307,622,1327
10,40,10,305,317,622,1216
20,-20,10,306,316,622,1433
170,-80,-130,300,322,622,1368
-180,-70,-90,301,321,622,1382
180,-70,-90,301,321,622,1382
180,-60,-120,294,328,622,1336
170,-40,-160,314,308,622,1185
10,-20,-150,309,314,623,1327
90,10,-170,286,337,623,1310
30,0,0,279,344,623,1283
170,-70,-90,318,305,623,1328
110,20,110,288,335,623,1285
60,80,-30,323,300,623,1300
-180,-80,-100,294,330,624,1243
-10,10,40,310,314,624,1315
60,-70,-80,317,307,624,1206
100,70,30,312,312,624,1275
180,-80,-100,294,330,624,1243
180,-50,-130,308,316,624,1431
-180,-50,-130,308,316,624,1431
100,60,0,289,335,624,1290
40,60,40,296,328,624,1382
170,70,10,315,309,624,1319
170,40,-110,297,328,625,1360
60,-10,-70,292,333,625,1326
10,-50,160,299,326,625,1298
0,-30,170,301,324,625,1287
-10,70,180,318,307,625,1328
0,-50,-150,316,309,625,1230
0,-10,150,318,307,625,1266
-10,70,-180,318,307,625,1328
180,30,-140,300,325,625,1254
170,-40,-40,298,327,625,1326
90,10,-160,290,335,625,1364
110,-40,110,303,322,625,1303
-180,30,-140,300,325,625,1254
110,0,130,290,335,625,1167
10,-70,90,291,335,626,1313
0,20,90,304,322,626,1322
60,-50,40,300,326,626,1372
20,-70,120,305,321,626,1366
10,-60,100,301,325,626,1296
170,10,-60,296,330,626,1285
100,20,130,290,336,626,1193
10,-30,120,305,321,626,1370
150,10,50,300,326,626,1270
130,-40,150,297,329,626,1224
-20,-60,170,325,301,626,1326
160,80,30,312,314,626,1356
40,80,100,313,313,626,1304
20,-70,110,308,319,627,1339
80,20,160,308,319,627,1292
30,-70,140,306,321,627,1389
140,-80,-100,314,313,627,1366
80,-50,-50,314,313,627,1212
170,0,-10,318,309,627,1284
130,-30,160,295,332,627,1280
-170,-50,-140,312,315,627,1097
30,80,-20,313,314,627,1186
170,-10,-30,296,331,627,1229
110,80,90,309,318,627,1368
160,-80,-130,299,328,627,1380
160,-70,-80,297,330,627,1278
170,-80,-90,309,319,628,1381
170,60,10,318,310,628,1355
10,-60,90,297,331,628,1346
160,80,-130,313,315,628,1298
140,-80,-90,293,335,628,1302
10,80,-180,319,309,628,1289
160,30,-60,303,325,628,1250
0,-70,-150,324,304,628,1304
10,80,180,319,309,628,1289
-10,40,170,316,312,628,1243
20,-80,90,295,333,628,1334
160,-70,-50,304,324,628,1351
-40,-80,150,319,309,628,1321
-10,80,170,318,310,628,1343
20,-70,160,316,312,628,1335
0,20,150,307,322,629,1225
60,10,-70,297,332,629,1250
170,80,10,313,316,629,1314
-120,-80,-90,300,329,629,1230
-180,-80,-10,311,318,629,1356
180,80,-10,320,309,629,1330
-170,-70,-90,299,330,629,1274
70,-30,20,292,337,629,1354
180,-80,-10,311,318,629,1356
-180,80,-10,320,309,629,1330
160,60,30,317,312,629,1320
60,60,150,316,313,629,1302
130,-20,30,297,333,630,1419
0,60,140,311,319,630,1228
-40,-80,140,313,317,630,1381
180,-10,-120,308,322,630,1357
-180,-60,-90,307,323,630,1370
-180,-10,-120,308,322,630,1357
10,-80,170,306,324,630,1336
180,-60,-90,307,323,630,1370
160,20,40,305,325,630,1241
170,30,-150,314,317,631,1188
70,70,50,306,325,631,1361
10,-50,110,314,317,631,1311
140,10,60,292,339,631,1198
-180,20,-90,314,317,631,1208
-180,-30,-100,302,329,631,1297
40,20,-20,297,334,631,1335
30,60,20,300,331,631,1364
30,70,-20,302,329,631,1238
180,20,-90,314,317,631,1208
80,-30,-40,299,332,631,1299
180,-30,-100,302,329,631,1297
40,80,160,325,306,631,1370
-10,30,180,325,306,631,1274
-10,30,-180,325,306,631,1274
-10,20,-180,316,316,632,1239
0,-10,70,309,323,632,1371
-160,-80,-120,300,332,632,1273
0,60,-170,330,302,632,1226
160,30,40,313,319,632,1310
-180,20,-120,307,325,632,1387
10,-40,110,312,320,632,1323
0,-50,60,315,317,632,1298
10,-50,130,303,329,632,1378
-10,20,180,316,316,632,1239
180,20,-120,307,325,632,1387
70,80,70,316,316,632,1271
170,-70,-80,312,320,632,1406
170,-70,20,315,317,632,1363
30,50,-180,319,314,633,1302
-170,-70,-100,294,339,633,1265
0,-20,160,310,323,633,1360
0,-40,60,311,322,633,1367
70,30,160,330,303,633,1326
-60,-80,-30,303,330,633,1230
20,-60,-120,317,316,633,1203
20,50,30,306,327,633,1374
30,50,180,319,314,633,1302
160,20,-50,297,336,633,1309
70,20,170,316,317,633,1321
-150,-80,30,306,327,633,1331
170,80,-10,315,319,634,1318
130,-70,-10,327,307,634,1232
20,70,-180,324,310,634,1349
100,-40,70,305,329,634,1315
180,0,-150,308,326,634,1182
50,-70,-90,321,313,634,1252
-180,0,-150,308,326,634,1182
20,70,180,324,310,634,1349
130,-10,70,304,330,634,1226
120,60,-30,300,334,634,1412
-10,10,60,321,313,634,1280
140,50,-50,304,330,634,1379
120,-20,60,319,315,634,1253
0,20,140,307,328,635,1245
110,60,-10,297,338,635,1374
60,-80,180,308,327,635,1349
170,-30,-50,303,332,635,1311
100,70,-40,305,330,635,1414
-10,60,-180,309,326,635,1290
60,10,-110,304,331,635,1256
50,80,-20,329,306,635,1389
-160,-70,30,319,316,635,1356
-10,60,180,309,326,635,1290
60,-80,-180,308,327,635,1349
30,-70,160,306,330,636,1359
-180,80,0,313,323,636,1348
180,80,0,313,323,636,1348
160,-70,-60,308,328,636,1389
-140,-80,-120,304,332,636,1111
10,60,20,305,331,636,1301
10,-30,130,305,331,636,1408
-170,-80,-90,302,334,636,1264
80,80,60,320,316,636,1305
60,70,-10,307,329,636,1285
-20,-60,20,318,318,636,1225
100,60,110,328,308,636,1297
80,30,150,309,327,636,1235
170,30,-80,312,325,637,1305
-170,-60,30,326,311,637,1334
60,-40,30,308,329,637,1469
-30,-80,170,322,315,637,1306
0,-30,60,312,325,637,1405
80,-70,-60,320,317,637,1227
110,-40,100,309,328,637,1408
-10,-50,170,317,320,637,1395
-20,80,-170,334,303,637,1375
30,-70,150,303,335,638,1428
100,-50,90,304,334,638,1416
100,20,-140,309,329,638,1285
40,-80,50,325,313,638,1254
180,-50,-80,308,330,638,1352
170,10,-10,319,319,638,1348
-10,-30,10,315,323,638,1304
-50,-80,140,324,314,638,1350
-10,-40,-160,327,311,638,1342
-160,-80,40,316,322,638,1346
30,60,50,303,335,638,1353
60,20,-70,302,336,638,1262
120,-20,90,310,328,638,1272
10,-70,80,308,330,638,1374
-180,-50,-80,308,330,638,1352
120,60,10,310,328,638,1353
170,-40,-50,310,328,638,1347
50,-80,130,306,333,639,1389
-10,-40,40,316,323,639,1359
40,-70,-100,326,313,639,1230
-10,20,60,320,319,639,1231
0,50,100,311,328,639,1280
140,50,-60,307,332,639,1455
-20,-70,20,312,327,639,1202
180,0,10,322,318,640,1207
-10,20,70,313,327,640,1246
-180,0,10,322,318,640,1207
-140,-80,50,319,321,640,1297
10,-30,10,324,316,640,1353
60,0,-30,297,343,640,1308
-10,-80,40,309,331,640,1333
-40,-80,0,313,327,640,1312
-180,-10,0,318,322,640,1280
180,-40,-80,294,346,640,1302
180,-10,0,318,322,640,1280
-170,-60,-90,310,330,640,1422
0,50,140,320,320,640,1276
-170,-50,-100,302,338,640,1437
-180,-40,-80,294,346,640,1302
10,-80,110,327,313,640,1324
10,-60,80,304,336,640,1319
-10,-60,40,329,312,641,1252
10,-70,100,311,330,641,1376
60,20,180,320,321,641,1329
180,-40,-90,308,333,641,1274
150,-80,-90,313,328,641,1398
110,70,-60,313,328,641,1399
170,50,10,312,329,641,1430
-180,-40,-90,308,333,641,1274
60,20,-180,320,321,641,1329
-110,-80,-80,310,331,641,1278
-10,-80,-160,318,323,641,1295
160,40,40,322,319,641,1272
140,70,60,327,314,641,1385
130,20,-150,325,317,642,1266
170,30,20,318,324,642,1313
-20,-50,20,324,318,642,1297
170,-70,-30,306,336,642,1376
20,60,20,318,324,642,1398
160,50,-90,299,343,642,1323
10,-30,-140,308,334,642,1253
170,20,-70,310,332,642,1356
-20,80,-160,329,313,642,1333
-170,-90,-80,312,331,643,1303
170,0,30,324,319,643,1258
50,-90,140,312,331,643,1303
180,-90,-90,312,331,643,1303
70,-90,160,312,331,643,1303
-30,-90,60,312,331,643,1303
-170,-50,-110,305,338,643,1400
140,-90,-130,312,331,643,1303
-60,-90,30,312,331,643,1303
160,-90,-110,312,331,643,1303
150,-90,-120,312,331,643,1303
170,-90,-100,312,331,643,1303
-70,-90,20,312,331,643,1303
-130,-90,-40,312,331,643,1303
-40,-90,50,312,331,643,1303
160,70,0,322,321,643,1352
60,-90,150,312,331,643,1303
40,50,-30,290,353,643,1260
-70,-80,-40,314,329,643,1272
50,40,170,327,316,643,1337
-150,-90,-60,312,331,643,1303
80,-90,170,312,331,643,1303
40,-90,130,312,331,643,1303
170,-80,-120,300,343,643,1429
-140,-90,-50,312,331,643,1303
30,-90,120,312,331,643,1303
-50,-90,40,312,331,643,1303
-160,-90,-70,312,331,643,1303
-180,-10,20,313,330,643,1190
130,60,10,309,334,643,1308
-90,-90,0,312,331,643,1303
180,-10,20,313,330,643,1190
120,-90,-150,312,331,643,1303
-100,-90,-10,312,331,643,1303
-20,-90,70,312,331,643,1303
10,-90,100,312,331,643,1303
-110,-90,-20,312,331,643,1303
-10,-40,170,317,326,643,1306
0,40,100,313,330,643,1397
120,-20,70,309,334,643,1263
-180,-90,-90,312,331,643,1303
130,-90,-140,312,331,643,1303
-80,-90,10,312,331,643,1303
20,-90,110,312,331,643,1303
10,50,-170,335,308,643,1261
90,-90,180,312,331,643,1303
110,-50,-20,304,339,643,1373
-120,-90,-30,312,331,643,1303
100,-90,-170,312,331,643,1303
90,-90,-180,312,331,643,1303
-10,-90,80,312,331,643,1303
110,-90,-160,312,331,643,1303
0,-90,90,312,331,643,1303
170,70,0,329,315,644,1329
130,-20,170,303,341,644,1215
120,-30,130,295,349,644,1200
0,70,140,315,329,644,1225
160,-80,-90,328,316,644,1375
0,-20,150,316,328,644,1325
-20,-30,10,319,325,644,1246
0,70,-170,335,309,644,1291
160,-40,20,320,324,644,1266
150,40,-60,314,331,645,1412
-10,90,-170,326,319,645,1329
-180,70,-150,324,321,645,1325
0,90,180,326,319,645,1329
50,90,130,326,319,645,1329
60,90,120,326,319,645,1329
170,60,-130,311,334,645,1188
-180,90,0,326,319,645,1329
180,0,20,322,323,645,1245
80,-40,40,295,350,645,1450
-110,90,-70,326,319,645,1329
50,-80,170,310,335,645,1355
20,90,160,326,319,645,1329
-50,90,-130,326,319,645,1329
-140,90,-40,326,319,645,1329
-150,90,-30,326,319,645,1329
130,90,50,326,319,645,1329
-120,90,-60,326,319,645,1329
-90,90,-90,326,319,645,1329
90,90,90,326,319,645,1329
180,90,0,326,319,645,1329
-80,90,-100,326,319,645,1329
120,90,60,326,319,645,1329
-60,90,-120,326,319,645,1329
-130,90,-50,326,319,645,1329
10,-60,110,316,329,645,1305
-20,90,-160,326,319,645,1329
10,-60,120,322,323,645,1372
170,90,10,326,319,645,1329
-180,0,20,322,323,645,1245
140,90,40,326,319,645,1329
120,80,80,322,323,645,1418
-160,90,-20,326,319,645,1329
160,90,20,326,319,645,1329
150,90,30,326,319,645,1329
80,90,100,326,319,645,1329
-170,90,-10,326,319,645,1329
10,90,170,326,319,645,1329
70,90,110,326,319,645,1329
-40,90,-140,326,319,645,1329
100,90,80,326,319,645,1329
30,90,150,326,319,645,1329
0,90,-180,326,319,645,1329
130,60,-60,314,331,645,1440
-70,90,-110,326,319,645,1329
180,70,-150,324,321,645,1325
110,60,10,307,338,645,1315
-30,90,-150,326,319,645,1329
-100,90,-80,326,319,645,1329
40,90,140,326,319,645,1329
110,90,70,326,319,645,1329
150,60,50,326,320,646,1353
170,80,20,327,319,646,1383
130,80,70,322,324,646,1394
140,-80,150,303,343,646,1204
40,-80,-180,317,329,646,1329
140,70,-90,308,338,646,1355
-150,-80,50,327,319,646,1381
0,-60,-150,336,310,646,1423
40,-80,180,317,329,646,1329
130,10,-160,306,340,646,1219
90,70,-30,306,340,646,1425
10,60,110,312,334,646,1295
120,60,-20,304,342,646,1369
20,-70,130,322,325,647,1435
-180,-50,-90,313,334,647,1368
110,-30,50,316,331,647,1465
180,-50,-90,313,334,647,1368
30,-80,120,314,333,647,1375
-30,-70,160,324,323,647,1400
130,70,-130,314,333,647,1239
50,-80,180,319,328,647,1350
-50,-80,130,331,316,647,1410
30,60,-20,305,342,647,1243
50,-80,-180,319,328,647,1350
-20,90,-150,331,317,648,1324
30,-80,-180,312,336,648,1424
170,-80,-140,317,331,648,1393
80,90,110,331,317,648,1324
170,90,20,331,317,648,1324
70,70,-70,319,329,648,1178
30,-80,180,312,336,648,1424
40,60,20,301,347,648,1349
10,90,180,331,317,648,1324
-170,90,0,331,317,648,1324
-110,90,-60,331,317,648,1324
-40,90,-130,331,317,648,1324
10,90,-180,331,317,648,1324
-100,90,-70,331,317,648,1324
70,90,120,331,317,648,1324
0,90,-170,331,317,648,1324
30,90,160,331,317,648,1324
-180,-30,-70,307,341,648,1314
180,-30,-70,307,341,648,1314
160,90,30,331,317,648,1324
-10,90,-160,331,317,648,1324
140,-10,50,304,344,648,1384
90,90,100,331,317,648,1324
-80,90,-90,331,317,648,1324
100,90,90,331,317,648,1324
120,90,70,331,317,648,1324
70,30,-100,305,343,648,1180
140,90,50,331,317,648,1324
-70,90,-100,331,317,648,1324
170,0,-40,299,349,648,1302
50,90,140,331,317,648,1324
150,90,40,331,317,648,1324
40,90,150,331,317,648,1324
90,20,150,313,335,648,1267
-180,90,10,331,317,648,1324
60,90,130,331,317,648,1324
180,90,10,331,317,648,1324
110,90,80,331,317,648,1324
-30,90,-140,331,317,648,1324
10,-80,70,305,343,648,1368
-170,-60,10,323,325,648,1274
-50,90,-120,331,317,648,1324
-60,90,-110,331,317,648,1324
20,90,170,331,317,648,1324
130,90,60,331,317,648,1324
20,80,120,312,336,648,1361
-120,90,-50,331,317,648,1324
-150,90,-20,331,317,648,1324
0,0,80,309,339,648,1426
-90,90,-80,331,317,648,1324
-160,90,-10,331,317,648,1324
-130,90,-40,331,317,648,1324
-140,90,-30,331,317,648,1324
20,60,70,328,321,649,1325
50,-20,-90,315,334,649,1336
0,-20,10,319,330,649,1405
170,10,-70,308,341,649,1319
10,-80,80,307,342,649,1331
90,-50,70,309,340,649,1351
-160,80,-180,327,322,649,1326
-20,-70,-180,335,314,649,1413
-20,-70,180,335,314,649,1413
170,50,-120,302,347,649,1379
-160,80,180,327,322,649,1326
150,-80,-60,303,346,649,1356
-20,-80,150,315,335,650,1340
-20,-30,30,329,321,650,1331
20,-60,140,330,320,650,1497
110,70,-50,318,332,650,1422
-170,-30,10,335,315,650,1299
100,-50,-30,311,339,650,1333
10,-60,160,311,339,650,1319
130,-20,40,307,343,650,1263
170,10,-50,310,340,650,1256
130,70,-80,308,342,650,1401
30,80,170,335,315,650,1382
170,-80,-30,312,338,650,1485
10,80,10,338,312,650,1307
-160,-70,-90,302,348,650,1281
-160,-80,-80,312,339,651,1318
-180,-80,-80,323,328,651,1417
-180,-10,-110,306,345,651,1390
180,0,-120,306,345,651,1409
0,80,150,310,341,651,1337
160,50,40,331,320,651,1317
170,0,-60,311,340,651,1340
180,-10,-110,306,345,651,1390
10,40,-170,333,318,651,1165
20,50,40,313,338,651,1424
-170,-70,-130,322,329,651,1397
-180,0,-120,306,345,651,1409
180,-80,-80,323,328,651,1417
-30,-70,0,324,327,651,1238
130,-10,-180,313,339,652,1285
40,-80,120,307,345,652,1426
-180,-30,-80,315,337,652,1303
40,10,-160,319,333,652,1302
130,-10,180,313,339,652,1285
-50,-80,-30,325,327,652,1158
170,70,20,325,327,652,1407
120,10,100,309,343,652,1391
180,-30,-80,315,337,652,1303
150,70,50,330,322,652,1430
80,70,40,314,338,652,1392
-10,50,-170,340,312,652,1366
-20,-70,0,325,327,652,1292
-160,-70,20,319,333,652,1366
170,20,-10,314,338,652,1291
140,80,10,324,329,653,1382
120,70,-70,319,334,653,1424
40,60,30,313,340,653,1438
-180,-80,-120,311,342,653,1464
180,40,-110,314,339,653,1243
180,-80,-120,311,342,653,1464
180,-80,-110,304,349,653,1470
150,-60,10,315,338,653,1229
50,60,160,328,325,653,1366
-170,-80,-80,311,342,653,1345
-180,-80,-110,304,349,653,1470
-180,40,-110,314,339,653,1243
110,-40,90,311,343,654,1378
170,-80,20,335,319,654,1383
0,-50,70,320,334,654,1390
-170,-80,0,328,326,654,1422
40,20,-170,324,330,654,1372
-20,80,180,322,332,654,1409
0,-70,160,328,326,654,1466
-20,80,-180,322,332,654,1409
150,-80,-80,316,339,655,1349
-180,10,-120,311,344,655,1460
-170,80,-10,325,330,655,1384
20,-10,-150,316,339,655,1349
160,60,-100,300,355,655,1340
0,-30,130,322,333,655,1422
-180,20,-130,317,338,655,1371
10,-70,120,324,331,655,1429
180,20,-130,317,338,655,1371
170,40,-90,319,336,655,1313
-170,0,-100,320,335,655,1206
0,-70,90,317,338,655,1397
180,10,-120,311,344,655,1460
110,-30,10,308,347,655,1401
0,80,-170,333,322,655,1344
30,-80,140,323,332,655,1369
130,-10,60,313,342,655,1394
60,10,-60,311,344,655,1306
30,-80,40,328,327,655,1324
100,-30,0,316,339,655,1356
100,30,120,299,356,655,1272
160,10,-30,325,331,656,1384
50,70,0,317,339,656,1381
150,40,-20,314,342,656,1402
-170,30,-120,315,341,656,1315
-10,-50,40,321,335,656,1399
170,10,30,325,331,656,1278
30,-70,-110,337,319,656,1290
-30,-60,0,330,326,656,1290
-10,30,170,327,330,657,1344
80,70,-20,310,347,657,1418
150,-80,-70,313,344,657,1359
-10,-70,160,321,336,657,1352
170,-10,30,333,324,657,1297
-170,80,-20,335,322,657,1388
110,-30,60,311,346,657,1332
90,80,50,324,333,657,1326
-10,0,60,320,337,657,1364
110,-50,110,320,337,657,1406
140,-70,0,334,323,657,1280
90,10,170,319,338,657,1361
90,-40,50,313,344,657,1430
-80,-80,-50,317,341,658,1324
170,-60,-60,322,336,658,1311
160,10,40,312,346,658,1267
130,20,80,300,358,658,1266
-180,0,-110,316,342,658,1435
90,-30,-20,315,343,658,1426
100,10,-170,308,350,658,1349
10,-10,10,329,329,658,1405
-140,-80,40,321,337,658,1400
170,-10,-60,309,349,658,1342
-130,-80,60,329,329,658,1325
20,20,0,316,342,658,1383
180,0,-110,316,342,658,1435
-10,-90,90,321,338,659,1424
110,-90,-150,321,338,659,1424
-90,-90,10,321,338,659,1424
100,10,150,321,338,659,1279
20,-90,120,321,338,659,1424
80,-90,-180,321,338,659,1424
170,80,-140,332,327,659,1331
80,-90,180,321,338,659,1424
-180,-90,-80,321,338,659,1424
0,-90,100,321,338,659,1424
-10,60,-170,351,308,659,1297
-60,-90,40,321,338,659,1424
100,-90,-160,321,338,659,1424
-10,20,-170,323,336,659,1341
-100,-90,0,321,338,659,1424
10,-20,10,322,337,659,1428
120,-90,-140,321,338,659,1424
60,-90,160,321,338,659,1424
20,-50,-120,334,325,659,1242
180,-90,-80,321,338,659,1424
10,-90,110,321,338,659,1424
30,-90,130,321,338,659,1424
140,-90,-120,321,338,659,1424
-20,-90,80,321,338,659,1424
-140,-90,-40,321,338,659,1424
70,-90,170,321,338,659,1424
-40,-90,60,321,338,659,1424
-110,-90,-10,321,338,659,1424
90,-90,-170,321,338,659,1424
-160,-90,-60,321,338,659,1424
-50,-90,50,321,338,659,1424
130,-90,-130,321,338,659,1424
50,-90,150,321,338,659,1424
40,-90,140,321,338,659,1424
-130,-90,-30,321,338,659,1424
-120,-90,-20,321,338,659,1424
-170,-90,-70,321,338,659,1424
120,20,100,314,345,659,1343
-150,-90,-50,321,338,659,1424
-80,-90,20,321,338,659,1424
170,-90,-90,321,338,659,1424
-30,-90,70,321,338,659,1424
120,-20,150,309,350,659,1273
150,-90,-110,321,338,659,1424
110,60,0,312,347,659,1331
-70,-90,30,321,338,659,1424
160,-90,-100,321,338,659,1424
-170,-40,-110,301,358,659,1542
170,80,-160,338,322,660,1248
0,-70,60,319,341,660,1409
10,40,50,305,355,660,1410
100,-60,100,325,335,660,1419
50,0,-140,316,344,660,1250
-30,80,-160,347,313,660,1402
170,-70,-60,320,340,660,1439
80,70,0,318,342,660,1368
-150,-80,-70,318,342,660,1366
30,-80,110,312,348,660,1465
0,-30,-150,331,329,660,1246
-40,-80,160,336,324,660,1357
0,30,100,308,352,660,1377
-160,-90,50,332,329,661,1375
-80,-90,130,332,329,661,1375
170,-50,-40,316,345,661,1382
170,-90,20,332,329,661,1375
30,10,-160,334,327,661,1297
70,-90,-80,332,329,661,1375
140,-90,-10,332,329,661,1375
60,-90,-90,332,329,661,1375
120,-90,-30,332,329,661,1375
-70,-90,140,332,329,661,1375
-110,-90,100,332,329,661,1375
-10,70,160,324,337,661,1363
-40,-90,170,332,329,661,1375
30,-90,-120,332,329,661,1375
-130,-90,80,332,329,661,1375
20,70,100,320,341,661,1271
-90,-90,120,332,329,661,1375
-150,-90,60,332,329,661,1375
180,-90,30,332,329,661,1375
120,70,-60,322,339,661,1497
-20,-90,-170,332,329,661,1375
-100,-90,110,332,329,661,1375
160,30,-20,312,349,661,1359
160,-90,10,332,329,661,1375
-60,-90,150,332,329,661,1375
-180,40,-140,325,336,661,1378
10,40,40,310,351,661,1454
50,-90,-100,332,329,661,1375
170,50,-110,303,358,661,1290
0,-70,80,313,348,661,1399
10,-90,-140,332,329,661,1375
-140,-90,70,332,329,661,1375
-180,-90,30,332,329,661,1375
-20,-10,30,340,321,661,1287
100,-90,-50,332,329,661,1375
-170,-90,40,332,329,661,1375
80,-90,-70,332,329,661,1375
40,-90,-110,332,329,661,1375
-30,-90,-180,332,329,661,1375
180,40,-140,325,336,661,1378
90,-90,-60,332,329,661,1375
10,0,-160,335,326,661,1405
0,-30,10,330,331,661,1330
20,-90,-130,332,329,661,1375
-120,-90,90,332,329,661,1375
110,-90,-40,332,329,661,1375
-50,-90,160,332,329,661,1375
130,-90,-20,332,329,661,1375
0,-90,-150,332,329,661,1375
-30,-90,180,332,329,661,1375
-10,-90,-160,332,329,661,1375
110,30,110,314,347,661,1342
150,-90,0,332,329,661,1375
40,-80,170,330,332,662,1386
0,30,50,325,337,662,1420
-20,-60,180,342,320,662,1415
80,70,-10,304,358,662,1491
40,80,-10,341,321,662,1469
0,30,140,325,337,662,1385
10,80,130,319,343,662,1409
-10,40,90,332,330,662,1275
-20,-60,-180,342,320,662,1415
140,60,-70,311,351,662,1490
-20,70,180,331,332,663,1440
20,-30,10,320,343,663,1494
140,80,60,329,334,663,1422
-180,10,-80,334,329,663,1310
-20,70,-180,331,332,663,1440
90,70,-20,309,354,663,1487
170,-60,-50,314,349,663,1455
180,10,-80,334,329,663,1310
70,70,-10,316,347,663,1419
-100,-80,-70,316,347,663,1332
20,60,60,311,352,663,1372
90,70,-10,319,344,663,1396
-180,30,-130,308,355,663,1420
180,30,-130,308,355,663,1420
170,-20,-60,307,357,664,1424
90,40,130,321,343,664,1422
30,-10,-140,323,341,664,1212
-170,-80,-100,310,354,664,1456
40,-10,0,314,350,664,1388
-170,-50,30,336,328,664,1306
180,-30,-60,323,341,664,1375
0,-70,110,331,333,664,1405
-180,-30,-60,323,341,664,1375
80,10,-160,303,361,664,1458
20,-80,110,321,344,665,1367
-140,-80,-60,322,343,665,1389
0,60,100,322,343,665,1345
-10,80,160,315,350,665,1417
-10,60,160,323,342,665,1400
40,-30,-100,333,332,665,1323
180,80,10,334,331,665,1382
-180,80,10,334,331,665,1382
-10,70,-170,343,322,665,1336
150,50,-70,320,346,666,1433
-50,-80,-10,327,339,666,1395
150,70,-100,312,354,666,1344
0,-80,100,339,327,666,1384
180,70,0,331,335,666,1413
0,60,20,333,333,666,1386
-180,70,0,331,335,666,1413
50,10,-160,299,367,666,1404
100,70,-30,319,347,666,1469
-20,-80,30,318,348,666,1403
10,60,80,335,331,666,1392
-20,-70,30,328,338,666,1407
-150,-80,-110,320,346,666,1334
170,0,-50,316,351,667,1368
0,30,40,317,350,667,1469
0,50,80,336,331,667,1367
170,70,-130,320,347,667,1281
0,10,150,319,348,667,1344
-130,-80,-110,321,346,667,1174
20,80,-180,348,319,667,1408
40,0,-150,316,351,667,1364
20,80,180,348,319,667,1408
160,-20,30,327,340,667,1328
-10,10,20,336,331,667,1239
60,30,-70,313,354,667,1326
-170,-70,-120,320,347,667,1454
20,-60,150,319,348,667,1478
10,-70,110,333,334,667,1324
0,40,70,325,342,667,1289
170,-20,-40,308,360,668,1380
10,70,120,323,345,668,1285
160,40,-70,323,345,668,1381
0,-30,120,332,336,668,1399
10,-40,10,317,351,668,1363
0,-50,90,323,345,668,1396
180,-50,-70,319,349,668,1393
0,-60,100,321,347,668,1393
120,-10,170,316,352,668,1293
-180,-50,-70,319,349,668,1393
170,20,-60,317,352,669,1337
180,80,-20,333,336,669,1379
0,-20,110,330,339,669,1401
130,60,-50,323,346,669,1456
-180,-20,-150,329,340,669,1270
-180,-50,-20,319,350,669,1393
0,-10,120,324,345,669,1461
-180,80,-20,333,336,669,1379
-60,-80,120,345,324,669,1434
30,60,40,321,348,669,1457
-170,-70,-110,320,349,669,1423
10,-70,160,330,339,669,1409
70,70,10,318,351,669,1392
180,-50,-20,319,350,669,1393
180,-20,-150,329,340,669,1270
170,-80,-80,345,324,669,1432
0,-60,90,323,347,670,1457
10,50,60,322,348,670,1342
20,80,-10,331,339,670,1276
10,-50,140,320,350,670,1513
20,-70,30,335,335,670,1458
-170,-50,-90,323,347,670,1485
40,-80,160,323,347,670,1406
30,-20,-120,330,340,670,1242
180,-10,-70,332,338,670,1489
-180,-10,-70,332,338,670,1489
140,-20,30,332,338,670,1404
160,-80,-80,324,346,670,1475
0,-40,110,344,326,670,1473
-160,-70,40,344,326,670,1454
-60,-80,-40,330,341,671,1205
170,-70,-40,319,352,671,1441
0,70,20,331,340,671,1365
-170,40,-120,325,346,671,1299
-30,-70,150,337,334,671,1376
170,40,20,332,339,671,1413
180,-80,30,351,320,671,1441
-180,-80,30,351,320,671,1441
0,-30,150,330,341,671,1456
80,-30,20,327,344,671,1414
80,10,-150,316,356,672,1421
-10,80,-160,341,331,672,1404
120,-40,0,319,353,672,1383
20,-40,-120,335,337,672,1308
0,-60,70,318,354,672,1381
160,-80,-50,321,351,672,1420
10,-80,100,335,337,672,1355
20,-80,130,332,340,672,1412
-170,-50,-130,333,339,672,1426
-170,20,-120,323,349,672,1342
-150,-70,-80,328,344,672,1375
100,-90,180,315,358,673,1446
-30,-90,50,315,358,673,1446
170,50,20,331,342,673,1462
-50,-80,150,341,332,673,1364
20,-90,100,315,358,673,1446
-10,-70,-160,338,335,673,1436
-70,-90,10,315,358,673,1446
-170,-90,-90,315,358,673,1446
170,-50,-50,326,347,673,1451
110,-90,-170,315,358,673,1446
80,-90,160,315,358,673,1446
0,-90,80,315,358,673,1446
130,-90,-150,315,358,673,1446
100,70,-20,320,353,673,1474
-170,-60,-120,328,345,673,1457
120,-90,-160,315,358,673,1446
30,-50,20,321,352,673,1404
170,-90,-110,315,358,673,1446
90,-90,170,315,358,673,1446
130,50,80,330,343,673,1325
150,60,-80,322,351,673,1411
150,-90,-130,315,358,673,1446
-90,-90,-10,315,358,673,1446
160,-90,-120,315,358,673,1446
60,-90,140,315,358,673,1446
50,-90,130,315,358,673,1446
-50,-90,30,315,358,673,1446
-180,-60,-70,319,354,673,1426
-150,-90,-70,315,358,673,1446
-180,-90,-100,315,358,673,1446
-80,-90,0,315,358,673,1446
110,10,120,310,363,673,1229
180,-90,-100,315,358,673,1446
-120,-90,-40,315,358,673,1446
-160,-90,-80,315,358,673,1446
-130,-90,-50,315,358,673,1446
-60,-90,20,315,358,673,1446
30,-90,110,315,358,673,1446
-10,-90,70,315,358,673,1446
140,-90,-140,315,358,673,1446
-140,-90,-60,315,358,673,1446
70,-90,150,315,358,673,1446
0,-50,110,341,332,673,1395
100,-90,-180,315,358,673,1446
180,-60,-70,319,354,673,1426
-110,-90,-30,315,358,673,1446
40,-90,120,315,358,673,1446
-40,-90,40,315,358,673,1446
10,-90,90,315,358,673,1446
-100,-90,-20,315,358,673,1446
-20,-90,60,315,358,673,1446
-170,-60,-110,316,358,674,1365
-140,-80,60,344,330,674,1405
-20,-80,-170,335,339,674,1355
-10,10,-170,336,338,674,1404
130,-30,20,315,359,674,1415
-10,-30,-160,346,328,674,1331
-160,80,-20,337,337,674,1401
180,-30,-150,341,333,674,1315
-180,-30,-150,341,333,674,1315
-170,10,-100,336,338,674,1257
170,-50,-60,322,352,674,1364
-120,-80,70,331,343,674,1376
70,70,0,322,352,674,1488
140,50,-10,321,353,674,1466
170,-70,-70,331,344,675,1476
180,-60,-80,339,336,675,1458
0,-80,60,322,353,675,1436
-90,-80,-60,322,353,675,1370
-150,-70,40,332,343,675,1400
-10,0,180,334,341,675,1402
-10,0,-180,334,341,675,1402
-10,0,-170,345,330,675,1358
10,-80,90,317,358,675,1429
-160,-60,-90,321,354,675,1476
-180,-60,-80,339,336,675,1458
120,-50,-10,320,355,675,1460
170,-60,-170,322,353,675,1402
-170,-40,-100,319,356,675,1495
-10,-70,50,335,340,675,1444
0,-40,120,339,336,675,1395
160,50,0,333,342,675,1379
-160,80,-30,347,328,675,1408
110,70,20,331,344,675,1420
170,0,-30,320,355,675,1374
-180,90,-160,343,333,676,1379
-170,0,-90,329,347,676,1243
-70,90,90,343,333,676,1379
-110,-80,80,339,337,676,1423
-110,90,130,343,333,676,1379
70,90,-50,343,333,676,1379
-170,90,-170,343,333,676,1379
150,90,-130,343,333,676,1379
-180,50,-140,331,345,676,1420
-160,90,-180,343,333,676,1379
-50,90,70,343,333,676,1379
160,-30,-170,333,343,676,1332
20,90,0,343,333,676,1379
-120,90,140,343,333,676,1379
80,90,-60,343,333,676,1379
10,90,10,343,333,676,1379
-130,90,150,343,333,676,1379
180,-60,-60,333,343,676,1374
-180,-60,-60,333,343,676,1374
110,90,-90,343,333,676,1379
-160,90,180,343,333,676,1379
-100,90,120,343,333,676,1379
170,90,-150,343,333,676,1379
-20,90,40,343,333,676,1379
-60,90,80,343,333,676,1379
160,90,-140,343,333,676,1379
-90,90,110,343,333,676,1379
0,-70,70,321,355,676,1474
140,90,-120,343,333,676,1379
40,90,-20,343,333,676,1379
110,70,-40,326,350,676,1467
-10,20,30,330,346,676,1238
-30,90,50,343,333,676,1379
-140,90,160,343,333,676,1379
130,90,-110,343,333,676,1379
120,90,-100,343,333,676,1379
-150,90,170,343,333,676,1379
-40,90,60,343,333,676,1379
-80,90,100,343,333,676,1379
30,90,-10,343,333,676,1379
-10,90,30,343,333,676,1379
50,90,-30,343,333,676,1379
180,50,-140,331,345,676,1420
90,90,-70,343,333,676,1379
60,90,-40,343,333,676,1379
100,90,-80,343,333,676,1379
0,90,20,343,333,676,1379
180,90,-160,343,333,676,1379
-30,80,-150,344,333,677,1387
-170,-80,-110,317,360,677,1503
-180,80,-150,343,334,677,1412
180,-80,-20,327,350,677,1511
30,60,30,324,353,677,1487
60,10,-160,312,365,677,1437
150,30,-150,325,352,677,1394
170,60,20,334,343,677,1460
180,80,-150,343,334,677,1412
0,-40,130,338,339,677,1395
-180,-80,-20,327,350,677,1511
150,-20,30,328,349,677,1402
60,70,20,325,352,677,1481
0,30,20,332,345,677,1296
0,-80,70,324,354,678,1412
-60,-80,130,340,338,678,1418
20,-80,100,321,357,678,1437
-60,-80,-20,329,349,678,1410
-180,-30,-20,343,335,678,1422
-130,-80,50,330,348,678,1456
10,-50,150,329,349,678,1482
0,-10,10,328,350,678,1468
110,-40,80,327,351,678,1376
-160,-60,30,347,331,678,1434
180,40,-120,321,357,678,1385
-180,40,-120,321,357,678,1385
0,10,90,321,357,678,1441
180,-30,-20,343,335,678,1422
150,80,50,340,338,678,1455
100,80,40,339,339,678,1371
90,10,180,311,368,679,1407
0,-60,160,327,352,679,1441
-170,-40,0,346,333,679,1394
170,-60,-40,325,354,679,1385
10,50,30,320,359,679,1405
-10,20,50,328,351,679,1405
90,10,-180,311,368,679,1407
170,-10,-40,311,368,679,1372
-160,-80,-70,322,357,679,1416
-170,-10,-90,336,343,679,1237
130,10,80,308,371,679,1344
0,-70,100,347,333,680,1322
0,-40,100,340,340,680,1390
160,0,-160,326,354,680,1280
130,70,-70,323,357,680,1519
-170,-30,20,341,339,680,1460
-10,40,-170,350,330,680,1404
-40,80,-150,353,327,680,1425
150,0,50,332,348,680,1451
0,-80,160,331,349,680,1457
30,20,-10,329,351,680,1454
0,-30,160,338,342,680,1480
-70,-80,120,337,343,680,1429
-160,-80,10,335,345,680,1472
30,-80,170,336,344,680,1408
-10,-50,-160,357,323,680,1444
-30,-80,140,331,349,680,1449
180,40,-150,341,340,681,1355
-180,-70,-160,324,357,681,1250
0,-60,80,330,351,681,1401
160,-80,-70,329,352,681,1437
30,70,10,328,353,681,1435
-140,-80,-100,327,354,681,1392
-180,40,-150,341,340,681,1355
20,-80,170,328,353,681,1522
-170,-70,0,342,339,681,1398
180,-70,-160,324,357,681,1250
0,-20,70,330,351,681,1489
30,70,80,332,349,681,1426
110,-30,70,332,349,681,1381
70,-90,-130,335,347,682,1412
160,-90,-40,335,347,682,1412
70,10,-130,328,354,682,1411
140,-30,170,317,365,682,1344
-50,-90,110,335,347,682,1412
20,-90,180,335,347,682,1412
180,-80,-130,331,351,682,1453
140,-90,-60,335,347,682,1412
0,20,100,323,359,682,1413
120,-90,-80,335,347,682,1412
110,-90,-90,335,347,682,1412
40,60,170,344,338,682,1473
-170,-90,-10,335,347,682,1412
40,-10,-120,326,356,682,1339
-110,-90,50,335,347,682,1412
-70,-90,90,335,347,682,1412
80,-90,-120,335,347,682,1412
20,-90,-180,335,347,682,1412
-160,-80,-90,317,365,682,1491
60,70,0,323,359,682,1518
-140,-90,20,335,347,682,1412
-10,-90,150,335,347,682,1412
-130,-90,30,335,347,682,1412
-80,-90,80,335,347,682,1412
0,-90,160,335,347,682,1412
20,-80,30,335,347,682,1408
180,-90,-20,335,347,682,1412
60,-90,-140,335,347,682,1412
50,-90,-150,335,347,682,1412
170,-90,-30,335,347,682,1412
-180,-90,-20,335,347,682,1412
130,-90,-70,335,347,682,1412
-180,-80,-130,331,351,682,1453
-170,-30,0,349,333,682,1329
40,-90,-160,335,347,682,1412
10,-90,170,335,347,682,1412
-60,-90,100,335,347,682,1412
-100,-90,60,335,347,682,1412
-30,-90,130,335,347,682,1412
150,-90,-50,335,347,682,1412
90,-90,-110,335,347,682,1412
-40,-90,120,335,347,682,1412
-170,-80,-70,341,341,682,1511
-150,-90,10,335,347,682,1412
0,-50,160,332,350,682,1456
100,-90,-100,335,347,682,1412
30,-90,-170,335,347,682,1412
-20,-90,140,335,347,682,1412
-160,-90,0,335,347,682,1412
-180,-70,30,343,339,682,1432
-120,-90,40,335,347,682,1412
180,-70,30,343,339,682,1432
-90,-90,70,335,347,682,1412
50,30,-40,321,362,683,1498
-10,-70,70,329,354,683,1448
10,-50,10,330,353,683,1401
110,60,100,350,333,683,1324
100,60,-110,336,347,683,1291
70,10,-160,305,378,683,1432
20,-70,-120,343,340,683,1325
0,-80,80,320,363,683,1444
-10,-20,-180,335,349,684,1424
120,60,-10,330,354,684,1429
180,-40,-150,352,332,684,1360
170,40,0,331,353,684,1378
-30,80,-170,339,345,684,1445
-10,-20,180,335,349,684,1424
160,60,40,345,339,684,1417
10,-80,120,335,349,684,1471
140,50,-20,328,356,684,1506
-180,-40,-150,352,332,684,1360
170,60,0,339,345,684,1436
-20,70,-170,351,334,685,1437
50,70,30,328,357,685,1521
-10,-70,100,348,337,685,1417
0,-50,100,331,354,685,1486
170,50,-100,333,352,685,1373
-40,-70,150,341,344,685,1477
-10,-20,-170,338,347,685,1396
180,10,10,346,340,686,1372
180,-40,-20,343,343,686,1477
0,-30,100,329,357,686,1386
-180,10,10,346,340,686,1372
-10,30,80,339,347,686,1346
170,-20,-50,320,366,686,1469
180,-40,-70,327,359,686,1448
-180,-40,-20,343,343,686,1477
-180,-40,-70,327,359,686,1448
20,-70,140,333,353,686,1518
140,-70,150,322,364,686,1315
60,-40,-70,333,353,686,1271
-160,-70,-80,333,353,686,1432
0,-60,110,347,339,686,1364
-30,-70,10,334,352,686,1313
140,50,-40,327,359,686,1517
0,-40,160,340,347,687,1519
60,-60,50,332,355,687,1541
-180,70,-170,336,351,687,1335
150,-30,180,335,352,687,1379
180,70,-170,336,351,687,1335
150,-30,-180,335,352,687,1379
0,-20,140,331,356,687,1550
0,0,140,348,339,687,1406
0,-80,90,336,351,687,1427
-10,-80,70,327,360,687,1464
30,80,0,351,336,687,1526
70,-90,180,340,348,688,1544
170,-90,-80,340,348,688,1544
100,-30,20,328,360,688,1407
100,-90,-150,340,348,688,1544
110,-90,-140,340,348,688,1544
160,-90,-90,340,348,688,1544
50,-90,160,340,348,688,1544
-160,70,180,333,355,688,1324
-180,-90,-70,340,348,688,1544
60,-90,170,340,348,688,1544
-110,-90,0,340,348,688,1544
-160,70,-180,333,355,688,1324
-150,-90,-40,340,348,688,1544
-160,-90,-50,340,348,688,1544
10,-90,120,340,348,688,1544
-160,-50,-100,321,367,688,1505
0,-90,110,340,348,688,1544
-100,-90,10,340,348,688,1544
70,-90,-180,340,348,688,1544
-50,-90,60,340,348,688,1544
-60,-90,50,340,348,688,1544
60,-20,0,321,367,688,1416
-30,-90,80,340,348,688,1544
150,-90,-100,340,348,688,1544
20,70,-10,339,349,688,1325
-130,-90,-20,340,348,688,1544
-120,-90,-10,340,348,688,1544
-80,-90,30,340,348,688,1544
-90,-90,20,340,348,688,1544
90,-90,-160,340,348,688,1544
-10,-90,100,340,348,688,1544
-20,-90,90,340,348,688,1544
80,-90,-170,340,348,688,1544
-130,-80,-90,329,359,688,1435
-90,-80,-50,336,352,688,1454
-20,-80,60,324,364,688,1492
140,-90,-110,340,348,688,1544
120,-90,-130,340,348,688,1544
-20,80,-150,356,332,688,1424
180,-90,-70,340,348,688,1544
-70,-90,40,340,348,688,1544
130,-90,-120,340,348,688,1544
-170,-90,-60,340,348,688,1544
40,-90,150,340,348,688,1544
-40,-90,70,340,348,688,1544
-10,-80,90,347,341,688,1446
20,-90,130,340,348,688,1544
-140,-90,-30,340,348,688,1544
-80,-80,110,343,345,688,1462
-10,30,-170,347,341,688,1374
30,-90,140,340,348,688,1544
0,80,20,363,326,689,1436
-10,-10,180,344,345,689,1367
10,80,-170,356,333,689,1425
0,-10,80,341,348,689,1453
-180,-50,-60,343,346,689,1510
-10,-10,-180,344,345,689,1367
-170,-10,-80,348,341,689,1266
-10,0,170,338,351,689,1468
180,80,-170,350,339,689,1325
-130,-80,-50,333,356,689,1449
-20,-60,0,347,342,689,1415
130,70,10,343,346,689,1411
-170,-70,-80,335,354,689,1571
180,-50,-60,343,346,689,1510
-180,80,-170,350,339,689,1325
-100,-80,90,341,348,689,1448
150,30,-40,331,359,690,1552
110,-30,40,326,364,690,1413
30,-80,150,335,355,690,1479
110,-40,-10,330,360,690,1419
40,70,70,338,352,690,1459
20,10,-160,344,347,691,1389
-130,90,140,339,352,691,1260
30,90,-20,339,352,691,1260
-150,90,160,339,352,691,1260
-50,90,60,339,352,691,1260
0,90,10,339,352,691,1260
-10,-80,60,332,359,691,1457
70,-50,-60,336,355,691,1358
-180,90,-170,339,352,691,1260
80,90,-70,339,352,691,1260
-120,90,130,339,352,691,1260
40,-40,20,337,354,691,1566
-110,90,120,339,352,691,1260
-170,90,-180,339,352,691,1260
50,90,-40,339,352,691,1260
-20,-50,180,361,330,691,1451
60,90,-50,339,352,691,1260
-10,90,20,339,352,691,1260
-80,90,90,339,352,691,1260
-20,-50,-180,361,330,691,1451
-160,-80,-60,341,350,691,1556
0,40,60,338,353,691,1442
180,90,-170,339,352,691,1260
140,90,-130,339,352,691,1260
170,60,-120,321,370,691,1365
100,90,-90,339,352,691,1260
-70,90,80,339,352,691,1260
-30,-70,170,349,342,691,1529
-60,90,70,339,352,691,1260
10,90,0,339,352,691,1260
-40,90,50,339,352,691,1260
150,90,-140,339,352,691,1260
-130,-80,70,349,342,691,1427
70,90,-60,339,352,691,1260
40,90,-30,339,352,691,1260
170,90,-160,339,352,691,1260
30,-30,-110,342,349,691,1295
-30,90,40,339,352,691,1260
130,90,-120,339,352,691,1260
-90,90,100,339,352,691,1260
-140,90,150,339,352,691,1260
-100,90,110,339,352,691,1260
10,70,-170,369,322,691,1481
-180,-60,-20,331,360,691,1478
110,90,-100,339,352,691,1260
160,90,-150,339,352,691,1260
180,-60,-20,331,360,691,1478
120,90,-110,339,352,691,1260
170,-20,30,349,342,691,1350
-170,90,180,339,352,691,1260
20,90,-10,339,352,691,1260
90,90,-80,339,352,691,1260
-20,90,30,339,352,691,1260
-160,90,170,339,352,691,1260
60,70,50,322,370,692,1470
-10,30,70,341,351,692,1384
170,50,0,337,355,692,1378
-70,-80,-30,335,357,692,1436
100,-30,30,331,361,692,1398
0,-60,10,338,354,692,1586
120,0,100,329,363,692,1484
-160,-60,-100,329,363,692,1374
110,0,140,325,367,692,1426
-160,-70,-130,334,358,692,1328
50,-60,40,333,359,692,1590
10,60,-170,360,332,692,1391
100,-50,80,337,355,692,1448
90,70,0,329,363,692,1473
-170,30,-110,343,350,693,1346
-180,-60,30,339,354,693,1372
140,50,-30,326,367,693,1517
0,10,140,343,350,693,1461
130,-20,50,331,362,693,1378
-60,-80,140,351,342,693,1387
130,-50,140,319,374,693,1429
180,-60,30,339,354,693,1372
0,-50,120,361,332,693,1440
140,20,70,343,350,693,1442
160,70,-110,319,374,693,1401
180,-70,-80,342,351,693,1518
-180,40,-100,338,355,693,1339
-10,20,80,344,349,693,1442
180,40,-130,328,365,693,1471
-80,-80,-40,340,353,693,1451
-10,-10,-170,348,345,693,1404
180,40,-100,338,355,693,1339
-180,40,-130,328,365,693,1471
-180,-70,-80,342,351,693,1518
-150,-80,-80,318,375,693,1476
-10,-90,50,320,374,694,1427
100,-90,160,320,374,694,1427
160,-90,-140,320,374,694,1427
-30,-90,30,320,374,694,1427
110,-90,170,320,374,694,1427
-120,-90,-60,320,374,694,1427
140,30,70,344,350,694,1458
150,-90,-150,320,374,694,1427
20,-90,80,320,374,694,1427
50,70,50,345,349,694,1440
40,-90,100,320,374,694,1427
70,70,20,330,364,694,1588
-170,-90,-110,320,374,694,1427
-50,-90,10,320,374,694,1427
-10,-70,90,355,339,694,1363
90,-90,150,320,374,694,1427
0,-90,60,320,374,694,1427
-170,-40,-120,331,363,694,1496
130,-90,-170,320,374,694,1427
170,-90,-130,320,374,694,1427
80,-90,140,320,374,694,1427
-10,-80,50,339,355,694,1482
60,70,10,325,369,694,1461
180,-90,-120,320,374,694,1427
-100,-90,-40,320,374,694,1427
10,-90,70,320,374,694,1427
-20,-80,70,339,355,694,1463
60,-90,120,320,374,694,1427
-110,-90,-50,320,374,694,1427
-40,-90,20,320,374,694,1427
140,-90,-160,320,374,694,1427
30,-90,90,320,374,694,1427
120,-90,180,320,374,694,1427
-60,-90,0,320,374,694,1427
-160,-90,-100,320,374,694,1427
70,-90,130,320,374,694,1427
120,-90,-180,320,374,694,1427
-20,-90,40,320,374,694,1427
-10,-60,160,351,343,694,1499
-180,-90,-120,320,374,694,1427
-80,-90,-20,320,374,694,1427
-150,-90,-90,320,374,694,1427
-90,-90,-30,320,374,694,1427
70,-60,60,337,357,694,1543
-30,-80,20,335,359,694,1463
-70,-90,-10,320,374,694,1427
-130,-90,-70,320,374,694,1427
50,-90,110,320,374,694,1427
20,70,90,347,347,694,1441
-140,-90,-80,320,374,694,1427
160,70,40,354,341,695,1449
160,80,40,349,346,695,1456
150,80,0,342,353,695,1460
-180,70,10,349,346,695,1474
180,70,10,349,346,695,1474
100,-30,10,317,378,695,1466
120,60,0,328,367,695,1422
0,-30,110,345,350,695,1449
-20,80,170,336,359,695,1458
-10,-70,60,337,358,695,1526
80,70,10,329,367,696,1552
0,-40,70,351,345,696,1504
-150,80,-40,356,340,696,1474
30,50,-20,324,372,696,1341
-10,10,-180,343,353,696,1399
0,-10,140,341,355,696,1503
0,-30,70,341,355,696,1519
-30,-60,170,358,338,696,1498
-170,-50,-120,330,366,696,1499
-10,10,180,343,353,696,1399
0,-50,80,329,368,697,1387
-180,10,-150,343,354,697,1267
60,20,-80,328,369,697,1503
40,80,90,347,350,697,1415
-10,20,40,340,357,697,1498
160,0,40,332,365,697,1468
-120,-80,-100,335,362,697,1237
-150,-70,30,344,353,697,1460
180,10,-150,343,354,697,1267
-150,-80,-60,333,364,697,1453
-90,-80,100,347,351,698,1476
-120,-80,-80,342,356,698,1379
-30,-80,50,326,372,698,1511
110,-60,110,340,358,698,1506
-170,20,-110,342,356,698,1313
10,80,0,351,347,698,1333
-180,30,-90,347,351,698,1368
-10,-80,80,342,356,698,1452
-20,-60,160,358,340,698,1483
0,80,140,336,362,698,1432
180,30,-90,347,351,698,1368
-20,-80,80,352,346,698,1489
40,70,60,340,358,698,1469
-170,70,-160,346,352,698,1424
-180,70,-10,350,349,699,1423
180,70,-10,350,349,699,1423
-160,-80,-100,325,374,699,1544
-170,-60,0,351,348,699,1402
40,70,40,334,365,699,1542
20,-70,150,326,373,699,1502
0,-10,110,343,356,699,1595
90,70,30,334,365,699,1457
150,70,-90,330,369,699,1488
-70,-80,-50,340,359,699,1274
-150,80,-30,355,344,699,1443
-140,-80,-70,327,372,699,1476
-10,-10,60,335,365,700,1468
30,70,70,346,354,700,1469
160,40,-10,344,356,700,1458
-10,30,90,356,344,700,1470
-180,-40,-60,338,362,700,1460
180,-40,-60,338,362,700,1460
-10,-10,170,351,349,700,1511
140,70,-80,325,375,700,1505
-10,-60,90,347,353,700,1451
0,-20,120,342,358,700,1468
-70,-80,110,363,337,700,1501
-170,-80,40,362,338,700,1521
0,0,130,345,355,700,1538
-150,80,170,349,351,700,1416
-10,70,-160,368,333,701,1416
30,-80,160,345,356,701,1485
60,70,30,337,364,701,1492
120,-10,100,337,364,701,1460
90,60,-100,343,358,701,1352
-180,50,-160,331,370,701,1312
-40,80,-140,355,346,701,1449
170,-80,-70,338,363,701,1540
130,60,-40,334,367,701,1488
180,50,-160,331,370,701,1312
50,10,-30,319,382,701,1455
170,20,30,339,362,701,1351
150,40,-30,336,365,701,1524
150,40,-150,326,375,701,1353
70,70,40,340,362,702,1525
100,70,-10,333,369,702,1480
50,70,60,339,363,702,1487
140,70,-140,345,357,702,1350
-30,-80,60,340,362,702,1502
140,10,-160,344,358,702,1301
150,-10,40,332,370,702,1560
-120,-80,60,345,357,702,1490
70,-70,70,351,351,702,1542
30,80,100,355,347,702,1386
-170,10,-110,345,357,702,1362
120,60,90,352,350,702,1385
110,80,30,350,352,702,1436
-120,-80,-40,342,360,702,1491
90,-30,10,332,371,703,1414
-170,80,-30,347,356,703,1447
80,-60,70,337,366,703,1511
-100,-80,-60,346,357,703,1456
-170,-20,-70,336,367,703,1411
100,-40,-20,328,375,703,1417
-180,0,-70,340,363,703,1489
-170,-10,-100,346,357,703,1369
-170,80,-160,355,348,703,1488
-10,50,100,351,352,703,1380
180,0,-70,340,363,703,1489
0,0,90,337,366,703,1520
-10,-70,80,335,368,703,1481
50,-50,30,344,359,703,1568
-10,30,160,343,360,703,1437
10,-60,150,347,356,703,1529
100,-60,-30,342,361,703,1338
-10,-50,160,346,358,704,1465
-90,90,-120,337,367,704,1460
-80,90,-130,337,367,704,1460
30,-90,100,334,370,704,1601
-110,90,-100,337,367,704,1460
130,-90,-160,334,370,704,1601
10,90,140,337,367,704,1460
70,90,80,337,367,704,1460
180,-70,-20,338,366,704,1493
100,-90,170,334,370,704,1601
50,-90,120,334,370,704,1601
80,90,70,337,367,704,1460
-60,-90,10,334,370,704,1601
120,-90,-170,334,370,704,1601
-170,-90,-100,334,370,704,1601
-130,-90,-60,334,370,704,1601
140,-90,-150,334,370,704,1601
110,-90,180,334,370,704,1601
110,-90,-180,334,370,704,1601
-90,-90,-20,334,370,704,1601
180,90,-30,337,367,704,1460
-120,90,-90,337,367,704,1460
40,-90,110,334,370,704,1601
-10,90,160,337,367,704,1460
-30,-90,40,334,370,704,1601
20,-90,90,334,370,704,1601
-50,90,-160,337,367,704,1460
-100,-90,-30,334,370,704,1601
-140,90,-70,337,367,704,1460
90,90,60,337,367,704,1460
0,-40,80,340,364,704,1540
-20,-90,50,334,370,704,1601
80,-90,150,334,370,704,1601
-160,-90,-90,334,370,704,1601
-140,-70,-70,341,363,704,1503
120,90,30,337,367,704,1460
130,90,20,337,367,704,1460
20,90,130,337,367,704,1460
30,90,120,337,367,704,1460
0,-90,70,334,370,704,1601
-30,90,180,337,367,704,1460
100,90,50,337,367,704,1460
-40,90,-170,337,367,704,1460
110,90,40,337,367,704,1460
-150,90,-60,337,367,704,1460
160,90,-10,337,367,704,1460
0,90,150,337,367,704,1460
70,-90,140,334,370,704,1601
10,-70,130,344,360,704,1561
-80,-90,-10,334,370,704,1601
30,-30,10,338,366,704,1667
160,-80,-60,343,361,704,1484
140,90,10,337,367,704,1460
-120,-90,-50,334,370,704,1601
170,90,-20,337,367,704,1460
-50,-90,20,334,370,704,1601
160,-90,-130,334,370,704,1601
-140,-90,-70,334,370,704,1601
-40,-80,40,325,379,704,1520
-60,90,-150,337,367,704,1460
-180,-90,-110,334,370,704,1601
60,-90,130,334,370,704,1601
-130,90,-80,337,367,704,1460
-40,-80,130,334,370,704,1528
-150,-80,20,348,356,704,1548
0,-20,100,354,350,704,1613
-160,90,-50,337,367,704,1460
-180,90,-30,337,367,704,1460
-170,90,-40,337,367,704,1460
60,90,90,337,367,704,1460
-70,-90,0,334,370,704,1601
-20,90,170,337,367,704,1460
50,90,100,337,367,704,1460
-110,-90,-40,334,370,704,1601
150,90,0,337,367,704,1460
150,-90,-140,334,370,704,1601
180,-90,-110,334,370,704,1601
170,-90,-120,334,370,704,1601
90,-90,160,334,370,704,1601
-40,-90,30,334,370,704,1601
-30,90,-180,337,367,704,1460
170,0,-20,351,353,704,1414
10,-90,80,334,370,704,1601
-100,90,-110,337,367,704,1460
-70,90,-140,337,367,704,1460
-10,-90,60,334,370,704,1601
-150,-90,-80,334,370,704,1601
40,90,110,337,367,704,1460
-180,-70,-20,338,366,704,1493
0,30,110,330,374,704,1461
0,10,130,359,346,705,1423
20,-80,140,345,360,705,1527
110,70,-30,330,375,705,1500
-10,-60,110,351,354,705,1547
-10,-60,-160,364,341,705,1530
0,0,10,345,360,705,1516
90,-30,20,343,362,705,1462
-120,-80,80,354,351,705,1455
0,-60,120,341,364,705,1554
0,40,30,339,367,706,1505
-30,-80,-180,354,352,706,1414
100,50,-120,347,359,706,1308
-20,-50,-170,359,347,706,1529
50,70,40,340,366,706,1441
-30,-80,180,354,352,706,1414
150,-80,160,325,381,706,1335
170,-80,-40,341,365,706,1487
150,40,-50,329,377,706,1520
0,-80,110,341,365,706,1533
60,30,170,356,350,706,1493
-180,-10,-10,344,362,706,1407
130,60,-30,331,375,706,1514
60,70,40,346,360,706,1458
40,40,-30,321,385,706,1412
-10,-80,150,348,358,706,1552
180,-10,-10,344,362,706,1407
-170,-30,-110,331,376,707,1550
150,-70,10,358,349,707,1408
-130,-80,-60,338,369,707,1525
120,30,100,341,366,707,1406
-180,-70,-70,350,357,707,1537
180,-70,-70,350,357,707,1537
-180,-80,-70,350,358,708,1566
-170,80,0,355,353,708,1443
180,-80,-70,350,358,708,1566
180,-10,-150,338,370,708,1355
-150,-80,-50,354,354,708,1540
10,70,100,342,366,708,1492
110,70,-20,342,366,708,1482
-180,-10,-150,338,370,708,1355
160,50,-80,338,370,708,1569
150,70,0,362,346,708,1437
170,-70,-50,344,364,708,1537
-160,-70,-100,336,372,708,1467
-170,40,-130,333,375,708,1535
10,-70,-130,354,354,708,1416
50,-80,-90,364,344,708,1466
120,20,-150,345,363,708,1396
0,40,140,349,359,708,1544
-180,50,-120,331,378,709,1407
-180,-70,-50,352,357,709,1522
0,-40,90,344,365,709,1370
180,-70,-50,352,357,709,1522
70,50,-80,338,371,709,1333
170,-80,-60,349,360,709,1557
180,50,-120,331,378,709,1407
90,-60,-40,354,355,709,1382
60,-70,60,361,348,709,1545
90,-70,90,347,362,709,1540
-120,-80,-50,347,362,709,1579
20,60,30,343,366,709,1529
10,70,110,338,371,709,1387
-110,-80,-30,343,366,709,1520
-20,-70,60,345,364,709,1479
-10,-30,170,356,354,710,1505
50,80,80,354,356,710,1444
40,-80,-100,360,350,710,1484
60,80,70,351,359,710,1498
-10,-60,50,354,356,710,1483
-170,-80,-10,345,365,710,1567
110,10,130,333,377,710,1350
120,-20,80,332,378,710,1433
120,-30,90,357,353,710,1442
0,40,110,346,364,710,1552
160,70,-100,334,376,710,1515
-170,70,-10,359,352,711,1459
140,10,70,340,371,711,1357
40,70,10,342,369,711,1556
-10,-60,80,342,369,711,1583
70,-40,30,329,382,711,1535
0,0,120,345,366,711,1493
170,60,-160,362,349,711,1346
90,-40,40,324,387,711,1528
20,90,-180,368,344,712,1507
-140,90,-20,368,344,712,1507
150,90,50,368,344,712,1507
30,90,170,368,344,712,1507
130,90,70,368,344,712,1507
-100,90,-60,368,344,712,1507
140,90,60,368,344,712,1507
-30,90,-130,368,344,712,1507
60,90,140,368,344,712,1507
-40,90,-120,368,344,712,1507
100,90,100,368,344,712,1507
70,90,130,368,344,712,1507
10,90,-170,368,344,712,1507
-90,90,-70,368,344,712,1507
160,90,40,368,344,712,1507
-10,40,160,343,369,712,1461
180,90,20,368,344,712,1507
110,90,90,368,344,712,1507
80,90,120,368,344,712,1507
40,90,160,368,344,712,1507
-20,-70,40,348,364,712,1522
90,90,110,368,344,712,1507
-50,80,-140,370,342,712,1487
-160,90,0,368,344,712,1507
-180,90,20,368,344,712,1507
-40,-80,50,346,366,712,1531
-60,90,-100,368,344,712,1507
50,90,150,368,344,712,1507
-130,90,-30,368,344,712,1507
-170,90,10,368,344,712,1507
-70,90,-90,368,344,712,1507
-10,90,-150,368,344,712,1507
170,90,30,368,344,712,1507
120,90,80,368,344,712,1507
0,90,-160,368,344,712,1507
-50,90,-110,368,344,712,1507
-150,90,-10,368,344,712,1507
-20,90,-140,368,344,712,1507
-80,90,-80,368,344,712,1507
-20,60,-170,357,355,712,1473
-120,90,-40,368,344,712,1507
20,90,180,368,344,712,1507
-110,90,-50,368,344,712,1507
-140,-70,50,352,360,712,1475
140,80,-100,345,368,713,1444
-110,-80,90,355,358,713,1438
-180,-70,-60,350,363,713,1557
60,20,-90,331,382,713,1400
-170,-30,-120,328,385,713,1594
150,-50,170,341,372,713,1491
120,70,-50,337,376,713,1554
-170,-80,-120,342,371,713,1524
-180,50,-110,345,368,713,1387
130,0,80,336,377,713,1477
0,80,-160,368,345,713,1461
-150,-70,50,363,350,713,1562
180,50,-110,345,368,713,1387
180,-70,-60,350,363,713,1557
10,-80,20,350,363,713,1458
60,70,-60,349,364,713,1357
-170,-20,-120,343,371,714,1588
10,-70,150,360,354,714,1517
-180,20,-150,345,369,714,1317
50,-10,-90,348,366,714,1481
20,-80,150,350,364,714,1573
-140,-80,-40,357,357,714,1538
70,-20,-10,328,386,714,1544
180,0,0,368,346,714,1445
-70,-80,130,356,358,714,1427
-10,20,170,361,353,714,1407
10,-60,130,354,360,714,1591
-30,-80,70,361,353,714,1563
-150,-80,-90,336,378,714,1609
-170,-40,-130,355,359,714,1555
160,60,-90,337,377,714,1598
170,70,-10,352,362,714,1471
40,0,-10,336,378,714,1502
180,20,-150,345,369,714,1317
130,60,0,341,373,714,1522
-110,-80,-70,345,369,714,1421
-180,0,0,368,346,714,1445
-170,-20,-90,348,367,715,1439
-40,80,-160,353,362,715,1527
-180,-60,-50,340,375,715,1507
20,80,10,366,349,715,1594
180,-60,-50,340,375,715,1507
10,70,20,351,364,715,1523
-20,-80,50,343,372,715,1502
80,-70,80,352,363,715,1569
20,60,40,350,365,715,1564
150,80,-110,346,369,715,1421
-20,-40,30,365,350,715,1573
-20,-10,20,344,372,716,1433
30,-10,0,333,383,716,1568
50,70,20,336,380,716,1506
-170,-40,-90,347,369,716,1455
40,70,30,340,376,716,1483
0,60,110,351,365,716,1424
30,70,50,338,378,716,1537
-100,-80,100,355,361,716,1436
20,-90,30,338,379,717,1348
150,-90,160,338,379,717,1348
180,-90,-170,338,379,717,1348
-120,-90,-110,338,379,717,1348
50,-90,60,338,379,717,1348
-50,-90,-40,338,379,717,1348
-170,80,-180,360,357,717,1404
170,60,-110,343,374,717,1516
-60,-80,20,338,379,717,1530
60,-90,70,338,379,717,1348
-170,-90,-160,338,379,717,1348
-30,-90,-20,338,379,717,1348
80,-90,90,338,379,717,1348
170,-90,-180,338,379,717,1348
-90,-90,-80,338,379,717,1348
-150,-90,-140,338,379,717,1348
90,-90,100,338,379,717,1348
130,80,-90,339,378,717,1477
180,-50,30,355,362,717,1413
-70,-90,-60,338,379,717,1348
-60,-90,-50,338,379,717,1348
-170,80,180,360,357,717,1404
160,-90,170,338,379,717,1348
140,-90,150,338,379,717,1348
-10,-60,70,352,365,717,1527
-100,-90,-90,338,379,717,1348
120,-90,130,338,379,717,1348
30,-90,40,338,379,717,1348
-180,-50,30,355,362,717,1413
-90,-80,110,349,368,717,1467
-160,-90,-150,338,379,717,1348
-130,-90,-120,338,379,717,1348
70,-90,80,338,379,717,1348
-50,-80,30,334,383,717,1541
-10,-90,0,338,379,717,1348
-180,-90,-170,338,379,717,1348
0,-90,10,338,379,717,1348
100,-90,110,338,379,717,1348
-170,-30,-130,339,378,717,1499
-20,-90,-10,338,379,717,1348
-140,-90,-130,338,379,717,1348
170,-90,180,338,379,717,1348
-20,-70,70,346,371,717,1509
-80,-90,-70,338,379,717,1348
110,-90,120,338,379,717,1348
10,-90,20,338,379,717,1348
-40,-90,-30,338,379,717,1348
-110,-90,-100,338,379,717,1348
130,-90,140,338,379,717,1348
40,-90,50,338,379,717,1348
20,70,80,351,367,718,1551
60,-80,-80,363,355,718,1436
80,70,30,345,373,718,1553
40,70,50,352,366,718,1423
140,40,70,349,369,718,1401
110,80,-70,346,372,718,1562
-20,60,180,357,362,719,1476
20,40,-170,362,357,719,1514
-20,60,-180,357,362,719,1476
40,-30,10,342,377,719,1560
-20,-70,80,373,346,719,1472
160,20,-30,352,367,719,1581
160,-50,20,358,361,719,1318
40,40,180,360,359,719,1502
-80,-80,100,366,353,719,1544
30,70,60,350,369,719,1410
40,40,-180,360,359,719,1502
-30,80,-140,373,346,719,1490
180,-70,-30,343,376,719,1559
0,-10,130,344,375,719,1507
-160,-50,30,367,352,719,1462
10,-80,160,352,367,719,1612
-180,-70,-30,343,376,719,1559
-80,-80,-60,355,364,719,1323
-160,-60,-120,333,387,720,1535
60,50,160,355,365,720,1429
-170,60,-160,347,373,720,1472
150,40,-40,341,379,720,1619
100,-40,60,352,368,720,1609
-10,0,70,348,372,720,1492
-20,-50,170,371,349,720,1519
70,80,-30,349,371,720,1629
140,0,60,350,370,720,1488
-160,-80,50,369,351,720,1569
160,60,0,349,372,721,1503
-10,-80,100,350,371,721,1590
50,-30,10,348,373,721,1577
70,70,30,341,380,721,1513
120,-20,100,349,372,721,1526
-10,20,90,359,362,721,1487
10,-60,-130,365,356,721,1430
-10,-60,100,364,357,721,1406
-180,20,-80,338,383,721,1444
-140,80,160,360,361,721,1497
0,30,120,342,379,721,1430
-30,-60,160,377,344,721,1472
90,30,140,333,388,721,1370
110,60,-120,356,365,721,1395
160,20,-40,348,373,721,1589
180,20,-80,338,383,721,1444
170,40,30,352,369,721,1487
20,60,50,347,374,721,1503
110,40,110,338,384,722,1434
-110,-80,70,358,364,722,1560
70,80,60,360,362,722,1538
-30,-80,30,349,373,722,1578
-10,80,30,376,346,722,1541
-20,-20,40,347,375,722,1509
170,30,-70,351,371,722,1469
-10,-20,10,371,351,722,1502
-160,-40,-90,359,363,722,1594
0,10,100,341,381,722,1533
-180,-80,-60,353,370,723,1599
100,80,-60,352,371,723,1606
-100,-80,-20,346,377,723,1536
0,60,90,359,364,723,1475
170,50,30,363,360,723,1474
-140,80,-40,362,361,723,1477
20,-60,20,363,360,723,1524
-30,-70,60,362,361,723,1618
70,10,-140,341,382,723,1544
-100,-80,-80,341,382,723,1320
180,-80,-60,353,370,723,1599
160,80,-120,357,366,723,1450
0,50,110,360,363,723,1546
30,-80,-110,371,352,723,1487
120,-20,140,350,373,723,1528
-160,80,-170,368,356,724,1558
50,-20,0,343,381,724,1552
-130,-80,-30,364,360,724,1588
20,60,-10,338,386,724,1361
150,50,-10,346,378,724,1541
120,80,-80,341,383,724,1506
10,70,0,347,377,724,1381
180,-30,30,364,360,724,1333
-20,-80,40,351,373,724,1552
-180,-30,30,364,360,724,1333
0,60,130,354,370,724,1355
-20,-30,180,368,356,724,1458
10,-70,20,363,361,724,1636
0,-40,140,351,373,724,1516
-20,-70,50,354,370,724,1600
-10,70,150,356,368,724,1412
20,-80,160,361,363,724,1510
-20,70,-160,374,350,724,1448
-20,-30,-180,368,356,724,1458
170,30,-10,351,373,724,1408
-10,-90,110,358,367,725,1537
-40,-90,80,358,367,725,1537
-180,-90,-60,358,367,725,1537
-80,-90,40,358,367,725,1537
0,-90,120,358,367,725,1537
-40,-80,30,349,376,725,1549
180,10,20,358,367,725,1528
100,-90,-140,358,367,725,1537
-60,-90,60,358,367,725,1537
-140,-90,-20,358,367,725,1537
50,-90,170,358,367,725,1537
60,-90,180,358,367,725,1537
-120,-90,0,358,367,725,1537
10,-80,130,355,370,725,1580
-30,-90,90,358,367,725,1537
80,-90,-160,358,367,725,1537
-110,-90,10,358,367,725,1537
-100,-90,20,358,367,725,1537
10,-90,130,358,367,725,1537
-180,10,20,358,367,725,1528
160,-90,-80,358,367,725,1537
-50,-90,70,358,367,725,1537
60,-90,-180,358,367,725,1537
40,-90,160,358,367,725,1537
-20,-90,100,358,367,725,1537
80,70,20,349,376,725,1565
130,-90,-110,358,367,725,1537
-170,-90,-50,358,367,725,1537
-110,-80,-90,342,383,725,1288
70,-90,-170,358,367,725,1537
-50,80,-130,372,353,725,1508
-150,-90,-30,358,367,725,1537
-70,-90,50,358,367,725,1537
170,-90,-70,358,367,725,1537
-90,-90,30,358,367,725,1537
-160,-90,-40,358,367,725,1537
150,-90,-90,358,367,725,1537
20,-90,140,358,367,725,1537
-140,80,-50,376,349,725,1508
140,-90,-100,358,367,725,1537
90,-90,-150,358,367,725,1537
180,-90,-60,358,367,725,1537
0,50,130,352,373,725,1451
110,-90,-130,358,367,725,1537
50,0,-110,368,357,725,1426
30,-90,150,358,367,725,1537
-130,-90,-10,358,367,725,1537
120,-90,-120,358,367,725,1537
-180,-20,-20,356,370,726,1513
-30,80,-180,358,368,726,1547
180,10,-70,347,379,726,1493
-10,-30,50,354,372,726,1586
-30,80,180,358,368,726,1547
-180,10,-70,347,379,726,1493
50,70,10,345,381,726,1606
0,20,130,361,365,726,1465
180,-20,-20,356,370,726,1513
20,10,0,336,390,726,1519
-10,10,70,354,372,726,1459
-160,80,-10,373,353,726,1453
0,-20,130,359,367,726,1569
120,-20,130,333,393,726,1352
20,80,110,358,369,727,1439
90,-60,80,352,375,727,1605
-140,-80,-50,356,371,727,1516
140,60,-60,337,390,727,1626
0,-70,120,362,365,727,1610
-160,-50,-110,349,378,727,1470
-40,-70,160,368,359,727,1586
70,40,-90,341,386,727,1424
10,60,70,348,379,727,1473
-40,-80,10,357,370,727,1518
-50,-80,40,361,366,727,1549
100,-70,100,357,370,727,1555
-110,-80,-40,357,370,727,1621
-80,-80,120,353,374,727,1449
50,-10,-10,336,392,728,1538
130,80,-80,346,382,728,1588
-180,80,20,376,352,728,1474
-20,50,-170,375,353,728,1473
90,-30,-10,335,393,728,1466
-140,-80,30,361,367,728,1616
-20,30,90,365,363,728,1590
50,-70,50,368,360,728,1599
-40,-70,-10,370,358,728,1393
-170,20,-100,359,369,728,1403
-10,-60,60,357,371,728,1536
-30,-80,40,346,382,728,1536
180,80,20,376,352,728,1474
-180,60,0,354,375,729,1508
10,50,50,339,390,729,1483
180,60,0,354,375,729,1508
0,-30,90,348,381,729,1624
-10,10,170,362,367,729,1492
-180,40,10,362,367,729,1593
-160,-80,-110,351,378,729,1564
180,40,10,362,367,729,1593
-10,-10,70,359,370,729,1533
-20,-40,-180,370,359,729,1518
-20,-40,180,370,359,729,1518
-10,10,80,364,365,729,1497
140,60,0,355,374,729,1600
-180,70,-140,343,387,730,1483
-170,-50,0,360,370,730,1502
180,70,-140,343,387,730,1483
-140,-80,-80,353,377,730,1664
-40,-80,60,370,360,730,1592
60,80,-20,357,373,730,1626
80,80,-40,353,377,730,1637
70,-30,-50,357,374,731,1461
-50,-80,50,372,359,731,1572
-80,-80,0,349,382,731,1553
50,0,-120,356,375,731,1489
180,60,10,356,375,731,1608
-180,60,10,356,375,731,1608
-20,-70,90,371,360,731,1545
130,-50,0,352,379,731,1522
-180,10,0,367,364,731,1426
-170,-60,-80,356,375,731,1634
0,50,20,355,376,731,1544
170,80,-130,362,369,731,1519
180,10,0,367,364,731,1426
20,-80,-120,378,353,731,1526
0,-30,80,354,378,732,1628
20,50,-10,348,384,732,1467
-70,-80,10,349,383,732,1557
120,80,20,368,364,732,1519
-10,-50,110,375,357,732,1478
-10,40,80,358,374,732,1517
170,-10,-50,342,390,732,1392
-30,70,-160,375,357,732,1569
-70,-80,30,375,357,732,1613
120,70,-40,344,388,732,1605
-50,-80,20,354,378,732,1549
50,50,-50,341,391,732,1490
30,60,-180,364,368,732,1593
-50,-80,120,350,382,732,1567
-60,-80,40,372,360,732,1592
50,80,-10,348,384,732,1613
170,80,30,371,361,732,1493
170,70,30,360,372,732,1503
30,60,180,364,368,732,1593
50,-40,20,349,383,732,1720
180,-50,-40,343,390,733,1666
0,-20,80,357,376,733,1554
-180,-50,-40,343,390,733,1666
-170,-80,-60,354,379,733,1662
-180,-20,-60,360,373,733,1626
-90,-80,-10,352,381,733,1540
170,30,30,367,366,733,1415
-170,-40,30,367,366,733,1496
180,-40,-50,345,388,733,1518
-170,-70,-70,362,371,733,1671
180,-20,-60,360,373,733,1626
-20,50,-180,372,361,733,1448
-30,-70,-10,367,366,733,1457
60,0,-60,347,386,733,1522
-180,-40,-50,345,388,733,1518
-110,-80,-20,358,375,733,1612
-170,0,-110,357,376,733,1487
-160,-70,-110,353,380,733,1585
-20,50,180,372,361,733,1448
-170,-20,-110,350,383,733,1512
-170,-10,-110,357,376,733,1547
80,-40,30,353,381,734,1626
-20,-60,80,365,369,734,1640
170,60,30,365,369,734,1505
-180,60,-140,362,372,734,1500
-170,60,-170,375,359,734,1450
-150,-60,-80,362,372,734,1558
160,80,-10,362,372,734,1537
-90,-80,-70,356,378,734,1351
-180,-80,-50,365,369,734,1639
80,-80,-60,370,364,734,1473
10,-60,140,365,369,734,1657
90,80,-50,360,374,734,1619
180,-80,-30,358,376,734,1596
-130,-80,-40,361,373,734,1550
0,20,110,349,385,734,1502
-180,-80,-30,358,376,734,1596
180,60,-140,362,372,734,1500
180,-80,-50,365,369,734,1639
-100,-80,80,368,367,735,1563
-180,50,10,366,369,735,1577
50,20,-170,358,377,735,1554
-80,-80,20,375,360,735,1655
-170,30,-130,334,401,735,1534
-50,-70,140,373,362,735,1577
-60,-80,30,365,370,735,1599
110,-30,30,348,387,735,1579
-150,-70,-90,342,393,735,1564
-170,-20,-80,358,377,735,1324
-170,-70,40,371,364,735,1544
120,-30,20,342,393,735,1493
-20,-80,90,355,380,735,1638
60,-30,10,370,365,735,1623
0,-10,90,349,386,735,1620
-20,-10,40,373,362,735,1510
180,50,10,366,369,735,1577
180,-60,-160,356,380,736,1458
80,80,50,369,367,736,1601
-120,-80,-30,363,373,736,1581
-150,-60,-90,353,383,736,1516
-180,-50,-50,351,385,736,1606
180,-50,-50,351,385,736,1606
-180,-60,-160,356,380,736,1458
-60,80,-120,378,358,736,1521
-130,80,-50,370,366,736,1505
-10,-50,100,366,370,736,1506
0,0,100,345,391,736,1667
-160,-50,-90,357,380,737,1629
-160,-60,20,369,368,737,1527
0,-70,-140,367,370,737,1522
-170,-20,-100,350,387,737,1552
-170,10,-130,348,389,737,1550
-30,70,-170,381,356,737,1577
-10,-70,150,365,372,737,1685
170,70,-120,343,394,737,1528
-20,-70,-170,369,368,737,1602
-60,-80,10,353,384,737,1586
-100,-80,-30,359,378,737,1608
-160,80,-40,364,373,737,1511
-20,70,170,368,369,737,1507
10,-50,-130,369,369,738,1516
90,-80,-50,367,371,738,1479
-100,-80,0,367,371,738,1661
150,50,-60,348,390,738,1576
0,-80,120,357,381,738,1620
-90,-80,10,373,365,738,1654
-20,-70,150,359,379,738,1584
20,70,20,349,389,738,1612
-160,-40,-110,351,387,738,1555
-40,80,-130,385,353,738,1569
-30,-70,20,360,379,739,1522
110,10,-170,343,396,739,1561
120,80,-70,355,384,739,1634
-80,-80,-10,362,377,739,1577
100,40,120,357,382,739,1520
-10,0,80,365,374,739,1500
-20,-60,-170,379,360,739,1592
-100,-80,-10,357,382,739,1617
180,30,-150,359,381,740,1350
110,-30,20,348,392,740,1527
120,70,-30,350,390,740,1562
-90,-80,-20,362,378,740,1596
-170,-50,-80,361,379,740,1508
-90,-80,90,373,367,740,1567
100,70,20,355,385,740,1597
-180,30,-150,359,381,740,1350
-160,-70,10,371,369,740,1539
90,70,20,358,382,740,1583
40,80,0,352,388,740,1627
-170,-70,-50,365,375,740,1627
-70,80,-110,378,362,740,1533
-110,-80,-10,367,373,740,1652
10,70,90,366,374,740,1577
-40,-70,0,355,386,741,1438
10,10,-160,364,377,741,1489
0,50,30,358,383,741,1589
-90,-80,0,361,380,741,1608
180,30,10,366,375,741,1597
0,80,10,375,366,741,1431
170,40,-80,345,396,741,1535
-150,80,-20,376,365,741,1490
-180,30,10,366,375,741,1597
-10,80,150,359,382,741,1509
30,70,40,347,394,741,1548
0,40,120,368,373,741,1480
110,-60,-20,360,381,741,1469
160,-70,20,373,368,741,1540
-20,-80,140,362,379,741,1623
-70,-80,0,360,381,741,1594
-80,-80,10,364,377,741,1611
110,20,-150,360,381,741,1462
-170,-30,-100,359,383,742,1497
130,50,-140,368,374,742,1409
130,60,-20,346,396,742,1590
0,-10,-160,374,368,742,1562
-150,-80,-100,354,388,742,1634
90,70,10,350,392,742,1624
-40,-80,170,370,372,742,1458
-180,-60,-40,356,386,742,1563
30,30,-170,368,374,742,1545
-160,-70,-120,360,382,742,1666
180,-60,-40,356,386,742,1563
-120,-80,-20,370,372,742,1630
80,-30,10,347,396,743,1452
70,-80,-70,378,365,743,1460
-10,80,-150,384,359,743,1496
0,70,130,349,394,743,1464
-130,-70,-60,364,379,743,1601
-170,70,0,373,370,743,1569
40,-60,30,355,388,743,1693
60,0,-40,338,405,743,1535
170,50,-90,352,391,743,1633
10,60,0,345,399,744,1500
-10,60,-160,387,357,744,1472
0,-80,10,366,378,744,1519
70,-20,-40,355,389,744,1587
0,30,130,370,374,744,1590
10,-40,-130,372,372,744,1532
110,0,170,358,386,744,1509
-20,-50,0,369,375,744,1486
100,-80,-40,372,372,744,1480
-170,-20,10,374,370,744,1538
-150,-80,60,373,371,744,1627
150,-40,20,364,380,744,1585
-150,80,-180,374,370,744,1631
-10,-10,10,361,383,744,1569
140,50,70,367,377,744,1488
70,50,150,373,371,744,1529
-150,80,180,374,370,744,1631
70,10,-150,354,391,745,1652
-160,-70,-70,362,383,745,1674
0,40,130,362,383,745,1567
-10,-20,170,371,374,745,1574
70,-30,10,348,397,745,1657
-50,-80,0,363,382,745,1536
-10,-50,90,361,384,745,1662
100,70,0,357,388,745,1616
-170,-20,-130,345,400,745,1628
-20,-60,30,376,369,745,1574
-160,-80,0,367,378,745,1602
-30,-70,70,378,367,745,1578
10,50,0,362,383,745,1461
0,-60,150,368,377,745,1599
60,70,150,374,372,746,1615
-60,80,-130,386,360,746,1574
140,80,-90,355,391,746,1584
-10,50,160,368,378,746,1562
-50,-80,10,358,388,746,1690
160,-60,20,367,379,746,1413
-10,-30,130,369,377,746,1560
170,-20,-160,380,366,746,1427
170,10,-20,369,377,746,1671
-130,-80,-70,357,390,747,1680
-80,80,-100,377,370,747,1560
0,-50,-140,368,379,747,1606
-30,-80,80,358,389,747,1660
-140,-70,40,367,380,747,1564
-50,80,-150,369,378,747,1626
-170,10,-90,376,371,747,1447
-150,-70,-70,365,382,747,1541
-70,-80,20,371,376,747,1613
130,60,80,371,376,747,1492
70,70,140,384,364,748,1582
-20,-50,160,376,372,748,1571
170,-80,-50,365,383,748,1616
0,-40,150,369,379,748,1666
100,10,160,356,392,748,1581
-170,-70,-150,365,383,748,1413
-180,20,10,372,376,748,1565
10,80,20,375,373,748,1684
180,20,10,372,376,748,1565
10,-80,150,370,378,748,1587
-10,50,90,372,376,748,1503
-170,-60,-50,363,385,748,1579
40,-90,170,367,382,749,1587
0,10,110,365,384,749,1581
-100,-90,30,367,382,749,1587
-20,-90,110,367,382,749,1587
-80,-90,50,367,382,749,1587
-180,-90,-50,367,382,749,1587
-10,-90,120,367,382,749,1587
160,-90,-70,367,382,749,1587
150,60,0,367,382,749,1582
0,40,50,350,399,749,1650
170,20,-20,369,380,749,1644
-120,-90,10,367,382,749,1587
50,-90,180,367,382,749,1587
-50,-90,80,367,382,749,1587
-20,-40,170,379,370,749,1521
150,-90,-80,367,382,749,1587
10,50,40,354,395,749,1582
170,-90,-60,367,382,749,1587
0,-90,130,367,382,749,1587
70,-90,-160,367,382,749,1587
-130,80,-60,384,365,749,1588
120,-90,-110,367,382,749,1587
140,-90,-90,367,382,749,1587
-30,-90,100,367,382,749,1587
30,-90,160,367,382,749,1587
80,-90,-150,367,382,749,1587
-90,-90,40,367,382,749,1587
-110,-90,20,367,382,749,1587
130,-90,-100,367,382,749,1587
10,-90,140,367,382,749,1587
-70,-90,60,367,382,749,1587
60,-90,-170,367,382,749,1587
180,-90,-50,367,382,749,1587
-60,-90,70,367,382,749,1587
80,-50,50,369,380,749,1656
-40,-70,140,380,369,749,1491
-20,-60,90,385,364,749,1565
-170,-90,-40,367,382,749,1587
140,-60,150,350,399,749,1515
150,80,-100,360,389,749,1581
50,-90,-180,367,382,749,1587
110,-90,-120,367,382,749,1587
10,-80,140,369,380,749,1658
100,-90,-130,367,382,749,1587
-150,-90,-20,367,382,749,1587
90,-90,-140,367,382,749,1587
-40,-90,90,367,382,749,1587
50,0,-100,358,391,749,1517
-140,-90,-10,367,382,749,1587
50,0,-130,357,392,749,1562
-170,-80,-50,373,376,749,1662
-130,-90,0,367,382,749,1587
130,-40,10,352,397,749,1598
20,-90,150,367,382,749,1587
-160,-90,-30,367,382,749,1587
-40,-80,20,362,388,750,1633
-20,60,-160,392,358,750,1522
-10,-80,0,366,384,750,1561
60,40,-70,356,394,750,1430
-170,-60,-60,360,390,750,1602
50,60,-50,355,395,750,1449
10,-80,-130,380,370,750,1556
0,-10,100,355,396,751,1710
-10,30,60,374,377,751,1547
-10,-70,110,372,379,751,1695
-140,-70,-60,373,378,751,1603
-160,-60,-110,361,390,751,1586
-170,-10,-120,351,400,751,1589
180,-70,-40,348,404,752,1556
0,10,10,354,398,752,1511
80,70,130,380,372,752,1558
20,70,70,364,388,752,1500
170,10,-40,360,392,752,1534
-40,-80,70,368,384,752,1664
180,-10,-20,364,388,752,1629
-130,-80,40,371,381,752,1668
-160,-60,-80,364,388,752,1677
-30,-70,40,365,387,752,1638
160,-80,170,352,400,752,1429
-180,-70,-40,348,404,752,1556
0,40,40,358,394,752,1672
150,60,-150,386,366,752,1475
150,30,60,387,365,752,1623
-180,-10,-20,364,388,752,1629
-30,-60,10,371,381,752,1499
-170,50,-160,386,367,753,1491
-20,0,30,378,375,753,1565
110,80,-60,363,390,753,1652
60,-10,-60,352,401,753,1654
130,60,-10,361,392,753,1593
-140,-80,-90,360,393,753,1685
150,40,60,384,369,753,1594
20,0,0,359,394,753,1597
70,80,-20,359,394,753,1655
-50,80,-120,393,360,753,1559
-140,-70,60,384,369,753,1601
140,60,-50,364,389,753,1657
-160,70,-20,380,373,753,1567
-20,-40,-170,381,372,753,1553
-170,-20,0,383,371,754,1481
150,-10,-170,366,388,754,1539
80,-40,-40,363,391,754,1575
150,50,-150,365,389,754,1434
-40,-70,50,375,379,754,1661
0,20,120,358,396,754,1501
150,50,-20,365,389,754,1668
-30,-70,50,363,391,754,1597
-170,-70,-40,372,382,754,1624
-10,-20,130,378,377,755,1587
50,0,-20,344,411,755,1588
-70,80,-120,388,367,755,1625
-80,-80,-20,368,387,755,1695
100,20,140,358,397,755,1426
-90,80,-90,385,370,755,1604
10,80,120,363,392,755,1488
-30,-50,0,388,367,755,1583
100,80,-50,371,384,755,1647
30,70,20,358,397,755,1706
-60,-80,110,365,390,755,1640
-50,-80,160,381,375,756,1497
-10,-40,160,364,392,756,1626
-10,40,100,382,374,756,1594
-180,-40,30,387,369,756,1432
-10,-20,-160,376,380,756,1557
-130,80,150,372,384,756,1599
-10,-20,140,363,393,756,1576
-150,-60,40,382,374,756,1611
180,-40,30,387,369,756,1432
0,-20,90,354,402,756,1707
-60,-80,0,357,399,756,1723
20,-40,10,372,384,756,1611
-140,80,-30,379,377,756,1535
-20,20,80,371,385,756,1515
150,10,-160,364,393,757,1442
0,-70,150,366,391,757,1609
20,70,60,355,402,757,1571
-20,-60,100,378,379,757,1592
-180,80,-140,372,385,757,1567
110,0,150,364,393,757,1546
-60,-80,-10,369,388,757,1576
90,80,-40,364,393,757,1626
110,-80,-30,380,377,757,1473
-120,80,-60,383,374,757,1579
180,80,-140,372,385,757,1567
120,-30,60,383,374,757,1681
-70,-80,-10,361,396,757,1727
140,30,-150,377,380,757,1664
50,70,160,371,386,757,1633
70,-90,-140,366,392,758,1647
-160,-60,-130,365,393,758,1548
90,-90,-120,366,392,758,1647
20,-90,170,366,392,758,1647
-20,-90,130,366,392,758,1647
90,-50,60,379,379,758,1671
-160,-90,-10,366,392,758,1647
130,-90,-80,366,392,758,1647
-120,-90,30,366,392,758,1647
50,-90,-160,366,392,758,1647
30,-90,180,366,392,758,1647
80,-90,-130,366,392,758,1647
110,-90,-100,366,392,758,1647
0,-50,130,379,379,758,1643
130,80,10,376,382,758,1620
-130,-90,20,366,392,758,1647
-170,-90,-20,366,392,758,1647
110,-50,100,376,382,758,1633
-150,-90,0,366,392,758,1647
170,-90,-40,366,392,758,1647
160,30,-50,359,399,758,1638
-10,-20,60,358,400,758,1656
180,-90,-30,366,392,758,1647
-60,-90,90,366,392,758,1647
30,-90,-180,366,392,758,1647
-10,-40,120,380,378,758,1539
120,-90,-90,366,392,758,1647
-90,-90,60,366,392,758,1647
-10,0,160,385,373,758,1587
-70,-90,80,366,392,758,1647
60,-90,-150,366,392,758,1647
0,-90,150,366,392,758,1647
100,-90,-110,366,392,758,1647
-170,10,-120,366,392,758,1563
160,80,-110,361,397,758,1564
10,-70,140,364,394,758,1674
-140,-90,10,366,392,758,1647
-40,-90,110,366,392,758,1647
-110,-90,40,366,392,758,1647
-30,-90,120,366,392,758,1647
140,-90,-70,366,392,758,1647
-10,-40,50,362,396,758,1715
10,-90,160,366,392,758,1647
150,-90,-60,366,392,758,1647
-180,-90,-30,366,392,758,1647
-80,-90,70,366,392,758,1647
40,-90,-170,366,392,758,1647
20,40,-10,368,390,758,1485
-100,-90,50,366,392,758,1647
180,50,-130,370,388,758,1606
-10,-90,140,366,392,758,1647
160,-90,-50,366,392,758,1647
-180,50,-130,370,388,758,1606
-50,-90,100,366,392,758,1647
0,70,-160,401,358,759,1620
130,70,-60,354,405,759,1694
80,-30,-30,355,404,759,1581
40,30,-30,351,408,759,1501
50,30,-180,371,388,759,1631
50,30,180,371,388,759,1631
90,-40,-30,359,400,759,1622
-10,-80,110,362,397,759,1678
120,-30,50,357,402,759,1641
180,-40,-30,359,400,759,1633
-180,-40,-30,359,400,759,1633
0,50,120,367,392,759,1578
-170,-30,30,384,376,760,1613
50,50,170,369,391,760,1511
110,30,-140,377,383,760,1669
60,-50,-70,371,389,760,1483
-160,-40,-100,356,404,760,1692
-140,80,170,378,382,760,1655
30,40,-20,356,404,760,1510
-50,-80,60,366,394,760,1673
100,80,-20,370,390,760,1635
-130,-70,60,376,384,760,1551
-170,20,-130,362,398,760,1597
0,70,110,360,400,760,1549
80,90,-50,379,382,761,1611
100,90,-70,379,382,761,1611
30,90,0,379,382,761,1611
-150,90,180,379,382,761,1611
70,90,-40,379,382,761,1611
-170,70,-180,379,382,761,1420
0,90,30,379,382,761,1611
90,90,-60,379,382,761,1611
40,90,-10,379,382,761,1611
50,90,-20,379,382,761,1611
60,90,-30,379,382,761,1611
-70,90,100,379,382,761,1611
-160,90,-170,379,382,761,1611
-110,90,140,379,382,761,1611
-80,90,110,379,382,761,1611
120,90,-90,379,382,761,1611
10,90,20,379,382,761,1611
0,60,30,359,402,761,1652
-170,-30,-90,354,407,761,1595
170,90,-140,379,382,761,1611
0,50,70,363,398,761,1589
180,90,-150,379,382,761,1611
-10,90,40,379,382,761,1611
140,90,-110,379,382,761,1611
-30,90,60,379,382,761,1611
-40,90,70,379,382,761,1611
-90,90,120,379,382,761,1611
-20,90,50,379,382,761,1611
150,90,-120,379,382,761,1611
-60,90,90,379,382,761,1611
-130,90,160,379,382,761,1611
-170,70,180,379,382,761,1420
130,90,-100,379,382,761,1611
-120,90,150,379,382,761,1611
-150,90,-180,379,382,761,1611
-140,90,170,379,382,761,1611
-100,90,130,379,382,761,1611
110,90,-80,379,382,761,1611
-180,90,-150,379,382,761,1611
160,90,-130,379,382,761,1611
20,90,10,379,382,761,1611
-50,90,80,379,382,761,1611
-170,90,-160,379,382,761,1611
90,80,40,379,383,762,1668
-180,-10,-60,360,402,762,1640
0,-70,10,387,375,762,1763
180,-40,-40,365,397,762,1636
60,0,-50,362,400,762,1412
-140,-80,70,390,372,762,1672
-160,-80,-50,369,393,762,1698
-170,-30,-60,359,403,762,1559
0,-80,150,376,386,762,1701
-30,-70,80,386,376,762,1666
-150,70,170,371,391,762,1469
50,40,-50,352,410,762,1588
60,80,-10,364,398,762,1698
-180,-40,-40,365,397,762,1636
-130,-80,-80,362,400,762,1685
180,-10,-60,360,402,762,1640
-170,-30,-80,371,391,762,1580
-20,10,60,379,383,762,1509
90,40,-120,367,396,763,1407
100,70,110,389,374,763,1557
-170,0,-80,374,389,763,1478
-20,0,40,384,379,763,1535
150,-10,50,361,402,763,1583
0,-80,130,376,387,763,1700
-150,80,-50,377,386,763,1617
0,0,110,363,400,763,1663
100,70,10,365,398,763,1652
80,80,-30,362,401,763,1653
30,0,-150,377,387,764,1537
-60,-80,50,372,392,764,1675
170,80,-120,366,398,764,1566
150,-70,160,356,408,764,1521
-20,80,40,395,369,764,1646
0,40,20,376,388,764,1556
130,70,-50,357,407,764,1686
20,-20,-130,362,402,764,1524
160,30,-30,361,403,764,1652
40,-20,0,364,400,764,1674
-180,60,-120,365,400,765,1573
-60,80,-110,399,366,765,1567
10,60,30,362,403,765,1654
120,70,10,373,392,765,1613
-10,50,-160,387,378,765,1565
-170,10,-140,376,389,765,1503
-170,80,10,393,372,765,1524
180,60,-120,365,400,765,1573
170,60,-100,362,403,765,1687
80,50,140,373,392,765,1634
50,80,40,371,394,765,1631
110,80,-30,370,395,765,1659
-30,-70,30,372,393,765,1621
-70,-80,-20,371,395,766,1606
140,60,-40,371,395,766,1679
-170,-70,-10,369,397,766,1683
-160,-80,-40,380,386,766,1699
0,70,120,362,404,766,1526
120,-30,100,371,395,766,1640
110,70,10,365,401,766,1682
-10,-50,50,370,396,766,1670
90,80,-30,364,402,766,1714
130,10,90,357,409,766,1700
0,10,120,363,404,767,1603
30,80,90,372,395,767,1581
150,60,-70,356,411,767,1747
-170,-50,-50,377,390,767,1663
20,80,100,370,397,767,1573
-140,-60,-80,370,397,767,1649
-20,60,170,374,393,767,1663
-170,-80,-20,374,393,767,1671
-70,-80,100,371,396,767,1634
80,20,170,382,385,767,1572
-20,-70,100,377,391,768,1714
-170,-10,-130,363,405,768,1663
80,80,-20,365,403,768,1740
-30,-50,-180,393,375,768,1671
-30,-50,180,393,375,768,1671
-140,-70,-80,370,398,768,1662
-10,30,100,371,397,768,1622
100,-50,70,380,388,768,1623
-110,80,-70,393,375,768,1610
60,80,30,370,398,768,1653
100,80,-40,365,403,768,1712
-30,-80,130,373,396,769,1696
-90,-80,-30,374,395,769,1687
180,-60,-30,364,405,769,1591
120,-10,110,362,407,769,1683
-20,10,80,382,387,769,1582
130,80,-50,372,397,769,1751
60,10,-120,356,413,769,1606
90,70,120,391,378,769,1578
10,60,60,366,403,769,1516
170,80,-20,383,386,769,1634
-180,-60,-30,364,405,769,1591
-150,-50,-90,374,395,769,1606
70,80,-10,363,406,769,1795
-160,80,170,392,377,769,1471
-160,-60,40,394,375,769,1605
-20,0,50,378,391,769,1552
90,-30,0,356,413,769,1673
40,80,80,376,394,770,1604
180,0,-60,360,410,770,1546
-120,-80,-60,371,399,770,1716
-50,-70,150,390,380,770,1674
-160,-50,-130,361,409,770,1545
-170,50,-120,374,396,770,1539
120,0,180,370,400,770,1491
170,10,-30,379,391,770,1597
110,20,120,346,424,770,1531
-180,50,-100,382,388,770,1571
-10,-30,120,391,379,770,1597
-160,-70,-60,373,397,770,1755
-60,80,-140,382,388,770,1712
120,0,-180,370,400,770,1491
-160,-40,-120,368,402,770,1618
-180,0,-60,360,410,770,1546
180,50,-100,382,388,770,1571
-170,-70,-60,382,388,770,1700
120,40,100,376,395,771,1523
-180,-50,-30,362,409,771,1640
-100,80,-80,399,372,771,1634
-20,40,180,385,386,771,1563
90,80,-10,377,394,771,1644
-10,60,150,375,396,771,1571
130,-20,60,379,392,771,1747
180,-50,-30,362,409,771,1640
-20,40,-180,385,386,771,1563
30,80,10,368,403,771,1685
160,40,50,401,370,771,1586
80,60,-90,382,390,772,1458
-20,40,-170,388,384,772,1585
0,-20,-150,379,393,772,1565
120,-20,110,376,396,772,1609
120,40,-140,378,394,772,1565
170,20,-50,367,405,772,1632
-180,70,20,381,391,772,1572
180,70,20,381,391,772,1572
-170,-30,-70,369,403,772,1575
160,40,-60,371,401,772,1667
0,20,-160,390,382,772,1576
-170,70,-20,384,388,772,1546
-10,70,30,385,388,773,1643
-120,80,-70,389,384,773,1653
-170,40,-110,377,396,773,1503
-70,-80,40,375,398,773,1733
120,80,-40,369,404,773,1700
60,-10,-20,349,424,773,1676
-160,-50,-120,384,389,773,1671
-150,-70,-100,371,402,773,1691
80,20,-130,381,392,773,1611
70,80,10,373,400,773,1686
-160,70,-10,392,381,773,1636
-20,10,50,381,392,773,1499
-30,-50,170,399,374,773,1597
-170,-60,-70,382,392,774,1661
-170,-80,-40,389,385,774,1735
-80,80,-110,397,377,774,1660
150,50,60,403,371,774,1596
-100,-80,-40,374,400,774,1701
0,-60,-140,393,381,774,1632
0,10,-160,391,383,774,1605
180,20,0,389,385,774,1513
-180,20,0,389,385,774,1513
60,-20,-10,361,413,774,1620
-20,80,-140,402,372,774,1569
120,-10,130,348,426,774,1502
170,30,-60,370,404,774,1666
140,70,0,378,396,774,1671
-170,-70,-20,364,410,774,1659
-10,60,100,384,390,774,1568
70,80,20,372,402,774,1703
70,-50,40,376,398,774,1692
90,80,-20,366,408,774,1730
40,-20,-100,378,397,775,1599
70,20,-180,377,398,775,1630
-20,40,100,394,381,775,1605
100,80,-30,364,411,775,1742
-180,10,-60,381,394,775,1582
40,80,50,377,398,775,1645
120,-30,80,376,399,775,1577
180,10,-60,381,394,775,1582
70,20,180,377,398,775,1630
-20,0,70,404,371,775,1670
10,80,110,373,402,775,1595
-20,50,-160,406,370,776,1671
-130,80,-40,392,384,776,1599
170,70,-110,365,411,776,1663
-110,-80,-50,372,404,776,1716
-150,-70,-120,378,398,776,1547
-20,20,70,390,386,776,1614
-10,30,40,381,395,776,1677
-20,70,-150,407,369,776,1564
-170,0,-120,363,413,776,1655
-20,-60,70,380,396,776,1696
-20,-20,10,398,378,776,1672
-120,-80,-70,370,407,777,1704
-170,0,-130,372,405,777,1624
-40,-60,160,403,374,777,1601
80,80,-10,367,410,777,1707
0,0,-160,382,395,777,1655
-10,20,100,374,403,777,1650
-30,-60,-10,395,382,777,1667
0,80,130,370,407,777,1538
-30,-60,180,398,380,778,1677
-30,-60,-180,398,380,778,1677
-10,-10,80,385,393,778,1686
-10,-60,150,374,404,778,1718
20,-30,-120,379,399,778,1488
-150,-50,-100,363,415,778,1538
-160,-50,20,400,378,778,1612
-10,-40,110,392,386,778,1597
-150,-80,10,379,399,778,1652
-10,-20,120,389,389,778,1674
10,70,70,383,395,778,1658
-20,10,70,389,389,778,1547
-70,80,-100,401,378,779,1613
140,-40,160,373,406,779,1651
80,30,-120,381,398,779,1563
40,-10,-110,391,388,779,1526
40,-70,40,388,391,779,1743
100,-40,50,370,409,779,1706
-120,-80,50,379,400,779,1719
130,70,-40,371,408,779,1641
-10,-50,80,382,397,779,1648
50,80,0,366,413,779,1748
40,70,20,367,412,779,1686
130,0,90,370,409,779,1690
-80,80,-90,400,379,779,1640
-170,-40,-80,371,409,780,1561
-170,-60,-40,370,410,780,1647
-100,80,-90,396,384,780,1689
0,-50,150,388,392,780,1685
-40,-70,10,383,397,780,1676
-90,-80,20,376,404,780,1765
-130,-80,80,399,381,780,1699
120,70,-10,381,399,780,1695
-160,-30,-90,383,397,780,1634
110,70,100,398,382,780,1586
-80,-80,-30,376,404,780,1637
0,60,120,373,407,780,1629
110,-70,110,378,402,780,1636
110,70,-10,369,411,780,1685
110,80,-50,371,409,780,1716
-20,80,160,385,395,780,1616
-20,-80,-10,378,402,780,1589
-50,-90,90,371,410,781,1688
-10,-90,130,371,410,781,1688
70,80,0,372,409,781,1713
160,-90,-60,371,410,781,1688
-40,-90,100,371,410,781,1688
-130,-90,10,371,410,781,1688
80,-90,-140,371,410,781,1688
-160,-90,-20,371,410,781,1688
-160,-50,-80,382,399,781,1698
170,-90,-50,371,410,781,1688
50,-90,-170,371,410,781,1688
20,70,50,371,410,781,1665
-80,-90,60,371,410,781,1688
110,-90,-110,371,410,781,1688
70,-90,-150,371,410,781,1688
-100,-90,40,371,410,781,1688
20,-90,160,371,410,781,1688
-170,-90,-30,371,410,781,1688
-10,-80,120,378,403,781,1756
-140,-90,0,371,410,781,1688
120,-80,-20,395,386,781,1516
-150,-90,-10,371,410,781,1688
-180,-90,-40,371,410,781,1688
-90,80,-100,399,382,781,1687
0,-90,140,371,410,781,1688
150,-90,-70,371,410,781,1688
180,-90,-40,371,410,781,1688
-110,-80,-60,375,406,781,1705
-150,70,-30,389,392,781,1646
-110,-90,30,371,410,781,1688
-20,-90,120,371,410,781,1688
-180,-10,30,386,395,781,1472
-60,-90,80,371,410,781,1688
30,-90,170,371,410,781,1688
-90,-90,50,371,410,781,1688
-120,-90,20,371,410,781,1688
100,-90,-120,371,410,781,1688
90,-90,-130,371,410,781,1688
40,-50,20,383,398,781,1749
-30,-90,110,371,410,781,1688
180,-10,30,386,395,781,1472
60,-90,-160,371,410,781,1688
140,-90,-80,371,410,781,1688
10,-90,150,371,410,781,1688
120,-90,-100,371,410,781,1688
40,-90,180,371,410,781,1688
-70,-90,70,371,410,781,1688
130,-90,-90,371,410,781,1688
40,-90,-180,371,410,781,1688
170,-80,180,374,408,782,1523
80,80,0,377,405,782,1692
10,-10,-150,382,400,782,1651
10,70,80,375,407,782,1571
150,20,60,390,392,782,1658
-60,-80,150,399,383,782,1541
-20,0,20,376,406,782,1622
120,60,-130,385,397,782,1529
-20,10,40,382,400,782,1590
50,80,30,377,405,782,1764
-180,30,0,381,401,782,1618
130,-10,90,379,403,782,1684
180,30,0,381,401,782,1618
-40,-60,-10,408,374,782,1545
-20,-80,100,380,402,782,1733
170,-80,-180,374,408,782,1523
170,-30,30,391,391,782,1473
-100,-80,-50,381,401,782,1687
80,40,-110,371,412,783,1482
-40,-70,40,375,408,783,1692
120,-30,110,386,397,783,1536
60,80,0,372,411,783,1807
-180,70,-20,390,393,783,1568
-40,80,-170,382,401,783,1628
40,70,170,393,390,783,1750
180,70,-20,390,393,783,1568
-160,-40,20,390,393,783,1594
180,40,-90,376,407,783,1592
-170,-20,20,399,384,783,1577
-120,80,-50,392,391,783,1635
-180,40,-90,376,407,783,1592
-160,80,0,402,381,783,1584
140,70,-70,355,428,783,1804
140,80,0,383,401,784,1692
-170,-50,-70,372,412,784,1579
-40,-60,150,392,392,784,1630
0,-60,130,388,396,784,1764
60,80,20,382,402,784,1712
100,80,30,391,393,784,1719
-10,-30,110,383,401,784,1675
-10,-30,140,373,411,784,1647
130,-10,80,383,401,784,1665
160,30,50,389,395,784,1683
-80,-80,90,386,398,784,1691
150,70,-150,382,402,784,1491
-110,-80,60,379,405,784,1712
-100,-80,10,384,400,784,1761
-30,-70,180,389,396,785,1698
-10,-50,120,385,400,785,1638
140,80,-60,378,407,785,1801
-10,60,110,383,402,785,1623
120,-10,160,379,406,785,1586
-20,-40,0,385,400,785,1599
0,70,100,383,402,785,1627
120,-60,-10,381,404,785,1602
-30,-70,-180,389,396,785,1698
20,50,-170,388,397,785,1584
60,-40,20,376,409,785,1738
-10,10,90,389,396,785,1561
-160,-20,-100,389,396,785,1593
-150,-70,-60,381,404,785,1749
50,80,70,385,400,785,1636
-130,-70,70,399,386,785,1651
-10,-10,160,376,409,785,1618
-120,80,140,386,400,786,1681
160,40,-20,392,394,786,1693
30,80,60,386,400,786,1687
-10,80,20,394,392,786,1557
-180,50,0,381,405,786,1583
-80,-80,30,381,405,786,1753
0,80,30,391,395,786,1767
-10,-40,100,385,401,786,1701
20,-50,10,372,414,786,1710
180,50,0,381,405,786,1583
0,-80,140,383,404,787,1658
140,60,-20,371,416,787,1648
-170,50,-150,385,402,787,1656
110,0,160,379,408,787,1561
0,60,80,377,410,787,1639
-40,-70,60,400,387,787,1718
-150,-70,20,383,404,787,1679
-30,-60,150,406,381,787,1690
10,60,50,381,406,787,1661
-160,40,-130,380,407,787,1512
-110,80,-80,395,392,787,1668
-170,80,-150,384,403,787,1633
-90,-80,-40,385,402,787,1670
60,-20,-60,383,404,787,1719
-30,80,50,399,388,787,1718
60,20,-100,370,417,787,1470
90,50,-110,374,414,788,1452
80,80,10,380,408,788,1688
140,60,-30,371,417,788,1642
160,-30,30,382,406,788,1581
-150,-60,-100,379,409,788,1613
150,50,-40,378,410,788,1733
-160,70,-170,381,407,788,1642
-170,30,-100,385,403,788,1624
-30,-40,10,398,390,788,1577
-170,-10,-70,378,410,788,1603
140,-20,50,368,421,789,1583
-150,-80,-40,380,409,789,1786
50,-30,-80,385,404,789,1539
-60,-70,130,399,390,789,1672
-10,20,160,383,406,789,1663
90,20,-140,394,395,789,1638
0,70,10,385,404,789,1496
60,80,10,378,411,789,1726
30,70,30,378,411,789,1755
-20,-50,90,404,385,789,1729
110,70,0,375,414,789,1712
-20,-50,30,394,395,789,1686
0,50,40,381,408,789,1700
-170,-40,-70,385,405,790,1666
90,80,0,381,409,790,1707
-150,-80,-30,391,399,790,1750
40,80,10,371,419,790,1787
50,70,-50,381,409,790,1577
-180,20,20,391,399,790,1719
-140,-70,-90,371,419,790,1774
180,20,20,391,399,790,1719
60,80,60,384,407,791,1703
-20,50,100,388,403,791,1667
-180,60,-110,372,419,791,1708
120,70,-20,373,418,791,1694
-160,-40,-80,380,411,791,1676
-170,-40,-140,407,384,791,1709
-140,-60,-70,392,399,791,1629
0,-70,130,385,406,791,1765
-30,-80,90,386,405,791,1774
-150,-70,-50,385,406,791,1836
-40,70,-150,399,392,791,1696
70,-60,50,380,411,791,1782
-30,70,-150,409,382,791,1590
180,60,-110,372,419,791,1708
-10,-60,120,390,401,791,1765
-20,-30,40,397,394,791,1690
-10,-80,140,385,406,791,1757
-130,-70,-50,384,408,792,1659
-180,70,-130,373,419,792,1626
-20,-60,150,392,400,792,1751
80,-30,0,379,413,792,1703
-10,-50,0,382,410,792,1631
180,70,-130,373,419,792,1626
-180,80,-130,374,418,792,1626
120,-50,120,378,414,792,1579
-170,0,-140,376,416,792,1614
180,80,-130,374,418,792,1626
50,80,60,388,404,792,1680
0,60,70,382,410,792,1645
100,-60,90,377,415,792,1747
-20,20,90,391,402,793,1635
120,70,0,377,416,793,1800
40,80,30,376,417,793,1753
50,-40,-80,383,410,793,1615
180,60,20,395,398,793,1628
-180,60,20,395,398,793,1628
140,-20,40,373,420,793,1723
10,70,30,369,424,793,1788
-20,-10,50,382,411,793,1682
90,80,-90,392,401,793,1489
80,80,30,402,391,793,1661
-100,-80,70,385,408,793,1740
60,20,-170,377,416,793,1726
-170,60,0,386,407,793,1688
-110,80,-60,397,396,793,1675
100,30,130,375,418,793,1607
160,-50,180,364,430,794,1723
-20,-50,100,401,393,794,1672
-30,-80,-20,381,413,794,1628
-140,80,-60,389,405,794,1661
120,-60,120,385,409,794,1638
160,-50,-180,364,430,794,1723
-20,30,80,398,396,794,1709
30,-20,0,388,406,794,1762
0,-60,140,396,399,795,1749
-130,80,160,389,406,795,1714
-170,-10,-140,383,412,795,1565
10,60,40,380,415,795,1709
50,80,10,379,416,795,1820
180,-80,-40,386,409,795,1737
-160,-30,-100,365,430,795,1700
-90,-80,80,386,409,795,1734
-70,-80,140,405,390,795,1586
-180,-80,-40,386,409,795,1737
-170,-50,-60,385,411,796,1656
-180,-30,-50,378,418,796,1688
70,-40,20,388,408,796,1772
-170,-60,-30,382,414,796,1696
-10,-40,90,394,402,796,1823
0,50,60,377,419,796,1634
180,-30,-50,378,418,796,1688
140,0,-170,383,413,796,1587
-10,-70,-150,398,398,796,1631
-20,-40,110,398,398,796,1729
-170,70,-150,373,423,796,1666
-40,-70,70,398,398,796,1773
120,-30,40,380,416,796,1620
-10,30,150,399,398,797,1651
160,50,-70,376,421,797,1797
160,20,50,387,410,797,1639
-160,10,-110,404,393,797,1482
140,60,-10,377,420,797,1701
150,70,-80,372,425,797,1787
-10,-30,160,386,411,797,1865
40,0,-140,389,408,797,1542
120,80,-60,375,422,797,1730
-30,-50,10,409,388,797,1643
-160,-70,-40,382,415,797,1701
110,-50,90,386,411,797,1703
-170,50,-130,379,418,797,1586
150,50,-50,368,429,797,1712
-30,-60,70,398,399,797,1750
-10,-70,120,392,405,797,1771
0,20,10,389,408,797,1591
110,80,-40,363,434,797,1770
-20,-30,-170,404,393,797,1602
170,20,-30,389,409,798,1773
60,50,-70,380,418,798,1552
90,80,20,403,395,798,1695
0,70,90,389,409,798,1740
140,0,70,388,410,798,1656
-150,-70,-110,388,410,798,1788
-20,40,90,390,408,798,1701
-20,0,60,397,401,798,1705
-20,-60,60,401,397,798,1701
-120,-70,-50,391,407,798,1720
50,80,20,380,418,798,1761
-120,-80,90,406,392,798,1698
0,-80,-140,401,397,798,1622
30,10,-10,372,426,798,1690
-50,-70,-20,401,397,798,1595
-10,-10,130,392,406,798,1662
40,80,40,383,415,798,1790
-100,80,-70,403,396,799,1695
-130,-70,-70,395,404,799,1733
-160,30,-130,387,412,799,1677
160,50,-10,390,409,799,1629
30,30,-20,368,431,799,1652
-90,80,-80,409,390,799,1673
-170,-40,-50,384,415,799,1707
-10,-30,60,394,405,799,1763
50,80,50,401,398,799,1602
70,-30,0,380,419,799,1568
80,-60,-50,392,408,800,1562
60,80,50,391,409,800,1662
-110,80,130,396,404,800,1725
70,80,30,401,399,800,1629
-170,-60,-10,388,412,800,1710
-30,70,180,397,403,800,1670
-30,-30,10,393,407,800,1560
20,80,20,379,421,800,1780
-30,70,-180,397,403,800,1670
130,-80,-10,407,394,801,1572
-170,-20,-60,399,402,801,1613
150,80,-70,381,420,801,1796
140,70,-50,382,419,801,1706
-120,-70,70,396,405,801,1617
-40,-80,80,389,412,801,1807
-50,-70,-10,385,416,801,1580
120,0,110,371,430,801,1718
130,-20,70,392,409,801,1564
-40,-70,30,396,405,801,1694
20,80,80,394,407,801,1683
-160,-70,-140,394,407,801,1561
-10,10,160,397,404,801,1737
40,80,70,392,409,801,1688
-160,-40,30,395,406,801,1596
90,50,130,402,399,801,1708
0,60,-160,419,382,801,1641
-180,60,-130,369,433,802,1674
-170,-50,-10,393,409,802,1673
80,80,20,397,405,802,1645
180,60,-130,369,433,802,1674
-150,-40,-100,377,425,802,1673
10,20,-160,392,410,802,1621
180,40,0,390,412,802,1653
-20,-70,140,392,410,802,1850
-180,40,0,390,412,802,1653
-10,0,90,393,409,802,1760
0,80,120,385,417,802,1657
160,50,50,419,383,802,1656
120,-30,70,384,418,802,1708
-30,-70,140,386,416,802,1771
120,70,90,409,394,803,1651
0,50,50,382,421,803,1769
160,-20,-170,391,412,803,1617
-160,-50,-70,390,413,803,1653
180,30,-80,377,426,803,1719
40,80,60,399,404,803,1611
-140,-70,-50,401,402,803,1782
140,60,70,396,407,803,1662
-180,30,-80,377,426,803,1719
-160,-60,10,395,409,804,1646
30,80,80,403,401,804,1680
30,80,70,396,408,804,1663
-10,30,50,387,417,804,1719
10,-20,-140,389,415,804,1720
180,40,20,400,404,804,1693
-180,40,20,400,404,804,1693
-20,-60,40,394,410,804,1756
0,70,30,390,414,804,1752
-20,-60,110,405,399,804,1731
30,80,40,382,422,804,1761
-160,-30,-110,387,418,805,1809
-120,-70,-40,396,409,805,1709
-140,-80,20,395,410,805,1714
-10,-50,60,393,412,805,1768
80,-60,60,387,418,805,1785
120,10,110,367,438,805,1717
70,80,40,405,400,805,1652
-170,-60,-150,394,411,805,1614
-140,70,160,387,419,806,1591
80,80,-80,402,404,806,1549
-120,-70,80,407,399,806,1666
150,50,-30,384,422,806,1640
150,70,-60,387,419,806,1796
100,80,-100,390,416,806,1471
120,-40,120,380,426,806,1658
-20,-50,110,395,411,806,1714
120,-40,110,390,416,806,1644
-30,-70,90,393,413,806,1835
-10,40,-160,400,406,806,1644
-10,40,70,388,418,806,1729
160,70,-10,406,400,806,1664
0,-50,140,402,404,806,1838
0,-70,140,396,411,807,1744
110,-40,70,410,397,807,1631
150,60,-60,378,429,807,1778
-140,-80,-20,405,402,807,1785
130,20,90,385,422,807,1772
-160,-70,50,409,398,807,1704
-10,-50,-150,411,396,807,1734
-20,-40,100,415,392,807,1773
-10,-70,0,407,400,807,1837
20,80,50,385,422,807,1791
70,80,50,391,416,807,1743
-160,-80,-30,400,407,807,1843
-70,80,-130,399,408,807,1758
20,-10,0,380,427,807,1794
-160,-60,-70,383,424,807,1795
-160,-20,-110,379,429,808,1730
140,-10,60,387,421,808,1798
-10,60,30,405,403,808,1688
60,80,40,403,405,808,1618
-30,-60,90,398,410,808,1768
-30,-60,80,408,400,808,1738
160,-10,40,400,408,808,1818
120,-10,120,383,425,808,1626
120,-20,120,381,427,808,1683
100,20,-150,387,421,808,1696
20,70,40,383,425,808,1782
20,70,30,375,434,809,1845
140,70,-60,378,431,809,1737
-160,-30,-120,385,424,809,1714
-150,80,-10,416,393,809,1646
-160,60,-170,401,408,809,1706
100,10,-180,376,433,809,1684
-180,0,-10,399,410,809,1742
-170,40,-140,372,437,809,1725
120,-30,30,387,422,809,1664
180,-20,30,394,415,809,1495
-160,-50,40,404,405,809,1687
-10,-10,120,392,417,809,1709
90,80,10,401,408,809,1671
-180,-20,30,394,415,809,1495
-170,-70,-30,372,437,809,1635
100,10,180,376,433,809,1684
180,0,-10,399,410,809,1742
-170,30,-140,389,421,810,1714
-170,-50,-30,386,424,810,1773
-50,-70,40,410,400,810,1730
-10,-20,160,407,403,810,1806
60,-60,40,389,421,810,1837
130,70,-30,379,431,810,1724
120,20,110,375,435,810,1650
130,-30,150,369,441,810,1670
20,80,90,406,404,810,1717
160,70,-90,383,427,810,1834
100,80,-10,388,422,810,1772
50,-20,-80,388,422,810,1614
170,70,-100,386,424,810,1868
-20,70,160,391,420,811,1631
-140,-80,-30,387,424,811,1798
-20,-80,110,387,424,811,1794
-180,60,-10,402,409,811,1642
-160,-70,-30,395,416,811,1697
180,60,-10,402,409,811,1642
20,60,-170,404,407,811,1714
130,80,-60,376,435,811,1838
0,60,10,386,425,811,1617
50,20,-40,384,427,811,1728
-40,-80,120,396,415,811,1782
30,80,50,392,419,811,1801
-50,-70,130,403,409,812,1632
-180,80,-30,406,406,812,1697
-10,-50,150,400,412,812,1770
-170,-20,-140,400,412,812,1656
-20,-10,70,400,412,812,1674
180,80,-30,406,406,812,1697
50,30,-50,370,442,812,1586
-20,30,100,414,398,812,1662
-170,-60,40,400,412,812,1663
30,80,20,380,432,812,1833
-20,-30,170,414,398,812,1687
-10,-80,130,390,422,812,1724
-10,0,140,406,406,812,1711
160,60,-80,378,434,812,1850
-30,-40,0,421,391,812,1662
-10,-30,100,403,410,813,1770
-20,20,60,401,412,813,1631
-10,30,-160,405,408,813,1660
-110,-80,0,398,415,813,1807
-30,60,-160,420,393,813,1691
110,50,-130,402,412,814,1542
-20,20,-170,416,398,814,1721
-180,20,-70,382,432,814,1717
-170,-30,-50,382,432,814,1759
160,80,-80,388,426,814,1787
180,20,-70,382,432,814,1717
160,30,-40,381,433,814,1858
110,80,20,404,410,814,1732
-50,-60,150,409,405,814,1707
-50,-80,70,395,419,814,1823
-10,-10,140,396,418,814,1680
-170,-50,-40,392,422,814,1686
-10,50,110,410,404,814,1761
-180,50,20,404,411,815,1714
-180,-30,-40,392,423,815,1761
40,10,-20,395,420,815,1732
180,-30,-40,392,423,815,1761
170,30,-20,398,417,815,1693
-170,-40,-10,398,417,815,1758
-40,-70,80,404,411,815,1863
-30,-50,160,413,402,815,1692
130,80,-70,378,437,815,1782
70,-20,-20,375,440,815,1736
-160,-80,-10,393,422,815,1750
20,80,60,397,418,815,1779
180,50,20,404,411,815,1714
60,-50,30,405,410,815,1865
120,-30,120,384,432,816,1739
140,-80,0,412,404,816,1602
-20,-20,-180,406,410,816,1674
-40,-70,170,412,404,816,1735
120,80,-50,374,442,816,1804
-20,-20,180,406,410,816,1674
-20,50,110,408,408,816,1629
70,-60,-60,394,422,816,1622
110,80,-110,392,424,816,1503
-20,-10,180,414,403,817,1682
90,80,120,423,394,817,1710
-20,-80,130,404,413,817,1827
-10,50,150,404,413,817,1682
-20,-10,-180,414,403,817,1682
-110,-80,100,413,404,817,1687
80,80,130,422,395,817,1729
-30,80,-130,424,393,817,1653
110,80,-10,406,411,817,1731
-160,-70,-10,378,439,817,1787
-10,-50,70,384,433,817,1703
100,80,0,403,414,817,1704
110,80,-20,389,428,817,1773
150,60,60,407,410,817,1741
-170,20,-90,391,426,817,1700
-10,-20,110,406,412,818,1731
120,80,-30,390,428,818,1860
-10,80,40,400,418,818,1834
-170,-30,-140,410,408,818,1657
-180,-80,-170,384,434,818,1600
180,-80,-170,384,434,818,1600
-180,0,30,411,407,818,1533
-80,-80,130,414,404,818,1620
-140,-60,-90,392,426,818,1760
20,80,70,397,421,818,1702
180,0,30,411,407,818,1533
120,-40,100,401,417,818,1734
-60,-70,140,414,404,818,1762
170,40,-10,397,421,818,1745
-150,80,160,415,403,818,1603
-160,70,-30,404,414,818,1694
-50,-70,50,418,400,818,1728
60,10,-150,389,430,819,1866
-150,70,-20,410,409,819,1714
-180,30,20,401,418,819,1704
180,30,20,401,418,819,1704
-130,80,-70,409,410,819,1737
-130,-80,-20,393,426,819,1818
-10,70,140,406,414,820,1679
170,50,-160,401,419,820,1609
-10,80,140,385,435,820,1644
20,-20,0,391,429,820,1863
170,60,-90,390,430,820,1870
130,70,0,397,423,820,1841
10,70,50,394,426,820,1803
170,50,-10,396,424,820,1682
-60,-70,-20,392,428,820,1667
70,30,-110,395,425,820,1526
90,-40,30,399,421,820,1783
-30,60,-170,411,409,820,1678
40,80,20,393,427,820,1860
-50,-70,30,394,426,820,1768
-50,-70,60,409,411,820,1861
-40,70,-160,415,406,821,1753
-140,70,-40,412,409,821,1695
-20,60,110,408,413,821,1710
30,-40,10,416,405,821,1885
30,70,180,416,405,821,1864
-40,80,60,402,419,821,1785
100,80,10,411,410,821,1710
30,70,-180,416,405,821,1864
70,80,-70,407,414,821,1596
170,50,-80,390,431,821,1850
30,-60,20,385,436,821,1861
-40,-70,-20,410,411,821,1685
-170,20,-140,394,427,821,1656
-50,-70,0,405,416,821,1767
-20,40,-160,421,400,821,1811
170,-70,30,410,412,822,1700
70,20,-120,403,419,822,1692
50,-30,0,405,417,822,1765
-180,0,-50,391,431,822,1673
180,0,-50,391,431,822,1673
80,80,40,401,421,822,1784
180,-30,-30,386,436,822,1732
-170,-40,-60,394,428,822,1683
-10,-60,0,410,412,822,1882
-180,-30,-30,386,436,822,1732
30,-70,30,414,408,822,1856
-20,-20,50,397,425,822,1675
-120,-80,-10,400,422,822,1821
-70,-70,120,418,404,822,1747
-130,-70,50,410,413,823,1723
-60,90,-160,412,411,823,1645
170,90,-30,412,411,823,1645
-10,-40,0,388,435,823,1611
-80,90,-140,412,411,823,1645
140,90,0,412,411,823,1645
-70,90,-150,412,411,823,1645
-110,90,-110,412,411,823,1645
10,80,100,416,407,823,1719
-100,90,-120,412,411,823,1645
160,90,-20,412,411,823,1645
-10,-20,70,402,421,823,1787
-40,90,-180,412,411,823,1645
-160,90,-60,412,411,823,1645
80,90,60,412,411,823,1645
70,90,70,412,411,823,1645
-170,90,-50,412,411,823,1645
110,90,30,412,411,823,1645
-150,90,-70,412,411,823,1645
40,90,100,412,411,823,1645
60,90,80,412,411,823,1645
0,90,140,412,411,823,1645
-20,90,160,412,411,823,1645
-30,90,170,412,411,823,1645
180,90,-40,412,411,823,1645
-20,-10,60,408,415,823,1748
-180,90,-40,412,411,823,1645
-40,90,180,412,411,823,1645
-130,90,-90,412,411,823,1645
150,90,-10,412,411,823,1645
-90,90,-130,412,411,823,1645
-120,90,-100,412,411,823,1645
-50,90,-170,412,411,823,1645
100,90,40,412,411,823,1645
120,90,20,412,411,823,1645
10,90,130,412,411,823,1645
170,-40,30,408,415,823,1658
-30,-80,100,384,439,823,1805
130,0,100,409,414,823,1673
30,90,110,412,411,823,1645
20,90,120,412,411,823,1645
-140,90,-80,412,411,823,1645
90,90,50,412,411,823,1645
50,90,90,412,411,823,1645
140,-50,10,407,416,823,1704
-10,90,150,412,411,823,1645
130,90,10,412,411,823,1645
170,20,40,388,435,823,1669
-160,20,-120,405,419,824,1604
-170,80,-140,398,426,824,1682
90,30,-130,410,414,824,1658
180,-20,-50,403,421,824,1713
50,0,-90,402,422,824,1638
-20,-70,110,413,411,824,1821
-130,-80,30,401,423,824,1771
-180,-20,-50,403,421,824,1713
-80,80,-120,411,413,824,1794
100,50,120,404,420,824,1780
-140,-70,30,400,424,824,1832
70,-20,-30,379,445,824,1814
140,80,-70,387,437,824,1847
-150,-40,-110,403,421,824,1669
-120,80,150,390,434,824,1737
-160,-70,0,394,430,824,1802
-90,-80,120,414,410,824,1648
-90,90,130,395,430,825,1758
180,90,-140,395,430,825,1758
-160,90,-160,395,430,825,1758
-70,90,110,395,430,825,1758
-60,90,100,395,430,825,1758
110,90,-70,395,430,825,1758
-100,90,140,395,430,825,1758
130,-40,140,388,437,825,1694
60,90,-20,395,430,825,1758
-20,-40,160,412,413,825,1724
70,90,-30,395,430,825,1758
100,90,-60,395,430,825,1758
-180,90,-140,395,430,825,1758
-30,90,70,395,430,825,1758
-130,90,170,395,430,825,1758
120,90,-80,395,430,825,1758
170,90,-130,395,430,825,1758
0,-40,-140,414,411,825,1643
150,90,-110,395,430,825,1758
-20,90,60,395,430,825,1758
-170,90,-150,395,430,825,1758
140,90,-100,395,430,825,1758
-170,-40,-40,381,444,825,1753
30,90,10,395,430,825,1758
-10,90,50,395,430,825,1758
160,70,-80,393,432,825,1909
-140,90,-180,395,430,825,1758
-120,90,160,395,430,825,1758
50,90,-10,395,430,825,1758
80,90,-40,395,430,825,1758
-150,90,-170,395,430,825,1758
-40,90,80,395,430,825,1758
160,90,-120,395,430,825,1758
-80,90,120,395,430,825,1758
90,90,-50,395,430,825,1758
10,90,30,395,430,825,1758
40,90,0,395,430,825,1758
-20,0,80,400,425,825,1748
130,90,-90,395,430,825,1758
90,80,30,406,419,825,1810
-50,90,90,395,430,825,1758
-110,90,150,395,430,825,1758
20,90,20,395,430,825,1758
0,90,40,395,430,825,1758
-140,90,180,395,430,825,1758
-160,80,-160,405,420,825,1699
130,70,-20,396,430,826,1775
-160,-70,-50,403,423,826,1813
140,80,-80,384,442,826,1785
-150,-60,-70,398,428,826,1816
-150,-60,-110,390,436,826,1772
-170,-80,-30,400,426,826,1801
-160,0,-110,410,416,826,1609
-170,-10,10,413,413,826,1647
170,80,-110,394,432,826,1824
-170,-10,20,401,425,826,1616
-50,-80,110,401,425,826,1817
170,80,-90,391,435,826,1829
-10,-40,130,402,424,826,1691
-140,80,-20,420,406,826,1692
110,80,100,429,398,827,1761
120,80,-20,402,425,827,1772
120,10,-170,402,425,827,1707
-20,30,-170,424,403,827,1732
90,-80,90,396,431,827,1696
10,70,60,393,434,827,1776
-160,-60,-30,401,426,827,1724
100,-40,40,401,426,827,1737
-60,-70,-30,406,421,827,1678
70,40,160,405,422,827,1675
150,70,-70,386,441,827,1782
-160,50,-130,401,426,827,1748
-30,30,90,413,414,827,1809
130,70,80,415,412,827,1740
150,80,-90,390,437,827,1781
-160,-10,-110,399,428,827,1644
-10,-70,140,394,433,827,1788
-10,-40,60,397,431,828,1845
-30,80,170,418,410,828,1709
-20,-60,50,403,425,828,1758
10,-30,-130,413,415,828,1622
-180,0,-20,390,438,828,1721
-170,50,-140,395,433,828,1797
140,70,-40,392,436,828,1831
-10,0,150,412,416,828,1721
180,0,-20,390,438,828,1721
30,-10,-130,403,425,828,1680
-120,-70,-60,402,427,829,1775
0,60,60,389,440,829,1804
170,40,-70,388,441,829,1817
-100,-80,110,420,409,829,1701
-20,0,-180,416,413,829,1717
150,60,-20,402,427,829,1813
-40,-70,20,404,425,829,1767
-160,-60,-40,408,421,829,1793
110,10,140,404,425,829,1692
-150,-60,30,413,416,829,1752
-20,0,180,416,413,829,1717
0,60,40,393,436,829,1796
150,-80,10,417,413,830,1636
-20,-20,60,400,430,830,1736
60,40,170,411,419,830,1734
-130,-80,-10,415,415,830,1797
140,80,-50,402,428,830,1912
-30,-50,100,411,419,830,1817
-30,-30,20,407,423,830,1707
-160,20,-110,411,419,830,1681
150,80,-80,390,440,830,1870
10,80,60,405,425,830,1803
-10,-40,-150,426,404,830,1689
-170,40,-150,401,429,830,1770
-160,-20,-90,404,426,830,1670
140,40,-150,402,428,830,1738
-160,0,-100,408,423,831,1579
160,60,-70,392,439,831,1906
-20,80,30,416,415,831,1683
-10,-80,-150,417,414,831,1686
110,80,10,413,418,831,1796
150,60,-10,405,426,831,1820
0,50,-160,425,406,831,1706
-100,80,120,409,422,831,1801
-130,-70,-80,402,429,831,1811
160,50,-60,381,450,831,1849
-10,30,110,398,433,831,1722
160,80,-100,389,442,831,1802
10,80,90,403,429,832,1708
120,0,120,400,432,832,1651
-20,-80,120,394,438,832,1786
-10,70,120,392,440,832,1688
170,40,40,416,416,832,1733
70,80,140,426,406,832,1750
60,-30,0,392,440,832,1767
130,-10,100,404,428,832,1756
-10,-20,150,410,423,833,1761
100,80,110,439,394,833,1747
-180,-20,-30,390,443,833,1788
180,-20,-30,390,443,833,1788
-10,-30,150,402,431,833,1869
-170,70,10,422,411,833,1685
-160,30,-120,406,427,833,1687
150,60,-50,401,432,833,1784
80,-80,80,401,432,833,1715
110,-40,50,399,434,833,1777
150,80,-10,415,418,833,1807
90,20,160,404,429,833,1783
-50,-70,20,416,418,834,1777
150,80,-60,400,434,834,1945
20,80,30,392,442,834,1924
-180,70,-120,392,442,834,1736
-10,80,130,401,433,834,1686
180,70,-120,392,442,834,1736
120,-70,120,403,431,834,1699
100,80,20,405,429,834,1779
170,-60,30,412,422,834,1632
160,70,-70,400,434,834,1877
180,-10,-50,388,446,834,1763
130,80,-40,404,430,834,1905
170,-10,-160,408,426,834,1779
-180,-10,-50,388,446,834,1763
-10,30,30,403,431,834,1645
-40,-80,90,397,437,834,1838
-40,-70,130,405,429,834,1898
170,-50,-170,403,431,834,1646
-10,70,110,418,416,834,1739
-10,10,100,397,438,835,1815
-20,10,30,417,418,835,1655
-60,-70,50,415,420,835,1887
-160,10,-100,406,429,835,1672
80,40,150,398,437,835,1740
10,40,0,406,429,835,1724
-10,50,50,404,431,835,1908
110,50,110,402,433,835,1696
-150,-80,-20,413,422,835,1863
30,80,30,393,443,836,1861
110,80,0,417,419,836,1716
-160,-60,-60,401,435,836,1820
-130,-70,-40,420,416,836,1791
-40,80,-120,438,398,836,1693
-40,-80,-30,402,434,836,1677
-50,-70,70,418,418,836,1948
60,80,150,428,408,836,1811
170,60,-70,400,436,836,1929
-140,-70,-40,405,432,837,1883
150,-30,30,390,447,837,1723
-150,-70,-130,409,428,837,1694
130,-60,0,408,429,837,1674
20,20,-160,419,418,837,1723
60,30,-80,393,444,837,1759
120,-40,90,416,421,837,1780
-10,40,110,400,437,837,1766
70,-80,70,403,434,837,1763
-170,60,-130,393,444,837,1725
-170,60,-150,397,440,837,1831
-20,0,-170,417,420,837,1692
-10,50,80,411,426,837,1898
-160,-10,-100,406,432,838,1599
170,20,-40,395,443,838,1798
-30,-60,60,419,419,838,1800
-180,10,30,424,414,838,1697
-10,70,-150,438,400,838,1781
0,70,80,400,438,838,1747
-40,-60,170,433,405,838,1766
180,10,30,424,414,838,1697
50,-50,-80,412,426,838,1769
-140,-70,-100,385,453,838,1865
-160,70,170,416,422,838,1519
90,-50,50,408,430,838,1858
-10,-10,90,403,436,839,1806
160,50,-20,402,437,839,1775
10,80,70,410,429,839,1823
-140,-50,-80,407,432,839,1756
0,80,110,423,416,839,1755
-120,-80,0,417,422,839,1811
120,80,0,418,421,839,1803
-20,-40,-160,419,420,839,1781
-20,10,90,414,425,839,1742
160,40,-30,403,437,840,1793
130,70,-10,401,439,840,1822
-160,-50,-40,409,431,840,1757
-170,60,-120,398,442,840,1800
-160,80,-150,405,435,840,1755
180,-50,-160,419,422,841,1645
0,60,50,395,446,841,1831
-150,-60,50,426,415,841,1839
-60,-80,60,409,432,841,1884
10,70,40,397,444,841,1960
-10,40,60,397,444,841,1786
-180,-50,-160,419,422,841,1645
-180,0,-40,397,444,841,1771
60,80,-60,418,423,841,1703
100,40,-130,400,441,841,1671
20,80,40,394,447,841,1810
160,10,-160,412,429,841,1696
180,0,-40,397,444,841,1771
10,80,50,395,446,841,1815
-20,-30,120,414,427,841,1778
-20,30,180,421,421,842,1809
170,30,40,421,421,842,1666
160,40,-50,387,455,842,1793
-20,30,-180,421,421,842,1809
-10,10,150,418,424,842,1806
10,80,40,396,446,842,1928
-50,80,-160,407,435,842,1728
60,-80,60,401,441,842,1807
90,-60,70,408,434,842,1844
120,80,-120,405,437,842,1572
-40,70,-140,431,411,842,1766
110,-40,0,393,450,843,1818
-180,20,-10,411,432,843,1802
160,40,-40,394,449,843,1900
40,-40,10,413,430,843,1988
-110,-80,10,417,426,843,1821
-10,40,40,402,441,843,1826
0,80,70,412,431,843,1811
180,20,-10,411,432,843,1802
-10,0,10,410,433,843,1666
-170,50,0,414,430,844,1793
-180,70,-110,399,445,844,1836
-180,-10,-30,396,448,844,1790
-10,-40,70,406,438,844,1943
-110,-70,-40,407,437,844,1763
150,60,-40,398,446,844,1780
-90,80,110,413,431,844,1796
180,70,-110,399,445,844,1836
130,-20,160,395,449,844,1700
-170,-60,-20,411,433,844,1812
180,-10,-30,396,448,844,1790
-10,-10,150,424,421,845,1797
160,90,-80,411,434,845,1930
10,90,70,411,434,845,1930
120,90,-40,411,434,845,1930
-10,80,120,421,424,845,1781
-100,90,180,411,434,845,1930
-40,90,120,411,434,845,1930
-170,0,20,414,431,845,1655
-10,0,130,414,431,845,1856
-70,-70,40,420,425,845,1852
50,90,30,411,434,845,1930
110,90,-30,411,434,845,1930
-100,90,-180,411,434,845,1930
180,90,-100,411,434,845,1930
-80,90,160,411,434,845,1930
-130,-70,-90,399,446,845,1861
130,90,-50,411,434,845,1930
-120,90,-160,411,434,845,1930
-20,-50,80,420,425,845,1864
60,90,20,411,434,845,1930
-90,90,170,411,434,845,1930
-10,90,90,411,434,845,1930
-70,90,150,411,434,845,1930
-170,60,10,431,414,845,1839
-120,-80,40,410,435,845,1840
-150,90,-130,411,434,845,1930
-140,90,-140,411,434,845,1930
-30,90,110,411,434,845,1930
150,90,-70,411,434,845,1930
20,90,60,411,434,845,1930
-20,90,100,411,434,845,1930
40,90,40,411,434,845,1930
-50,90,130,411,434,845,1930
30,90,50,411,434,845,1930
-130,90,-150,411,434,845,1930
-160,-30,20,416,429,845,1773
140,90,-60,411,434,845,1930
-60,90,140,411,434,845,1930
-180,90,-100,411,434,845,1930
-150,-50,-80,411,434,845,1840
70,90,10,411,434,845,1930
0,90,80,411,434,845,1930
-170,10,-80,425,420,845,1763
130,80,-30,410,435,845,1805
170,90,-90,411,434,845,1930
-170,90,-110,411,434,845,1930
-10,-40,80,400,445,845,1865
-110,90,-170,411,434,845,1930
100,90,-20,411,434,845,1930
90,90,-10,411,434,845,1930
-160,90,-120,411,434,845,1930
80,90,0,411,434,845,1930
-100,-80,20,416,430,846,1851
40,-30,0,405,441,846,1741
-20,-20,-170,421,425,846,1712
-70,-70,-30,404,442,846,1763
-150,-50,-110,410,436,846,1793
-10,60,90,404,442,846,1862
-140,-50,-90,400,446,846,1757
0,70,70,412,435,847,1778
-20,-30,0,403,444,847,1820
-120,80,-80,421,426,847,1819
100,-80,100,405,442,847,1747
150,70,-50,408,440,848,1908
20,0,-150,409,439,848,1763
-160,-60,-20,398,450,848,1783
-170,50,-110,419,429,848,1756
-20,-50,150,411,437,848,1829
140,70,-30,414,434,848,1833
-60,-70,20,410,438,848,1764
-110,-70,80,419,429,848,1747
180,0,-30,401,448,849,1700
20,90,50,404,445,849,1853
-90,80,-110,421,428,849,1832
-30,90,100,404,445,849,1853
-180,90,-110,404,445,849,1853
-110,90,-180,404,445,849,1853
40,90,30,404,445,849,1853
-140,90,-150,404,445,849,1853
-170,90,-120,404,445,849,1853
100,90,-30,404,445,849,1853
-80,-80,40,413,436,849,1876
130,90,-60,404,445,849,1853
-150,80,-170,406,443,849,1766
-90,90,160,404,445,849,1853
180,90,-110,404,445,849,1853
-180,0,-30,401,448,849,1700
-150,90,-140,404,445,849,1853
60,90,10,404,445,849,1853
70,90,0,404,445,849,1853
-120,90,-170,404,445,849,1853
50,90,20,404,445,849,1853
-110,90,180,404,445,849,1853
120,80,10,414,435,849,1801
70,20,-170,397,452,849,1807
-60,90,130,404,445,849,1853
-10,20,-160,425,424,849,1771
-130,90,-160,404,445,849,1853
160,60,-60,399,450,849,1835
-80,90,150,404,445,849,1853
-100,90,170,404,445,849,1853
-20,90,90,404,445,849,1853
150,90,-80,404,445,849,1853
-170,-10,0,416,433,849,1682
170,90,-100,404,445,849,1853
10,-20,0,417,432,849,1983
-70,90,140,404,445,849,1853
-50,90,120,404,445,849,1853
-150,-40,-90,411,438,849,1765
140,90,-70,404,445,849,1853
110,90,-40,404,445,849,1853
-150,-70,-20,417,432,849,1781
160,90,-90,404,445,849,1853
-160,90,-130,404,445,849,1853
10,90,60,404,445,849,1853
90,90,-20,404,445,849,1853
120,90,-50,404,445,849,1853
-10,90,80,404,445,849,1853
110,30,120,402,447,849,1790
10,80,30,399,450,849,1835
-40,90,110,404,445,849,1853
80,90,-10,404,445,849,1853
30,90,40,404,445,849,1853
0,90,70,404,445,849,1853
-150,70,-180,413,437,850,1811
-10,-20,100,419,431,850,1883
0,50,10,403,447,850,1748
10,-60,10,409,441,850,1935
-20,-70,-160,431,419,850,1744
0,30,-160,429,421,850,1726
-180,20,-60,404,446,850,1861
-160,-60,-50,404,446,850,1848
-90,-80,30,415,435,850,1885
-10,20,20,406,444,850,1638
-30,-70,100,412,438,850,1825
-150,70,180,413,437,850,1811
-110,-70,-30,421,429,850,1798
180,20,-60,404,446,850,1861
-140,-80,-10,423,427,850,1897
10,80,80,409,441,850,1761
-160,-80,-20,417,433,850,1901
150,70,-10,414,436,850,1861
160,10,50,411,439,850,1760
-10,70,130,407,443,850,1729
150,-60,160,409,441,850,1755
-10,-20,90,410,441,851,1921
-160,-50,10,415,436,851,1845
-160,50,-140,413,438,851,1685
-180,80,-100,400,451,851,1897
120,80,90,444,407,851,1791
-180,40,-160,414,437,851,1657
-50,-80,80,415,436,851,1888
-140,80,150,424,427,851,1669
-30,-60,100,424,427,851,1834
180,40,-160,414,437,851,1657
120,80,-10,428,423,851,1764
-40,80,180,428,423,851,1750
-40,80,-180,428,423,851,1750
180,80,-100,400,451,851,1897
-10,20,150,414,437,851,1733
-30,-80,120,409,442,851,1909
-80,80,100,415,436,851,1811
-170,0,-70,427,424,851,1814
130,10,100,416,435,851,1810
170,50,40,431,420,851,1749
60,-30,-60,411,440,851,1815
-130,80,-30,433,418,851,1750
-70,-80,50,410,441,851,1922
160,80,-90,401,450,851,1948
-150,90,-80,423,429,852,1751
140,90,-10,423,429,852,1751
-70,80,100,415,437,852,1843
-140,90,-90,423,429,852,1751
20,90,110,423,429,852,1751
170,90,-40,423,429,852,1751
-60,90,-170,423,429,852,1751
30,90,100,423,429,852,1751
50,80,160,433,419,852,1860
90,90,40,423,429,852,1751
0,90,130,423,429,852,1751
-120,90,-110,423,429,852,1751
-160,0,-90,415,437,852,1674
-80,-70,110,430,422,852,1843
-80,90,-150,423,429,852,1751
-10,40,150,413,439,852,1883
-10,40,50,400,452,852,1847
-100,80,130,411,441,852,1768
50,90,80,423,429,852,1751
-100,90,-130,423,429,852,1751
160,90,-30,423,429,852,1751
130,90,0,423,429,852,1751
-10,90,140,423,429,852,1751
110,90,20,423,429,852,1751
-70,90,-160,423,429,852,1751
-140,-60,50,432,420,852,1812
-160,90,-70,423,429,852,1751
40,90,90,423,429,852,1751
-150,-80,-10,418,434,852,1977
150,90,-20,423,429,852,1751
80,90,50,423,429,852,1751
60,90,70,423,429,852,1751
-30,90,160,423,429,852,1751
-30,-80,110,405,447,852,1857
-170,70,-30,425,427,852,1693
-90,90,-140,423,429,852,1751
-110,90,-120,423,429,852,1751
-20,-40,40,431,421,852,1898
-170,90,-60,423,429,852,1751
180,90,-50,423,429,852,1751
-180,90,-50,423,429,852,1751
-50,90,-180,423,429,852,1751
-130,90,-100,423,429,852,1751
70,90,60,423,429,852,1751
-40,-60,0,425,427,852,1764
-20,90,150,423,429,852,1751
100,90,30,423,429,852,1751
-50,80,70,412,440,852,1851
10,90,120,423,429,852,1751
-50,90,180,423,429,852,1751
0,70,40,395,457,852,1954
120,90,10,423,429,852,1751
-40,90,170,423,429,852,1751
-30,-60,20,410,443,853,1889
50,-60,30,406,447,853,1921
-170,-30,-10,421,432,853,1850
-30,-30,30,429,424,853,1844
-20,20,50,412,441,853,1831
-180,10,-50,411,442,853,1750
-10,60,140,419,434,853,1707
-160,-40,10,426,427,853,1785
-70,-70,-40,414,439,853,1743
-150,-80,0,412,441,853,1837
-10,-10,110,419,434,853,1845
180,10,-50,411,442,853,1750
150,10,60,407,446,853,1864
-120,-70,-30,431,422,853,1857
-20,-40,120,411,442,853,1843
80,-30,-20,384,470,854,1979
-20,-50,-160,444,410,854,1831
-170,-80,-160,406,448,854,1691
-60,-70,10,423,431,854,1892
40,-50,-90,416,438,854,1861
-150,-70,-30,402,452,854,1846
-10,80,80,422,432,854,1816
60,30,-90,401,453,854,1668
110,-50,80,411,443,854,1892
-10,0,-160,430,424,854,1824
80,-30,-10,390,464,854,1917
160,-70,170,400,455,855,1699
0,80,100,420,435,855,1789
-10,50,70,406,449,855,1811
50,-80,50,411,444,855,1855
130,-20,80,428,427,855,1776
-130,-60,-70,418,437,855,1808
-10,-30,70,422,433,855,1916
80,-50,40,411,444,855,1932
170,0,40,413,442,855,1783
170,10,40,410,446,856,1749
-140,-70,-110,411,445,856,1702
-120,-70,60,420,436,856,1865
180,80,-120,407,449,856,1899
-20,10,-170,428,428,856,1746
-10,-30,90,418,438,856,1882
-30,60,-150,444,412,856,1792
-100,80,-100,423,433,856,1844
170,70,-90,409,447,856,1948
-160,20,-130,412,444,856,1734
130,80,-20,433,423,856,1825
-20,80,150,402,454,856,1739
-130,-60,-60,410,446,856,1845
-100,-70,-30,418,438,856,1856
-130,-70,-30,412,444,856,1889
-20,40,170,425,431,856,1745
-110,80,140,409,447,856,1792
-180,80,-120,407,449,856,1899
-10,90,60,399,458,857,1795
-120,-70,-70,416,441,857,1931
-170,90,-140,399,458,857,1795
-30,70,-140,444,413,857,1745
110,20,130,392,465,857,1696
80,90,-30,399,458,857,1795
-160,-70,-20,403,454,857,1758
-20,80,50,399,458,857,1917
40,90,10,399,458,857,1795
100,90,-50,399,458,857,1795
-60,80,90,416,441,857,1886
70,-40,-50,421,436,857,1777
20,90,30,399,458,857,1795
-70,90,120,399,458,857,1795
-60,90,110,399,458,857,1795
160,90,-110,399,458,857,1795
-90,90,140,399,458,857,1795
-150,90,-160,399,458,857,1795
0,90,50,399,458,857,1795
10,90,40,399,458,857,1795
-10,60,120,419,438,857,1800
-130,90,180,399,458,857,1795
110,90,-60,399,458,857,1795
-120,90,170,399,458,857,1795
-130,90,-180,399,458,857,1795
130,30,90,407,450,857,1889
120,90,-70,399,458,857,1795
-100,90,150,399,458,857,1795
60,-60,-70,415,442,857,1744
100,-40,-10,407,450,857,1847
50,90,0,399,458,857,1795
150,90,-100,399,458,857,1795
-20,90,70,399,458,857,1795
180,90,-130,399,458,857,1795
60,90,-10,399,458,857,1795
-30,90,80,399,458,857,1795
0,40,-160,433,424,857,1760
90,90,-40,399,458,857,1795
130,90,-80,399,458,857,1795
80,30,160,421,436,857,1818
140,90,-90,399,458,857,1795
-140,90,-170,399,458,857,1795
-180,90,-130,399,458,857,1795
-80,90,130,399,458,857,1795
-110,90,160,399,458,857,1795
30,90,20,399,458,857,1795
70,90,-20,399,458,857,1795
140,70,-10,417,440,857,1958
170,90,-120,399,458,857,1795
-160,90,-150,399,458,857,1795
-40,90,90,399,458,857,1795
-50,90,100,399,458,857,1795
-10,-70,130,411,447,858,1862
160,80,-70,414,444,858,2021
-60,-70,30,430,428,858,1798
170,70,-80,409,449,858,1916
0,80,60,409,449,858,1872
-160,-20,-120,415,443,858,1834
-170,60,-10,415,443,858,1708
-20,-20,70,415,443,858,1880
-170,80,-40,427,431,858,1851
-60,-70,40,436,422,858,1838
-20,-80,-160,427,431,858,1754
-30,50,-160,438,420,858,1767
-10,-40,150,425,433,858,1955
-20,80,130,423,435,858,1806
150,60,-30,416,443,859,1783
-20,80,140,416,443,859,1733
50,20,-50,395,464,859,1714
-160,40,-140,399,460,859,1768
-10,-60,-150,435,424,859,1836
-150,-60,-60,413,446,859,1938
140,70,70,436,423,859,1823
140,-10,70,429,430,859,1787
-50,70,-140,434,425,859,1874
100,-50,60,427,432,859,1865
170,60,-80,409,450,859,1981
160,-80,20,433,426,859,1722
-10,0,100,407,452,859,1838
-20,-30,50,426,433,859,1915
-130,-90,90,437,423,860,1796
-60,-90,160,437,423,860,1796
-50,-90,170,437,423,860,1796
150,-90,10,437,423,860,1796
110,-90,-30,437,423,860,1796
-150,-90,70,437,423,860,1796
-20,-90,-160,437,423,860,1796
-80,-90,140,437,423,860,1796
30,-90,-110,437,423,860,1796
90,-90,-50,437,423,860,1796
120,-10,140,409,451,860,1876
170,50,-70,405,455,860,2015
170,-90,30,437,423,860,1796
120,-90,-20,437,423,860,1796
30,20,-160,426,434,860,1808
-110,-70,-50,415,445,860,1854
-180,-90,40,437,423,860,1796
-160,-90,60,437,423,860,1796
-90,-90,130,437,423,860,1796
130,-90,-10,437,423,860,1796
-40,-90,-180,437,423,860,1796
-60,-80,100,422,438,860,1900
80,-90,-60,437,423,860,1796
-170,-90,50,437,423,860,1796
-10,-60,130,422,438,860,1954
160,-90,20,437,423,860,1796
-40,-90,180,437,423,860,1796
60,-90,-80,437,423,860,1796
-120,-90,100,437,423,860,1796
-10,20,110,411,449,860,1843
70,-90,-70,437,423,860,1796
140,-90,0,437,423,860,1796
40,20,-30,401,459,860,1804
10,-90,-130,437,423,860,1796
-70,-90,150,437,423,860,1796
70,60,-80,421,439,860,1727
-30,-90,-170,437,423,860,1796
-10,70,100,420,440,860,1872
-110,-90,110,437,423,860,1796
160,60,50,442,418,860,1805
40,-90,-100,437,423,860,1796
-30,80,40,431,429,860,1778
100,-90,-40,437,423,860,1796
50,-90,-90,437,423,860,1796
-10,-90,-150,437,423,860,1796
180,-90,40,437,423,860,1796
-100,-90,120,437,423,860,1796
0,-90,-140,437,423,860,1796
-140,-90,80,437,423,860,1796
20,-90,-120,437,423,860,1796
110,-60,100,407,454,861,1913
-110,-80,50,414,447,861,1905
-20,30,70,421,440,861,1899
-160,10,-120,423,438,861,1717
-50,-60,140,442,419,861,1759
170,70,-20,427,434,861,1808
130,30,-150,421,440,861,1921
0,80,80,416,445,861,1874
-10,70,40,413,448,861,1898
110,90,-50,409,453,862,1891
120,90,-60,409,453,862,1891
60,90,0,409,453,862,1891
20,90,40,409,453,862,1891
-130,90,-170,409,453,862,1891
-20,90,80,409,453,862,1891
-150,90,-150,409,453,862,1891
-60,90,120,409,453,862,1891
30,90,30,409,453,862,1891
160,90,-100,409,453,862,1891
-30,10,70,436,426,862,1756
-90,90,150,409,453,862,1891
-80,90,140,409,453,862,1891
0,90,60,409,453,862,1891
-180,90,-120,409,453,862,1891
90,90,-30,409,453,862,1891
-100,90,160,409,453,862,1891
-40,-50,170,428,434,862,1830
110,-40,60,420,442,862,1888
180,90,-120,409,453,862,1891
-100,-70,90,430,432,862,1820
10,90,50,409,453,862,1891
-10,90,70,409,453,862,1891
-110,90,170,409,453,862,1891
180,50,-90,409,453,862,1877
-160,-40,-40,415,447,862,1858
-160,90,-140,409,453,862,1891
-180,50,-90,409,453,862,1877
-30,90,90,409,453,862,1891
-150,-70,60,432,430,862,1825
60,-10,-50,409,453,862,1720
-170,90,-130,409,453,862,1891
50,90,10,409,453,862,1891
-70,90,130,409,453,862,1891
100,90,-40,409,453,862,1891
-140,90,-160,409,453,862,1891
150,90,-90,409,453,862,1891
-120,90,-180,409,453,862,1891
-50,90,110,409,453,862,1891
80,90,-20,409,453,862,1891
140,90,-80,409,453,862,1891
-120,90,180,409,453,862,1891
40,90,20,409,453,862,1891
-40,90,100,409,453,862,1891
70,90,-10,409,453,862,1891
130,90,-70,409,453,862,1891
170,90,-110,409,453,862,1891
-60,-70,-10,426,437,863,1847
140,80,-20,433,430,863,1838
-150,-50,40,434,429,863,1862
20,30,-10,430,433,863,1784
-170,-50,-20,411,452,863,1887
-30,-40,20,435,428,863,1820
-30,20,80,426,437,863,1731
-170,40,-100,424,439,863,1752
-10,80,70,415,448,863,1881
-60,-70,60,438,426,864,1950
160,80,-20,426,438,864,1897
-140,-60,-100,408,456,864,1921
-40,-60,80,427,437,864,1907
30,-30,0,414,450,864,1896
-10,20,140,433,432,865,1892
170,0,-160,420,445,865,1662
110,-80,110,414,451,865,1804
-180,60,-100,401,464,865,1846
-10,-50,130,428,437,865,1999
180,60,-100,401,464,865,1846
-110,-70,90,431,434,865,1762
120,30,110,403,462,865,1784
-140,70,-30,429,436,865,1806
-50,80,-110,453,412,865,1763
-170,70,-120,412,454,866,1881
170,80,-100,408,458,866,1943
-170,-20,30,423,443,866,1700
-20,-10,80,424,442,866,1924
-30,50,110,421,445,866,1903
120,-50,110,416,450,866,1861
0,-40,0,424,442,866,1750
40,80,170,445,421,866,1910
50,10,-150,409,457,866,1905
-20,-10,-170,428,438,866,1704
-30,-40,-180,440,426,866,1814
20,-70,20,432,434,866,1984
-10,80,110,432,434,866,1829
170,60,-10,418,448,866,1819
-50,80,80,417,449,866,1935
-30,-40,180,440,426,866,1814
-170,70,-140,415,452,867,1853
130,80,-10,433,434,867,1813
150,80,-50,419,448,867,1859
130,80,0,421,446,867,1884
-10,-10,100,417,450,867,1878
-150,-60,-120,415,452,867,1861
-60,80,80,417,450,867,1878
-110,80,-90,425,442,867,1852
-90,80,120,422,445,867,1781
-40,-70,90,423,444,867,1902
120,0,130,400,467,867,1629
140,70,-20,421,446,867,1902
-10,-30,80,416,452,868,1959
-130,-80,0,426,442,868,1928
-20,30,-160,445,423,868,1860
-50,-70,10,424,444,868,1879
-150,-50,-70,412,456,868,1952
-30,-50,90,434,434,868,1901
150,70,-40,422,446,868,1891
-50,-80,-40,415,453,868,1726
-160,40,-120,418,450,868,1729
-20,60,-150,460,408,868,1782
60,10,-140,411,457,868,1800
-160,70,-160,410,458,868,1841
-180,70,-90,415,453,868,1966
90,-50,-30,417,451,868,1879
-170,-20,-10,422,446,868,1825
180,70,-90,415,453,868,1966
-170,70,-130,411,458,869,1811
170,30,-50,412,457,869,1888
120,50,100,422,447,869,1767
-160,-30,-80,423,446,869,1782
-160,70,0,445,424,869,1805
0,70,60,418,451,869,1854
40,60,-40,413,456,869,1731
130,-30,30,417,452,869,1899
-100,-80,60,418,451,869,1952
-30,80,60,412,457,869,1966
130,80,80,454,415,869,1812
-150,-70,-40,415,454,869,1916
-170,80,-130,414,456,870,1968
-50,-70,160,445,425,870,1859
160,60,-10,421,449,870,1921
-60,-80,70,424,446,870,1922
180,80,-110,412,458,870,1953
100,10,170,411,459,870,1837
-10,10,-160,443,427,870,1811
-20,-20,130,433,437,870,1886
-10,-60,140,421,449,870,1911
-30,-70,130,428,442,870,1969
-180,80,-110,412,458,870,1953
-50,70,-150,434,436,870,1876
70,30,170,433,437,870,1924
-20,-20,170,436,435,871,1932
0,80,40,403,468,871,1921
-10,-10,-160,427,444,871,1811
-60,80,-100,449,422,871,1796
-150,80,-160,423,448,871,1843
-70,80,90,427,444,871,1859
40,70,-40,432,439,871,1735
-10,50,120,433,438,871,1890
140,80,-40,418,453,871,1855
-90,-70,100,437,435,872,1898
-40,-80,100,409,463,872,1908
-20,-30,110,445,427,872,1903
180,60,-170,445,427,872,1739
0,70,50,409,463,872,2023
-160,-50,-30,414,458,872,1818
-60,-70,0,425,447,872,1911
80,20,-180,415,457,872,1868
-150,70,-40,438,434,872,1801
-60,-60,140,439,433,872,1915
140,-40,20,416,456,872,1864
40,-80,40,419,453,872,1931
80,20,180,415,457,872,1868
170,70,-70,438,434,872,2007
-10,40,120,422,450,872,1773
-10,-20,80,423,449,872,1825
-180,60,-170,445,427,872,1739
-10,50,40,418,454,872,1902
160,70,-60,432,440,872,1971
-120,80,-40,448,424,872,1807
-70,-70,0,424,448,872,1942
0,90,120,434,439,873,1777
-60,90,-180,434,439,873,1777
-20,90,140,434,439,873,1777
-90,90,-150,434,439,873,1777
120,90,0,434,439,873,1777
-170,90,-70,434,439,873,1777
50,90,70,434,439,873,1777
160,90,-40,434,439,873,1777
160,0,50,422,451,873,1798
-70,-70,30,435,438,873,1900
10,90,110,434,439,873,1777
40,50,-180,438,435,873,1747
-160,90,-80,434,439,873,1777
150,90,-30,434,439,873,1777
-50,90,170,434,439,873,1777
-120,90,-120,434,439,873,1777
40,90,80,434,439,873,1777
-60,90,180,434,439,873,1777
-110,90,-130,434,439,873,1777
-180,90,-60,434,439,873,1777
-30,90,150,434,439,873,1777
-80,90,-160,434,439,873,1777
-40,90,160,434,439,873,1777
-30,-20,20,426,447,873,1743
-100,90,-140,434,439,873,1777
-10,90,130,434,439,873,1777
-180,10,-10,429,444,873,1880
-130,90,-110,434,439,873,1777
180,10,-10,429,444,873,1880
140,90,-20,434,439,873,1777
170,90,-50,434,439,873,1777
-140,90,-100,434,439,873,1777
130,90,-10,434,439,873,1777
90,90,30,434,439,873,1777
60,90,60,434,439,873,1777
40,50,180,438,435,873,1747
20,90,100,434,439,873,1777
30,90,90,434,439,873,1777
70,90,50,434,439,873,1777
0,80,90,421,452,873,1803
-30,40,100,421,452,873,1928
-70,90,-170,434,439,873,1777
-150,90,-90,434,439,873,1777
100,90,20,434,439,873,1777
80,90,40,434,439,873,1777
180,90,-60,434,439,873,1777
110,90,10,434,439,873,1777
-80,-70,-40,430,444,874,1791
60,10,-130,426,448,874,1849
-70,-70,130,440,434,874,1860
-30,0,70,445,429,874,1775
-30,-50,150,443,431,874,1894
-60,-70,120,427,447,874,1776
-20,-60,140,417,457,874,1966
130,80,-130,423,451,874,1652
-170,-50,40,428,446,874,1730
-180,-10,-40,410,464,874,1912
50,80,-50,427,447,874,1785
180,-10,-40,410,464,874,1912
-170,0,10,431,444,875,1774
80,-40,20,430,445,875,1945
160,80,-60,419,456,875,1916
0,80,50,414,461,875,1958
30,-20,-110,428,447,875,1673
60,-10,-30,414,461,875,1918
-150,-30,-110,431,444,875,1841
-40,-50,160,449,426,875,1870
-40,80,70,413,463,876,1979
-140,80,-180,423,453,876,1817
30,40,-170,444,432,876,1840
80,-60,50,438,438,876,1850
-10,10,140,440,436,876,1906
-130,70,-50,438,438,876,1840
-30,-10,60,450,426,876,1831
130,20,100,419,457,876,1922
-140,80,180,423,453,876,1817
80,50,-100,424,452,876,1688
-10,50,60,412,464,876,1896
170,80,-80,425,451,876,2027
140,80,-10,423,453,876,1900
-20,70,40,434,443,877,1880
-20,-70,-10,436,441,877,1926
30,80,-180,449,428,877,1943
30,80,180,449,428,877,1943
-80,80,110,425,452,877,1805
-20,-70,130,415,462,877,1951
-80,-70,-50,416,461,877,1830
-160,-40,-50,432,445,877,1908
-170,-40,-30,424,453,877,1944
-10,30,140,432,445,877,1879
140,80,-30,445,432,877,1848
-80,-70,-10,425,452,877,1923
160,70,-160,432,446,878,1670
-10,60,70,422,456,878,1898
-70,-80,90,425,453,878,1941
-30,-50,110,430,448,878,1875
-20,-50,40,427,451,878,2047
40,50,-40,398,480,878,1764
-10,60,20,420,458,878,1777
50,-10,-80,405,473,878,1776
-40,-80,110,418,460,878,2023
-20,20,100,438,440,878,1812
-160,80,-50,427,451,878,1916
-170,-50,-150,432,446,878,1695
160,50,-50,415,464,879,1909
-20,-40,90,438,441,879,1918
150,-20,40,429,450,879,1975
-30,70,170,423,456,879,1774
130,40,90,426,453,879,1920
-160,-40,-70,433,446,879,1888
-80,80,-80,458,421,879,1855
120,-40,10,415,464,879,1916
-10,50,140,418,461,879,1866
-60,-80,-50,427,452,879,1729
-40,-60,70,439,440,879,1912
-90,-70,-20,426,453,879,1882
-30,0,60,441,438,879,1794
-10,70,80,432,447,879,1867
-10,60,40,410,469,879,1973
-30,80,150,427,452,879,1776
-20,0,90,439,440,879,1894
-140,-80,10,427,452,879,1897
-10,10,110,416,464,880,1931
20,70,-170,450,430,880,1944
-160,-10,-120,424,456,880,1782
-170,-10,-10,419,461,880,1823
-120,-70,-90,427,453,880,1825
-70,-70,10,423,457,880,1832
20,-10,-140,425,455,880,1771
-50,-70,-30,436,444,880,1788
-10,0,120,428,453,881,1853
-80,-80,80,426,455,881,1960
-160,-80,-150,426,455,881,1768
-140,-80,0,436,445,881,2057
70,-60,40,432,449,881,1879
-90,-80,70,421,460,881,1977
140,-50,150,411,470,881,1838
-180,30,-70,410,471,881,1940
130,-20,100,427,454,881,1841
-20,80,80,427,454,881,1901
-170,20,10,444,437,881,1918
-30,-60,140,437,444,881,1986
160,80,-40,443,438,881,1886
-130,-70,-100,427,454,881,1800
-10,60,80,429,452,881,1883
180,70,-100,414,467,881,1971
10,-10,0,428,453,881,1977
180,30,-70,410,471,881,1940
-180,70,-100,414,467,881,1971
-10,70,20,435,447,882,1698
-180,30,-60,423,459,882,1951
180,30,-60,423,459,882,1951
-180,40,-80,418,464,882,1953
140,80,70,456,426,882,1865
130,-30,50,416,466,882,1788
-120,-70,-80,423,459,882,1914
180,40,-80,418,464,882,1953
-20,40,110,441,441,882,1839
-50,-70,120,431,452,883,1971
-50,-60,-20,453,430,883,1795
-70,-80,60,435,448,883,1913
180,50,-10,436,447,883,1686
-10,80,90,430,453,883,1940
-50,70,-130,452,431,883,1868
170,40,-60,418,465,883,1977
-160,60,180,439,444,883,1702
20,-30,0,431,452,883,2000
-20,80,90,443,440,883,1847
-80,-70,30,445,438,883,1910
-120,-80,10,431,452,883,1914
-180,50,-10,436,447,883,1686
-150,-70,0,408,475,883,1850
-160,60,-180,439,444,883,1702
-90,80,-70,464,420,884,1834
-80,90,-180,437,447,884,1856
-60,80,-150,433,451,884,1842
150,-40,170,412,472,884,1906
-150,90,-110,437,447,884,1856
-40,90,140,437,447,884,1856
170,90,-70,437,447,884,1856
70,90,30,437,447,884,1856
60,90,40,437,447,884,1856
-170,90,-90,437,447,884,1856
30,-50,10,436,448,884,1949
-160,90,-100,437,447,884,1856
-180,90,-80,437,447,884,1856
-120,90,-140,437,447,884,1856
-80,90,180,437,447,884,1856
170,80,-30,439,445,884,1953
110,90,-10,437,447,884,1856
-100,90,-160,437,447,884,1856
-110,90,-150,437,447,884,1856
160,90,-60,437,447,884,1856
10,90,90,437,447,884,1856
80,90,20,437,447,884,1856
120,90,-20,437,447,884,1856
140,90,-40,437,447,884,1856
50,90,50,437,447,884,1856
-60,90,160,437,447,884,1856
20,90,80,437,447,884,1856
30,90,70,437,447,884,1856
-130,90,-130,437,447,884,1856
-20,60,120,433,451,884,1884
90,90,10,437,447,884,1856
-140,90,-120,437,447,884,1856
-20,90,120,437,447,884,1856
100,90,0,437,447,884,1856
0,90,100,437,447,884,1856
150,90,-50,437,447,884,1856
-10,90,110,437,447,884,1856
-30,90,130,437,447,884,1856
-50,90,150,437,447,884,1856
40,90,60,437,447,884,1856
-70,90,170,437,447,884,1856
180,90,-80,437,447,884,1856
-90,90,-170,437,447,884,1856
130,90,-30,437,447,884,1856
-100,80,-60,463,422,885,1829
-30,60,120,438,447,885,1872
-170,80,-110,414,471,885,1980
-20,0,140,447,438,885,1819
-20,10,-180,442,443,885,1909
-100,-70,-20,434,451,885,1873
-180,60,-80,424,461,885,2013
140,-30,30,435,450,885,1961
-160,60,-130,427,458,885,1900
-160,-30,10,433,452,885,1793
-20,10,180,442,443,885,1909
-10,70,60,417,468,885,1973
-130,-70,40,426,459,885,1984
180,60,-80,424,461,885,2013
-110,-70,-20,440,445,885,1929
40,-40,-90,422,463,885,1892
-10,60,60,416,470,886,1958
-70,-80,-60,433,453,886,1738
170,30,-30,430,456,886,1922
140,-20,60,439,447,886,1975
-20,50,170,437,449,886,1847
-10,60,130,439,447,886,1938
-110,80,-50,464,422,886,1817
150,80,-20,428,458,886,1931
-20,-20,120,426,461,887,1900
-130,70,150,424,463,887,1749
-20,-10,130,446,441,887,1945
-160,80,-140,425,462,887,1988
-180,80,-70,441,446,887,1941
140,80,-140,430,457,887,1695
-30,-60,50,436,451,887,2002
180,80,-70,441,446,887,1941
-20,60,160,443,444,887,1867
-110,-70,70,439,448,887,1909
140,-10,180,423,465,888,1795
140,-10,-180,423,465,888,1795
-10,80,50,415,473,888,1992
130,-30,40,432,456,888,1944
-70,80,-90,459,429,888,1850
-20,70,120,439,449,888,1865
-40,-60,140,451,437,888,1946
10,30,-160,433,455,888,1840
-120,-70,-20,432,456,888,1954
30,-80,30,427,461,888,2006
160,80,-30,432,456,888,1924
-40,80,50,440,448,888,1883
-160,60,-140,432,456,888,1850
-160,-20,-70,449,439,888,1831
-130,-80,10,441,448,889,2098
-30,-60,110,445,444,889,1912
-40,70,-170,439,450,889,1877
90,40,140,421,468,889,1921
-170,60,-140,409,480,889,1871
-10,-50,140,442,447,889,1980
-90,-70,110,451,438,889,1912
-130,-60,-80,426,463,889,1939
-10,-30,0,421,468,889,1856
60,20,-110,421,468,889,1766
0,-30,0,435,455,890,1863
150,-20,-180,424,466,890,1830
170,80,-70,431,459,890,1944
-70,-70,-20,445,445,890,1906
-20,-60,120,445,445,890,1975
60,-40,10,435,455,890,1911
-20,40,80,429,461,890,2002
-80,-70,-30,448,442,890,1926
150,-20,180,424,466,890,1830
-150,0,-110,441,449,890,1720
-20,80,100,433,458,891,1967
-180,10,-20,434,457,891,1918
-30,80,160,423,468,891,1821
150,80,-30,443,448,891,1895
-100,-70,100,448,443,891,1853
-150,-30,-100,438,453,891,1891
-140,-70,-10,432,459,891,1910
-160,-40,-130,449,442,891,1820
-20,-70,120,420,471,891,1932
120,-80,120,417,474,891,1851
-110,-70,-80,436,455,891,1830
180,10,-20,434,457,891,1918
50,-50,20,448,443,891,2032
150,70,60,438,454,892,1931
-150,-50,-30,442,450,892,1854
-140,-60,-60,435,457,892,1876
-170,-40,-20,418,474,892,1923
-30,-20,40,437,455,892,1936
150,80,-40,442,450,892,1848
160,50,-40,432,460,892,1820
-140,-50,-100,422,470,892,1888
-30,50,-170,454,438,892,1764
-170,-10,-60,436,456,892,1892
50,10,-100,413,480,893,1779
-80,-70,20,447,446,893,1914
-30,-50,20,436,457,893,1999
-170,10,20,453,440,893,1871
-180,70,-80,433,460,893,2018
-20,-30,60,441,452,893,1993
180,70,-80,433,460,893,2018
-170,30,10,439,454,893,1987
100,-60,80,425,468,893,1965
80,-50,-40,443,450,893,1816
170,60,40,457,436,893,1757
30,90,60,436,458,894,1950
90,90,0,436,458,894,1950
-10,90,100,436,458,894,1950
-140,-70,-20,428,466,894,1948
0,90,90,436,458,894,1950
-100,90,-170,436,458,894,1950
-10,30,120,425,469,894,1892
-120,90,-150,436,458,894,1950
-10,50,130,429,465,894,1901
50,90,40,436,458,894,1950
-110,-80,20,439,455,894,1950
160,90,-70,436,458,894,1950
110,90,-20,436,458,894,1950
-160,-10,-90,436,458,894,1785
-40,90,130,436,458,894,1950
-80,90,170,436,458,894,1950
80,90,10,436,458,894,1950
10,90,80,436,458,894,1950
180,90,-90,436,458,894,1950
120,90,-30,436,458,894,1950
60,90,30,436,458,894,1950
70,90,20,436,458,894,1950
40,90,50,436,458,894,1950
-130,90,-140,436,458,894,1950
-20,90,110,436,458,894,1950
150,90,-60,436,458,894,1950
-180,-20,-40,405,489,894,1746
-70,90,160,436,458,894,1950
-40,-60,90,449,445,894,1907
-60,90,150,436,458,894,1950
140,90,-50,436,458,894,1950
-160,90,-110,436,458,894,1950
-10,-40,140,432,462,894,2017
170,90,-80,436,458,894,1950
-50,90,140,436,458,894,1950
-150,-60,-20,437,457,894,1885
-170,90,-100,436,458,894,1950
20,90,70,436,458,894,1950
-30,90,120,436,458,894,1950
-90,90,180,436,458,894,1950
100,90,-10,436,458,894,1950
-140,90,-130,436,458,894,1950
130,90,-40,436,458,894,1950
-150,90,-120,436,458,894,1950
-80,-70,120,458,436,894,1894
-110,90,-160,436,458,894,1950
-80,-80,50,434,460,894,1954
-180,90,-90,436,458,894,1950
180,-20,-40,405,489,894,1746
-170,60,-110,418,476,894,1972
-30,-20,30,436,458,894,1816
-50,80,-170,450,444,894,1832
-90,90,-180,436,458,894,1950
70,-50,30,435,460,895,2017
-50,-80,100,426,469,895,2102
-180,30,-10,442,453,895,1862
170,-50,30,432,463,895,1769
170,80,-60,441,454,895,1901
180,20,30,447,448,895,1807
-40,-50,-10,452,443,895,1906
-90,-70,-50,434,461,895,1845
-20,-30,100,448,447,895,1939
180,30,-10,442,453,895,1862
-30,80,90,435,460,895,1954
-180,20,30,447,448,895,1807
50,-40,10,422,473,895,1945
-150,-70,-10,427,468,895,1868
-140,-60,-50,430,465,895,1976
-30,-40,170,463,433,896,1807
-170,50,10,453,443,896,1950
130,-50,130,418,478,896,1914
-170,80,-120,425,471,896,1959
40,30,-170,452,444,896,1887
-10,70,70,435,461,896,1911
120,-40,80,444,452,896,1876
-150,50,-140,431,465,896,1818
-30,-20,50,442,454,896,1990
160,80,-50,440,457,897,1911
0,-50,0,440,457,897,1840
-130,80,140,443,454,897,1724
-20,20,40,446,451,897,1905
170,50,-60,427,470,897,1988
-150,-70,10,428,469,897,1927
-140,70,170,434,463,897,1903
-20,80,120,450,447,897,1945
0,-30,-140,437,460,897,1804
130,-20,90,440,457,897,1897
130,-60,130,425,472,897,1938
-160,50,-150,423,474,897,1901
-110,-70,-60,433,464,897,2017
60,-10,-40,417,481,898,1892
-140,80,-170,433,465,898,1911
170,-80,30,449,449,898,1803
90,-40,-20,430,468,898,1903
-80,-70,0,435,463,898,1897
170,80,-50,448,450,898,1943
-70,-70,-10,437,461,898,1957
-170,-20,-50,431,467,898,1942
-30,-40,110,434,464,898,1938
50,-60,-80,434,464,898,1881
-30,-10,50,453,445,898,1916
140,-20,170,430,468,898,1758
-10,60,50,430,469,899,2013
-150,50,-150,441,458,899,1874
70,-40,10,442,457,899,1972
-30,-20,60,456,443,899,1930
-90,-70,10,447,452,899,1944
-90,-70,20,453,446,899,1934
-20,-30,130,433,466,899,1855
-160,70,-140,433,466,899,1925
-160,-50,-50,435,464,899,1976
-130,80,170,430,469,899,1886
100,-50,-20,432,467,899,1957
-10,80,60,423,476,899,1937
-40,-60,60,450,449,899,1879
-40,60,-150,459,440,899,1890
140,90,-30,442,458,900,1860
120,90,-10,442,458,900,1860
70,90,40,442,458,900,1860
150,90,-40,442,458,900,1860
10,90,100,442,458,900,1860
130,90,-20,442,458,900,1860
-160,-30,30,442,458,900,1954
110,90,0,442,458,900,1860
-70,90,180,442,458,900,1860
40,90,70,442,458,900,1860
180,90,-70,442,458,900,1860
-150,-30,-90,441,459,900,1823
-70,90,-180,442,458,900,1860
-20,90,130,442,458,900,1860
-120,90,-130,442,458,900,1860
80,90,30,442,458,900,1860
-50,90,160,442,458,900,1860
-10,90,120,442,458,900,1860
-160,-10,-80,437,463,900,1813
-90,90,-160,442,458,900,1860
-100,90,-150,442,458,900,1860
100,90,10,442,458,900,1860
140,-60,10,439,461,900,1757
30,90,80,442,458,900,1860
50,90,60,442,458,900,1860
-30,90,140,442,458,900,1860
0,90,110,442,458,900,1860
20,90,90,442,458,900,1860
90,-70,80,430,470,900,1954
-150,90,-100,442,458,900,1860
-170,90,-80,442,458,900,1860
170,90,-60,442,458,900,1860
-130,90,-120,442,458,900,1860
-110,90,-140,442,458,900,1860
-30,80,140,442,458,900,1895
-80,90,-170,442,458,900,1860
-170,40,10,441,459,900,1917
-80,80,-130,454,446,900,1886
160,90,-50,442,458,900,1860
-40,90,150,442,458,900,1860
-140,90,-110,442,458,900,1860
60,90,50,442,458,900,1860
-160,90,-90,442,458,900,1860
-180,90,-70,442,458,900,1860
-60,90,170,442,458,900,1860
90,90,20,442,458,900,1860
-160,30,-140,430,470,900,1899
-160,0,-120,446,454,900,1868
-160,-20,-80,443,458,901,1938
40,-10,-100,442,459,901,1844
-100,-80,30,439,462,901,1951
-70,-70,20,446,455,901,1865
30,-50,-100,444,457,901,1851
160,50,-30,429,472,901,1824
20,80,-170,458,443,901,1961
180,20,-50,427,474,901,1947
-160,-60,0,434,467,901,1996
-110,-70,-10,448,453,901,1970
-180,20,-50,427,474,901,1947
-140,-70,-30,435,467,902,1985
-20,-50,70,440,462,902,2041
-160,-60,-140,447,455,902,1896
120,10,120,409,493,902,1746
-70,80,-140,451,451,902,1864
30,-60,-100,453,449,902,1875
-100,-70,-40,435,467,902,1976
-50,-70,80,446,456,902,2025
170,40,-20,441,461,902,1913
-150,-60,-10,426,476,902,1894
-30,-80,-170,450,452,902,1801
-100,-70,0,446,456,902,1945
130,-70,130,438,464,902,1874
-20,70,90,442,460,902,1976
-160,-30,-130,439,463,902,1888
-160,60,-10,441,462,903,1881
-30,-50,-10,445,458,903,2012
-170,70,-100,427,476,903,2053
180,80,-50,444,459,903,1869
-30,80,110,439,464,903,1994
-160,80,-120,421,482,903,2009
-180,80,-90,436,467,903,2041
-10,70,90,431,472,903,1943
180,80,-90,436,467,903,2041
-100,-70,-60,441,462,903,1890
-180,80,-50,444,459,903,1869
-10,80,100,445,458,903,1905
-180,80,-40,458,446,904,1971
120,-10,150,424,480,904,1966
-180,-40,-160,448,456,904,1826
180,50,30,444,460,904,1895
10,-30,0,439,465,904,1993
180,-40,-160,448,456,904,1826
-50,-60,160,453,451,904,1916
-10,40,140,443,461,904,1932
-30,-60,40,440,464,904,1956
-180,50,30,444,460,904,1895
-150,-50,-20,433,471,904,1954
180,80,-40,458,446,904,1971
-20,70,80,440,464,904,1940
-20,-50,120,435,469,904,1986
-160,-50,-20,432,472,904,1969
-30,80,100,448,456,904,1943
-10,50,30,431,474,905,1895
-150,-80,-140,437,468,905,1836
-90,-70,-10,436,469,905,1921
-90,-80,40,441,464,905,1960
180,60,-90,428,477,905,2100
140,0,80,437,468,905,1944
-150,-50,-120,425,480,905,1904
-80,-80,-70,446,459,905,1824
-50,-80,90,429,476,905,2002
110,-50,-10,436,469,905,1992
-180,60,-90,428,477,905,2100
-160,-30,-60,436,469,905,1927
80,-70,70,436,469,905,1934
-140,-70,-120,435,470,905,1786
-20,-10,10,453,453,906,1988
-120,-70,-10,437,469,906,2007
50,-10,-20,425,481,906,1929
-40,-60,-20,462,444,906,1944
-20,70,70,430,476,906,1939
-170,10,10,461,445,906,1832
-150,-10,-110,456,450,906,1937
-30,-30,0,434,472,906,1901
-150,-60,-50,423,483,906,1939
-80,-70,10,452,454,906,1914
-150,-40,-80,432,474,906,1868
-150,80,-150,430,476,906,2030
-20,-30,70,447,460,907,2004
160,60,-50,439,468,907,1965
70,60,150,449,458,907,1981
-180,40,30,459,448,907,1894
80,20,-170,434,473,907,1902
0,-20,0,449,458,907,2035
130,-10,170,439,468,907,1826
-170,80,-80,440,467,907,1969
-110,-70,-70,440,467,907,1916
-170,50,-100,445,462,907,1938
-30,-40,160,452,455,907,1901
-140,-70,70,457,450,907,1962
-160,-30,-70,452,455,907,1920
180,40,30,459,448,907,1894
130,-40,130,418,490,908,1930
-170,80,-70,459,449,908,1975
-170,80,-100,440,468,908,2070
-30,50,-150,462,446,908,1991
60,60,160,437,471,908,1971
-60,-70,150,456,452,908,1948
90,-60,60,453,455,908,1962
170,80,-40,452,456,908,1917
-30,20,90,442,466,908,1923
170,40,-50,436,472,908,2018
-150,-50,30,456,452,908,1975
-20,80,70,431,477,908,1942
-100,-70,-10,449,459,908,1945
-40,80,100,443,466,909,1969
70,-70,60,438,471,909,1956
-30,-40,30,454,455,909,2058
-30,0,50,449,460,909,1860
20,-60,10,436,473,909,2052
-10,60,-150,464,445,909,1917
-160,80,-130,433,476,909,2001
-30,-50,-170,452,457,909,1910
-10,70,50,419,490,909,2058
-160,-50,-60,434,475,909,1947
-180,10,-30,437,473,910,1853
-20,60,100,435,475,910,2005
-20,80,60,427,483,910,2064
130,-30,60,442,468,910,1931
-90,80,130,447,463,910,1961
-130,-80,20,431,479,910,2021
150,70,-30,441,469,910,1948
180,10,-30,437,473,910,1853
50,-20,-10,437,474,911,1853
-20,30,60,437,474,911,1988
-180,-70,40,455,456,911,1865
-160,0,-80,441,470,911,1870
-30,-50,80,467,444,911,1909
170,40,-160,439,472,911,1838
40,80,-40,445,466,911,1846
180,-70,40,455,456,911,1865
-60,70,-130,454,457,911,1998
-70,-70,50,453,458,911,2013
100,-40,30,434,478,912,1933
-160,10,-130,434,478,912,1913
70,-30,-40,424,488,912,1870
-30,-10,30,447,465,912,1894
-150,-20,-100,455,457,912,1935
-20,70,130,441,471,912,1861
-150,-60,-30,458,454,912,1949
-20,70,150,441,471,912,1940
-180,80,-60,461,452,913,1974
-60,-80,90,434,479,913,2190
180,80,-60,461,452,913,1974
-130,-70,-20,442,471,913,2050
-20,-20,110,452,461,913,2043
-120,80,160,437,476,913,1911
-150,70,-10,453,460,913,1911
-90,-70,0,455,459,914,1960
-160,60,-160,426,488,914,1999
-20,70,-140,473,441,914,1898
-160,30,-110,435,479,914,1874
-160,-60,-10,436,478,914,2009
-150,70,-170,432,482,914,1949
180,10,-40,441,473,914,1875
-10,0,110,435,479,914,1969
-40,70,-130,471,443,914,1912
-10,10,130,438,476,914,2033
-150,80,-60,452,462,914,1963
50,20,-160,429,485,914,1943
-160,60,0,458,456,914,1962
-20,50,60,429,485,914,1970
-170,80,-50,459,455,914,1945
-40,-60,50,460,454,914,1942
60,-70,50,442,472,914,1981
-180,10,-40,441,473,914,1875
-140,-40,-100,439,475,914,1867
-40,80,160,449,466,915,1798
-30,-30,110,458,457,915,2009
160,70,-40,454,461,915,1939
-20,70,110,448,467,915,2005
160,70,-20,450,465,915,2082
180,40,-70,435,480,915,2039
-150,-10,-100,465,450,915,1853
-30,-70,110,431,484,915,1968
20,-80,20,440,475,915,2072
-20,-20,80,440,475,915,2011
10,0,-150,459,456,915,1973
-20,20,-180,456,459,915,1925
-180,40,-70,435,480,915,2039
50,10,-90,449,466,915,1763
-20,20,180,456,459,915,1925
-20,50,90,440,475,915,2043
130,-20,110,445,470,915,1872
10,0,0,443,473,916,1998
-120,-80,20,453,463,916,2152
-170,-10,-20,444,472,916,1925
-90,-70,-40,461,455,916,1991
-140,-60,40,456,460,916,1929
-70,-70,110,451,465,916,1921
-90,-70,-60,436,480,916,1889
-30,30,80,453,463,916,1990
-100,-70,-50,450,466,916,2015
-160,70,-150,439,477,916,1990
-140,70,-50,457,459,916,1915
0,-10,0,446,470,916,2049
-10,40,30,443,473,916,1889
-20,-40,50,454,462,916,2056
10,-40,0,440,476,916,1960
120,-40,60,444,472,916,1971
-90,-70,90,448,469,917,2071
180,80,-80,445,472,917,1956
-40,-50,90,449,468,917,2020
-110,80,150,440,477,917,1897
-30,-70,120,429,488,917,2019
-30,-60,30,436,481,917,2022
10,10,0,446,471,917,2012
-100,-70,-70,440,477,917,1899
160,60,-40,451,466,917,2003
-180,80,-80,445,472,917,1956
180,30,-50,445,473,918,2092
90,-40,20,446,472,918,1924
-180,30,-50,445,473,918,2092
-20,-10,170,451,467,918,2028
-170,-40,-150,467,451,918,1921
40,-60,-90,454,464,918,1919
-160,70,-130,436,483,919,2001
-30,-40,100,453,466,919,1947
-150,-50,-60,435,484,919,2018
-160,20,-100,443,476,919,1866
-10,-30,-150,460,459,919,1886
-30,40,90,438,481,919,2092
-100,-70,80,454,465,919,2032
-30,60,-180,449,470,919,1953
-20,-30,160,452,467,919,2098
-20,-20,0,438,481,919,1972
-40,-70,120,450,469,919,2139
-130,70,-40,459,460,919,1947
150,0,60,449,470,919,2039
110,-40,40,442,477,919,1922
-40,80,110,453,466,919,2034
-30,60,180,449,470,919,1953
-20,-10,140,464,456,920,1964
-120,80,130,454,466,920,1820
-30,70,50,448,472,920,2004
160,70,-50,442,478,920,1937
-20,70,50,432,488,920,2052
-160,-30,-50,438,482,920,1943
-100,80,140,443,477,920,1924
-170,80,-60,452,468,920,1877
-30,-30,120,444,477,921,2045
50,10,-40,442,479,921,1942
-80,-70,-20,443,478,921,1980
150,80,60,476,445,921,1928
-30,70,130,454,467,921,1960
170,-70,180,435,486,921,1878
-20,-60,-160,471,450,921,1934
-160,80,-110,446,475,921,2053
-20,60,60,440,481,921,2057
-60,-80,80,441,480,921,2051
-80,80,120,452,469,921,1987
170,-70,-180,435,486,921,1878
-50,-60,70,458,463,921,1997
60,30,-180,446,475,921,2010
150,70,-20,446,475,921,2102
-130,80,-180,445,476,921,1986
150,80,-150,451,470,921,1746
130,-30,140,423,498,921,1964
-130,80,180,445,476,921,1986
160,70,50,455,466,921,1945
-100,-70,10,459,462,921,1981
60,30,180,446,475,921,2010
-140,80,-160,434,488,922,2045
160,-40,-180,438,484,922,1887
-20,70,140,453,469,922,1909
-10,40,130,441,481,922,1913
40,20,-160,450,472,922,1953
-160,80,-90,449,473,922,1956
170,30,-40,444,478,922,2076
-140,-60,60,467,455,922,2025
-40,80,120,448,474,922,2037
160,-40,180,438,484,922,1887
-40,80,170,443,479,922,1876
180,50,-70,445,478,923,2059
120,-70,-10,463,460,923,1848
170,10,-160,456,467,923,1890
20,-20,-120,454,469,923,1854
-180,50,-70,445,478,923,2059
-20,30,110,459,464,923,1911
-160,-40,-60,444,479,923,1994
-30,-30,40,458,465,923,2029
-60,70,-120,458,466,924,2008
-160,80,-80,464,460,924,1965
60,-60,30,454,470,924,2025
-70,80,110,449,475,924,2022
150,-20,50,436,488,924,2013
-150,-60,20,448,476,924,1951
-80,-70,100,456,468,924,1989
-170,30,-90,444,480,924,1871
-30,10,80,455,469,924,1873
-170,-30,-40,440,484,924,2040
-20,-50,50,448,477,925,2095
-30,10,60,462,463,925,1915
-20,-60,130,444,481,925,2091
100,30,-140,450,475,925,1969
30,-10,-120,437,488,925,1853
50,-70,40,448,477,925,2029
-120,-80,30,441,484,925,2086
-130,-60,-90,432,493,925,1962
-110,-70,0,455,470,925,2013
90,20,-150,442,483,925,1987
170,-40,-170,437,488,925,1894
-30,-40,-170,470,456,926,1960
-30,70,100,466,460,926,1980
-140,-70,10,431,495,926,1970
-20,30,50,439,487,926,2015
-170,70,-110,442,484,926,1995
-140,-40,-90,443,483,926,1926
-130,-60,60,466,460,926,1917
-140,80,-70,454,473,927,1966
-90,80,-120,462,465,927,1941
110,-70,-20,467,460,927,1851
10,-70,10,461,466,927,2158
170,70,-60,448,479,927,2027
90,20,170,452,475,927,2063
40,-60,20,443,484,927,2060
-30,-70,-170,466,461,927,1893
-160,10,-90,441,486,927,1875
-20,-40,80,452,475,927,2012
-170,-10,-50,443,485,928,2040
-150,80,-90,464,464,928,1941
-160,50,-160,432,496,928,1877
110,60,110,457,471,928,1923
-60,-60,130,465,463,928,1938
-20,-10,120,460,468,928,1944
-100,80,-110,460,468,928,1963
-20,-20,140,443,485,928,1958
-20,-30,80,452,476,928,2056
-140,80,-110,456,472,928,2042
-140,-70,0,437,491,928,1950
-150,-20,-110,461,468,929,2083
170,40,-30,449,480,929,1972
180,70,-30,449,480,929,1958
10,20,0,447,482,929,1918
-180,70,-30,449,480,929,1958
-50,80,60,464,465,929,1914
-160,-40,-30,435,494,929,1976
160,60,-160,451,478,929,1895
40,0,-130,459,471,930,1857
-160,80,-70,452,478,930,1844
-30,50,100,450,480,930,2089
170,60,-60,446,484,930,2042
-30,-10,40,447,483,930,1931
-150,80,-100,453,477,930,1991
130,-80,130,440,490,930,1988
140,10,80,438,492,930,1941
-50,80,160,459,471,930,2000
-20,-50,140,447,483,930,2120
70,40,-100,459,472,931,1876
-140,-70,20,439,492,931,2029
-160,50,-120,455,476,931,2002
100,60,120,455,476,931,1909
-150,-60,-40,450,481,931,2033
-90,-70,-30,449,482,931,2014
170,-10,40,456,475,931,1984
-120,80,170,449,482,931,2053
-30,-30,50,464,467,931,2096
-170,60,-20,468,463,931,1934
-60,80,-160,464,467,931,1930
-180,40,-60,451,481,932,2010
160,60,-30,455,477,932,1960
-30,30,100,455,477,932,1992
-160,-40,40,457,475,932,2003
-40,80,150,461,471,932,1978
40,10,-150,444,488,932,2021
-30,80,80,444,488,932,2010
-20,-10,90,448,484,932,1965
180,40,-60,451,481,932,2010
-70,-80,80,448,484,932,2232
170,30,-160,455,478,933,1880
-70,-80,70,456,477,933,2105
-120,-80,-110,455,478,933,1922
-180,30,30,468,465,933,1947
-120,-60,-60,457,476,933,2040
-40,-50,150,466,467,933,1996
-50,80,110,452,481,933,2025
180,30,30,468,465,933,1947
-130,80,-100,452,481,933,1940
-40,60,-160,472,461,933,1920
130,0,110,451,482,933,1999
-160,60,-150,441,492,933,2007
-170,20,0,472,461,933,1966
0,30,10,460,473,933,1969
-70,-60,130,463,470,933,2026
-130,-70,80,467,466,933,2068
-160,40,-150,454,479,933,2020
140,20,80,438,495,933,1983
-160,80,-60,461,472,933,1975
10,30,0,454,479,933,2068
-30,-20,10,452,481,933,1920
-20,0,170,457,477,934,2035
-20,10,100,445,489,934,1992
40,-30,-90,442,492,934,1926
180,40,-10,453,481,934,2034
120,-50,100,450,484,934,2080
-110,-80,30,457,477,934,2218
-130,-70,-10,453,481,934,2044
-30,40,-160,466,468,934,2008
-90,-80,-80,463,471,934,1901
-120,70,-60,476,458,934,1970
-140,-80,-130,454,480,934,1907
-180,40,-10,453,481,934,2034
-30,80,130,462,472,934,2036
150,-50,20,452,482,934,1936
-20,-50,60,446,488,934,2065
-160,70,-40,471,464,935,1888
80,-40,10,448,487,935,1836
-170,20,-80,452,483,935,2007
180,-30,-160,443,492,935,1797
-30,-70,-20,456,479,935,1982
-20,60,70,444,491,935,2015
-180,-30,-160,443,492,935,1797
-20,20,-160,462,474,936,2001
-70,70,-120,459,477,936,2099
-170,40,0,460,476,936,1974
170,50,-20,458,478,936,1919
90,-40,10,453,483,936,1874
150,-10,60,452,484,936,2058
-150,80,-140,444,492,936,2020
130,-30,70,465,471,936,2043
-30,0,40,463,473,936,1898
-40,-50,0,466,471,937,2022
-50,80,170,452,485,937,1848
-20,0,130,469,468,937,2074
100,-40,20,466,471,937,1926
130,-30,110,446,491,937,1916
-150,80,-120,455,482,937,2088
-30,40,110,468,469,937,1998
-180,20,-20,458,479,937,2033
-150,80,-80,458,479,937,1870
-20,70,60,439,498,937,2076
180,20,-20,458,479,937,2033
160,-40,30,459,478,937,1927
-20,30,170,463,474,937,1947
-130,-80,-120,456,482,938,1918
40,-10,-10,443,495,938,2021
-30,60,110,461,477,938,1982
-130,80,-170,444,494,938,2083
-170,0,-60,445,493,938,2076
-20,0,100,452,486,938,2018
160,60,-20,449,489,938,2004
-150,60,-150,464,474,938,1995
-170,80,-90,460,478,938,2023
130,50,90,466,472,938,2002
-150,0,-100,464,475,939,1903
-110,-80,40,453,486,939,2139
180,60,-70,448,491,939,2088
-40,60,-140,482,457,939,2006
-180,60,-70,448,491,939,2088
-20,60,80,459,480,939,1990
-150,40,-140,457,482,939,1985
50,0,-80,453,486,939,1963
-20,10,170,473,466,939,2011
-170,20,-150,451,488,939,1900
180,50,-80,441,499,940,2071
-180,50,-80,441,499,940,2071
-40,-80,180,468,472,940,1876
-110,80,-100,466,474,940,1976
170,40,-40,446,494,940,2035
-170,60,-100,453,487,940,2082
-10,10,120,439,501,940,2054
-20,-40,70,454,486,940,2068
-30,-40,120,465,475,940,2053
-40,-80,-180,468,472,940,1876
-60,80,100,456,485,941,2037
-20,60,40,455,486,941,1966
-20,50,120,471,470,941,2046
130,-10,110,458,483,941,1943
-170,20,20,470,471,941,2045
-40,-70,100,449,492,941,2064
-20,-40,130,455,486,941,2132
-110,80,120,466,475,941,1859
120,-40,50,447,494,941,1996
80,20,-160,444,497,941,2030
-30,-30,170,472,469,941,1985
-80,-80,70,454,488,942,2260
10,50,-160,478,464,942,1917
-20,70,100,448,494,942,2069
-20,-20,160,458,484,942,2164
-60,70,-140,463,479,942,2031
40,-70,30,459,483,942,2055
-140,-50,-70,451,491,942,1963
-140,-60,-40,448,494,942,2016
-150,80,-130,440,502,942,2073
-120,80,-90,463,479,942,1993
-10,20,120,448,494,942,2066
-20,60,90,469,473,942,2015
-170,20,-50,438,505,943,2098
-50,80,120,452,491,943,2124
-130,-70,0,454,489,943,2016
-130,80,-80,462,481,943,2005
-30,10,50,478,465,943,2011
-30,-30,60,462,481,943,2175
60,20,-160,441,502,943,1927
-30,70,90,458,485,943,2027
-120,-70,50,460,483,943,2119
-140,80,-100,467,477,944,1974
-120,70,-50,481,463,944,2001
-20,-30,-160,476,468,944,1889
-20,40,70,439,505,944,2094
80,60,140,466,478,944,2025
-30,50,120,468,476,944,1951
50,40,180,477,467,944,2003
60,-50,20,465,479,944,2131
-60,-60,60,481,463,944,2013
50,40,-180,477,467,944,2003
-40,80,90,460,484,944,2052
-50,-60,80,477,467,944,2055
-80,-80,60,464,480,944,2126
-170,70,-90,458,486,944,2017
110,-50,70,478,466,944,2024
100,-70,-30,469,476,945,1902
-40,-50,100,469,476,945,1952
-170,10,0,481,464,945,1990
-60,-70,-40,458,487,945,1851
-110,-80,-100,460,485,945,1912
90,30,150,453,492,945,1979
-130,-60,-50,459,486,945,2089
-70,80,-150,466,479,945,1974
-120,-60,-70,453,492,945,2150
-100,-80,-90,464,481,945,1921
-20,50,70,457,488,945,2067
-30,70,70,450,495,945,2066
90,60,130,468,477,945,1994
-30,80,70,443,502,945,2083
-30,-60,130,445,501,946,2123
-30,-50,70,477,469,946,1998
-50,80,180,457,489,946,1933
-50,80,-180,457,489,946,1933
-160,20,-140,459,487,946,1987
-170,50,-10,470,477,947,1928
0,-10,-150,464,483,947,2004
10,-80,10,462,485,947,2115
-20,80,110,468,479,947,2020
-40,-40,100,463,484,947,2116
-50,80,130,456,491,947,2101
-160,-50,0,453,494,947,2020
-30,60,70,449,498,947,2065
-20,-50,130,465,482,947,2198
-150,80,-70,466,481,947,1994
180,60,30,483,465,948,1924
160,80,50,492,456,948,1952
-170,0,-20,477,471,948,1931
60,60,-70,459,489,948,1899
160,-20,40,467,481,948,2169
-40,-60,10,454,494,948,2190
-30,20,70,475,473,948,1940
130,60,-140,469,479,948,1862
20,-40,0,471,477,948,2176
-170,10,-70,452,496,948,2055
-180,60,30,483,465,948,1924
-140,80,-140,454,494,948,2075
50,10,-110,462,487,949,1962
-60,80,170,470,479,949,2082
170,70,-50,467,482,949,1997
170,70,40,477,472,949,1952
-40,70,140,467,482,949,2051
-170,-30,-20,438,511,949,2045
180,-80,40,479,471,950,1940
-180,-80,40,479,471,950,1940
-40,80,80,444,506,950,2062
-40,-60,100,475,475,950,2044
170,70,-40,461,489,950,2047
-130,-70,10,449,501,950,2089
-80,80,-140,468,482,950,1973
-140,80,-90,468,482,950,1917
-30,70,120,468,482,950,2081
10,40,-160,482,469,951,1982
-90,-80,60,456,495,951,2264
-20,50,50,461,490,951,2077
70,20,-160,438,513,951,2040
-20,50,160,471,480,951,2045
-80,-70,40,476,475,951,2082
-60,-60,150,477,474,951,2045
-140,80,-150,453,499,952,2084
160,-10,50,450,502,952,1997
-30,-50,30,469,483,952,2244
-30,-30,-180,473,479,952,1919
-30,-30,180,473,479,952,1919
30,20,-20,461,491,952,1963
-110,80,160,454,498,952,2104
-160,80,-100,460,492,952,2075
-70,-70,140,479,473,952,2045
-30,70,80,459,494,953,2032
-160,70,-110,454,499,953,2126
-140,80,-130,464,489,953,2114
-50,-60,60,485,468,953,2104
-160,40,-110,450,503,953,2084
-140,80,-80,472,481,953,2014
130,10,-170,450,503,953,1996
70,-30,-10,455,498,953,1992
-150,-40,40,474,479,953,2046
90,-70,-40,466,487,953,1941
-150,10,-110,481,472,953,1809
-40,-50,80,476,477,953,2091
50,60,170,469,484,953,2006
-150,-40,-30,462,491,953,2005
160,70,-30,460,493,953,2114
110,10,-180,458,496,954,1915
-20,50,80,467,487,954,2053
160,-60,170,451,503,954,2012
-100,-80,50,459,495,954,2202
-60,-70,70,471,483,954,2057
-160,60,-120,453,501,954,2112
110,10,180,458,496,954,1915
0,40,10,473,481,954,1999
-150,10,-120,474,480,954,1840
-40,80,140,468,486,954,2067
-40,-20,40,482,472,954,2086
160,80,-160,460,494,954,1852
-20,-40,150,467,488,955,2084
-90,-70,30,473,482,955,2148
-160,-10,-130,457,498,955,2149
170,20,-160,472,483,955,2030
-160,-30,-40,454,501,955,2033
150,30,70,475,480,955,2060
-50,80,90,451,504,955,2052
100,20,150,449,506,955,1987
-40,-60,40,473,483,956,2149
-160,50,-110,467,489,956,2063
70,-70,-60,467,489,956,1930
-130,80,-90,476,480,956,2021
-40,-70,110,446,510,956,2182
110,40,120,449,507,956,1957
-150,-40,-70,452,504,956,2098
-20,40,50,458,498,956,2003
-80,70,-110,477,479,956,2130
-120,70,140,455,501,956,1901
-160,-60,50,473,483,956,2037
-150,40,-130,455,501,956,1981
-10,30,130,450,506,956,2086
-50,70,-160,479,478,957,2037
60,-30,-10,453,504,957,2004
-150,-30,-80,469,488,957,2075
80,-50,30,467,490,957,2153
40,-50,10,481,476,957,2206
-20,-40,60,457,500,957,2098
-160,0,-130,448,509,957,2040
-130,80,-150,452,506,958,2086
-90,-80,50,469,489,958,2171
-150,70,-160,465,493,958,2076
180,70,-60,467,491,958,2098
-160,70,-100,466,492,958,2087
-30,-50,120,466,492,958,2116
-150,0,-120,468,490,958,1995
-180,70,-60,467,491,958,2098
-20,-60,-10,492,466,958,2135
-130,-50,-80,465,493,958,2095
-130,-70,20,448,510,958,2099
-140,-60,-10,468,490,958,2047
-30,-20,130,477,481,958,2034
-130,-70,-110,467,491,958,1871
-170,60,-90,464,494,958,2084
-130,80,-120,472,486,958,2120
-130,80,-110,475,484,959,2021
-40,-70,-30,461,498,959,2028
-180,20,-40,453,506,959,2156
-170,-30,-30,447,512,959,2046
-40,60,130,475,484,959,2059
-100,-80,40,468,491,959,2232
180,20,-40,453,506,959,2156
120,-40,70,464,495,959,2092
-160,60,-20,468,491,959,1987
-160,70,-120,461,499,960,2064
-30,40,-170,477,483,960,2006
30,0,-10,469,491,960,2108
-160,-20,-130,470,490,960,2079
40,0,-20,456,504,960,1948
130,10,110,451,509,960,2033
-170,30,-150,464,496,960,1941
-170,0,0,488,472,960,2000
100,-50,50,459,501,960,2071
-150,70,-150,465,495,960,2009
-60,80,130,457,503,960,2145
10,80,-160,486,474,960,2003
-60,80,110,463,497,960,2063
-150,40,-150,461,499,960,1977
-170,0,-50,460,500,960,2092
-160,-40,0,467,493,960,2091
-20,40,120,472,488,960,1947
120,-60,110,457,503,960,2108
-110,-70,10,465,495,960,2082
-60,80,-170,464,497,961,1949
50,0,-30,453,508,961,2058
-60,80,120,463,498,961,2094
10,60,-160,478,483,961,2032
100,-60,70,472,489,961,2039
-130,-50,-70,466,495,961,2090
-130,80,-140,465,496,961,2134
-20,-30,90,467,494,961,2096
-170,-20,-40,454,507,961,2101
20,30,-160,471,490,961,2032
-150,-20,-90,479,483,962,2015
180,70,-50,476,486,962,2012
60,-70,-70,465,497,962,1988
-110,80,-110,463,499,962,2002
180,70,-70,462,500,962,2067
-100,-70,20,464,498,962,2124
-20,40,60,455,507,962,2067
-20,60,50,452,510,962,2207
-180,70,-70,462,500,962,2067
170,70,-30,473,489,962,2164
-30,60,130,479,483,962,2071
-170,-20,-20,470,492,962,2151
-180,70,-50,476,486,962,2012
-170,-10,-30,450,512,962,2088
-30,-10,70,467,495,962,2066
-10,-20,0,456,506,962,2032
-130,70,-60,476,486,962,2058
-140,70,-20,479,484,963,2040
-180,60,-20,478,485,963,2045
-170,40,-160,471,492,963,2000
-150,60,-180,464,499,963,1986
-20,-20,150,456,507,963,2116
130,-20,120,459,504,963,2120
-90,80,-130,466,497,963,1986
-30,60,80,468,495,963,2077
-150,-50,-10,449,514,963,2121
-30,-10,20,474,489,963,1895
120,20,120,435,528,963,1888
-160,-10,-70,472,491,963,1909
-50,-60,-10,478,485,963,2101
180,60,-20,478,485,963,2045
-150,60,180,464,499,963,1986
30,80,-30,469,494,963,1969
-120,80,-120,476,488,964,2016
-20,70,30,471,493,964,1883
-120,80,-180,461,503,964,2091
-40,-60,130,470,494,964,2188
-50,-70,90,466,498,964,2194
-20,30,40,470,494,964,2060
-180,70,30,495,469,964,1970
-60,80,70,478,486,964,1972
180,70,30,495,469,964,1970
-30,60,100,463,501,964,2099
10,-50,0,461,503,964,2073
-120,80,-150,462,502,964,2142
-120,80,180,461,503,964,2091
-120,-70,0,467,497,964,2055
-70,70,-110,474,490,964,2064
-170,70,-60,482,482,964,2020
-170,10,-150,468,497,965,1925
-80,70,-100,475,490,965,2122
140,-30,160,463,502,965,2012
100,40,130,475,490,965,2088
-30,-40,40,488,477,965,2185
-50,-60,130,479,486,965,2103
100,-70,90,469,496,965,2072
120,40,110,455,510,965,1992
60,-20,-20,459,506,965,2131
110,40,-140,471,494,965,2049
140,30,80,468,497,965,2035
110,20,-160,449,516,965,2137
90,90,120,500,466,966,2007
-50,80,100,464,502,966,2085
-130,70,160,461,505,966,2050
160,90,50,500,466,966,2007
140,50,-150,483,483,966,1990
-20,90,-130,500,466,966,2007
-70,90,-80,500,466,966,2007
150,90,60,500,466,966,2007
-150,90,0,500,466,966,2007
-170,90,20,500,466,966,2007
60,90,150,500,466,966,2007
-100,90,-50,500,466,966,2007
50,90,160,500,466,966,2007
70,90,140,500,466,966,2007
-150,60,-140,473,493,966,2055
-10,90,-140,500,466,966,2007
170,90,40,500,466,966,2007
120,0,170,467,499,966,1990
180,90,30,500,466,966,2007
30,-40,-100,471,495,966,2005
100,90,110,500,466,966,2007
-30,90,-120,500,466,966,2007
-160,90,10,500,466,966,2007
-60,90,-90,500,466,966,2007
-120,90,-30,500,466,966,2007
-10,20,130,458,508,966,2088
10,70,-160,488,478,966,2031
30,50,-170,485,481,966,2016
-80,90,-70,500,466,966,2007
-160,-50,-10,458,508,966,2124
-50,90,-100,500,466,966,2007
-130,90,-20,500,466,966,2007
-170,70,-80,461,505,966,2094
170,50,-50,459,507,966,2124
-140,90,-10,500,466,966,2007
0,90,-150,500,466,966,2007
-150,-60,0,450,516,966,2176
120,90,90,500,466,966,2007
-90,90,-60,500,466,966,2007
30,90,180,500,466,966,2007
50,-40,0,463,503,966,2052
-40,90,-110,500,466,966,2007
-20,60,130,475,491,966,2121
20,90,-170,500,466,966,2007
110,90,100,500,466,966,2007
30,90,-180,500,466,966,2007
40,90,170,500,466,966,2007
-110,90,-40,500,466,966,2007
-180,90,30,500,466,966,2007
130,90,80,500,466,966,2007
-150,-50,-50,471,495,966,2160
10,90,-160,500,466,966,2007
80,90,130,500,466,966,2007
140,90,70,500,466,966,2007
-140,70,-180,470,497,967,2053
-30,-20,120,483,484,967,2147
-140,70,180,470,497,967,2053
140,-10,80,471,496,967,1946
-30,-40,90,489,478,967,2039
180,30,-160,472,495,967,1876
-60,80,140,458,509,967,2132
-40,-40,0,487,480,967,2173
-170,30,-60,456,511,967,2120
-180,30,-160,472,495,967,1876
-170,20,-70,469,498,967,2097
-120,-70,10,466,501,967,2075
-170,40,-90,473,494,967,2054
-120,80,-110,470,497,967,1977
-120,70,-70,477,490,967,2138
-120,80,-100,472,495,967,2021
-100,80,-140,479,488,967,1975
-30,-50,140,465,503,968,2152
-20,50,-150,486,482,968,1993
-70,-60,120,479,489,968,2101
-130,-70,30,456,512,968,2127
30,-20,-10,474,494,968,2190
-50,70,140,482,486,968,2098
-170,30,-80,471,497,968,2112
-110,70,-70,492,476,968,2070
170,80,40,496,472,968,2003
90,-50,40,472,496,968,2147
140,-80,140,460,508,968,2049
-140,-60,-110,465,504,969,2162
-50,70,-120,494,475,969,2028
-110,70,-60,487,482,969,2102
-170,30,20,478,491,969,2124
-40,-30,110,478,491,969,2084
-130,80,-160,461,508,969,2136
0,-60,0,474,495,969,2251
-160,-20,20,474,495,969,2102
-110,-70,60,466,503,969,2204
-20,10,160,477,493,970,2055
-160,-20,-60,465,505,970,2065
-100,80,110,470,500,970,1928
-30,60,-140,497,473,970,2056
160,20,-160,471,499,970,2128
-40,70,110,479,491,970,2081
-170,30,-70,463,507,970,2134
-20,-30,140,464,506,970,2119
-170,70,-70,479,492,971,2075
-130,-60,-40,473,498,971,2140
150,20,70,475,496,971,2068
-100,80,-170,466,505,971,2141
130,-70,0,485,486,971,1879
-180,20,-30,467,504,971,2034
-50,-70,110,466,505,971,2330
-120,-70,90,482,489,971,2038
40,40,-40,456,515,971,1980
120,-50,0,459,512,971,2177
180,20,-30,467,504,971,2034
-110,80,-120,470,501,971,1947
-20,20,170,473,499,972,2089
-100,80,-120,470,502,972,2005
50,-60,20,486,486,972,2112
-40,70,180,475,497,972,2026
70,-50,20,484,488,972,2159
-40,70,-180,475,497,972,2026
130,20,-160,471,501,972,2029
-30,0,30,491,482,973,1981
-120,80,-160,453,520,973,2128
100,20,-160,448,525,973,2086
-110,80,-160,467,506,973,2156
30,0,-140,463,510,973,1960
-40,60,120,477,496,973,2032
-150,60,-20,473,500,973,2043
-70,-70,-50,468,505,973,1920
-60,80,180,474,499,973,1934
-60,80,-180,474,499,973,1934
60,-40,0,459,514,973,2022
-100,80,150,466,507,973,2173
-60,-60,-30,493,480,973,2010
-60,-70,110,467,506,973,2080
-40,80,130,476,497,973,2142
-40,-20,50,492,481,973,1999
-170,0,30,479,494,973,1939
110,-60,90,463,511,974,2173
-100,70,-80,486,488,974,2130
-30,70,60,452,522,974,2168
-160,70,-80,475,499,974,2015
-130,-50,-90,470,504,974,2162
50,10,-50,444,530,974,1938
140,-70,140,466,508,974,2100
-40,-30,40,487,487,974,2098
-20,60,150,470,505,975,2088
-40,70,90,471,504,975,2115
-70,80,-180,480,495,975,2095
-40,70,130,489,486,975,2108
-30,80,120,478,497,975,2093
80,-70,-50,475,500,975,1998
-20,0,150,478,497,975,1980
-120,-70,20,461,514,975,2162
-70,80,180,480,495,975,2095
-40,-40,110,482,493,975,2100
-140,-60,0,471,504,975,2042
170,60,-50,468,507,975,2180
-110,80,-170,460,515,975,2139
-80,80,170,484,492,976,2151
-30,0,80,485,491,976,2187
-90,80,-150,479,497,976,1983
50,0,-70,461,515,976,2090
-150,70,160,484,492,976,1827
-110,80,-130,483,493,976,2012
-150,70,-140,460,516,976,2144
-180,30,-40,467,509,976,2119
-30,-30,130,476,500,976,2111
120,10,130,470,506,976,1917
-70,80,-160,470,506,976,1956
180,30,-40,467,509,976,2119
30,70,-30,485,491,976,1966
-30,70,140,478,498,976,2043
60,-40,-60,473,504,977,1998
-80,70,170,481,496,977,2132
180,-60,40,478,499,977,1975
40,-20,-10,480,497,977,2118
-80,80,160,459,518,977,2177
-70,80,160,487,490,977,2167
-30,-60,120,467,510,977,2199
130,-40,20,462,515,977,2079
170,60,-20,476,501,977,2156
-30,50,70,464,513,977,2071
-100,80,-130,472,505,977,1965
-180,-60,40,478,499,977,1975
-110,-70,20,472,505,977,2115
30,-40,0,477,500,977,2210
130,30,100,474,503,977,2108
-170,30,0,480,497,977,2044
-150,-40,-120,473,504,977,2077
-70,70,-130,485,492,977,2125
-40,50,110,482,496,978,2044
-20,30,160,473,505,978,2181
120,60,100,480,498,978,2055
-60,70,150,486,492,978,2127
-100,-70,70,465,513,978,2237
0,80,-150,498,480,978,2072
50,50,-60,453,525,978,2009
-90,80,170,460,518,978,2205
60,30,-100,474,504,978,1884
-80,80,-170,487,491,978,2128
-70,80,130,472,506,978,2135
-90,70,-90,481,497,978,2142
-70,80,140,458,520,978,2150
-150,50,-160,465,513,978,2147
-150,80,-110,470,508,978,2113
-140,50,-150,479,499,978,2050
-70,80,120,466,512,978,2165
-70,80,150,460,519,979,2176
-30,-40,50,487,492,979,2220
-170,50,-80,477,502,979,2163
-120,80,-130,484,495,979,2143
-50,80,150,479,500,979,2121
-160,50,-170,496,483,979,1961
-100,80,-180,460,519,979,2195
-20,-20,90,467,512,979,2150
-100,80,180,460,519,979,2195
90,20,-160,468,511,979,2031
-60,80,160,477,502,979,2135
-170,10,-60,461,519,980,2100
120,-50,90,473,507,980,2068
100,-50,40,477,503,980,2220
-50,-80,170,487,493,980,1999
-150,60,170,478,502,980,1935
-70,80,-170,476,504,980,1957
-20,50,130,479,501,980,2032
-90,80,-140,478,502,980,1983
130,-30,130,461,519,980,2052
-170,20,-60,469,511,980,2142
120,20,-160,479,502,981,2101
40,-40,0,470,511,981,2040
-20,10,140,492,489,981,2153
50,40,-60,452,529,981,2013
-80,80,-160,480,501,981,1971
40,0,-120,478,503,981,1980
-170,-10,-40,463,518,981,2153
-160,70,-70,492,489,981,2053
100,70,-110,488,493,981,1918
-90,80,140,468,514,982,2163
-160,70,-90,459,523,982,2114
-40,70,120,474,508,982,2111
180,-70,-170,462,520,982,2026
-50,70,150,491,491,982,2107
-20,-10,110,487,495,982,2150
-150,-10,-120,480,502,982,2064
30,60,-30,459,523,982,1955
20,-60,-110,481,501,982,1943
-180,-70,-170,462,520,982,2026
-80,80,130,473,510,983,2173
100,30,140,478,505,983,2063
-80,-70,130,493,490,983,2136
-170,50,-90,473,510,983,2139
-30,70,110,464,519,983,2127
-120,-60,-50,481,502,983,2132
110,-50,60,472,512,984,2155
110,10,150,455,529,984,2062
-150,60,-160,477,507,984,2126
-20,20,110,479,505,984,2127
-120,80,-140,478,506,984,2136
-140,50,-160,474,510,984,2043
-170,40,20,502,482,984,2093
-20,0,120,496,488,984,2176
-170,-10,30,486,498,984,1932
-170,-20,-30,461,523,984,2197
-20,10,110,478,507,985,2144
140,20,-160,480,505,985,2141
-70,-70,60,487,498,985,2080
-110,70,130,471,514,985,1994
20,-50,-110,498,487,985,1887
-90,80,180,480,505,985,2196
-100,80,-150,485,500,985,2145
-60,70,-110,505,480,985,2112
-80,80,-150,479,506,985,1993
-120,80,-170,464,521,985,2174
-90,80,-180,480,505,985,2196
130,-30,90,494,491,985,2038
-160,-40,-20,462,523,985,2182
-150,-30,-120,490,495,985,2071
-70,80,170,480,505,985,2152
-40,-60,30,469,516,985,2170
-150,-40,-40,474,511,985,2203
50,-10,-70,470,515,985,2090
-70,70,100,478,507,985,2122
-40,40,100,475,511,986,2193
180,40,-50,468,518,986,2182
-80,80,140,475,511,986,2161
-130,80,-130,473,513,986,2122
140,-30,40,480,506,986,2283
110,-40,30,496,490,986,2155
-90,80,-160,487,499,986,2134
-20,-40,140,480,506,986,2318
170,50,-30,475,511,986,2044
-180,40,-50,468,518,986,2182
0,-70,0,485,501,986,2275
-100,80,-160,478,508,986,2169
30,10,-150,480,506,986,2062
-150,-50,50,487,499,986,2194
-100,70,120,466,520,986,2004
-50,80,140,482,505,987,2179
-20,-20,-160,491,496,987,2039
-80,70,180,486,501,987,2096
-90,-70,40,478,509,987,2157
-170,70,-40,484,503,987,2117
-80,80,180,482,505,987,2166
-80,80,-180,482,505,987,2166
80,20,-140,483,504,987,2082
-160,50,0,476,511,987,2082
-160,60,-110,462,525,987,2132
-80,70,-180,486,501,987,2096
-30,-60,-170,501,486,987,2087
-170,-80,50,505,482,987,2053
170,60,-40,479,508,987,2153
-140,-30,-100,473,514,987,2054
-150,30,-130,465,522,987,2078
-130,-60,50,482,505,987,2018
-140,60,-160,487,500,987,2166
-20,40,160,480,507,987,2227
-170,60,-180,492,496,988,1886
-20,10,150,487,501,988,2037
-10,-20,-150,496,492,988,2027
-140,70,-160,481,507,988,2069
-60,80,150,482,506,988,2167
90,20,-170,466,522,988,2083
0,-80,0,489,499,988,2154
-90,80,100,482,506,988,2013
-40,70,70,466,522,988,2217
-40,70,60,474,514,988,2164
140,-20,70,489,499,988,2121
-170,60,180,492,496,988,1886
-110,-70,30,469,520,989,2178
180,30,-20,492,497,989,2158
-140,-50,-60,476,513,989,2223
-70,80,80,491,498,989,1980
180,40,-20,474,515,989,2081
-180,40,-20,474,515,989,2081
-50,60,130,490,499,989,2086
-170,60,-80,480,509,989,2138
-100,-70,30,475,514,989,2157
-80,70,100,483,506,989,2011
-120,-70,-100,479,510,989,2025
-30,20,60,481,508,989,2164
-180,30,-20,492,497,989,2158
-40,-60,20,460,529,989,2242
90,70,-100,505,484,989,2036
-180,80,30,502,487,989,2041
180,80,30,502,487,989,2041
60,40,-80,472,518,990,2123
-160,-20,10,482,508,990,2029
130,-40,110,464,526,990,2128
-110,80,-150,480,510,990,2164
-110,80,170,475,515,990,2163
30,-10,-10,495,495,990,2192
-30,70,160,482,508,990,2172
-70,70,160,484,506,990,2139
-170,30,-50,477,513,990,2174
-130,-60,70,490,500,990,2109
-150,60,-10,497,493,990,2080
-30,50,90,482,509,991,2120
-140,80,-120,478,513,991,2129
-170,10,-50,470,521,991,2201
-50,-50,150,495,496,991,2210
-20,20,30,476,515,991,2013
-150,70,-120,477,514,991,2189
-20,10,20,477,514,991,2047
-30,60,90,484,507,991,2189
130,0,-180,489,502,991,2054
-90,70,-170,478,513,991,2103
-70,-70,100,478,513,991,2195
130,0,180,489,502,991,2054
170,70,-170,495,497,992,1861
-150,60,-170,475,517,992,2102
-150,-50,-40,485,507,992,2103
-90,70,-100,501,491,992,2212
-170,40,-70,482,510,992,2216
-20,-20,100,494,498,992,2187
20,80,-20,492,500,992,2024
-30,-30,100,500,492,992,2121
140,-60,140,475,517,992,2218
-150,70,-100,478,514,992,2162
40,0,-110,484,508,992,2122
110,-40,10,468,524,992,2096
160,30,-160,483,510,993,2132
100,-40,10,479,514,993,2077
-20,-10,100,479,514,993,2161
-140,70,-170,479,514,993,2220
-50,60,-140,502,491,993,2127
-170,0,-10,485,508,993,2112
-90,70,-180,483,510,993,2208
-90,70,180,483,510,993,2208
130,-30,100,485,508,993,2073
50,10,-140,473,520,993,2067
-70,70,170,480,513,993,2165
110,70,-120,485,509,994,1937
-150,-40,-20,462,532,994,2124
-50,-60,-30,480,514,994,2143
-30,40,80,472,522,994,2140
-170,40,-80,481,513,994,2065
50,-30,-10,483,512,995,2239
40,-20,-90,477,518,995,1977
-20,-30,150,478,517,995,2265
-30,-20,0,473,522,995,2047
-110,70,-80,493,502,995,2189
-50,-50,160,504,491,995,2128
-60,70,-150,493,502,995,2142
-30,10,40,492,503,995,2059
-130,70,170,482,513,995,2179
-160,70,-60,494,501,995,2091
-30,-20,70,487,508,995,2292
-110,80,-140,493,503,996,2155
-20,20,150,492,504,996,2242
-90,80,150,479,517,996,2169
-40,-70,-180,498,498,996,2021
-150,70,-130,472,524,996,2122
-40,-70,180,498,498,996,2021
-60,70,90,482,514,996,2177
140,40,80,486,510,996,2085
-40,-50,10,493,504,997,2144
-150,-40,30,493,504,997,2192
-140,-60,-20,498,499,997,2143
90,-60,50,494,503,997,2124
110,-40,20,481,516,997,2085
-40,70,100,480,517,997,2150
30,-70,20,489,508,997,2170
150,-80,150,479,518,997,2116
-150,-60,10,473,524,997,2243
-50,70,80,476,522,998,2191
-150,20,-120,499,499,998,1927
-80,-70,90,474,524,998,2239
-180,70,-40,494,504,998,2202
-20,10,-160,502,496,998,2013
-130,-60,-30,478,520,998,2176
-70,70,90,484,514,998,2095
-90,70,110,478,520,998,2025
70,50,-90,477,521,998,2060
180,70,-40,494,504,998,2202
-120,-60,70,503,495,998,2070
-40,70,150,485,514,999,2154
-40,50,120,496,503,999,2078
-170,70,20,517,482,999,2050
120,50,-140,494,505,999,2030
-100,70,-160,485,514,999,2128
-40,-40,170,516,483,999,2190
60,-20,-50,468,531,999,2016
-120,70,150,477,522,999,2108
-150,20,-130,487,512,999,2138
-110,-70,100,502,497,999,2043
-30,-10,130,499,500,999,2142
-30,70,-130,517,482,999,2033
-90,-70,80,479,520,999,2249
-170,80,20,514,485,999,2080
-170,70,-50,504,495,999,2107
-110,80,-180,470,530,1000,2211
-90,70,120,491,509,1000,2066
-10,30,20,490,510,1000,1978
-170,50,-170,499,501,1000,1963
-90,80,160,464,536,1000,2231
-100,80,160,484,516,1000,2167
-110,80,180,470,530,1000,2211
50,10,-70,472,528,1000,2194
-110,70,-150,482,518,1000,2167
150,0,-170,483,517,1000,2080
40,-30,-10,490,511,1001,2199
-60,70,160,498,503,1001,2151
-30,-50,50,489,512,1001,2281
-100,70,-70,497,504,1001,2162
-90,80,-170,486,515,1001,2182
-170,50,20,499,502,1001,2093
-80,-70,50,487,514,1001,2160
-50,60,-130,509,492,1001,2198
-50,70,130,488,513,1001,2155
170,-20,40,474,527,1001,2223
-40,-50,110,488,514,1002,2195
-80,80,150,460,542,1002,2247
-100,70,-170,484,518,1002,2219
20,10,-150,504,498,1002,2091
50,30,-60,478,524,1002,2074
-160,-30,-30,477,525,1002,2230
120,30,-150,493,509,1002,2192
-120,-70,40,467,535,1002,2210
30,-30,-10,486,516,1002,2118
50,-70,-80,483,519,1002,2099
-140,-50,-10,479,523,1002,2171
-80,-60,120,492,510,1002,2206
-30,70,150,490,513,1003,2138
80,-40,-30,471,532,1003,2144
-120,-60,-80,473,530,1003,2186
-80,80,90,493,510,1003,2033
-170,-30,-150,503,500,1003,1917
-140,-40,-80,490,513,1003,2061
140,0,90,499,505,1004,2227
140,-30,60,476,528,1004,2181
-30,-50,40,490,514,1004,2286
50,-20,-70,481,523,1004,2101
-10,10,10,490,514,1004,2157
50,10,-80,478,526,1004,2087
100,-40,0,469,535,1004,2193
120,0,140,477,527,1004,2165
-120,-70,30,464,540,1004,2225
-170,-70,50,504,500,1004,2052
-150,-40,-50,482,523,1005,2189
-20,40,40,492,513,1005,2091
-20,50,150,479,526,1005,2138
150,20,-160,493,512,1005,2185
170,50,-40,477,528,1005,2133
-40,70,80,488,517,1005,2188
20,-50,0,494,512,1006,2185
-150,70,-50,511,495,1006,2180
60,20,-120,485,521,1006,2110
-80,70,110,491,515,1006,2083
150,40,70,483,523,1006,2169
50,20,-60,478,528,1006,2102
-30,60,60,472,534,1006,2315
-160,50,-10,500,507,1007,2087
-30,-40,60,498,509,1007,2284
-30,-50,60,483,524,1007,2214
130,60,90,503,504,1007,2243
-20,60,140,491,516,1007,2269
-100,70,130,487,520,1007,2165
-110,70,140,486,522,1008,2207
-170,-20,-150,505,503,1008,2086
-160,-20,-50,487,521,1008,2154
-170,0,-150,485,523,1008,1928
-30,0,140,492,516,1008,2191
130,20,110,467,541,1008,2155
-170,-70,-160,478,530,1008,2086
-140,-60,-30,486,522,1008,2184
-140,-50,-110,483,526,1009,2106
-160,-40,-10,469,540,1009,2217
150,-60,20,493,516,1009,1977
-20,10,130,501,508,1009,2182
-30,20,50,494,515,1009,2213
-40,-40,10,509,500,1009,2271
-160,60,-100,481,528,1009,2167
-30,50,-180,502,507,1009,2181
-20,0,160,500,509,1009,2284
160,30,60,502,507,1009,2294
-10,80,-140,514,495,1009,2091
-140,-60,30,485,524,1009,2169
-30,50,180,502,507,1009,2181
180,30,-30,487,523,1010,2210
90,-50,30,501,509,1010,2241
-100,80,170,473,537,1010,2251
-180,30,-30,487,523,1010,2210
-150,30,-120,500,510,1010,2061
-20,40,130,497,513,1010,2207
-10,50,20,480,530,1010,2119
-150,70,-110,476,534,1010,2124
-150,-40,-60,499,511,1010,2248
180,50,-60,488,523,1011,2276
-170,-40,40,495,516,1011,2131
-30,60,170,497,514,1011,2217
-30,30,70,485,526,1011,2156
-100,70,-90,508,503,1011,2204
-70,70,-100,514,497,1011,2169
-60,70,80,489,522,1011,2208
-20,-10,150,494,517,1011,2150
-180,50,-60,488,523,1011,2276
-30,-50,130,476,535,1011,2315
-50,-50,80,493,518,1011,2133
-150,-40,20,503,508,1011,2218
-40,60,140,495,516,1011,2233
-40,60,80,479,532,1011,2167
-140,70,-150,485,527,1012,2204
70,-50,-50,496,516,1012,2151
-40,-40,40,505,507,1012,2313
-30,40,-150,513,499,1012,2219
-40,-10,50,497,515,1012,2119
-40,60,110,499,513,1012,2182
-30,-40,80,509,503,1012,2117
130,-30,120,475,537,1012,2142
170,60,-30,490,522,1012,2220
-140,-40,-110,486,526,1012,2141
-50,-60,40,503,509,1012,2136
-40,-50,180,505,507,1012,2073
-40,-50,-180,505,507,1012,2073
-180,50,-20,485,528,1013,2093
180,50,-20,485,528,1013,2093
130,40,-150,499,514,1013,2215
-40,50,100,505,508,1013,2294
-170,10,30,508,505,1013,2054
110,-60,80,495,518,1013,2141
160,40,-160,498,515,1013,2248
-30,50,130,493,520,1013,2141
70,-40,0,482,531,1013,2056
-40,-50,140,500,513,1013,2296
-20,50,140,486,528,1014,2121
-150,70,-90,491,523,1014,2163
-150,10,-100,499,515,1014,2037
-20,20,160,489,525,1014,2271
-30,-20,110,520,494,1014,2193
50,10,-120,500,514,1014,2054
110,-70,100,484,530,1014,2187
-20,60,30,497,517,1014,2025
20,20,-10,493,521,1014,2186
-40,-10,60,512,503,1015,2124
-100,-70,110,505,510,1015,2108
-180,60,-50,485,530,1015,2165
80,-40,0,501,514,1015,2108
-140,-50,-20,486,529,1015,2105
140,50,80,503,512,1015,2147
160,50,-160,496,519,1015,2140
180,60,-50,485,530,1015,2165
-50,-70,100,485,530,1015,2381
-40,-30,30,498,517,1015,2233
-10,-80,-10,510,505,1015,2200
-150,50,-130,483,532,1015,2182
-150,60,-120,475,541,1016,2199
-160,-30,0,493,523,1016,2192
-60,-70,100,490,526,1016,2448
-30,60,140,499,517,1016,2245
-40,30,90,494,522,1016,2228
-140,-50,-30,491,525,1016,2262
150,-50,160,486,530,1016,2200
-50,-60,90,510,506,1016,2191
-150,-20,-120,507,509,1016,2132
-40,60,-170,505,511,1016,2247
-90,-70,120,504,513,1017,2201
50,-50,10,504,513,1017,2257
-150,60,-30,501,516,1017,2116
-20,0,110,499,518,1017,2173
-40,20,80,509,508,1017,2202
-50,70,100,494,524,1018,2281
-150,70,-80,512,506,1018,2128
-10,-70,-10,503,515,1018,2333
-80,70,-90,510,508,1018,2178
-10,-10,0,496,522,1018,2277
20,-10,-10,491,527,1018,2298
-40,-40,30,500,518,1018,2276
-40,30,100,502,516,1018,2227
-130,70,-30,511,508,1019,2130
-40,-40,20,504,515,1019,2203
180,60,-60,487,532,1019,2253
-180,60,-60,487,532,1019,2253
-50,70,70,486,533,1019,2226
-60,70,140,501,518,1019,2178
-90,70,-80,505,514,1019,2213
-150,60,-130,487,532,1019,2308
-40,-60,110,493,526,1019,2248
150,10,70,496,524,1020,2227
-30,10,90,501,519,1020,2223
-110,-70,50,474,546,1020,2271
-30,-40,-10,504,516,1020,2272
-30,-30,-170,512,508,1020,2106
-140,50,-140,498,522,1020,2241
-40,-40,180,518,503,1021,2187
-30,-20,-180,513,508,1021,2124
-40,-40,-180,518,503,1021,2187
-140,-30,-110,502,519,1021,2160
40,30,-40,477,544,1021,2243
-30,-20,180,513,508,1021,2124
-160,-30,-20,479,542,1021,2174
-90,-70,50,485,536,1021,2214
70,-30,-30,491,530,1021,2220
20,-10,-130,503,519,1022,2147
-30,50,140,506,516,1022,2140
-40,-60,120,484,538,1022,2317
-130,-60,0,502,520,1022,2279
-20,30,120,503,519,1022,2224
130,-40,120,483,539,1022,2258
-150,30,-140,505,517,1022,2145
-120,70,-140,488,534,1022,2176
50,20,-70,475,548,1023,2263
-20,30,150,493,530,1023,2221
40,-70,-90,493,530,1023,2172
-100,-70,40,478,545,1023,2177
-30,50,80,494,529,1023,2189
-70,-60,140,509,514,1023,2134
-140,70,-110,507,516,1023,2238
-140,-50,-50,489,534,1023,2287
-50,60,140,504,519,1023,2238
160,-10,-170,485,538,1023,2145
-110,-70,40,482,542,1024,2274
-50,-60,30,500,524,1024,2180
-160,-50,-140,491,533,1024,1947
170,80,-170,495,529,1024,1979
140,-70,10,520,504,1024,2003
-110,70,-160,489,535,1024,2219
-140,70,-90,513,511,1024,2166
130,-10,120,486,538,1024,2176
130,-30,80,501,523,1024,2187
-30,-40,130,496,528,1024,2292
-60,-60,70,521,504,1025,2196
-30,50,60,492,533,1025,2201
-130,70,-170,502,523,1025,2134
-10,50,-150,507,518,1025,2061
-50,-60,50,505,520,1025,2164
-30,-40,150,503,522,1025,2236
20,-20,-10,491,535,1026,2195
-50,-70,-40,497,529,1026,2101
80,20,-150,492,534,1026,2242
-120,-60,80,513,513,1026,2168
-150,-50,20,511,515,1026,2260
-140,70,-140,486,540,1026,2243
-160,-20,-40,491,535,1026,2191
-40,-30,20,513,514,1027,2212
-20,-10,160,492,535,1027,2302
-150,40,-120,498,529,1027,2255
-20,50,40,500,527,1027,2260
80,-60,40,508,519,1027,2107
-170,0,-40,483,544,1027,2234
-50,70,160,503,524,1027,2233
170,-90,170,492,536,1028,2222
120,-90,120,492,536,1028,2222
180,-90,-180,492,536,1028,2222
10,-90,10,492,536,1028,2222
60,-90,60,492,536,1028,2222
-90,-90,-90,492,536,1028,2222
90,20,180,480,548,1028,2273
100,-90,100,492,536,1028,2222
150,-90,150,492,536,1028,2222
-110,-90,-110,492,536,1028,2222
-40,-40,90,507,521,1028,2249
90,20,-180,480,548,1028,2273
70,20,-130,500,528,1028,2214
160,-90,160,492,536,1028,2222
40,-90,40,492,536,1028,2222
-40,-90,-40,492,536,1028,2222
-180,-90,-180,492,536,1028,2222
140,-90,140,492,536,1028,2222
-70,-90,-70,492,536,1028,2222
-160,-90,-160,492,536,1028,2222
20,-90,20,492,536,1028,2222
50,-90,50,492,536,1028,2222
130,-90,130,492,536,1028,2222
20,-40,-110,509,519,1028,1906
-50,70,120,499,529,1028,2227
0,-90,0,492,536,1028,2222
-130,-90,-130,492,536,1028,2222
110,-90,110,492,536,1028,2222
-150,-90,-150,492,536,1028,2222
-20,-90,-20,492,536,1028,2222
-30,0,130,512,516,1028,2146
30,-90,30,492,536,1028,2222
70,-90,70,492,536,1028,2222
-140,70,-120,491,537,1028,2172
90,-90,90,492,536,1028,2222
-40,50,-150,518,510,1028,2128
180,-90,180,492,536,1028,2222
-50,-90,-50,492,536,1028,2222
-10,-90,-10,492,536,1028,2222
-60,-90,-60,492,536,1028,2222
90,-40,-10,476,552,1028,2303
-120,-90,-120,492,536,1028,2222
140,-30,50,497,531,1028,2252
-100,-90,-100,492,536,1028,2222
-30,30,-160,516,512,1028,2216
80,-90,80,492,536,1028,2222
-180,-90,180,492,536,1028,2222
-170,-90,-170,492,536,1028,2222
-30,-90,-30,492,536,1028,2222
-140,-90,-140,492,536,1028,2222
-80,-90,-80,492,536,1028,2222
-170,0,-30,494,535,1029,2179
-130,-60,-100,494,535,1029,2299
-160,70,10,533,496,1029,2122
-140,70,-130,498,531,1029,2257
160,20,60,514,515,1029,2357
-30,20,100,514,516,1030,2223
-40,-30,120,502,528,1030,2233
50,60,-60,491,539,1030,2165
-170,10,-10,497,533,1030,2284
150,-20,60,503,527,1030,2196
-20,0,10,501,529,1030,2199
-160,80,10,528,502,1030,2116
-40,-40,160,506,524,1030,2170
130,-40,70,500,531,1031,2231
110,-50,50,511,520,1031,2251
180,40,-30,502,529,1031,2140
0,0,0,484,547,1031,2274
-80,-60,110,511,520,1031,2274
-130,70,-120,515,516,1031,2210
-20,40,150,501,530,1031,2254
-120,70,160,506,525,1031,2214
-180,40,-30,502,529,1031,2140
-50,-60,0,493,539,1032,2400
170,-30,-170,495,537,1032,2108
-140,-50,50,522,510,1032,2280
-40,-30,50,509,523,1032,2245
-30,-10,140,506,526,1032,2278
10,-20,-130,506,526,1032,2051
-60,-60,120,502,530,1032,2270
80,-70,60,511,521,1032,2213
40,-10,-20,491,541,1032,2213
-160,30,-100,493,539,1032,2122
-60,-80,160,513,519,1032,2090
-160,-70,-150,505,528,1033,2171
-60,-70,80,505,528,1033,2277
-30,40,70,496,537,1033,2226
-130,70,-130,497,536,1033,2207
-50,70,90,502,531,1033,2308
-30,60,50,488,545,1033,2256
-150,70,-70,510,523,1033,2224
-30,0,-170,507,526,1033,2159
140,-40,150,485,549,1034,2176
-40,-10,40,502,532,1034,2285
-170,40,-10,514,520,1034,2187
-140,60,-170,500,534,1034,2256
-20,-50,-10,515,519,1034,2327
-120,-60,60,507,527,1034,2232
-140,60,-130,496,538,1034,2349
60,-50,10,511,523,1034,2240
-170,-10,-150,503,532,1035,2079
-20,20,120,505,530,1035,2301
-130,70,-180,495,540,1035,2296
120,30,120,487,548,1035,2053
-60,-50,140,517,518,1035,2332
90,-40,0,476,559,1035,2249
-130,70,180,495,540,1035,2296
-80,70,-120,520,515,1035,2243
-140,60,-30,513,522,1035,2192
30,-60,10,500,536,1036,2309
-160,20,-90,496,540,1036,2149
-130,70,-140,503,533,1036,2293
-40,-20,120,518,518,1036,2281
-140,-50,0,484,552,1036,2232
-40,60,90,500,536,1036,2244
180,60,-40,514,522,1036,2346
-180,60,-40,514,522,1036,2346
-150,-60,-130,504,532,1036,2146
140,10,90,508,528,1036,2316
-20,80,-130,526,510,1036,2145
70,-60,30,516,521,1037,2190
40,60,180,505,532,1037,2196
-40,60,100,505,532,1037,2328
40,60,-180,505,532,1037,2196
-160,-80,60,530,507,1037,2147
50,-30,-70,504,533,1037,2159
-180,40,-40,494,543,1037,2208
180,40,-40,494,543,1037,2208
-20,10,120,516,521,1037,2151
80,-50,20,514,523,1037,2313
-70,-60,50,526,511,1037,2185
-80,-70,-60,493,545,1038,2063
120,-40,30,503,535,1038,2261
-30,30,60,495,543,1038,2253
-160,-20,30,505,533,1038,2239
-40,-50,50,503,535,1038,2357
-60,70,170,498,540,1038,2249
-40,-50,20,508,530,1038,2317
100,70,120,516,522,1038,2204
-50,-50,140,513,525,1038,2285
-170,20,-10,508,530,1038,2296
-40,-30,100,508,531,1039,2258
80,70,-90,517,522,1039,2135
70,30,180,511,528,1039,2266
-180,50,-30,494,545,1039,2230
150,-70,150,505,534,1039,2283
-40,-40,50,510,529,1039,2423
70,30,-180,511,528,1039,2266
-120,70,-130,506,533,1039,2253
60,-20,-30,509,530,1039,2331
120,-40,20,507,532,1039,2180
-120,-60,-30,509,530,1039,2365
-120,-60,-40,506,533,1039,2353
180,50,-30,494,545,1039,2230
170,-60,-180,498,541,1039,2253
-160,10,-80,499,540,1039,2129
130,-20,150,472,567,1039,2274
-140,-60,10,489,550,1039,2291
-150,20,-110,511,528,1039,2093
170,-60,180,498,541,1039,2253
-170,60,-70,494,546,1040,2201
-170,40,-60,497,543,1040,2341
50,10,-60,492,548,1040,2162
40,0,-100,504,536,1040,2171
-50,70,110,497,543,1040,2336
0,-20,-140,511,529,1040,2243
-160,60,-90,503,537,1040,2175
-150,-50,0,500,541,1041,2309
-90,90,90,512,529,1041,2110
-80,90,80,512,529,1041,2110
170,90,-170,512,529,1041,2110
-20,90,20,512,529,1041,2110
-50,90,50,512,529,1041,2110
-160,90,160,512,529,1041,2110
160,-30,180,492,549,1041,2112
100,90,-100,512,529,1041,2110
-180,90,180,512,529,1041,2110
-170,50,-70,503,538,1041,2325
-40,-40,-10,518,523,1041,2263
-180,90,-180,512,529,1041,2110
160,-30,-180,492,549,1041,2112
-30,90,30,512,529,1041,2110
180,90,180,512,529,1041,2110
30,90,-30,512,529,1041,2110
130,90,-130,512,529,1041,2110
100,-60,-20,499,542,1041,2234
90,90,-90,512,529,1041,2110
90,70,130,510,531,1041,2226
10,90,-10,512,529,1041,2110
160,90,-160,512,529,1041,2110
180,90,-180,512,529,1041,2110
-70,90,70,512,529,1041,2110
-110,90,110,512,529,1041,2110
40,90,-40,512,529,1041,2110
-100,90,100,512,529,1041,2110
0,90,0,512,529,1041,2110
110,20,140,496,545,1041,2106
-120,90,120,512,529,1041,2110
50,90,-50,512,529,1041,2110
-10,90,10,512,529,1041,2110
140,90,-140,512,529,1041,2110
-170,90,170,512,529,1041,2110
110,90,-110,512,529,1041,2110
120,90,-120,512,529,1041,2110
40,40,-170,513,528,1041,2255
-140,90,140,512,529,1041,2110
80,90,-80,512,529,1041,2110
-60,90,60,512,529,1041,2110
130,-50,10,499,542,1041,2269
70,-30,-20,505,536,1041,2271
-130,90,130,512,529,1041,2110
70,90,-70,512,529,1041,2110
60,90,-60,512,529,1041,2110
150,90,-150,512,529,1041,2110
20,90,-20,512,529,1041,2110
-150,90,150,512,529,1041,2110
-40,90,40,512,529,1041,2110
-150,-10,-90,514,528,1042,2187
-50,60,-150,517,525,1042,2248
130,-50,120,491,551,1042,2315
160,-80,160,506,536,1042,2193
-150,-80,70,524,518,1042,2215
50,-20,-20,511,531,1042,2277
-130,-60,10,499,543,1042,2290
-30,40,60,504,538,1042,2164
-40,40,110,511,531,1042,2279
-160,60,-30,519,523,1042,2229
-70,70,-180,508,535,1043,2221
-170,60,20,532,511,1043,2127
-70,70,-140,523,520,1043,2268
-50,-50,70,518,525,1043,2292
-70,70,180,508,535,1043,2221
-160,70,-50,525,518,1043,2272
10,80,-10,520,523,1043,2120
-160,0,-70,501,542,1043,2144
-30,30,110,527,516,1043,2245
150,0,70,511,532,1043,2318
30,-70,-100,515,529,1044,2183
-110,-70,-90,503,541,1044,2162
-150,50,-120,499,545,1044,2275
-50,70,-170,515,530,1045,2180
-110,-60,-60,498,547,1045,2353
-160,60,-80,507,538,1045,2286
-30,-10,80,507,538,1045,2339
-30,-30,160,515,530,1045,2311
30,50,-30,495,551,1046,2191
80,30,170,521,525,1046,2321
-50,-60,20,505,541,1046,2265
-40,60,70,496,550,1046,2341
-40,-20,30,509,537,1046,2281
30,-30,-100,505,541,1046,2115
20,10,-10,497,549,1046,2250
10,-50,-120,510,536,1046,2095
-20,-80,-20,522,524,1046,2255
20,-70,-110,516,530,1046,2171
-30,-10,120,520,527,1047,2261
-60,-60,-20,525,522,1047,2332
-20,60,-140,528,519,1047,2263
-170,10,-20,504,543,1047,2270
-160,-20,0,508,539,1047,2200
-110,-60,80,523,524,1047,2280
-170,20,-40,506,542,1048,2286
-170,60,-60,515,533,1048,2279
-50,-60,120,507,541,1048,2427
-80,70,120,507,541,1048,2281
30,-50,0,528,520,1048,2431
140,-10,90,522,526,1048,2217
-100,-70,60,503,546,1049,2306
-180,-10,40,498,551,1049,2198
-160,30,-150,522,527,1049,2250
-130,70,-150,496,553,1049,2360
-90,-60,110,517,532,1049,2320
-140,-50,-40,527,522,1049,2330
50,30,-170,493,556,1049,2243
-40,10,80,517,532,1049,2296
-30,-20,140,506,543,1049,2213
180,-10,40,498,551,1049,2198
70,-70,50,513,536,1049,2222
-160,-50,50,523,526,1049,2201
-40,70,170,510,540,1050,2317
-90,-70,60,496,554,1050,2434
180,20,-160,499,551,1050,2123
40,10,-30,498,552,1050,2184
130,0,120,509,541,1050,2274
-80,70,-170,513,537,1050,2272
-120,70,-150,501,549,1050,2304
130,-20,130,488,562,1050,2225
-180,20,-160,499,551,1050,2123
150,50,70,523,528,1051,2258
-60,-60,50,526,525,1051,2303
90,-70,70,513,538,1051,2263
-30,-60,-20,529,522,1051,2340
-60,70,100,519,532,1051,2335
-90,70,130,511,540,1051,2236
-160,10,-140,510,541,1051,2152
-30,30,-170,520,531,1051,2267
-50,-60,10,500,551,1051,2388
80,70,140,514,538,1052,2256
-130,70,-160,509,543,1052,2311
-140,-30,-90,522,530,1052,2164
-130,-50,-60,508,544,1052,2285
-50,-70,170,527,525,1052,2178
-140,60,-150,510,542,1052,2250
-30,70,40,524,528,1052,2121
-150,-30,-70,513,539,1052,2309
-40,40,90,499,553,1052,2355
50,20,-90,503,550,1053,2120
180,60,-30,508,545,1053,2320
-20,40,-150,529,524,1053,2194
-180,60,-30,508,545,1053,2320
-140,60,170,500,553,1053,2220
-30,10,140,527,526,1053,2244
-30,10,150,514,539,1053,2238
-110,70,-140,514,540,1054,2245
-140,40,-140,506,548,1054,2202
-120,-60,-20,506,548,1054,2283
160,40,60,514,540,1054,2341
-140,70,-100,525,529,1054,2285
170,30,50,515,539,1054,2325
-40,50,80,512,542,1054,2230
-40,60,-130,534,520,1054,2291
-150,-60,60,525,529,1054,2227
-70,-80,150,528,526,1054,2196
110,50,120,495,559,1054,2165
-110,-60,-70,521,533,1054,2288
-180,50,-50,506,549,1055,2376
-130,-60,-10,516,539,1055,2289
-40,20,90,521,534,1055,2263
-40,50,-160,544,511,1055,2148
-40,70,-120,548,507,1055,2192
180,50,-50,506,549,1055,2376
120,50,110,503,552,1055,2179
-40,0,60,525,530,1055,2239
-40,-50,70,529,526,1055,2287
-30,-40,140,511,544,1055,2438
-80,-70,60,517,539,1056,2270
100,20,-170,499,557,1056,2266
-80,70,160,514,542,1056,2328
-30,40,-180,534,522,1056,2215
-150,0,-90,511,545,1056,2255
-160,40,-100,512,544,1056,2240
-70,70,110,507,549,1056,2384
-130,-60,-20,516,540,1056,2276
-150,60,-90,515,541,1056,2361
-30,40,180,534,522,1056,2215
-140,-60,20,506,550,1056,2462
-30,40,120,528,529,1057,2283
-30,60,150,517,540,1057,2392
140,-50,140,498,559,1057,2316
20,40,-160,527,530,1057,2217
-40,60,150,514,543,1057,2221
10,-60,0,518,539,1057,2289
-40,-40,120,519,538,1057,2291
-140,-40,-70,507,551,1058,2287
-140,-80,80,528,530,1058,2248
-110,-60,-50,510,548,1058,2384
110,10,170,506,552,1058,2298
-180,50,-40,504,554,1058,2329
150,-40,30,501,557,1058,2255
140,20,90,510,548,1058,2377
180,50,-40,504,554,1058,2329
-100,-70,50,500,558,1058,2354
-30,-30,70,500,559,1059,2395
-40,0,70,525,534,1059,2234
-140,60,180,508,551,1059,2225
-20,40,140,505,554,1059,2312
-140,60,-180,508,551,1059,2225
-150,-30,-50,505,554,1059,2326
-20,0,-160,533,526,1059,2113
-60,70,130,513,546,1059,2348
-90,70,-160,513,547,1060,2266
140,-30,70,513,547,1060,2281
-160,10,-50,509,551,1060,2331
-40,-20,60,540,520,1060,2327
40,-60,10,531,529,1060,2256
-40,10,70,521,539,1060,2250
-60,-70,90,519,541,1060,2504
130,40,100,516,544,1060,2246
-40,-50,120,499,562,1061,2310
-130,-50,0,516,545,1061,2344
120,70,-130,527,534,1061,2070
-150,80,0,545,516,1061,2203
120,-40,40,526,535,1061,2389
-150,-30,-30,511,550,1061,2193
130,-40,60,504,557,1061,2222
-170,10,-40,503,558,1061,2414
70,70,150,525,536,1061,2299
-180,10,40,523,539,1062,2116
-120,70,-40,530,532,1062,2221
60,-20,-40,494,568,1062,2260
-140,60,-40,531,531,1062,2209
-170,-30,40,523,539,1062,2193
-40,70,160,522,540,1062,2269
180,10,40,523,539,1062,2116
-30,0,150,518,545,1063,2215
-30,-10,-170,515,548,1063,2193
-160,-20,-30,497,566,1063,2381
-30,-20,-170,533,530,1063,2168
140,60,80,527,536,1063,2374
-100,70,140,520,543,1063,2240
-120,70,-160,502,561,1063,2417
-70,-70,70,526,537,1063,2303
-150,-50,10,508,555,1063,2292
-160,-30,40,520,543,1063,2387
-20,20,140,516,548,1064,2394
-100,70,-150,518,546,1064,2250
-160,30,-70,508,556,1064,2239
180,-50,40,509,555,1064,2280
-180,-50,40,509,555,1064,2280
110,70,110,522,542,1064,2291
20,-30,-10,513,551,1064,2257
-20,-40,-10,508,556,1064,2346
-90,-60,100,526,538,1064,2419
-110,70,150,519,545,1064,2265
70,-50,10,517,547,1064,2353
-160,30,-80,520,545,1065,2247
-90,70,170,520,545,1065,2373
170,40,50,528,537,1065,2269
-160,-30,-10,492,574,1066,2305
150,-30,170,501,565,1066,2137
-130,60,-140,513,553,1066,2407
30,-10,-110,533,533,1066,2144
-40,-20,110,536,530,1066,2354
-160,-40,-140,539,527,1066,2244
100,20,160,518,548,1066,2328
-150,-20,-80,523,543,1066,2346
140,10,-170,515,551,1066,2290
180,0,40,521,546,1067,2184
-140,-40,-30,522,545,1067,2333
-150,-70,-140,521,546,1067,2223
-40,30,80,511,556,1067,2274
-180,0,40,521,546,1067,2184
-20,-70,-20,536,531,1067,2386
-50,-50,-10,536,531,1067,2363
-140,40,-150,529,539,1068,2243
-40,-50,40,512,556,1068,2450
-40,-60,180,540,528,1068,2203
-160,20,-80,516,552,1068,2259
-130,70,-100,529,539,1068,2292
-40,-60,-180,540,528,1068,2203
-120,70,170,508,561,1069,2366
-40,50,70,510,559,1069,2276
10,10,-150,535,534,1069,2271
130,-20,140,494,575,1069,2249
-70,-60,-40,516,553,1069,2241
-130,-80,90,535,534,1069,2251
-30,60,160,517,552,1069,2348
-130,60,-40,524,545,1069,2334
120,-70,110,506,564,1070,2381
-170,30,-10,532,538,1070,2312
-60,60,-130,534,536,1070,2333
-70,-50,130,532,538,1070,2361
-90,-70,70,519,551,1070,2413
-160,50,-100,520,550,1070,2287
0,0,-150,539,531,1070,2242
-130,70,-110,530,540,1070,2339
10,-20,-10,525,545,1070,2309
-30,-30,90,522,548,1070,2295
-160,60,-70,530,540,1070,2242
10,-10,-140,521,550,1071,2339
-150,70,0,553,518,1071,2221
10,-30,-10,519,552,1071,2350
-30,0,180,521,550,1071,2320
-160,-10,-60,515,556,1071,2222
-30,0,-180,521,550,1071,2320
-30,50,170,527,544,1071,2374
-40,20,70,519,552,1071,2309
50,0,-40,500,571,1071,2320
-180,-30,40,522,550,1072,2278
-140,60,160,520,552,1072,2166
180,-30,40,522,550,1072,2278
-140,70,-80,524,548,1072,2343
-90,-70,-70,518,554,1072,2151
-40,-30,10,524,548,1072,2250
-70,-70,90,519,553,1072,2455
-140,60,-20,526,546,1072,2303
-40,50,90,526,546,1072,2406
-170,10,-30,516,556,1072,2286
130,-50,110,503,570,1073,2382
0,70,-150,539,534,1073,2230
-110,-60,90,528,545,1073,2295
-50,-30,30,522,551,1073,2273
-50,60,120,515,558,1073,2340
-170,40,-50,506,567,1073,2467
60,-70,40,528,545,1073,2260
30,10,-20,528,545,1073,2305
-80,-70,70,515,558,1073,2514
-100,-60,90,523,550,1073,2409
-50,-40,30,538,535,1073,2342
50,10,-130,526,547,1073,2373
-30,-10,-180,526,548,1074,2205
-140,-50,40,539,535,1074,2351
-70,70,150,521,553,1074,2301
60,-60,20,532,542,1074,2252
110,30,130,497,577,1074,2271
-80,-70,80,528,546,1074,2434
110,10,160,523,551,1074,2426
80,50,150,519,555,1074,2316
-110,-60,-20,520,554,1074,2431
-30,-10,180,526,548,1074,2205
110,-60,-10,508,566,1074,2328
-120,70,180,520,555,1075,2303
-120,70,-180,520,555,1075,2303
-120,-60,-90,518,557,1075,2351
20,70,-20,516,559,1075,2227
-140,60,-140,514,561,1075,2386
-150,-30,-60,523,552,1075,2239
150,-10,70,522,553,1075,2290
-160,40,-80,526,549,1075,2279
-60,60,150,536,539,1075,2317
-150,-30,-40,520,556,1076,2400
-60,70,110,516,560,1076,2383
-70,-60,60,535,541,1076,2282
-170,60,-50,520,557,1077,2342
-130,-40,-90,532,545,1077,2388
10,-70,-120,534,543,1077,2234
-160,40,10,538,539,1077,2283
-180,-20,40,530,547,1077,2250
170,10,50,526,551,1077,2335
180,-20,40,530,547,1077,2250
-30,-40,70,511,566,1077,2382
-70,-60,110,522,556,1078,2377
70,20,-150,518,560,1078,2282
-150,60,-110,527,551,1078,2299
80,40,-120,520,558,1078,2296
-150,60,-100,526,552,1078,2277
20,-70,10,529,549,1078,2310
40,-10,-90,510,569,1079,2144
-160,0,-40,522,557,1079,2393
-40,-50,60,533,546,1079,2325
-30,-20,80,519,560,1079,2460
-50,60,150,524,555,1079,2433
-100,70,150,515,564,1079,2297
70,70,-80,528,551,1079,2219
-40,-20,130,540,539,1079,2355
-130,60,-170,536,543,1079,2359
-140,70,150,533,546,1079,2095
130,-10,130,513,566,1079,2285
-140,-40,-20,527,553,1080,2361
20,0,-10,530,550,1080,2342
140,-20,80,531,549,1080,2342
-120,-80,100,532,548,1080,2275
-40,-30,0,541,539,1080,2320
-130,50,-150,524,556,1080,2364
30,30,-160,536,544,1080,2381
50,20,-100,510,571,1081,2088
-160,50,-80,523,558,1081,2302
-50,-60,110,522,559,1081,2526
170,60,-170,520,561,1081,2154
-50,-50,90,532,549,1081,2342
-180,-20,-160,525,556,1081,2164
-150,-40,-10,509,572,1081,2301
-60,-50,150,543,538,1081,2365
180,-20,-160,525,556,1081,2164
-140,-40,-40,527,554,1081,2341
-60,-60,30,527,555,1082,2290
-30,-20,100,535,547,1082,2395
100,50,130,506,576,1082,2456
-50,-50,-20,551,531,1082,2271
-20,20,130,526,556,1082,2407
-30,-80,-30,532,550,1082,2335
-130,50,-160,517,565,1082,2276
-50,-50,100,533,550,1083,2390
100,-60,60,532,551,1083,2289
-170,50,-20,522,561,1083,2266
-30,-30,80,527,556,1083,2424
-40,-50,130,512,571,1083,2346
160,10,60,525,558,1083,2477
130,-40,100,527,556,1083,2313
-140,80,-10,550,533,1083,2218
-30,0,90,539,544,1083,2385
-80,-80,140,538,546,1084,2262
-30,50,160,529,555,1084,2351
-30,0,20,523,561,1084,2241
150,30,-160,536,548,1084,2453
-60,-60,10,524,560,1084,2407
-90,70,140,510,574,1084,2338
-160,20,-70,522,562,1084,2306
-160,40,0,542,542,1084,2264
-160,50,-90,533,551,1084,2261
160,-20,50,515,569,1084,2507
-120,70,-120,535,550,1085,2363
-60,60,140,533,552,1085,2308
-170,30,-40,518,567,1085,2307
-110,70,-90,540,545,1085,2410
-180,50,-170,545,540,1085,2231
-50,-40,80,536,549,1085,2356
180,50,-170,545,540,1085,2231
-160,-10,-40,521,564,1085,2377
170,-30,40,510,575,1085,2350
-140,-40,-10,527,558,1085,2336
-30,-20,170,534,551,1085,2312
-30,10,130,548,538,1086,2420
150,-60,150,523,563,1086,2327
-130,60,-180,523,563,1086,2452
120,-50,80,548,538,1086,2327
10,-40,-120,536,550,1086,2252
-110,70,-170,520,566,1086,2443
-110,-60,-40,530,556,1086,2361
-150,50,-170,514,572,1086,2206
-130,60,180,523,563,1086,2452
-140,10,-120,539,547,1086,2222
-100,-70,-80,515,571,1086,2216
-130,-50,10,516,571,1087,2317
70,50,160,540,547,1087,2258
-40,-50,30,516,571,1087,2457
-50,-50,0,549,538,1087,2405
-50,-60,100,522,565,1087,2466
-50,-40,20,543,544,1087,2413
-150,70,-60,547,540,1087,2409
-90,70,-110,538,549,1087,2350
-160,60,-60,530,557,1087,2346
70,-80,60,530,557,1087,2277
-70,70,140,520,567,1087,2441
-70,-60,40,549,538,1087,2378
130,-40,90,551,536,1087,2285
-120,-60,20,528,559,1087,2378
120,-60,100,531,556,1087,2336
-20,30,140,512,575,1087,2495
30,-20,-100,529,559,1088,2135
-30,-30,140,531,557,1088,2432
-160,60,170,547,541,1088,2031
0,-30,-10,533,555,1088,2332
-70,-70,80,529,559,1088,2561
80,-80,70,532,556,1088,2311
-140,70,-60,544,544,1088,2316
-100,-80,120,536,552,1088,2312
-30,20,-160,546,542,1088,2301
-20,-10,-160,533,555,1088,2270
120,-50,70,527,561,1088,2325
-160,20,-50,529,559,1088,2405
-40,-30,130,534,555,1089,2399
70,30,-120,527,562,1089,2270
-170,60,-30,537,552,1089,2263
160,50,60,539,550,1089,2306
-130,-60,20,518,571,1089,2397
60,70,160,537,552,1089,2311
170,20,50,524,565,1089,2317
-120,70,-110,542,547,1089,2335
-30,80,-120,559,530,1089,2240
150,-30,40,535,554,1089,2439
-180,80,-180,532,558,1090,2116
-60,-60,20,521,569,1090,2393
-40,40,80,524,566,1090,2326
-180,80,180,532,558,1090,2116
180,80,180,532,558,1090,2116
-30,-20,90,535,555,1090,2488
-40,50,130,529,561,1090,2339
10,-60,-120,538,552,1090,2130
180,80,-180,532,558,1090,2116
-60,-60,40,528,562,1090,2388
-150,-30,-20,516,574,1090,2407
90,-60,-30,539,552,1091,2243
60,-80,50,535,556,1091,2323
-40,50,-140,551,540,1091,2357
-160,20,-60,514,577,1091,2350
170,-80,170,537,554,1091,2331
-20,30,130,524,567,1091,2464
-160,30,-90,518,573,1091,2325
-100,-60,40,543,548,1091,2404
-50,-20,40,544,548,1092,2272
-50,60,80,531,561,1092,2388
-40,-50,-20,550,542,1092,2490
-160,40,-70,531,561,1092,2346
-140,50,-130,521,571,1092,2393
-20,-10,0,534,558,1092,2298
-50,60,110,523,569,1092,2436
-70,-60,-30,532,560,1092,2415
-80,-60,40,549,543,1092,2348
-160,-10,20,537,555,1092,2296
-160,50,10,543,549,1092,2401
100,-70,80,538,554,1092,2399
-50,60,160,527,566,1093,2300
170,0,50,533,560,1093,2377
-80,70,150,519,574,1093,2450
180,-60,-170,527,566,1093,2332
120,-50,60,522,571,1093,2372
-180,-60,-170,527,566,1093,2332
-60,70,120,520,573,1093,2521
-60,-50,70,529,564,1093,2293
60,20,-150,518,575,1093,2457
-60,-70,-50,535,558,1093,2195
-110,-60,70,551,542,1093,2477
-110,-80,110,542,551,1093,2312
50,0,-60,520,573,1093,2341
-140,-20,-110,541,552,1093,2232
120,70,100,539,554,1093,2429
-150,-20,-70,522,572,1094,2368
130,-60,120,522,572,1094,2361
-130,50,-170,531,563,1094,2242
-60,70,-160,541,553,1094,2299
-150,60,-40,537,557,1094,2362
-130,-50,-50,524,570,1094,2443
-100,-60,100,528,567,1095,2407
-160,10,-40,528,567,1095,2526
-130,70,-70,543,552,1095,2355
-170,50,-60,521,574,1095,2501
-110,70,160,526,569,1095,2355
-160,0,-140,530,565,1095,2264
-60,-60,80,538,557,1095,2371
-120,-60,-10,546,549,1095,2398
-140,-20,-100,536,559,1095,2342
-150,30,-110,525,570,1095,2239
130,30,110,518,577,1095,2343
-110,-60,30,533,562,1095,2413
-150,-30,20,554,541,1095,2329
120,0,160,523,573,1096,2461
-50,70,-180,527,569,1096,2384
-50,70,180,527,569,1096,2384
-100,70,-180,522,575,1097,2439
-60,-60,0,526,571,1097,2506
-10,-40,-10,541,556,1097,2470
-130,-50,-100,520,577,1097,2435
-120,70,-170,524,573,1097,2430
-170,30,-160,530,567,1097,2187
-50,50,120,531,566,1097,2432
-100,70,180,522,575,1097,2439
-90,-80,130,547,550,1097,2308
0,80,0,546,552,1098,2206
-140,60,-100,542,556,1098,2406
-170,50,-50,534,564,1098,2512
150,-20,70,541,558,1099,2401
-130,60,-120,532,567,1099,2356
-110,70,-130,532,567,1099,2348
50,-40,-10,537,562,1099,2486
-110,70,-50,551,548,1099,2285
90,-80,80,535,564,1099,2366
-30,40,130,543,556,1099,2221
-120,-60,0,540,559,1099,2367
150,-70,20,556,543,1099,2198
-140,-60,-120,542,557,1099,2337
-150,0,-130,531,568,1099,2385
-100,-60,-60,548,551,1099,2323
-50,-50,130,542,558,1100,2542
70,40,-110,538,562,1100,2173
130,-40,50,528,572,1100,2418
-160,60,10,557,543,1100,2359
-120,70,-80,550,550,1100,2378
160,-50,170,524,576,1100,2383
90,50,140,544,556,1100,2397
-160,-10,-50,528,573,1101,2328
90,50,-120,526,575,1101,2215
-40,60,60,530,571,1101,2408
-80,-60,130,542,559,1101,2281
-50,70,170,542,559,1101,2333
-130,-60,40,525,576,1101,2361
-110,70,170,530,571,1101,2373
-30,-10,10,535,566,1101,2418
-50,-40,90,541,561,1102,2406
-60,60,-120,554,548,1102,2382
-50,-60,170,551,551,1102,2368
-130,60,-160,543,559,1102,2476
-30,40,170,544,558,1102,2440
-30,20,-170,548,554,1102,2382
-60,-60,-10,526,576,1102,2456
-160,-20,-20,521,582,1103,2408
-150,-40,0,529,574,1103,2524
-160,30,10,542,561,1103,2432
-140,20,-130,546,557,1103,2221
60,50,170,537,566,1103,2257
-30,50,150,528,576,1104,2368
170,-10,50,533,571,1104,2381
-160,-10,10,535,569,1104,2312
110,-50,40,540,564,1104,2462
-50,70,-110,568,536,1104,2296
-30,-10,90,532,572,1104,2459
-70,70,120,516,588,1104,2390
-10,40,20,546,558,1104,2332
-150,60,-80,547,557,1104,2366
-180,40,40,543,562,1105,2304
180,40,40,543,562,1105,2304
-140,60,-120,540,565,1105,2369
50,30,-70,524,581,1105,2350
130,50,100,544,561,1105,2443
-120,60,-50,542,563,1105,2382
-50,60,100,534,571,1105,2507
-160,30,-60,532,573,1105,2387
-170,20,-20,537,568,1105,2367
-160,-10,-10,536,569,1105,2331
80,-70,50,547,559,1106,2393
-50,60,90,532,574,1106,2393
60,-40,-10,541,565,1106,2501
-160,50,-70,528,578,1106,2367
50,-70,30,542,564,1106,2339
120,-60,0,524,582,1106,2429
90,40,-130,541,565,1106,2317
-80,70,-130,553,553,1106,2434
20,60,-20,520,586,1106,2250
-30,-10,150,533,573,1106,2420
-140,-40,-60,525,581,1106,2456
-100,70,-140,541,565,1106,2324
150,60,70,567,540,1107,2479
-120,-60,10,548,559,1107,2416
-150,-30,30,539,568,1107,2378
140,60,-150,540,567,1107,2327
-100,70,-100,543,564,1107,2439
-80,-60,50,540,567,1107,2376
-60,70,180,536,571,1107,2403
-60,70,-180,536,571,1107,2403
-150,30,-150,554,553,1107,2321
-30,-10,0,549,559,1108,2361
-50,-50,170,550,558,1108,2326
-90,-60,50,551,557,1108,2442
-120,70,-100,550,558,1108,2417
-170,30,-20,549,559,1108,2464
-170,20,30,560,548,1108,2336
-30,10,160,556,552,1108,2350
-110,-60,0,537,571,1108,2391
50,-80,40,548,560,1108,2405
60,-50,0,531,578,1109,2424
-140,50,-170,537,572,1109,2399
-140,60,-110,537,572,1109,2424
-80,-60,-40,538,571,1109,2410
-160,40,-90,545,564,1109,2397
80,-40,-20,523,586,1109,2337
-30,-20,160,530,580,1110,2520
180,30,40,543,567,1110,2380
180,10,-160,530,580,1110,2278
-70,-60,-10,542,568,1110,2486
-140,-40,-50,541,569,1110,2401
-30,-10,110,542,568,1110,2449
100,60,-120,544,566,1110,2250
130,-40,30,531,579,1110,2450
180,-40,40,545,565,1110,2267
-180,10,-160,530,580,1110,2278
-180,30,40,543,567,1110,2380
-40,60,160,535,575,1110,2433
-40,40,70,537,573,1110,2385
-160,-10,0,530,580,1110,2286
70,-40,-40,513,597,1110,2244
-180,-40,40,545,565,1110,2267
40,-50,0,551,560,1111,2469
-160,-70,60,563,548,1111,2262
-170,20,-30,531,580,1111,2351
-70,70,130,528,583,1111,2552
-130,-50,-10,547,564,1111,2380
-160,0,-50,534,577,1111,2453
-170,40,-20,537,574,1111,2321
50,20,-80,517,594,1111,2272
-80,70,130,514,597,1111,2339
30,-40,-10,542,569,1111,2354
170,50,50,554,557,1111,2411
160,-10,60,534,577,1111,2456
-130,-60,30,547,565,1112,2574
-40,-40,130,522,590,1112,2484
0,-20,-10,544,568,1112,2433
-60,-50,130,535,577,1112,2491
40,0,-90,534,579,1113,2324
-40,-30,60,559,554,1113,2571
-40,-40,80,559,554,1113,2454
70,-80,-60,551,562,1113,2331
-10,-60,-10,547,566,1113,2474
100,-80,90,544,569,1113,2408
-40,50,150,538,575,1113,2334
50,0,-50,518,595,1113,2284
-110,-60,-30,541,572,1113,2465
-130,60,-50,551,562,1113,2408
-170,40,-30,542,571,1113,2394
-140,70,-70,558,556,1114,2418
-140,-70,-130,537,577,1114,2315
-180,-10,-160,547,567,1114,2358
180,70,-180,555,559,1114,2191
-180,70,180,555,559,1114,2191
-80,-60,30,567,547,1114,2482
180,70,180,555,559,1114,2191
-180,70,-180,555,559,1114,2191
-90,-60,-50,548,566,1114,2434
-160,0,-60,539,575,1114,2459
-110,-60,10,548,566,1114,2447
-120,60,-150,553,561,1114,2440
180,-10,-160,547,567,1114,2358
-140,70,-10,574,541,1115,2386
-140,-10,-110,542,573,1115,2392
50,-10,-30,538,577,1115,2433
-130,60,-150,526,589,1115,2468
180,20,40,555,560,1115,2287
-90,70,160,526,589,1115,2486
-180,20,40,555,560,1115,2287
-30,50,-140,566,549,1115,2477
-30,10,100,546,569,1115,2441
140,10,100,524,591,1115,2402
-40,-40,150,546,569,1115,2436
40,-40,-10,527,588,1115,2378
70,-70,40,553,562,1115,2370
-150,20,-100,526,589,1115,2322
-30,0,120,547,569,1116,2475
100,-50,30,555,561,1116,2500
-50,-40,10,552,564,1116,2435
-60,-60,110,540,577,1117,2557
-60,-70,160,558,559,1117,2341
-20,-30,-10,542,575,1117,2599
130,10,120,543,574,1117,2329
-50,50,110,540,577,1117,2424
-100,-60,-50,538,579,1117,2522
160,-70,160,534,583,1117,2424
-130,70,-90,540,577,1117,2450
-70,60,160,548,569,1117,2406
80,30,-130,548,569,1117,2314
-40,-10,30,540,577,1117,2392
-50,-30,40,549,568,1117,2416
-30,30,50,548,570,1118,2395
-70,-60,20,537,581,1118,2473
-130,70,-80,552,566,1118,2404
130,-70,120,542,576,1118,2495
60,-80,-70,551,567,1118,2326
60,-30,-20,532,586,1118,2498
-40,50,140,544,574,1118,2410
-130,60,160,539,580,1119,2367
180,-80,180,548,571,1119,2371
-120,-50,-70,536,583,1119,2426
-180,-80,-180,548,571,1119,2371
-180,-80,180,548,571,1119,2371
-160,10,-60,519,600,1119,2429
-30,-70,-30,552,567,1119,2504
-160,10,-70,531,588,1119,2397
10,-10,-10,529,590,1119,2441
120,20,130,538,581,1119,2352
180,-80,-180,548,571,1119,2371
-30,0,100,543,577,1120,2530
-120,-60,30,542,578,1120,2453
-130,60,-130,540,580,1120,2394
-60,-50,80,546,574,1120,2402
-110,70,180,526,594,1120,2481
90,60,-110,556,564,1120,2292
-40,10,150,549,571,1120,2406
-110,70,-180,526,594,1120,2481
-30,10,-170,549,571,1120,2419
140,-10,100,562,558,1120,2403
-70,70,-150,553,567,1120,2445
140,30,90,548,573,1121,2512
-30,20,40,546,575,1121,2365
-140,0,-120,563,558,1121,2367
-100,70,160,542,579,1121,2436
-30,-30,150,552,569,1121,2585
-50,-40,100,565,556,1121,2441
50,-80,-80,562,559,1121,2357
-140,-50,10,531,590,1121,2423
-50,50,130,553,568,1121,2458
-150,-20,-60,530,591,1121,2450
-70,-60,0,541,581,1122,2442
100,-60,50,554,568,1122,2400
-60,-60,-40,549,573,1122,2313
-160,-20,-10,531,591,1122,2380
-120,-50,-80,546,576,1122,2450
-40,10,90,555,567,1122,2412
20,40,-20,543,579,1122,2288
140,0,100,546,576,1122,2411
50,70,170,547,575,1122,2401
130,-10,160,530,592,1122,2496
-40,40,-150,561,561,1122,2468
-120,60,160,547,575,1122,2449
-130,-50,-40,553,570,1123,2511
-40,-10,70,561,562,1123,2418
-130,80,-20,573,550,1123,2282
-170,40,-40,544,579,1123,2447
-130,60,-30,557,566,1123,2374
-50,-50,30,538,585,1123,2521
-110,70,-110,561,562,1123,2411
-50,-30,100,560,563,1123,2533
-110,70,-120,560,563,1123,2413
-170,60,-40,542,582,1124,2518
-150,40,-160,534,590,1124,2424
-80,-60,-30,542,582,1124,2565
-40,60,180,550,574,1124,2439
-120,-50,-60,548,576,1124,2485
-40,60,-180,550,574,1124,2439
-50,-40,40,553,571,1124,2509
-50,-50,40,549,575,1124,2535
-50,60,-160,562,562,1124,2481
-150,10,-90,533,591,1124,2347
40,10,-140,530,594,1124,2379
130,70,-140,555,569,1124,2252
-150,20,-140,556,569,1125,2327
-150,-10,-80,550,575,1125,2337
-110,-60,20,563,562,1125,2433
-40,10,140,567,558,1125,2455
-160,40,-160,539,586,1125,2482
20,50,-160,558,567,1125,2357
-30,-20,150,529,596,1125,2495
-10,-40,-140,561,564,1125,2418
160,60,60,582,544,1126,2465
-100,70,170,531,595,1126,2505
60,40,180,548,578,1126,2490
60,40,-180,548,578,1126,2490
-70,-60,-20,541,585,1126,2546
-140,-60,70,554,572,1126,2444
-130,60,170,546,580,1126,2389
110,30,-150,546,581,1127,2471
-90,-60,60,552,575,1127,2437
-150,-30,-10,539,588,1127,2349
-160,20,10,559,568,1127,2395
10,-70,0,550,577,1127,2430
0,-50,-130,548,579,1127,2379
-20,-40,-150,560,567,1127,2346
160,-30,40,546,581,1127,2515
10,-40,-10,560,567,1127,2444
-30,20,110,548,580,1128,2447
140,-40,30,538,590,1128,2467
90,30,160,555,573,1128,2324
-60,70,-100,575,553,1128,2362
-150,-40,10,541,587,1128,2448
-130,-70,-120,545,583,1128,2354
-80,-60,60,552,576,1128,2498
-40,-60,-30,551,577,1128,2409
-40,10,60,558,570,1128,2370
30,0,-130,559,569,1128,2311
130,-40,80,542,587,1129,2531
-40,-20,140,555,574,1129,2409
-40,0,50,557,572,1129,2447
40,0,-30,554,575,1129,2483
-40,30,70,544,585,1129,2436
80,-80,-50,564,565,1129,2355
90,-70,60,558,572,1130,2388
-10,-50,-10,539,591,1130,2562
-100,-60,80,559,571,1130,2622
-30,30,120,550,580,1130,2429
-10,-30,-10,546,584,1130,2528
-50,-20,30,564,566,1130,2491
-50,-50,10,547,583,1130,2467
-90,-60,-40,559,571,1130,2531
120,0,150,528,602,1130,2547
-30,40,140,553,577,1130,2599
-120,60,170,548,583,1131,2517
-150,50,-90,542,589,1131,2479
-80,-60,100,560,571,1131,2504
-160,40,-60,549,582,1131,2482
120,10,-180,536,595,1131,2440
120,10,180,536,595,1131,2440
-50,-50,110,548,583,1131,2565
-30,20,150,562,569,1131,2502
-100,-60,50,550,581,1131,2439
-150,60,-70,556,575,1131,2443
-120,-50,10,550,581,1131,2535
-110,70,-100,565,566,1131,2477
-90,-60,40,559,572,1131,2445
-30,-30,-10,550,581,1131,2500
140,-20,90,556,575,1131,2410
110,-70,90,559,572,1131,2528
160,-50,30,541,590,1131,2409
-130,-50,-30,557,574,1131,2583
-130,-40,-70,551,580,1131,2478
-60,60,130,545,586,1131,2494
-70,70,-170,535,596,1131,2386
-90,70,-150,547,584,1131,2324
20,-30,-110,563,568,1131,2270
-150,40,-110,545,587,1132,2508
-120,60,-60,555,577,1132,2471
0,50,-150,564,568,1132,2336
60,30,-170,546,586,1132,2392
-30,-10,100,543,589,1132,2517
40,-20,-20,538,594,1132,2481
-30,-10,170,546,586,1132,2511
-160,50,-20,554,578,1132,2427
60,30,-110,544,588,1132,2373
-130,-40,-100,552,581,1133,2540
-40,20,100,557,576,1133,2460
-120,70,-90,559,574,1133,2456
-40,70,50,576,557,1133,2359
-150,10,-130,571,562,1133,2313
-110,-60,-10,541,592,1133,2394
-100,-60,-40,546,587,1133,2591
-170,30,-30,553,580,1133,2374
-30,30,170,550,583,1133,2540
-10,40,-150,547,586,1133,2336
-140,40,-130,549,584,1133,2382
160,-60,30,551,582,1133,2262
-50,-40,110,569,564,1133,2542
-70,60,100,557,576,1133,2423
160,0,60,544,589,1133,2562
-60,70,-170,553,580,1133,2514
-150,50,-80,560,573,1133,2482
120,10,140,549,585,1134,2453
-40,-40,60,556,578,1134,2580
-40,-20,20,550,584,1134,2451
90,-60,40,555,579,1134,2465
0,-40,-10,560,574,1134,2455
0,60,-150,559,575,1134,2437
-160,-10,-20,550,585,1135,2419
-110,60,150,558,577,1135,2504
-90,-60,20,562,573,1135,2457
-150,50,-10,553,582,1135,2382
-140,30,-130,563,572,1135,2368
30,40,-30,540,595,1135,2349
-150,40,-80,560,575,1135,2486
-100,-60,-10,540,595,1135,2557
-80,70,140,540,596,1136,2555
-80,70,-160,549,587,1136,2373
-50,50,90,554,582,1136,2481
140,-30,80,564,572,1136,2596
40,-80,30,560,576,1136,2462
-160,-10,-30,533,603,1136,2553
-30,30,180,561,575,1136,2452
-30,10,180,561,575,1136,2490
-30,10,-180,561,575,1136,2490
-160,50,-60,561,575,1136,2543
-30,30,-180,561,575,1136,2452
-100,-60,0,549,588,1137,2475
130,-40,40,552,585,1137,2652
-40,40,120,561,576,1137,2496
60,-30,-50,557,580,1137,2344
-160,20,0,568,569,1137,2485
-80,-60,-10,544,593,1137,2421
-40,80,-110,583,554,1137,2285
0,-40,-130,564,573,1137,2409
-40,-10,120,571,566,1137,2565
40,20,-40,539,598,1137,2498
-100,70,-60,567,571,1138,2370
70,-40,-10,540,598,1138,2460
70,20,-140,540,598,1138,2443
-130,60,-110,558,580,1138,2438
-30,20,140,572,566,1138,2522
170,-70,170,549,589,1138,2389
-90,70,150,550,589,1139,2538
-140,60,-50,569,570,1139,2538
-130,-50,-20,551,588,1139,2471
-40,-80,-40,567,572,1139,2516
-80,70,-140,572,567,1139,2489
-120,-60,40,555,584,1139,2658
-70,-60,10,542,597,1139,2514
-160,0,-20,548,591,1139,2420
-90,70,-120,572,568,1140,2536
130,0,130,559,581,1140,2323
-10,80,10,564,576,1140,2271
-40,-40,140,545,595,1140,2607
80,-60,-40,565,575,1140,2379
10,40,-10,566,574,1140,2336
-40,-10,140,569,571,1140,2470
-60,60,90,551,589,1140,2439
-140,-50,20,547,593,1140,2546
-60,60,160,556,584,1140,2563
-110,60,-160,557,584,1141,2498
-160,40,-10,563,578,1141,2390
-50,-20,50,574,567,1141,2360
-60,60,-140,570,571,1141,2563
-110,-60,40,550,591,1141,2505
-140,60,-80,561,580,1141,2472
-140,-40,0,544,597,1141,2422
30,0,-20,539,602,1141,2542
60,-50,-60,545,596,1141,2394
-70,-60,30,553,588,1141,2576
-100,-60,20,560,582,1142,2512
-70,60,150,552,590,1142,2520
-140,40,-160,543,599,1142,2328
-170,50,-40,557,585,1142,2581
-130,-40,-80,551,591,1142,2434
-160,-10,-140,567,576,1143,2516
110,-80,100,554,589,1143,2484
-40,30,110,568,575,1143,2536
-30,50,50,555,588,1143,2475
50,-10,-60,537,606,1143,2445
140,20,100,546,597,1143,2451
130,70,90,563,580,1143,2535
140,-50,20,550,593,1143,2496
-170,50,-30,545,599,1144,2456
-80,-60,70,556,588,1144,2510
70,40,170,562,582,1144,2528
20,50,-20,550,594,1144,2375
50,-40,-70,526,618,1144,2451
-150,30,-70,559,585,1144,2534
80,50,-110,551,593,1144,2344
-50,40,110,554,590,1144,2513
-40,20,60,564,580,1144,2418
-60,-60,100,565,580,1145,2702
-30,30,160,559,586,1145,2569
-40,0,80,564,581,1145,2475
-140,-30,-80,548,597,1145,2380
-120,60,-40,574,571,1145,2500
-160,30,-50,556,590,1146,2553
110,-60,70,574,572,1146,2516
80,-60,30,572,574,1146,2449
30,60,-170,565,581,1146,2501
50,-50,0,563,583,1146,2389
-60,-50,60,563,583,1146,2537
-120,80,-30,589,557,1146,2353
-100,-60,-30,551,595,1146,2538
100,20,170,545,601,1146,2529
40,-70,20,564,582,1146,2441
-60,-60,90,559,587,1146,2623
-140,-50,30,568,579,1147,2569
-40,-30,-180,571,576,1147,2546
-40,-30,180,571,576,1147,2546
-160,10,10,571,576,1147,2464
-70,70,-90,591,556,1147,2423
-150,30,-80,548,599,1147,2531
40,-80,-90,565,582,1147,2455
180,50,40,558,589,1147,2439
60,-70,30,573,574,1147,2483
170,-20,-170,550,597,1147,2472
50,-30,-20,545,602,1147,2565
-180,50,40,558,589,1147,2439
-40,-20,70,562,585,1147,2574
-90,-60,90,563,584,1147,2646
-70,-60,70,570,577,1147,2460
-150,50,-110,549,598,1147,2504
-100,-60,-20,554,593,1147,2601
-70,60,-110,573,575,1148,2514
90,-80,-40,567,581,1148,2380
-90,-60,30,565,583,1148,2441
-50,-30,90,572,576,1148,2518
-80,-60,-20,557,591,1148,2528
50,20,-150,555,593,1148,2444
-70,-70,-60,555,593,1148,2404
-50,60,-120,586,562,1148,2494
20,-60,0,558,590,1148,2580
140,0,110,551,598,1149,2276
-30,40,50,553,596,1149,2379
60,70,-70,564,585,1149,2378
-50,40,100,543,606,1149,2471
-160,-30,-140,578,571,1149,2309
-80,-60,-50,556,594,1150,2413
-50,-30,110,584,566,1150,2585
-130,70,140,560,590,1150,2228
-150,-40,50,571,579,1150,2476
120,-60,90,561,589,1150,2365
50,50,-180,572,578,1150,2330
-50,-40,-10,569,581,1150,2642
-170,30,30,584,566,1150,2562
50,50,180,572,578,1150,2330
-160,-20,-140,574,577,1151,2424
-160,0,-10,549,602,1151,2472
-140,20,-120,571,580,1151,2307
-140,0,-110,578,573,1151,2423
-50,-40,160,576,575,1151,2567
-160,30,0,575,576,1151,2472
70,-60,20,569,582,1151,2529
-160,60,-50,559,592,1151,2600
-120,60,-140,565,586,1151,2453
-120,-60,50,551,600,1151,2507
-130,50,-140,561,590,1151,2522
-120,60,180,563,588,1151,2470
-120,60,-180,563,588,1151,2470
-50,-40,0,571,581,1152,2609
-90,-60,-10,555,597,1152,2537
30,-60,0,569,583,1152,2456
-40,-30,90,582,570,1152,2588
140,30,-160,572,580,1152,2620
120,-50,50,559,593,1152,2614
-60,60,170,561,591,1152,2428
-100,70,-120,576,576,1152,2489
-100,70,-130,569,583,1152,2484
-30,30,130,559,594,1153,2537
-110,-60,-80,571,582,1153,2451
-50,-50,20,554,599,1153,2640
110,20,-170,542,611,1153,2484
140,-50,130,550,603,1153,2545
100,-50,-10,559,595,1154,2491
-160,-10,30,555,599,1154,2438
-50,50,-140,587,567,1154,2461
-90,-60,0,552,602,1154,2565
140,-20,100,578,576,1154,2472
-170,40,30,584,570,1154,2457
-100,-60,30,570,584,1154,2495
100,-80,-30,569,585,1154,2455
20,0,-140,564,590,1154,2458
90,30,-140,561,593,1154,2625
-80,-60,0,551,603,1154,2563
-120,60,-160,557,598,1155,2561
-10,20,10,553,602,1155,2389
90,-50,-20,541,614,1155,2520
-10,-10,-150,581,574,1155,2539
30,30,-30,565,590,1155,2413
150,-30,50,568,587,1155,2617
-70,-60,80,567,588,1155,2563
150,-10,180,553,603,1156,2450
110,-80,-20,573,583,1156,2470
-110,-60,50,556,600,1156,2695
-120,50,-160,561,595,1156,2520
-90,-60,-30,553,603,1156,2570
150,-10,-180,553,603,1156,2450
50,-60,10,571,585,1156,2383
-170,-60,50,566,590,1156,2347
-60,-40,20,581,575,1156,2504
-140,-50,60,578,578,1156,2534
-120,-70,-110,558,598,1156,2437
-40,-30,170,567,590,1157,2556
-40,30,60,560,597,1157,2482
-150,60,0,580,577,1157,2551
-170,-80,-170,569,588,1157,2425
0,-70,-130,579,578,1157,2328
-80,-60,10,560,597,1157,2534
-50,50,100,561,596,1157,2521
-30,20,120,571,586,1157,2553
50,20,-110,561,596,1157,2490
-160,60,-40,573,584,1157,2532
-10,-20,-10,549,608,1157,2378
-130,-50,60,592,565,1157,2476
140,-10,110,553,604,1157,2361
-60,60,120,555,602,1157,2607
10,0,-10,546,611,1157,2581
-10,0,0,568,590,1158,2558
-120,60,150,554,604,1158,2516
-40,-30,-10,565,593,1158,2508
-70,60,-120,577,581,1158,2530
-100,60,140,573,585,1158,2551
-100,70,-110,576,582,1158,2544
-100,-60,10,565,594,1159,2440
-40,-10,130,585,574,1159,2603
-50,-50,120,554,605,1159,2633
-90,-60,-20,562,597,1159,2506
-20,-20,-10,558,601,1159,2495
-160,0,20,580,579,1159,2495
80,40,160,562,597,1159,2491
-50,80,-100,585,574,1159,2341
-40,-20,100,575,585,1160,2553
20,-40,-10,570,590,1160,2503
-150,0,-80,546,614,1160,2408
-30,40,160,564,596,1160,2609
-110,60,140,560,601,1161,2515
-50,60,70,567,594,1161,2495
-120,60,-130,557,604,1161,2434
-40,60,170,563,598,1161,2576
-30,0,110,572,589,1161,2607
-110,80,-40,600,561,1161,2358
90,-50,20,576,586,1162,2592
-80,60,160,569,593,1162,2558
150,-40,160,555,607,1162,2492
-30,-20,-10,562,600,1162,2582
-150,50,0,577,585,1162,2500
-30,20,130,571,591,1162,2657
-20,80,20,576,587,1163,2327
-170,80,170,572,591,1163,2291
130,50,-150,572,591,1163,2420
-150,-20,-40,568,595,1163,2590
30,-10,-20,563,600,1163,2573
-110,60,-150,568,595,1163,2522
-40,-40,70,551,612,1163,2531
10,70,-10,553,610,1163,2382
-50,-50,60,577,586,1163,2508
-110,60,-70,572,591,1163,2588
110,-50,0,571,592,1163,2583
-120,60,-170,565,599,1164,2617
-80,60,170,566,598,1164,2479
-30,-10,160,557,607,1164,2627
110,60,-130,577,587,1164,2405
-30,60,-130,580,584,1164,2458
0,10,-150,569,595,1164,2540
140,-20,110,558,606,1164,2440
-180,0,-160,557,607,1164,2292
-130,60,-60,582,582,1164,2592
-40,10,160,577,587,1164,2488
180,0,-160,557,607,1164,2292
-40,40,-160,577,588,1165,2544
140,70,80,583,582,1165,2624
80,-40,-10,544,621,1165,2594
-90,-60,10,563,602,1165,2581
30,-10,-100,568,597,1165,2445
-30,0,160,570,595,1165,2517
-40,0,40,578,587,1165,2417
-80,-50,120,573,592,1165,2501
-20,50,30,557,608,1165,2474
30,-80,20,571,594,1165,2517
-50,-80,-50,577,588,1165,2628
-60,60,110,564,601,1165,2655
30,-80,-100,571,594,1165,2493
-30,20,160,572,594,1166,2637
-30,10,170,582,584,1166,2574
-140,30,-140,578,588,1166,2458
100,20,-180,559,607,1166,2505
-80,60,110,569,597,1166,2436
100,20,180,559,607,1166,2505
150,40,-160,562,605,1167,2547
-70,-50,120,568,599,1167,2640
-50,-30,20,574,593,1167,2583
-40,0,140,587,580,1167,2473
150,0,80,566,601,1167,2593
120,-80,110,571,596,1167,2553
-150,-20,-50,556,611,1167,2602
-140,60,-90,582,585,1167,2494
-130,-60,-110,561,606,1167,2516
-80,-60,20,563,604,1167,2640
100,50,-130,554,614,1168,2380
-90,70,-130,583,585,1168,2528
-130,60,-90,585,583,1168,2591
-90,70,-140,578,590,1168,2530
130,-10,140,549,619,1168,2628
-120,-50,20,566,602,1168,2552
-140,-10,-100,564,605,1169,2556
0,10,0,566,603,1169,2536
-90,-60,-60,557,612,1169,2455
-150,-20,-30,567,602,1169,2503
-150,40,-70,577,592,1169,2568
140,-40,140,541,628,1169,2585
-30,20,180,577,592,1169,2523
-30,20,-180,577,592,1169,2523
-100,80,-50,600,569,1169,2412
-110,60,160,581,588,1169,2617
-170,-20,40,568,601,1169,2395
-70,-60,90,572,598,1170,2670
-140,10,-130,580,590,1170,2327
10,50,-10,574,596,1170,2459
-60,60,100,563,608,1171,2569
-70,70,-160,570,601,1171,2590
-50,50,80,576,595,1171,2505
120,-80,-10,582,589,1171,2552
-80,60,-100,583,588,1171,2600
-150,-30,40,584,587,1171,2517
-140,-40,40,576,596,1172,2640
100,-70,70,588,584,1172,2458
-30,-40,-160,583,589,1172,2357
-40,50,-170,583,589,1172,2545
-50,-20,110,587,585,1172,2550
-160,10,0,567,605,1172,2530
-140,-30,-30,574,599,1173,2476
60,50,-80,559,614,1173,2416
-140,-30,-40,560,613,1173,2490
-130,70,-20,590,583,1173,2505
-50,-50,50,578,595,1173,2565
150,-10,80,574,599,1173,2641
-160,20,-40,582,591,1173,2500
50,-70,20,585,588,1173,2566
-160,20,-150,566,607,1173,2466
-50,60,170,574,599,1173,2507
-30,-50,-20,576,598,1174,2672
-70,-50,70,577,597,1174,2497
-150,60,-60,571,603,1174,2592
130,-50,70,566,608,1174,2491
-150,50,-100,571,604,1175,2556
-90,60,130,567,609,1176,2585
-60,-50,-10,578,598,1176,2717
-60,-50,90,576,601,1177,2623
-60,-40,80,593,584,1177,2546
-110,60,-170,571,606,1177,2631
-50,-40,150,582,595,1177,2653
50,-20,-30,559,618,1177,2537
-140,-20,-90,568,609,1177,2486
160,-20,60,578,599,1177,2645
-160,-80,-160,573,604,1177,2449
50,-20,-60,552,625,1177,2507
0,-50,-10,565,612,1177,2632
-170,-60,-160,552,625,1177,2492
-140,50,-120,568,609,1177,2625
-70,-50,140,579,599,1178,2541
-110,60,-60,580,598,1178,2569
-130,60,-100,585,593,1178,2511
-20,30,30,567,611,1178,2442
-120,-50,0,582,596,1178,2591
120,40,120,566,612,1178,2340
60,40,-90,559,620,1179,2429
150,-50,150,549,630,1179,2572
-130,-60,80,587,592,1179,2568
-30,10,120,585,594,1179,2632
-160,20,20,586,593,1179,2551
-60,80,-90,592,588,1180,2385
-100,-60,-70,585,595,1180,2501
20,30,-20,569,611,1180,2439
-150,-10,-70,577,603,1180,2455
-80,60,-110,583,597,1180,2642
-30,20,170,592,588,1180,2648
140,-40,70,566,614,1180,2412
-60,60,80,579,601,1180,2500
90,80,130,577,603,1180,2519
10,-30,-120,607,574,1181,2533
40,30,-160,573,608,1181,2598
40,20,-150,567,614,1181,2609
-130,-50,20,574,607,1181,2553
-150,10,-80,567,614,1181,2517
-70,-60,100,576,605,1181,2644
-70,-50,80,577,604,1181,2536
-80,60,100,588,593,1181,2421
110,-60,60,572,609,1181,2469
150,70,70,592,590,1182,2676
-90,60,180,574,608,1182,2553
-150,-30,10,569,613,1182,2520
-90,60,-180,574,608,1182,2553
-160,0,-30,546,636,1182,2681
-130,-50,50,577,605,1182,2563
-160,10,20,600,582,1182,2549
-30,40,150,565,617,1182,2652
-110,-60,60,569,613,1182,2706
-30,0,170,567,615,1182,2688
-40,-20,10,576,607,1183,2470
140,-40,80,582,601,1183,2602
80,-50,10,574,609,1183,2582
150,20,80,573,610,1183,2604
-180,-70,180,577,606,1183,2545
-90,60,-90,588,595,1183,2702
20,-50,-10,576,607,1183,2583
-40,-30,140,573,610,1183,2600
180,-70,-180,577,606,1183,2545
40,10,-110,572,611,1183,2519
-150,0,-70,562,621,1183,2600
180,-70,180,577,606,1183,2545
-90,70,-70,605,578,1183,2445
-180,-70,-180,577,606,1183,2545
-120,70,130,577,606,1183,2337
-100,-60,60,574,609,1183,2647
-90,-60,120,585,599,1184,2601
-70,-70,150,581,603,1184,2504
10,60,-10,573,611,1184,2448
-40,-40,-20,594,590,1184,2629
140,40,90,571,613,1184,2618
-150,50,-70,586,599,1185,2564
-170,-10,40,581,604,1185,2521
-150,-30,0,567,618,1185,2552
-30,10,110,582,603,1185,2575
130,-60,110,561,624,1185,2642
-100,60,-170,565,620,1185,2575
-80,60,120,569,616,1185,2432
-80,70,-80,602,583,1185,2466
20,-10,-120,567,618,1185,2456
40,70,180,571,614,1185,2559
40,70,-180,571,614,1185,2559
30,-20,-20,574,611,1185,2700
130,-80,0,587,599,1186,2601
-150,20,-70,554,632,1186,2536
0,-60,-130,582,604,1186,2436
-150,-10,-130,576,610,1186,2543
-40,-30,70,580,606,1186,2672
-80,-60,80,571,615,1186,2665
-40,50,-180,589,597,1186,2609
-60,-30,20,599,587,1186,2482
60,-60,10,577,609,1186,2609
-120,-50,-50,585,601,1186,2657
150,10,80,569,617,1186,2514
-40,50,180,589,597,1186,2609
-160,0,10,598,588,1186,2527
-10,70,-140,582,604,1186,2465
-60,-50,120,570,616,1186,2798
-70,60,170,573,613,1186,2661
-160,0,0,574,613,1187,2601
50,70,-60,571,616,1187,2461
-50,40,80,579,608,1187,2589
120,60,110,580,607,1187,2473
-50,-40,170,593,594,1187,2621
-30,30,-150,605,583,1188,2480
-70,60,90,581,607,1188,2487
-130,-40,-20,581,607,1188,2592
80,80,140,583,606,1189,2535
90,-60,30,578,611,1189,2683
-80,70,-150,576,613,1189,2589
160,-60,160,570,619,1189,2543
-100,60,-160,576,613,1189,2587
30,-70,10,572,617,1189,2570
130,-60,10,570,620,1190,2571
20,-80,10,585,605,1190,2587
-70,60,110,574,616,1190,2529
-100,60,150,585,605,1190,2660
-30,30,140,585,605,1190,2736
90,40,150,581,610,1191,2544
-110,60,-50,594,597,1191,2614
40,50,-50,551,640,1191,2587
-40,-20,80,577,614,1191,2716
-50,40,90,575,616,1191,2604
-150,-70,70,601,590,1191,2470
-140,-40,50,596,596,1192,2598
-150,50,-180,575,617,1192,2447
-150,50,180,575,617,1192,2447
-40,0,150,583,609,1192,2596
-50,-40,140,586,606,1192,2662
-40,20,140,597,595,1192,2687
80,60,-100,583,609,1192,2461
-90,-60,70,565,628,1193,2645
140,-70,130,569,624,1193,2690
140,-60,130,579,614,1193,2655
-140,50,-90,580,613,1193,2570
-140,60,-70,586,607,1193,2705
-90,60,120,574,619,1193,2557
-50,30,100,577,616,1193,2536
70,80,150,578,615,1193,2571
-100,60,180,584,609,1193,2631
0,-70,-10,584,609,1193,2526
-100,60,-80,591,602,1193,2712
-100,60,-180,584,609,1193,2631
60,-30,-30,569,624,1193,2565
-40,-10,110,607,587,1194,2620
-140,40,-90,588,606,1194,2669
20,-80,-110,582,612,1194,2596
-10,-50,-140,604,590,1194,2531
-120,50,180,574,620,1194,2535
160,0,-170,567,627,1194,2582
-120,50,-170,579,615,1194,2580
-120,50,-180,574,620,1194,2535
-120,60,-120,577,618,1195,2560
140,10,110,580,615,1195,2342
-140,10,-110,596,599,1195,2472
170,-50,-180,562,633,1195,2566
170,-50,180,562,633,1195,2566
140,-30,150,566,629,1195,2618
-40,-20,0,573,623,1196,2564
0,-30,-130,596,600,1196,2442
-110,60,170,583,613,1196,2618
10,-50,-10,589,607,1196,2640
-70,-50,90,574,622,1196,2632
50,40,-70,564,632,1196,2453
-170,50,30,590,606,1196,2592
150,-20,80,592,604,1196,2703
0,70,0,571,625,1196,2534
-90,80,-60,613,584,1197,2416
-40,50,60,563,634,1197,2613
-70,60,-100,602,595,1197,2669
-130,40,-150,590,607,1197,2618
-140,-30,-70,569,628,1197,2606
-150,10,-50,583,614,1197,2677
-70,60,140,575,623,1198,2607
-40,50,160,578,620,1198,2659
-50,-30,50,589,609,1198,2614
120,80,100,595,603,1198,2597
120,-50,10,583,615,1198,2609
-40,30,120,601,597,1198,2694
-120,-50,-10,589,610,1199,2595
100,-50,20,589,610,1199,2641
-120,-50,70,608,591,1199,2605
100,80,120,585,614,1199,2554
-40,20,150,600,599,1199,2672
-60,60,-110,611,588,1199,2647
-160,10,-30,567,632,1199,2650
140,70,-150,581,618,1199,2480
140,-40,130,583,616,1199,2661
-150,10,-70,565,634,1199,2609
-60,-40,10,602,598,1200,2636
160,70,60,606,594,1200,2651
-50,-40,50,589,611,1200,2749
-30,30,150,579,621,1200,2712
140,-40,120,571,629,1200,2611
-40,-30,80,588,612,1200,2672
-50,50,140,576,625,1201,2763
-70,60,180,589,612,1201,2520
-70,60,-180,589,612,1201,2520
-140,50,-70,595,606,1201,2720
-120,60,-70,593,608,1201,2616
-40,40,130,582,619,1201,2693
-140,-30,-20,592,609,1201,2521
-140,-40,10,580,621,1201,2699
130,-50,100,587,614,1201,2593
-40,0,130,597,605,1202,2671
-40,50,170,591,611,1202,2658
-140,30,-80,581,621,1202,2529
120,-70,100,598,604,1202,2654
-100,60,130,592,610,1202,2578
-80,-50,70,579,623,1202,2620
-60,-60,160,593,609,1202,2566
-160,30,20,607,595,1202,2658
140,-30,90,582,620,1202,2674
40,-30,-20,579,623,1202,2676
-140,50,-100,588,614,1202,2650
-160,20,-10,580,622,1202,2652
-50,-30,120,597,605,1202,2743
-140,-30,-50,585,618,1203,2598
-130,60,150,576,627,1203,2395
-40,10,50,590,613,1203,2527
-40,20,110,600,604,1204,2701
-150,20,-90,578,626,1204,2550
-40,10,100,591,613,1204,2690
160,-70,30,605,599,1204,2483
-90,60,170,586,618,1204,2627
-20,30,-150,598,606,1204,2496
-60,-50,0,594,610,1204,2668
-150,-20,20,586,618,1204,2610
-160,40,20,606,599,1205,2603
40,60,-50,570,635,1205,2551
-110,-50,20,603,602,1205,2722
-150,10,-60,581,624,1205,2587
-160,-20,40,581,624,1205,2655
-140,50,-80,599,606,1205,2659
-50,-10,120,599,606,1205,2688
-70,80,-80,621,584,1205,2447
130,-10,150,573,632,1205,2722
-160,10,-10,581,624,1205,2631
140,-20,120,579,626,1205,2446
130,80,90,592,613,1205,2647
-130,-30,-100,607,599,1206,2576
-130,-40,-30,584,622,1206,2646
-50,40,120,590,616,1206,2680
-110,60,180,587,619,1206,2724
140,-40,60,579,627,1206,2716
-100,-60,70,583,623,1206,2701
130,-50,90,596,610,1206,2636
-110,60,-180,587,619,1206,2724
170,-40,40,577,629,1206,2585
-150,40,-100,579,627,1206,2661
-160,40,-50,578,629,1207,2726
-130,-40,-60,583,624,1207,2587
-60,-50,20,574,633,1207,2699
-150,50,-60,599,608,1207,2676
-160,40,-40,597,610,1207,2748
-150,30,-90,584,623,1207,2652
160,0,70,589,618,1207,2760
-160,30,-40,583,624,1207,2739
-20,40,30,582,625,1207,2548
-140,30,-120,586,621,1207,2549
110,80,110,596,612,1208,2555
110,-70,80,590,618,1208,2512
-150,-80,-150,593,615,1208,2532
-120,-50,-20,593,615,1208,2718
30,-30,-20,585,623,1208,2687
-160,50,-180,602,607,1209,2503
-110,-50,30,593,616,1209,2682
-150,30,-60,590,619,1209,2623
-40,-70,-40,591,618,1209,2648
-50,-20,120,604,605,1209,2671
-120,50,-150,588,621,1209,2658
-50,-60,-40,583,626,1209,2622
-160,50,180,602,607,1209,2503
-120,-60,90,605,604,1209,2693
-50,30,90,589,620,1209,2590
-150,0,-50,589,620,1209,2660
-60,60,180,586,624,1210,2579
-60,-40,70,591,619,1210,2622
0,-10,-10,597,613,1210,2696
110,60,120,583,627,1210,2512
-70,60,130,580,630,1210,2690
-50,-40,70,602,608,1210,2757
-150,20,-80,570,640,1210,2606
-20,50,-140,607,603,1210,2595
20,-10,-20,593,617,1210,2673
-60,60,-180,586,624,1210,2579
-60,-30,30,608,602,1210,2513
40,40,-50,561,649,1210,2638
-160,40,-20,580,630,1210,2620
-130,-40,10,597,613,1210,2595
150,-30,70,592,619,1211,2645
-20,-60,-20,603,608,1211,2600
-40,10,130,601,610,1211,2735
140,-80,10,609,602,1211,2661
-150,50,-20,589,622,1211,2600
140,-10,170,578,633,1211,2588
180,60,180,594,618,1212,2448
-150,-20,10,583,629,1212,2653
-180,60,-180,594,618,1212,2448
-130,40,-140,585,627,1212,2617
-80,-70,-70,584,628,1212,2656
-180,60,180,594,618,1212,2448
10,20,-150,595,617,1212,2609
-40,-10,80,594,618,1212,2700
180,60,-180,594,618,1212,2448
-50,70,60,618,595,1213,2533
140,30,100,578,635,1213,2604
50,30,-80,570,643,1213,2559
-150,0,-40,589,624,1213,2768
-160,0,30,612,602,1214,2630
-70,-50,60,596,618,1214,2634
-140,-40,30,590,624,1214,2747
-50,-10,50,603,611,1214,2598
-80,-60,90,591,623,1214,2742
0,-60,-10,600,614,1214,2623
-50,50,-130,614,600,1214,2618
-90,60,-100,609,605,1214,2669
-50,50,160,586,628,1214,2608
-140,-30,-60,569,646,1215,2622
-80,60,180,595,620,1215,2690
130,20,120,584,631,1215,2446
-110,-50,80,610,605,1215,2727
130,-50,80,594,621,1215,2648
-130,-50,30,605,610,1215,2736
-80,60,-180,595,620,1215,2690
-70,60,-170,603,612,1215,2622
120,40,-150,580,635,1215,2655
180,-50,-170,580,635,1215,2613
170,60,50,611,604,1215,2546
-50,-50,-30,585,630,1215,2670
50,40,-170,584,631,1215,2633
-30,10,30,593,622,1215,2638
-180,-50,-170,580,635,1215,2613
80,-50,-30,586,630,1216,2646
-60,-80,-60,591,625,1216,2708
-120,-50,-90,596,620,1216,2718
-160,10,-20,588,628,1216,2591
90,-50,10,579,637,1216,2559
-150,-20,30,602,614,1216,2656
-50,-40,120,589,627,1216,2770
-60,-50,10,584,632,1216,2800
140,0,-180,591,625,1216,2652
-50,-30,10,603,613,1216,2743
140,0,180,591,625,1216,2652
-60,-50,100,608,608,1216,2764
170,-20,50,591,625,1216,2790
20,-30,-20,594,622,1216,2630
-130,-40,0,581,635,1216,2693
-40,0,90,597,619,1216,2591
100,60,130,588,628,1216,2564
-140,60,-60,604,613,1217,2841
-130,60,-80,605,612,1217,2744
-60,50,120,598,619,1217,2702
-140,-80,-140,594,623,1217,2563
-40,-20,90,599,618,1217,2750
-170,-50,50,592,625,1217,2578
60,80,160,587,630,1217,2594
50,-10,-40,573,645,1218,2616
-130,50,-180,577,641,1218,2611
-150,-50,-130,575,643,1218,2555
-80,60,150,596,622,1218,2644
100,40,140,588,630,1218,2632
150,-30,60,600,618,1218,2608
150,-30,80,595,623,1218,2573
-30,80,30,603,615,1218,2451
-80,80,-70,621,597,1218,2455
160,-10,70,597,621,1218,2670
-150,20,-60,577,641,1218,2617
-60,-50,-20,594,624,1218,2740
-130,50,180,577,641,1218,2611
-90,-60,80,592,626,1218,2739
130,-80,120,597,622,1219,2671
40,-10,-30,596,623,1219,2681
-140,40,-80,595,624,1219,2581
-60,-40,90,620,599,1219,2578
-110,-70,-100,585,635,1220,2567
-150,-10,-60,593,627,1220,2639
-50,60,-170,596,624,1220,2688
-40,-30,160,598,622,1220,2662
-80,-80,-80,593,627,1220,2747
-80,-50,110,607,613,1220,2810
-40,40,60,589,631,1220,2615
140,-30,110,588,632,1220,2630
-140,50,-110,598,623,1221,2671
80,-60,20,579,642,1221,2721
-70,60,120,593,628,1221,2731
30,40,-160,600,621,1221,2643
-150,-20,-20,579,642,1221,2647
150,30,80,607,614,1221,2762
-60,-50,-30,609,613,1222,2676
-150,30,-100,593,629,1222,2701
-90,-80,-90,593,629,1222,2749
-150,0,-60,580,642,1222,2732
-130,-30,-90,593,629,1222,2654
-90,60,-170,601,622,1223,2644
0,20,-150,607,616,1223,2665
150,10,-170,583,641,1224,2628
-110,-50,40,599,625,1224,2795
130,0,170,595,629,1224,2636
140,-40,40,595,629,1224,2579
-120,60,-100,614,610,1224,2647
-70,-80,-70,595,629,1224,2752
-110,50,-180,603,621,1224,2710
-110,50,180,603,621,1224,2710
-120,-50,-30,595,629,1224,2748
-160,50,-30,582,642,1224,2731
70,-70,30,618,606,1224,2583
-80,-50,60,604,620,1224,2630
-100,60,160,598,626,1224,2727
-120,60,-110,599,626,1225,2608
-160,80,160,610,615,1225,2490
180,60,40,620,605,1225,2671
-120,-50,-40,587,638,1225,2730
-180,60,40,620,605,1225,2671
-60,-50,30,600,625,1225,2766
80,30,180,600,625,1225,2617
130,60,100,603,622,1225,2672
40,50,-170,604,621,1225,2571
-80,-50,80,591,634,1225,2657
140,-30,100,604,621,1225,2675
-100,60,-70,602,623,1225,2751
80,30,-180,600,625,1225,2617
70,-50,0,593,633,1226,2641
-160,50,-50,602,624,1226,2724
140,-30,120,570,656,1226,2548
-20,10,10,595,631,1226,2503
-140,30,-70,596,630,1226,2661
-150,60,-50,600,626,1226,2761
-50,50,-150,615,612,1227,2522
-140,20,-80,594,633,1227,2567
-90,60,150,594,633,1227,2802
-140,-10,-90,592,635,1227,2804
-60,50,130,597,630,1227,2777
-110,60,-80,607,620,1227,2654
-50,-40,130,588,639,1227,2801
-130,-40,-40,601,626,1227,2717
40,-70,10,608,619,1227,2707
-90,60,140,592,635,1227,2741
-140,-20,-80,600,628,1228,2757
-60,-50,110,591,637,1228,2859
-10,70,10,590,638,1228,2584
-150,-20,-10,589,639,1228,2563
-40,40,140,595,633,1228,2664
140,50,90,604,624,1228,2739
-40,20,160,608,620,1228,2687
-150,-10,-40,596,632,1228,2664
-120,-50,30,605,623,1228,2723
-150,40,-90,595,633,1228,2620
110,40,130,593,636,1229,2590
10,-80,0,605,624,1229,2685
-60,-40,140,607,622,1229,2823
-60,50,90,607,623,1230,2696
-50,30,110,599,631,1230,2758
80,-70,40,610,620,1230,2565
0,40,-150,599,631,1230,2538
-100,60,170,602,628,1230,2778
0,40,0,602,628,1230,2613
30,0,-120,591,639,1230,2515
-130,-40,-10,607,624,1231,2764
20,20,-150,604,627,1231,2675
-160,30,-10,603,628,1231,2678
-50,30,80,591,640,1231,2705
-160,50,-40,599,633,1232,2850
-50,20,150,615,617,1232,2745
-100,60,-90,613,619,1232,2715
140,80,80,613,619,1232,2698
-110,60,-130,605,627,1232,2704
-60,-50,160,624,608,1232,2620
30,20,-150,583,649,1232,2647
-100,-50,40,601,631,1232,2719
-80,60,-160,605,627,1232,2656
-60,-40,30,603,629,1232,2753
-160,20,-20,591,641,1232,2744
-60,40,120,613,619,1232,2692
-120,70,-30,620,612,1232,2627
-10,-70,-140,614,619,1233,2530
40,-60,0,614,619,1233,2619
140,-20,160,576,657,1233,2711
-140,-10,-120,614,619,1233,2661
-80,60,-170,611,622,1233,2615
-130,-80,-130,600,633,1233,2597
-140,60,-10,612,622,1234,2646
120,-60,80,608,626,1234,2685
-100,-50,90,615,619,1234,2798
60,-30,-40,579,655,1234,2585
40,10,-90,588,647,1235,2611
-40,0,120,622,613,1235,2770
-30,10,-160,623,612,1235,2526
140,-30,140,585,650,1235,2740
-30,60,40,600,635,1235,2432
-90,60,-150,594,641,1235,2721
0,50,0,606,629,1235,2507
-110,-60,100,617,618,1235,2686
-160,-60,-150,590,646,1236,2620
-150,40,-60,604,632,1236,2740
-110,50,170,592,644,1236,2648
60,20,-130,589,647,1236,2757
130,40,110,592,645,1237,2649
-130,60,-70,614,623,1237,2766
-90,60,160,612,625,1237,2723
-40,30,140,615,622,1237,2777
30,20,-30,607,630,1237,2684
-110,70,120,605,632,1237,2442
130,-50,20,610,627,1237,2811
-60,-40,0,602,635,1237,2720
-60,60,-150,624,613,1237,2762
-50,-40,60,605,633,1238,2895
-50,20,160,608,630,1238,2791
-150,-10,-50,596,642,1238,2601
-100,-80,-100,600,638,1238,2724
-60,50,110,601,637,1238,2787
100,30,150,609,630,1239,2588
140,-10,120,605,634,1239,2616
160,-20,-180,605,634,1239,2625
160,-20,180,605,634,1239,2625
-140,0,-100,615,624,1239,2728
120,20,-170,581,658,1239,2843
-110,-50,10,614,625,1239,2719
-10,-10,-10,614,626,1240,2623
-100,-50,50,611,629,1240,2766
-150,-20,-130,620,620,1240,2657
100,40,-140,600,640,1240,2605
-110,-80,-110,602,639,1241,2682
40,-50,-10,606,635,1241,2625
70,-60,10,606,635,1241,2770
-40,-10,150,603,638,1241,2632
-130,50,-90,625,616,1241,2597
-140,-30,-10,600,641,1241,2674
20,-20,-110,613,628,1241,2478
150,-80,20,622,620,1242,2746
-90,-50,100,618,624,1242,2910
-10,30,-150,614,628,1242,2655
140,-30,130,603,639,1242,2760
-150,40,0,612,630,1242,2627
-80,60,130,602,640,1242,2740
-60,-50,50,602,640,1242,2801
-40,-30,150,601,642,1243,2874
-140,30,-150,620,623,1243,2623
150,-20,170,612,631,1243,2630
-140,-40,20,607,636,1243,2811
-50,-30,80,617,626,1243,2779
-60,50,140,617,626,1243,2745
-140,50,170,584,659,1243,2552
-10,0,-150,610,634,1244,2731
-50,-20,100,616,628,1244,2772
-160,30,-30,604,640,1244,2709
-50,-10,60,610,634,1244,2737
-70,-60,-50,606,638,1244,2586
30,-50,-10,618,626,1244,2706
-70,60,-130,611,633,1244,2786
-10,-70,-20,617,627,1244,2595
150,40,80,616,628,1244,2828
150,10,90,616,628,1244,2652
-150,-10,-30,600,645,1245,2840
10,-80,-120,605,640,1245,2661
-50,50,150,592,653,1245,2705
-40,40,150,609,636,1245,2806
150,50,-160,607,638,1245,2638
-60,50,100,613,632,1245,2804
70,-40,-30,586,659,1245,2760
50,30,-160,592,653,1245,2640
60,20,-140,583,662,1245,2683
100,-60,40,613,633,1246,2833
40,10,-100,599,647,1246,2582
-70,-50,50,600,646,1246,2718
-150,10,-40,599,647,1246,2847
-160,20,-30,596,651,1247,2738
-140,20,-70,610,637,1247,2631
-130,-40,-50,614,633,1247,2730
50,-10,-50,589,658,1247,2649
140,-80,130,607,640,1247,2833
-50,0,120,622,625,1247,2742
-40,80,40,618,629,1247,2515
-150,60,160,602,645,1247,2420
-110,50,-170,605,642,1247,2690
-70,-40,10,626,622,1248,2690
-140,40,-120,603,645,1248,2694
-140,50,180,603,645,1248,2630
-120,50,170,587,661,1248,2758
-10,-60,-140,613,635,1248,2614
-140,50,-180,603,645,1248,2630
-40,-20,180,631,618,1249,2731
70,30,-170,592,657,1249,2753
-40,-20,-180,631,618,1249,2731
-110,60,-140,599,650,1249,2668
-50,-10,110,629,620,1249,2719
60,40,-100,605,644,1249,2618
-50,-40,-20,624,625,1249,2820
110,50,-140,593,656,1249,2599
-80,60,-90,616,634,1250,2771
-90,-50,60,616,634,1250,2788
150,80,70,616,634,1250,2702
-110,50,160,605,645,1250,2775
110,-50,30,630,620,1250,2916
130,30,-160,617,633,1250,2809
-60,-30,40,614,636,1250,2574
-130,30,-140,624,626,1250,2594
-130,-50,70,621,629,1250,2706
-40,-10,20,627,624,1251,2625
20,-20,-20,602,649,1251,2768
-40,-20,160,607,644,1251,2889
10,10,-10,613,638,1251,2719
-100,-60,110,631,620,1251,2846
-100,60,-140,612,639,1251,2795
100,30,-150,592,660,1252,2785
-40,-40,-170,631,621,1252,2559
-20,-50,-150,630,622,1252,2587
-50,-20,60,626,626,1252,2651
-120,-80,-120,604,648,1252,2687
-50,40,130,614,638,1252,2835
-50,60,180,602,650,1252,2796
-80,60,140,602,650,1252,2796
-50,60,-180,602,650,1252,2796
170,50,-170,613,640,1253,2600
-150,-20,0,593,660,1253,2649
-60,-50,40,604,649,1253,2843
-50,30,120,618,635,1253,2853
-170,20,-160,618,635,1253,2630
40,30,-50,595,659,1254,2641
0,20,0,600,654,1254,2772
-70,-40,70,633,621,1254,2777
-90,60,-80,619,635,1254,2785
-60,50,-130,626,629,1255,2750
-150,40,-10,605,650,1255,2698
-40,40,-170,638,617,1255,2672
70,60,-90,607,648,1255,2634
50,-60,0,610,645,1255,2687
20,-60,-10,606,649,1255,2768
-160,40,-30,608,647,1255,2756
70,-60,-50,602,653,1255,2673
-70,-50,-20,612,644,1256,2887
-100,60,-150,613,643,1256,2819
-80,-40,70,624,632,1256,2723
-130,50,-80,622,635,1257,2771
140,-50,120,600,657,1257,2687
-90,-50,110,623,634,1257,2735
20,0,-20,608,649,1257,2769
-130,60,-20,615,642,1257,2724
-60,-40,150,641,616,1257,2832
50,80,170,606,651,1257,2652
-100,-50,30,622,636,1258,2798
-90,60,110,617,641,1258,2574
-120,-50,60,626,632,1258,2740
160,20,70,606,652,1258,2766
160,80,60,618,640,1258,2719
150,0,90,630,628,1258,2791
-130,50,-130,619,639,1258,2817
-70,50,100,611,647,1258,2711
-50,20,80,622,636,1258,2746
160,0,80,617,641,1258,2855
-50,30,70,615,643,1258,2825
-70,-40,80,650,610,1260,2722
-140,30,-90,623,637,1260,2685
-160,30,-20,607,653,1260,2800
130,-60,100,611,649,1260,2737
-70,50,110,619,641,1260,2788
-10,20,-150,621,639,1260,2741
-130,50,-100,621,640,1261,2679
-40,30,180,626,635,1261,2857
-90,60,-160,617,644,1261,2790
-40,-20,-10,615,646,1261,2735
140,-40,50,625,636,1261,2970
20,-70,0,613,648,1261,2776
30,-70,0,616,645,1261,2833
-70,-50,110,617,644,1261,2939
-150,-40,-130,619,642,1261,2752
-40,30,-180,626,635,1261,2857
-170,-70,-170,615,647,1262,2672
-140,40,-70,623,639,1262,2656
-140,-30,0,622,640,1262,2702
0,60,0,594,668,1262,2724
-120,60,-80,620,642,1262,2725
-50,50,70,613,649,1262,2669
110,20,150,612,650,1262,2661
-100,50,170,615,647,1262,2785
90,-70,50,627,636,1263,2667
160,30,70,603,660,1263,2813
-140,10,-100,623,640,1263,2798
-130,-50,40,618,645,1263,2834
160,-30,50,618,645,1263,2910
-70,-40,0,620,643,1263,2763
-140,20,-140,625,638,1263,2601
-20,20,20,599,664,1263,2628
-70,50,130,624,640,1264,2840
120,-60,70,619,645,1264,2637
-120,60,-90,626,638,1264,2807
-120,-50,40,626,638,1264,2866
0,-80,-10,626,638,1264,2755
-60,40,110,607,657,1264,2796
40,70,-50,614,650,1264,2669
-150,-50,60,615,649,1264,2767
50,-50,-70,601,664,1265,2792
-140,-20,-30,609,656,1265,2703
-40,10,110,626,639,1265,2847
-50,-20,130,618,648,1266,2768
-120,-60,-100,606,660,1266,2677
130,-50,60,625,641,1266,2814
-150,20,-50,600,666,1266,2885
40,-30,-80,599,667,1266,2733
-40,10,170,620,646,1266,2668
-50,0,60,613,653,1266,2795
-90,-50,40,631,635,1266,2826
160,10,70,603,663,1266,2864
-140,50,-60,628,639,1267,2838
-100,-70,-90,602,665,1267,2716
-100,60,-60,623,644,1267,2784
-60,-40,100,646,621,1267,2839
60,-80,40,606,661,1267,2772
-160,-40,50,611,656,1267,2699
160,-40,170,615,652,1267,2730
20,20,-20,616,651,1267,2671
-50,-10,130,621,647,1268,2829
120,-50,40,636,632,1268,2989
-110,-50,-70,622,646,1268,2844
100,-60,30,611,657,1268,2822
-150,50,-30,607,661,1268,2810
-90,-50,50,633,635,1268,2737
-40,20,120,622,646,1268,2792
-40,-20,170,618,651,1269,2880
-50,-70,-50,625,644,1269,2837
-50,-10,140,612,657,1269,2899
-70,-50,0,607,662,1269,2825
-140,20,-110,606,663,1269,2776
-90,-50,70,635,634,1269,2792
-110,-50,0,620,649,1269,2781
-80,50,110,631,638,1269,2709
0,30,-150,630,640,1270,2697
170,70,50,656,614,1270,2707
-60,-40,40,613,657,1270,2875
160,-20,70,622,648,1270,2843
-80,50,120,633,638,1271,2773
-130,50,-110,609,662,1271,2784
-30,-40,-20,618,653,1271,2889
110,-60,40,617,654,1271,2842
-40,0,100,620,651,1271,2784
-40,-10,90,623,648,1271,2800
-70,-50,10,612,660,1272,2816
-50,20,90,609,663,1272,2740
-140,50,-30,628,644,1272,2739
70,-80,50,614,658,1272,2786
-140,50,-20,626,646,1272,2687
10,30,-10,622,650,1272,2790
170,30,60,620,652,1272,2875
150,60,-160,624,648,1272,2711
-20,-10,-10,621,651,1272,2704
-50,50,-160,639,633,1272,2822
-110,-50,-60,609,663,1272,2835
100,-50,0,633,639,1272,2861
-70,-40,60,628,644,1272,2872
-70,-50,-10,615,658,1273,2862
-60,40,100,624,649,1273,2761
-110,60,-120,623,650,1273,2805
130,10,130,608,665,1273,2618
40,-10,-80,621,652,1273,2708
40,10,-120,620,653,1273,2783
40,-40,-80,607,666,1273,2769
-80,-50,50,632,642,1274,2722
90,30,170,638,636,1274,2828
-50,0,130,641,633,1274,2842
130,-50,50,621,653,1274,2868
90,60,140,620,654,1274,2760
-50,-30,60,616,658,1274,2921
-170,40,-170,628,646,1274,2623
-80,-40,80,632,642,1274,2797
-110,-50,-50,602,672,1274,2810
-50,-30,130,622,652,1274,2848
-90,-70,-80,614,661,1275,2768
-10,10,-150,634,641,1275,2797
-40,30,150,630,645,1275,2811
-40,-20,150,615,660,1275,2848
-20,70,-130,638,637,1275,2642
-170,60,30,633,642,1275,2887
-40,0,110,643,632,1275,2848
-140,50,-40,620,655,1275,2703
-40,0,160,624,651,1275,2790
-150,10,-140,629,646,1275,2758
-30,0,10,641,635,1276,2841
-100,70,110,622,654,1276,2651
140,-20,130,625,651,1276,2827
-60,-40,-10,626,650,1276,2832
-170,0,40,619,657,1276,2708
70,50,-100,620,656,1276,2604
40,10,-130,619,657,1276,2730
-80,-50,130,646,630,1276,2764
-40,20,170,631,645,1276,2862
-70,50,140,630,647,1277,2782
-50,-10,150,622,655,1277,2860
-40,-10,100,625,652,1277,2905
-110,60,-110,631,646,1277,2815
140,-40,100,628,649,1277,2801
-50,-30,0,634,643,1277,2897
100,-70,60,636,641,1277,2753
0,-80,-130,627,650,1277,2752
-140,0,-50,621,656,1277,2851
-50,10,150,626,651,1277,2772
-30,0,-160,641,637,1278,2528
-10,-30,-140,624,654,1278,2640
150,-80,140,616,662,1278,2914
-30,-60,-30,633,645,1278,2685
-160,50,20,630,648,1278,2816
-60,-40,-20,634,644,1278,2878
-50,20,100,618,660,1278,2797
-80,-70,140,633,645,1278,2729
170,-10,60,617,661,1278,2896
-50,20,70,621,657,1278,2760
-40,20,50,621,657,1278,2788
-100,-50,60,621,657,1278,2939
-110,-50,50,627,651,1278,2916
-20,0,0,630,649,1279,2818
70,-40,-20,620,659,1279,2830
-40,20,130,634,645,1279,2896
-50,-20,20,626,653,1279,2804
-170,50,180,623,656,1279,2575
-120,-40,20,620,659,1279,2815
-30,30,40,638,641,1279,2788
-40,40,-180,636,643,1279,2877
130,-70,110,621,658,1279,2709
-40,40,180,636,643,1279,2877
-170,50,-180,623,656,1279,2575
-170,70,170,635,644,1279,2631
-40,-10,0,625,655,1280,2694
-150,0,-30,617,663,1280,2915
-50,20,140,640,640,1280,2868
-60,50,150,621,660,1281,2889
-20,70,20,620,661,1281,2705
10,-60,-10,622,659,1281,2898
-150,80,150,643,638,1281,2628
-50,-30,170,641,640,1281,2915
-160,10,-150,618,663,1281,2654
-50,-10,40,627,655,1282,2833
40,-20,-80,621,661,1282,2707
170,80,50,636,646,1282,2771
0,0,-10,621,661,1282,2758
-40,30,130,623,659,1282,2869
-90,-50,90,628,654,1282,2968
-20,20,-150,635,648,1283,2678
-130,40,-90,627,656,1283,2749
80,-80,60,619,664,1283,2774
-110,-50,-40,620,663,1283,2948
-80,60,-120,629,655,1284,2917
120,60,-140,640,644,1284,2657
-40,30,-160,640,644,1284,2809
-100,-50,-30,622,662,1284,2956
-50,-30,-10,626,659,1285,2897
-140,10,-70,633,652,1285,2699
-30,-50,-160,650,635,1285,2686
50,-80,30,623,662,1285,2802
-110,-50,-30,620,666,1286,2957
-40,10,120,636,650,1286,2913
-70,-50,20,624,662,1286,2916
-40,-10,-10,644,642,1286,2802
10,-20,-20,633,653,1286,2839
-40,0,30,643,644,1287,2469
120,-70,90,639,648,1287,2705
-140,-70,80,641,646,1287,2748
60,-70,20,641,646,1287,2696
40,-50,-80,614,673,1287,2717
-130,50,-40,639,648,1287,2789
-50,20,170,648,639,1287,2788
-100,50,150,622,665,1287,2828
-60,50,-120,654,633,1287,2896
40,-20,-30,614,674,1288,2841
-150,-10,-10,621,667,1288,2855
-150,-10,-20,613,675,1288,2962
30,10,-140,601,687,1288,2700
-50,10,80,616,672,1288,2918
150,20,90,621,667,1288,2779
30,70,-170,626,662,1288,2736
-110,-50,-20,634,654,1288,2875
-100,-50,100,664,624,1288,2887
110,30,140,645,644,1289,2762
-100,50,180,629,660,1289,2815
120,30,-160,626,663,1289,2914
-140,-20,-40,619,670,1289,2775
-50,80,50,634,655,1289,2582
-20,-60,-150,653,636,1289,2700
120,30,130,612,677,1289,2788
-60,40,90,629,660,1289,2931
-100,50,-180,629,660,1289,2815
-100,-50,-40,613,677,1290,2899
150,-10,90,645,645,1290,2865
110,-50,20,595,695,1290,2706
-60,-40,130,630,660,1290,2975
40,10,-40,611,679,1290,2851
-120,-40,-80,640,650,1290,2871
-60,70,70,639,651,1290,2708
140,60,90,639,652,1291,2938
-40,50,-130,653,638,1291,2864
-110,70,-40,654,637,1291,2753
150,-40,40,617,674,1291,2911
-60,-30,90,655,636,1291,2829
-60,50,80,634,657,1291,2823
150,-70,140,628,663,1291,2774
-60,-40,110,650,641,1291,2991
-130,30,-80,636,655,1291,2804
-150,40,-50,639,652,1291,2963
-40,30,170,645,646,1291,2906
-60,50,170,627,665,1292,2791
-80,-50,40,635,657,1292,2871
-130,40,-160,630,662,1292,2699
-110,50,-160,626,666,1292,2894
-40,40,160,627,665,1292,2949
-10,60,-140,640,652,1292,2759
-50,20,110,616,677,1293,2839
-140,0,-60,616,677,1293,2792
-100,-50,80,641,652,1293,3022
-50,10,140,642,651,1293,2861
-50,10,160,631,662,1293,2792
-70,-40,90,641,652,1293,2801
0,30,0,639,655,1294,2944
-160,-60,60,645,649,1294,2727
-60,60,-170,621,673,1294,2940
40,80,180,627,667,1294,2715
40,80,-180,627,667,1294,2715
150,-50,30,619,675,1294,2913
-50,30,130,626,668,1294,3024
-70,-50,100,627,667,1294,2949
50,30,-90,617,677,1294,2646
-140,50,-10,642,652,1294,2770
140,-60,20,620,674,1294,2839
50,30,-100,622,673,1295,2620
-140,20,-60,631,664,1295,2864
-150,50,-50,637,658,1295,2999
160,-10,80,638,658,1296,2909
-150,-30,-130,652,644,1296,2778
90,-80,70,630,666,1296,2811
-100,50,160,635,662,1297,2815
-90,-50,-30,625,672,1297,2822
-50,-20,90,654,643,1297,2897
-40,40,170,629,668,1297,3001
20,-40,-20,618,679,1297,2769
40,20,-50,608,689,1297,2750
-120,-50,80,647,650,1297,2699
130,10,180,621,676,1297,2954
-50,-30,140,625,672,1297,2927
130,10,-180,621,676,1297,2954
-50,10,70,622,676,1298,2935
-60,60,-160,638,660,1298,2947
50,-50,-10,619,679,1298,2842
-150,50,-40,633,665,1298,2973
160,-80,30,644,654,1298,2860
-120,60,140,631,667,1298,2654
-20,-70,-150,634,664,1298,2685
-140,80,140,654,644,1298,2717
110,-60,50,637,662,1299,2850
-150,-60,-140,631,668,1299,2749
-120,-40,-10,645,654,1299,2846
-110,-50,-10,640,659,1299,2892
-40,60,-120,646,653,1299,2736
0,-10,-140,636,663,1299,2882
0,-30,-20,632,667,1299,2885
170,20,60,634,665,1299,2976
-60,-40,60,640,659,1299,2918
-100,50,140,638,662,1300,2869
-80,-50,-10,624,676,1300,2929
-60,-30,80,651,649,1300,2981
-180,70,40,666,634,1300,2784
-20,-30,-20,622,678,1300,2921
80,60,150,636,664,1300,2799
180,70,40,666,634,1300,2784
-100,60,-130,641,659,1300,2911
-130,40,-80,648,653,1301,2809
-50,50,170,632,669,1301,2873
-70,50,120,639,662,1301,3029
120,10,170,621,680,1301,2801
100,-50,10,600,702,1302,2890
10,-30,-20,637,665,1302,2818
-100,60,120,639,663,1302,2708
-130,-30,-30,640,662,1302,2949
-50,40,70,632,670,1302,2750
-150,30,-50,619,683,1302,2855
-150,20,-150,637,665,1302,2799
-90,60,-110,639,664,1303,2861
170,-70,40,648,655,1303,2702
-80,-50,90,623,680,1303,2915
-130,40,-170,628,675,1303,2841
140,-40,90,644,659,1303,2866
-40,-50,-30,636,668,1304,2908
170,-60,40,634,670,1304,2693
110,-50,10,639,665,1304,2975
100,-80,80,641,663,1304,2790
110,-70,70,636,668,1304,2826
-160,40,-170,631,673,1304,2695
-140,30,-60,640,664,1304,2837
80,-50,0,621,683,1304,2823
140,-60,120,621,683,1304,2879
-130,50,-70,642,662,1304,2922
40,-80,20,624,680,1304,2841
-90,-50,-20,631,673,1304,2883
-100,-50,20,635,669,1304,2864
-50,30,150,645,660,1305,2903
-70,60,-140,653,652,1305,2976
-70,-40,140,648,657,1305,2957
120,10,150,621,684,1305,2806
-80,-50,-20,629,676,1305,2923
-50,-30,70,624,681,1305,2996
-170,-50,-160,620,685,1305,2755
-90,50,160,634,671,1305,2800
-130,-20,-100,646,659,1305,2782
-10,30,10,636,670,1306,2873
-130,-30,-70,626,680,1306,2818
50,-40,-20,634,672,1306,2860
-140,-30,30,636,670,1306,2871
140,0,120,640,666,1306,2795
10,-10,-130,636,670,1306,2788
-130,30,-70,647,659,1306,2822
-30,-30,-20,630,676,1306,2898
-60,40,130,646,660,1306,2994
150,-40,150,624,682,1306,2818
-70,-50,-30,625,681,1306,2984
180,40,-170,644,663,1307,2859
10,-70,-10,645,662,1307,2942
-70,50,150,639,668,1307,2934
-70,-60,150,651,656,1307,2799
110,20,180,619,688,1307,2855
-180,40,-170,644,663,1307,2859
140,20,110,645,662,1307,2572
-110,60,-100,650,657,1307,2889
-140,-20,-60,623,684,1307,2898
110,20,-180,619,688,1307,2855
-140,-10,-50,626,682,1308,2917
30,10,-30,613,695,1308,2840
-40,30,-150,659,649,1308,2728
-140,-20,-50,630,678,1308,2882
-90,50,130,649,659,1308,2862
150,-40,80,628,680,1308,2797
-130,-30,-80,624,684,1308,2827
150,-60,140,622,686,1308,2851
-130,50,170,630,678,1308,2816
-50,0,140,654,654,1308,2937
-80,-50,-30,632,676,1308,3052
-40,-30,-20,654,654,1308,2947
140,40,100,625,684,1309,2849
-10,-60,-20,631,678,1309,2824
-50,10,130,637,672,1309,2906
-140,40,-100,632,677,1309,2897
-90,-50,30,634,675,1309,2888
150,0,100,632,677,1309,2826
-40,-10,10,635,674,1309,2748
-70,-40,20,639,671,1310,2896
-60,-50,-40,633,677,1310,2752
30,-40,-20,639,671,1310,2821
-70,-30,10,662,648,1310,2794
-40,40,-140,659,652,1311,2805
-180,0,50,628,683,1311,2796
180,0,50,628,683,1311,2796
-80,-50,100,640,671,1311,3001
-130,50,-60,644,667,1311,2975
-170,10,40,639,672,1311,2837
-50,20,120,639,672,1311,2936
-60,80,60,646,665,1311,2663
-130,50,-50,651,660,1311,2909
-140,10,-60,638,673,1311,2834
-130,50,-120,636,675,1311,2899
-140,20,-100,639,672,1311,2832
10,30,-150,628,683,1311,2740
-50,-30,150,648,664,1312,3030
-120,-50,50,646,666,1312,3045
-70,60,-160,648,664,1312,2997
-70,70,80,651,661,1312,2742
90,-60,20,627,685,1312,2916
-70,-30,20,649,664,1313,2798
160,-40,40,617,696,1313,2985
-80,50,140,644,669,1313,2913
-140,40,-60,660,653,1313,2856
-180,-10,50,630,683,1313,2958
180,-10,50,630,683,1313,2958
-160,-70,-160,629,685,1314,2796
-90,70,100,651,663,1314,2721
-110,60,-90,643,671,1314,2771
-150,40,-20,629,685,1314,2777
40,-40,-20,632,682,1314,2920
-10,60,10,621,693,1314,2862
-50,40,140,634,680,1314,2966
-60,-40,120,641,673,1314,3076
-140,30,-110,639,675,1314,2922
-150,-10,0,635,679,1314,2896
-140,-10,-40,623,691,1314,2887
-120,60,-30,650,664,1314,2836
-110,-50,70,649,666,1315,3009
-50,50,-170,648,667,1315,2911
-130,50,-30,653,662,1315,2843
-90,-40,70,646,669,1315,2913
180,80,40,660,655,1315,2792
-60,-30,100,654,661,1315,2924
30,0,-110,637,678,1315,2757
-180,80,40,660,655,1315,2792
-60,-40,50,623,692,1315,2954
-50,10,90,628,687,1315,2844
-10,-80,-140,648,668,1316,2806
-110,-40,40,638,678,1316,2912
40,0,-80,640,676,1316,2783
30,0,-30,635,681,1316,2890
-160,10,30,650,667,1317,2883
140,-20,140,631,686,1317,2796
-60,-30,10,653,664,1317,2900
-60,30,120,650,667,1317,2878
50,-20,-40,627,690,1317,2771
-120,-40,-70,630,687,1317,2931
-130,-40,20,644,673,1317,2851
150,50,80,659,658,1317,2981
170,0,60,658,659,1317,2970
-150,50,170,644,673,1317,2746
-40,-10,180,659,659,1318,2858
-100,-50,10,649,669,1318,2977
-40,-10,-180,659,659,1318,2858
-140,40,-170,614,704,1318,2691
-50,-20,140,638,680,1318,2943
140,40,-160,643,675,1318,2908
-50,0,150,634,684,1318,2915
90,80,-100,638,680,1318,2852
-120,-40,-60,648,670,1318,3036
-80,60,-150,654,664,1318,2958
-30,0,0,647,672,1319,2872
100,80,-110,646,673,1319,2839
-140,10,-50,631,688,1319,2961
170,-60,170,639,680,1319,2804
-40,-10,160,640,679,1319,2928
-130,40,-70,656,663,1319,2880
-110,-60,-90,628,691,1319,2869
-60,-60,-50,647,672,1319,2846
-70,-50,-40,645,675,1320,2964
-40,30,-170,637,683,1320,2936
-100,60,-110,657,663,1320,2991
20,60,-160,662,658,1320,2829
160,-80,150,643,677,1320,2922
150,70,-160,647,673,1320,2774
10,-10,-20,632,688,1320,2820
50,-30,-60,624,696,1320,2802
-10,-80,-20,654,667,1321,2848
-80,-50,0,631,690,1321,2951
-50,10,120,660,661,1321,2887
60,-40,-50,638,683,1321,2782
-50,0,70,646,675,1321,2948
-20,-50,-20,638,683,1321,2908
-120,50,160,640,681,1321,2899
20,10,-20,624,697,1321,2976
60,30,-160,628,693,1321,2876
-120,-40,-20,643,679,1322,2913
-50,30,160,671,651,1322,2951
-150,40,10,662,660,1322,2867
-130,20,-70,661,661,1322,2780
-10,10,0,646,676,1322,2790
-70,50,160,646,677,1323,2991
-70,50,90,662,661,1323,2763
-130,-20,-40,643,680,1323,2902
-70,40,100,656,667,1323,2909
-90,50,140,659,664,1323,2931
-90,-40,-30,644,679,1323,3017
-110,-40,30,639,684,1323,2961
-150,20,-40,649,674,1323,2915
-140,-20,-70,634,690,1324,2994
-140,0,-90,638,686,1324,2932
-50,10,100,637,687,1324,2858
170,-10,-170,635,689,1324,2742
-140,10,-90,637,687,1324,2758
-60,-20,40,656,668,1324,2816
-140,20,-90,639,685,1324,2760
-90,-50,-40,633,691,1324,3025
-130,-30,-40,650,675,1325,2953
-110,60,130,633,692,1325,2840
-70,-30,30,644,681,1325,2784
-120,50,-140,652,673,1325,2936
-80,50,150,644,681,1325,2858
-80,-50,10,644,681,1325,3045
-130,50,160,638,687,1325,2782
-110,50,150,657,669,1326,2921
0,-20,-20,655,671,1326,2834
180,30,50,648,678,1326,2947
110,80,-120,651,675,1326,2828
-180,30,50,648,678,1326,2947
-110,-50,90,666,660,1326,2905
-30,-10,-10,637,689,1326,2942
-120,-40,-90,647,679,1326,2941
-80,50,160,645,681,1326,2917
-140,-50,-120,627,699,1326,2811
-130,40,-100,648,678,1326,2849
-170,10,-160,642,684,1326,2939
-90,50,150,653,674,1327,2977
-60,30,110,652,675,1327,2896
-150,0,-10,647,680,1327,2906
140,-40,110,637,690,1327,2912
-80,-40,60,642,685,1327,2875
-30,70,-120,666,661,1327,2773
-120,-40,30,650,677,1327,2889
-100,60,-100,659,668,1327,2891
-50,-30,160,662,665,1327,3100
-50,0,50,654,673,1327,2763
140,-50,60,653,674,1327,2962
-50,20,130,633,694,1327,2965
60,-40,-20,633,695,1328,2951
-170,70,30,674,654,1328,2842
-100,-40,50,647,681,1328,2930
-140,40,-110,646,682,1328,3006
-70,40,130,667,661,1328,2886
-140,-10,-80,639,689,1328,3032
-150,10,-30,635,693,1328,3022
-120,50,-50,653,676,1329,2993
-140,0,-130,672,657,1329,2752
-140,-30,40,661,668,1329,2955
30,-60,-10,655,674,1329,2859
-90,50,120,657,673,1330,2869
120,80,-130,661,669,1330,2854
-140,50,-50,647,683,1330,2997
-90,-50,80,647,683,1330,2979
50,20,-140,626,704,1330,2876
20,-70,-10,648,682,1330,2919
-60,-20,30,670,661,1331,2948
30,-80,10,643,688,1331,2886
-40,30,160,657,674,1331,2956
-60,40,140,651,680,1331,3113
-140,10,-80,653,678,1331,2710
50,20,-120,636,695,1331,2754
50,50,-70,629,702,1331,2776
-130,20,-130,663,668,1331,2951
-60,50,160,649,683,1332,2981
-20,-40,-20,644,688,1332,2905
-120,50,-40,664,668,1332,2900
-100,60,-120,658,674,1332,2950
-20,-30,-150,665,667,1332,2879
160,-30,70,656,677,1333,3060
-30,-30,-160,649,684,1333,2841
-120,-40,-30,649,684,1333,2996
-100,-40,60,674,659,1333,2957
140,-50,80,643,691,1334,2786
160,-50,160,636,698,1334,2869
160,-70,150,647,687,1334,2897
-80,70,90,658,676,1334,2718
-100,-50,-50,633,701,1334,3005
-80,-30,80,662,672,1334,3018
-30,50,40,654,680,1334,2853
-70,50,-110,669,665,1334,2936
-50,-10,70,650,684,1334,2942
110,-80,90,654,680,1334,2806
-50,10,60,661,673,1334,2910
-60,30,130,666,668,1334,2991
-90,50,170,655,679,1334,2795
-150,30,10,673,661,1334,2888
-50,0,110,672,663,1335,2901
-60,20,120,672,663,1335,2942
-150,30,-40,658,677,1335,3023
-10,50,10,656,679,1335,2712
-100,-50,-10,647,688,1335,3107
-50,50,-180,641,694,1335,3002
-120,-40,-40,652,683,1335,3048
140,-20,150,626,709,1335,2968
-50,50,180,641,694,1335,3002
-90,-70,130,664,671,1335,2973
-70,-50,40,639,696,1335,3036
-70,-40,-10,645,691,1336,2926
60,-60,-60,643,693,1336,2886
-50,-20,80,658,678,1336,3004
150,30,90,650,686,1336,2946
160,10,-170,630,706,1336,3014
70,30,-130,644,692,1336,2989
-30,-10,-160,667,670,1337,2842
170,-40,-180,635,702,1337,2904
-60,-70,-60,657,680,1337,2970
170,-40,180,635,702,1337,2904
-10,-20,-20,663,674,1337,2866
-50,40,150,638,699,1337,2997
0,-50,-20,663,674,1337,3101
-120,50,-100,657,680,1337,2781
130,0,140,653,684,1337,2894
-140,0,-40,660,677,1337,2948
20,-50,-20,650,687,1337,2930
-40,-20,-170,670,667,1337,2857
-40,10,40,654,683,1337,2856
10,-40,-20,662,675,1337,2961
40,-60,-10,645,692,1337,2803
180,10,50,675,663,1338,2935
-50,-20,70,665,673,1338,2932
160,-30,60,651,687,1338,3085
-90,60,-140,665,673,1338,2954
-40,-30,-170,657,681,1338,2828
-140,-30,10,629,709,1338,2947
-90,-40,60,659,679,1338,2981
30,70,-40,648,690,1338,2892
-50,30,140,660,678,1338,2979
-180,10,50,675,663,1338,2935
170,-50,40,650,689,1339,2939
-100,-50,-20,639,700,1339,3093
-150,0,-20,651,688,1339,3016
-100,-50,70,656,683,1339,3164
-70,-40,130,657,682,1339,3046
-130,80,130,666,673,1339,2754
50,-70,10,669,670,1339,2841
-90,60,-120,660,679,1339,2971
-90,-50,20,661,678,1339,3058
170,10,60,664,675,1339,3058
-40,10,180,656,684,1340,2944
-130,-10,-40,664,676,1340,2871
-130,-30,-50,654,686,1340,2974
80,80,-90,646,694,1340,2889
130,-60,90,659,681,1340,2878
-40,10,-180,656,684,1340,2944
-30,40,-140,688,653,1341,2853
-50,-40,-30,665,676,1341,2969
-80,-40,50,660,681,1341,3057
-60,-30,70,669,672,1341,3028
-10,40,10,658,683,1341,2910
-130,-30,-20,658,683,1341,2963
150,-50,140,633,708,1341,3009
-90,-30,70,671,670,1341,2915
-60,30,100,646,695,1341,3054
-120,50,-60,662,679,1341,3058
-70,-50,30,650,692,1342,3104
-140,0,-70,646,696,1342,2745
-130,-70,90,662,680,1342,2961
-150,30,0,660,682,1342,2957
-70,60,-150,655,687,1342,3139
150,-10,100,647,696,1343,2829
-160,60,20,674,669,1343,3023
170,-80,40,658,685,1343,2980
-70,-30,90,670,673,1343,3027
150,-20,90,676,667,1343,2940
-30,-60,-160,679,664,1343,2897
-30,-20,-160,660,683,1343,2879
120,-50,30,638,706,1344,2857
-120,-40,10,658,686,1344,2987
-50,-20,150,658,686,1344,2978
-30,-20,-20,651,693,1344,2914
-140,-20,-20,659,685,1344,2908
30,60,-40,652,692,1344,2970
-60,50,-140,674,671,1345,2921
90,-50,-10,647,698,1345,2974
-10,-40,-20,660,685,1345,3066
-130,40,-130,656,689,1345,3014
-120,40,-160,659,686,1345,2937
80,30,-160,644,701,1345,2995
-40,-10,170,654,692,1346,3049
-90,60,-130,666,680,1346,3077
-140,-10,-60,638,708,1346,2972
130,20,-170,635,711,1346,2962
90,30,-150,637,709,1346,3010
-40,20,180,678,668,1346,2992
-20,-80,-30,664,682,1346,2974
-40,20,-180,678,668,1346,2992
-60,-30,50,653,693,1346,2923
70,-80,40,651,695,1346,2803
-140,30,-100,645,701,1346,2950
170,-20,60,654,693,1347,2969
170,-80,160,668,679,1347,2977
-80,-50,30,646,701,1347,3025
-60,10,130,664,683,1347,2888
-50,10,170,673,674,1347,2810
-150,40,-40,651,696,1347,3024
-150,40,-30,655,692,1347,2978
-110,-50,-80,666,681,1347,2940
80,30,-170,633,715,1348,2993
-80,60,-130,659,689,1348,3054
-50,-10,30,651,697,1348,2958
30,50,-40,643,705,1348,2898
-140,-20,-120,659,689,1348,2862
-70,40,140,674,674,1348,3073
-130,-40,40,669,679,1348,3127
160,40,70,667,682,1349,2995
-30,-90,-40,661,688,1349,2990
-140,-90,-150,661,688,1349,2990
180,-90,170,661,688,1349,2990
-10,-90,-20,661,688,1349,2990
-80,-90,-90,661,688,1349,2990
20,-90,10,661,688,1349,2990
-170,-90,180,661,688,1349,2990
-130,-90,-140,661,688,1349,2990
-170,-90,-180,661,688,1349,2990
150,-90,140,661,688,1349,2990
140,-90,130,661,688,1349,2990
70,-90,60,661,688,1349,2990
60,-90,50,661,688,1349,2990
90,-50,0,640,709,1349,3076
160,-90,150,661,688,1349,2990
90,-90,80,661,688,1349,2990
-130,-40,50,668,681,1349,3019
120,-90,110,661,688,1349,2990
-70,-40,50,659,690,1349,3010
-60,-90,-70,661,688,1349,2990
-130,0,-50,642,707,1349,2914
-100,-40,40,669,680,1349,3019
10,-90,0,661,688,1349,2990
170,-90,160,661,688,1349,2990
30,-90,20,661,688,1349,2990
50,-90,40,661,688,1349,2990
-20,-90,-30,661,688,1349,2990
-110,-90,-120,661,688,1349,2990
110,-90,100,661,688,1349,2990
-70,50,-120,676,673,1349,2888
150,-40,70,660,689,1349,3020
-160,-90,-170,661,688,1349,2990
-150,-90,-160,661,688,1349,2990
0,-90,-10,661,688,1349,2990
40,-90,30,661,688,1349,2990
-40,-90,-50,661,688,1349,2990
100,-90,90,661,688,1349,2990
50,-30,-30,644,705,1349,2872
-70,-90,-80,661,688,1349,2990
-90,-90,-100,661,688,1349,2990
-120,-90,-130,661,688,1349,2990
-180,-90,170,661,688,1349,2990
-50,-90,-60,661,688,1349,2990
80,-90,70,661,688,1349,2990
-90,-50,-10,655,694,1349,2980
-100,-90,-110,661,688,1349,2990
130,-90,120,661,688,1349,2990
140,-50,70,649,701,1350,3076
120,-50,20,651,699,1350,3097
-120,-40,-50,659,691,1350,3090
-120,-70,100,670,681,1351,2916
-170,80,30,672,679,1351,2836
-160,70,20,680,671,1351,3006
140,-10,130,655,696,1351,3001
-80,-40,-10,651,700,1351,2946
-110,-40,50,652,699,1351,2881
-100,50,-170,655,697,1352,2884
-80,-50,-40,647,705,1352,3208
50,-80,20,651,701,1352,2825
60,-80,30,656,696,1352,2810
-150,-70,-150,644,708,1352,2936
-80,-30,70,669,683,1352,3042
-60,30,90,663,689,1352,3029
-130,-30,-60,651,701,1352,2905
-60,-20,90,668,684,1352,3039
-10,-50,-20,673,679,1352,2940
30,80,-170,654,699,1353,2809
-120,80,120,667,686,1353,2791
70,-50,-40,644,709,1353,2912
-110,-50,60,674,679,1353,3116
-80,-60,-60,656,697,1353,2878
-40,0,170,648,705,1353,2969
-80,-40,0,663,690,1353,3025
10,20,-10,661,692,1353,3147
-110,50,-60,655,699,1354,2961
-160,-10,40,667,687,1354,3044
130,30,120,660,694,1354,2840
-160,30,-160,650,704,1354,2976
-130,40,-60,673,682,1355,3011
-90,60,-70,670,685,1355,2917
0,-70,-20,658,697,1355,3058
70,60,160,659,696,1355,2879
-150,-10,20,657,698,1355,2984
-130,30,-90,658,697,1355,2894
-130,-20,-30,650,705,1355,2933
-20,-80,-150,670,686,1356,2881
-30,40,40,655,701,1356,2885
-130,-40,30,667,689,1356,3092
180,-20,50,671,686,1357,3131
-40,0,-170,675,682,1357,2811
20,-80,0,656,701,1357,2930
-120,50,-70,656,701,1357,3049
150,-40,60,644,713,1357,3016
-180,-20,50,671,686,1357,3131
-100,40,160,680,677,1357,2984
-50,40,160,660,697,1357,3063
110,-90,-20,676,682,1358,2897
30,-90,-100,676,682,1358,2897
-170,-90,60,676,682,1358,2897
20,-90,-110,676,682,1358,2897
-30,-90,-160,676,682,1358,2897
-60,20,160,679,679,1358,3059
150,-90,20,676,682,1358,2897
0,-90,-130,676,682,1358,2897
50,-90,-80,676,682,1358,2897
140,-90,10,676,682,1358,2897
-120,-90,110,676,682,1358,2897
-140,-30,20,650,708,1358,3042
60,-90,-70,676,682,1358,2897
-50,-90,180,676,682,1358,2897
-110,-90,120,676,682,1358,2897
-80,-40,-20,668,690,1358,3089
-80,-90,150,676,682,1358,2897
-60,-90,170,676,682,1358,2897
100,-90,-30,676,682,1358,2897
-180,-90,50,676,682,1358,2897
-160,-90,70,676,682,1358,2897
80,-90,-50,676,682,1358,2897
-100,70,-50,685,673,1358,2943
-130,-90,100,676,682,1358,2897
-50,-90,-180,676,682,1358,2897
-20,-90,-150,676,682,1358,2897
40,-90,-90,676,682,1358,2897
-10,-90,-140,676,682,1358,2897
-140,-90,90,676,682,1358,2897
180,-90,50,676,682,1358,2897
170,-90,40,676,682,1358,2897
-30,10,20,646,712,1358,2820
10,-90,-120,676,682,1358,2897
-40,-90,-170,676,682,1358,2897
130,-90,0,676,682,1358,2897
90,-90,-40,676,682,1358,2897
120,-90,-10,676,682,1358,2897
130,80,-140,673,685,1358,2914
70,-90,-60,676,682,1358,2897
-70,-90,160,676,682,1358,2897
10,0,-140,678,680,1358,2948
160,-90,30,676,682,1358,2897
-150,-90,80,676,682,1358,2897
-140,-10,-30,655,703,1358,2977
-90,-90,140,676,682,1358,2897
-100,-90,130,676,682,1358,2897
-150,20,-20,657,702,1359,3005
-80,50,130,660,699,1359,3106
-50,-40,180,671,688,1359,2878
10,-20,-120,682,677,1359,2876
110,30,-160,650,709,1359,3066
-60,-30,0,681,678,1359,3118
-140,0,-80,653,706,1359,2862
-80,40,110,664,695,1359,3025
-50,-40,-180,671,688,1359,2878
-50,-10,90,669,690,1359,3030
140,-50,100,669,691,1360,2954
-130,-20,-80,654,706,1360,3006
-40,60,50,660,700,1360,2731
-90,40,150,680,680,1360,3011
-130,0,-60,669,691,1360,2920
120,-70,0,653,707,1360,2899
-70,-40,-20,654,706,1360,2991
50,40,-80,647,714,1361,2813
170,40,-170,668,693,1361,2901
-80,60,-140,668,693,1361,3164
-80,50,170,656,705,1361,2972
-150,10,-20,653,709,1362,3009
-40,-60,-40,671,691,1362,2945
-80,-50,20,659,703,1362,3212
-30,-80,-40,656,706,1362,3067
-160,-50,-150,650,712,1362,2802
-100,-40,-40,649,713,1362,3021
-60,-30,-10,670,693,1363,3043
-150,-20,40,664,699,1363,2967
-120,-40,0,661,702,1363,3045
-120,50,-90,672,691,1363,2898
150,-30,160,647,716,1363,3038
-60,-30,110,686,677,1363,3094
-60,-30,140,660,703,1363,3220
-40,-40,-30,674,689,1363,3020
-50,0,160,661,702,1363,3052
120,-80,100,661,702,1363,2836
90,30,-160,660,704,1364,3081
-140,-40,-120,651,713,1364,2919
-40,-20,-20,674,690,1364,2922
-160,20,30,685,679,1364,3073
30,0,-100,664,700,1364,2919
-60,50,180,669,696,1365,3021
-130,-20,-90,655,710,1365,2983
-60,50,-180,669,696,1365,3021
-30,70,30,664,701,1365,2825
-90,50,-180,664,701,1365,3028
-160,50,170,657,708,1365,2815
-120,40,-150,666,699,1365,2937
-90,50,180,664,701,1365,3028
140,20,-170,654,711,1365,3114
70,80,-80,655,710,1365,2962
30,-50,-20,653,713,1366,2886
150,10,100,663,703,1366,2965
40,40,-160,663,703,1366,2966
-70,-30,80,676,690,1366,3107
60,-60,0,661,705,1366,2890
-110,50,-50,680,686,1366,3011
-110,50,-150,673,693,1366,3055
70,30,-160,641,725,1366,3108
-60,-40,160,681,685,1366,3060
-60,20,130,671,695,1366,2903
40,0,-40,659,707,1366,2885
120,50,120,666,700,1366,2820
40,-80,10,659,707,1366,2838
10,-50,-20,687,680,1367,2934
-70,-40,30,658,709,1367,3010
150,-40,140,632,735,1367,3051
-120,50,150,676,691,1367,2925
-130,20,-140,672,695,1367,2867
-50,10,110,661,706,1367,2939
-150,20,-30,654,713,1367,3085
-90,-40,40,671,697,1368,3038
20,0,-130,655,713,1368,2955
-130,30,-150,673,695,1368,2929
-50,-30,-20,676,692,1368,3049
-140,-10,-70,637,731,1368,2933
-80,40,140,685,683,1368,3029
-140,-60,-130,664,704,1368,2890
-60,-20,100,691,678,1369,3009
-60,20,170,671,698,1369,3027
120,20,140,667,702,1369,3068
-90,-40,50,668,701,1369,3066
160,10,80,678,691,1369,3049
-130,10,-60,677,692,1369,2866
130,-50,30,646,723,1369,3090
-130,30,-130,668,701,1369,2924
-150,20,0,663,707,1370,3019
140,-50,90,677,693,1370,2923
120,-70,80,666,704,1370,2933
-120,-40,40,667,703,1370,3028
-130,-10,-50,670,700,1370,2825
-70,-70,-70,667,703,1370,3082
-70,30,120,690,680,1370,3039
160,-20,80,648,723,1371,3031
-50,0,90,671,700,1371,2969
40,10,-50,644,727,1371,2832
-150,50,10,683,688,1371,3027
180,-40,-170,649,722,1371,2846
-70,40,120,675,696,1371,3079
-90,-50,0,666,705,1371,3187
-110,60,-40,678,693,1371,3055
-80,-40,90,668,703,1371,3096
-180,-40,-170,649,722,1371,2846
60,30,-120,644,727,1371,2932
-20,-70,-30,680,691,1371,2808
-30,-70,-160,668,703,1371,2907
-170,-40,50,652,720,1372,2963
-70,-30,70,680,692,1372,3136
-50,60,-110,697,675,1372,2929
-150,30,-20,659,713,1372,2996
60,-50,-10,670,702,1372,3064
-130,20,-80,671,702,1373,2910
-90,-40,80,677,696,1373,3228
-120,50,-110,677,696,1373,2946
60,80,-70,660,713,1373,3005
130,0,150,659,714,1373,3012
-150,20,10,674,699,1373,3053
-80,-60,140,668,705,1373,2992
-110,40,170,678,695,1373,2898
-10,-10,-20,682,692,1374,3023
-80,40,120,669,705,1374,3066
160,50,70,678,696,1374,3148
-70,40,110,675,699,1374,3019
-170,20,40,694,680,1374,2985
150,60,80,689,685,1374,3182
-40,0,-180,669,705,1374,3007
-40,0,180,669,705,1374,3007
-80,80,80,675,699,1374,2741
-140,30,-50,668,706,1374,3140
10,40,-150,670,704,1374,2864
-10,-30,-20,674,701,1375,3029
60,60,-80,665,710,1375,2905
-140,-40,60,666,709,1375,3023
-140,-30,-120,667,708,1375,3006
-20,-20,-150,667,708,1375,2808
-70,-30,0,692,683,1375,3001
110,-70,-10,671,704,1375,2887
-60,-20,50,670,705,1375,2997
-50,-10,160,670,706,1376,3165
-70,80,70,677,699,1376,2730
120,-60,50,675,701,1376,3065
-110,-70,110,681,695,1376,2997
-130,0,-110,692,684,1376,2939
-50,-10,80,670,706,1376,3000
-50,0,80,664,712,1376,3055
-60,10,120,672,704,1376,2991
-150,30,-30,666,710,1376,3053
110,20,160,677,700,1377,3025
70,40,-120,660,717,1377,3014
-180,-80,170,694,683,1377,3026
130,20,130,655,722,1377,2928
180,-80,170,694,683,1377,3026
0,-40,-20,673,704,1377,3015
120,-60,60,673,705,1378,2982
50,-20,-50,673,705,1378,3008
-10,0,-10,678,700,1378,3061
10,-60,-20,676,702,1378,2929
-140,-20,0,676,702,1378,3009
-150,70,10,692,687,1379,3082
-120,50,-80,674,706,1380,3002
70,40,180,657,723,1380,2940
-100,-40,-30,666,714,1380,3151
70,40,-180,657,723,1380,2940
-110,50,-70,674,706,1380,3101
-80,-30,20,673,707,1380,2987
-150,10,-10,665,715,1380,3038
-150,60,10,682,698,1380,3127
-50,-50,-40,669,711,1380,3037
110,20,170,652,729,1381,3113
-60,-20,20,679,702,1381,2981
-90,40,120,677,704,1381,3039
-90,-50,10,659,722,1381,3176
40,10,-80,657,724,1381,2936
-90,40,140,674,707,1381,3056
-60,40,150,671,711,1382,3171
0,-10,-20,670,712,1382,3050
30,-10,-30,682,700,1382,3007
-150,-10,10,645,737,1382,3023
-30,20,-150,685,697,1382,2902
-90,-50,120,688,694,1382,2883
80,-80,50,668,714,1382,2881
-100,40,150,673,709,1382,3083
-100,-50,0,662,720,1382,3160
-140,40,-50,696,686,1382,2988
-150,40,-170,666,716,1382,2869
-70,30,130,682,700,1382,3082
60,60,170,681,702,1383,2965
50,-60,-70,671,712,1383,3074
-70,-40,100,681,702,1383,3065
-80,-30,0,689,694,1383,2918
150,-40,50,677,706,1383,3111
-110,80,110,686,698,1384,2858
-130,-20,-50,681,703,1384,3058
-160,80,20,681,704,1385,2902
-50,40,-140,687,698,1385,3069
100,30,160,689,696,1385,3011
-130,-20,-60,662,723,1385,3083
-110,-40,-20,675,710,1385,3166
50,80,-60,670,715,1385,2984
-100,50,130,675,710,1385,2980
-70,-50,150,691,694,1385,2973
170,-30,50,681,705,1386,3354
50,30,-110,640,746,1386,2947
-130,10,-50,684,702,1386,3034
-150,30,-10,667,719,1386,3027
-60,10,140,682,704,1386,3123
-100,50,-70,671,716,1387,3109
170,-70,160,666,721,1387,2932
100,30,-160,662,725,1387,3087
-130,30,-60,691,696,1387,3043
-40,-50,-170,688,700,1388,2882
-90,40,130,672,716,1388,3026
80,-50,-20,657,731,1388,3108
-120,40,-170,686,702,1388,2991
-110,-40,-30,673,715,1388,3228
-60,-30,120,689,699,1388,3235
30,-40,-90,683,705,1388,3019
40,-30,-30,669,719,1388,2974
-90,40,170,687,701,1388,3056
-130,20,-60,701,688,1389,2975
130,-70,10,668,721,1389,3017
-90,-40,-20,670,719,1389,3044
130,60,-150,691,698,1389,3004
-80,50,-100,696,693,1389,3066
-60,20,110,689,700,1389,3075
-120,-20,-30,695,694,1389,3073
-70,50,170,682,707,1389,3074
-90,-50,-50,661,729,1390,3187
-40,20,-170,678,712,1390,3022
30,-80,0,669,721,1390,2870
-110,40,-170,692,698,1390,2994
-70,20,120,680,710,1390,3063
90,30,180,667,724,1391,3047
20,70,-160,678,713,1391,3009
90,30,-180,667,724,1391,3047
150,20,-170,671,720,1391,3180
-110,-40,20,677,714,1391,3139
-20,60,20,659,732,1391,2956
-130,-40,60,694,697,1391,3034
-150,20,-10,663,728,1391,3075
130,-60,80,683,708,1391,2906
130,-70,100,677,714,1391,2978
140,-70,120,665,727,1392,3015
-50,-20,-10,687,705,1392,3022
-10,50,-140,691,701,1392,3020
-60,-20,110,683,709,1392,3200
-50,30,170,687,705,1392,3151
10,-80,-10,684,708,1392,2982
100,70,130,684,708,1392,3066
-80,30,120,677,715,1392,3004
170,40,60,684,708,1392,3063
-110,-40,-40,673,720,1393,3170
-100,40,-180,693,700,1393,3008
-100,-50,-60,677,716,1393,3110
-180,20,50,691,702,1393,3023
90,-70,40,681,712,1393,3079
-130,-60,-120,671,722,1393,3043
-80,40,130,685,708,1393,3046
-150,0,-140,673,720,1393,3039
-70,50,-180,677,716,1393,3046
-100,40,180,693,700,1393,3008
180,20,50,691,702,1393,3023
-70,50,180,677,716,1393,3046
-70,30,110,693,701,1394,3017
90,30,-170,657,737,1394,3128
-130,10,-130,685,709,1394,2939
-50,-10,100,687,707,1394,3033
-50,40,-150,686,708,1394,3077
-40,-10,-170,684,710,1394,2893
60,40,-110,679,716,1395,2909
-70,-30,60,684,711,1395,3226
-110,-40,0,679,716,1395,3132
-150,-10,30,689,706,1395,3046
-30,-80,-160,686,709,1395,2979
-70,-40,40,664,732,1396,3152
-100,-70,120,703,693,1396,3091
100,-70,-20,676,720,1396,2984
-70,-40,120,692,704,1396,3271
90,-80,60,683,713,1396,2948
-100,-60,-80,663,734,1397,2959
-80,-40,10,684,713,1397,3049
-130,-30,0,683,714,1397,3097
-60,50,-150,689,708,1397,3045
130,50,110,667,730,1397,3041
-120,50,-130,676,721,1397,3136
-110,50,-110,686,712,1398,3054
30,-50,-90,680,718,1398,3035
-180,40,50,682,716,1398,2971
180,40,50,682,716,1398,2971
-140,-20,-10,682,716,1398,3056
-100,80,100,688,710,1398,2884
80,40,-130,683,716,1399,3005
10,50,-150,695,704,1399,2950
-60,-10,150,677,722,1399,3177
-140,20,-50,666,733,1399,3171
-130,-30,10,693,706,1399,3068
20,30,-150,680,719,1399,3031
-60,-30,150,699,700,1399,3240
-60,30,140,687,713,1400,3156
80,40,170,684,716,1400,3075
100,-60,-10,669,731,1400,3083
-130,-10,-110,699,702,1401,2869
-60,-30,60,684,717,1401,3186
110,50,130,684,717,1401,2956
-60,0,130,691,710,1401,3102
10,0,-20,674,728,1402,3103
-60,20,140,684,718,1402,3127
-130,-20,-70,675,727,1402,3025
70,50,-110,665,737,1402,2983
130,-80,110,686,716,1402,2948
-80,50,100,691,711,1402,2917
-90,-60,-70,670,732,1402,3013
40,-70,0,696,706,1402,3014
-80,-30,10,682,721,1403,3052
-180,-80,50,684,719,1403,3109
-130,50,-20,689,714,1403,3144
180,-80,50,684,719,1403,3109
110,-60,0,662,741,1403,3139
80,-60,10,669,735,1404,3071
170,10,70,678,726,1404,3191
-60,-20,80,681,723,1404,3083
-150,0,0,665,739,1404,3033
-140,50,160,693,711,1404,2941
-40,10,-170,693,712,1405,3042
-150,-30,50,693,712,1405,3167
-160,70,160,691,714,1405,2933
-80,40,150,679,726,1405,3096
140,10,120,691,714,1405,3062
-60,30,160,706,699,1405,3145
80,-70,30,684,721,1405,3093
-90,80,90,694,711,1405,2822
-100,-40,30,686,720,1406,3131
-140,40,-30,691,715,1406,3139
-40,0,0,695,711,1406,3028
-170,-80,-180,704,702,1406,3147
110,70,120,703,703,1406,2982
-60,0,160,685,721,1406,3166
-30,50,-130,715,691,1406,3063
-170,-80,180,704,702,1406,3147
40,30,-60,670,737,1407,2885
-100,40,170,685,722,1407,3092
-60,-40,-30,680,727,1407,3193
-60,40,80,690,717,1407,3176
140,50,-160,693,714,1407,3027
-130,-10,-60,689,719,1408,3018
-130,-20,-110,704,704,1408,2881
-50,-30,180,708,700,1408,3041
-60,30,150,690,718,1408,3220
-50,-30,-180,708,700,1408,3041
-70,-30,100,691,718,1409,3116
40,-60,-80,694,715,1409,2931
-120,50,-120,680,729,1409,3109
-90,40,160,684,725,1409,3124
-130,10,-70,692,717,1409,2957
-50,-20,160,690,719,1409,3266
140,-50,110,682,727,1409,3138
30,-20,-90,694,715,1409,3033
-110,-40,-50,686,723,1409,3103
-90,50,-90,709,700,1409,3154
10,-70,-20,680,729,1409,3034
-180,-30,50,690,720,1410,3268
-180,-70,50,681,729,1410,2959
-170,30,40,695,715,1410,3042
-20,-20,-20,697,713,1410,3062
90,-60,-20,677,733,1410,3021
180,-30,50,690,720,1410,3268
-120,-30,-40,692,718,1410,3236
-60,-20,150,695,715,1410,3220
-70,-40,-30,692,718,1410,3151
-140,60,0,694,716,1410,3180
-120,-30,-20,693,717,1410,3176
180,-70,50,681,729,1410,2959
-50,-20,170,699,712,1411,3272
-80,30,130,693,718,1411,3152
-120,40,180,694,717,1411,3091
150,-30,90,708,703,1411,3077
40,40,-60,672,739,1411,2944
160,70,-170,693,718,1411,2940
-140,-30,50,701,710,1411,3078
-130,0,-40,667,744,1411,3025
-120,40,-180,694,717,1411,3091
-60,0,140,697,714,1411,3239
-170,60,170,692,719,1411,2923
110,40,-150,688,724,1412,3150
-100,50,-80,699,713,1412,3081
-140,0,-30,684,728,1412,3217
80,30,-140,684,728,1412,3214
-50,0,100,686,726,1412,3021
-80,-40,20,681,731,1412,3252
-130,-30,-10,689,723,1412,3122
140,80,-150,697,715,1412,3050
-180,-60,-180,677,735,1412,3115
20,-80,-10,684,728,1412,2933
180,-60,180,677,735,1412,3115
180,-60,-180,677,735,1412,3115
-180,-60,180,677,735,1412,3115
100,-80,70,691,721,1412,3064
130,0,160,674,738,1412,3265
-120,-20,-40,696,717,1413,3217
-90,-30,60,705,708,1413,3113
0,-60,-20,683,730,1413,3208
90,-70,-30,698,715,1413,3022
-140,10,-140,703,711,1414,3058
-20,10,0,688,726,1414,3012
-110,50,-120,703,711,1414,3133
120,70,110,702,712,1414,3022
-100,-30,-20,694,720,1414,3224
-130,0,-120,709,706,1415,3006
-50,-20,0,695,720,1415,3036
-50,30,180,704,712,1416,3168
140,-60,100,699,717,1416,3025
-130,-10,-100,699,717,1416,3018
-20,10,-150,718,698,1416,3049
-50,30,-180,704,712,1416,3168
-50,40,-160,709,707,1416,3180
-60,-10,90,696,721,1417,3163
40,80,-50,678,739,1417,3055
20,80,-160,694,723,1417,2943
160,60,70,696,721,1417,3267
-140,10,-40,684,733,1417,3239
-40,-60,-170,714,704,1418,3161
-120,40,-70,695,723,1418,3098
150,-20,100,690,728,1418,2989
-80,50,180,695,723,1418,3178
-50,50,-120,716,702,1418,3089
120,10,160,662,756,1418,3270
160,-60,150,677,741,1418,3053
-70,-30,40,692,726,1418,3120
-80,-70,-80,686,732,1418,3123
-80,50,-180,695,723,1418,3178
-100,50,-130,702,717,1419,3237
120,50,-150,692,727,1419,2911
-100,-40,70,701,718,1419,3293
-140,-70,-140,679,740,1419,2977
30,-30,-90,694,725,1419,2977
-60,20,100,690,729,1419,3101
-60,-30,130,696,723,1419,3317
100,-70,50,702,717,1419,3095
130,-60,70,682,737,1419,3100
-50,40,-170,702,718,1420,3268
-70,30,100,689,731,1420,3050
-70,50,-170,701,719,1420,3194
-90,-30,-10,704,716,1420,3214
-50,-20,10,677,743,1420,3144
10,-20,-30,687,733,1420,2974
-60,20,150,695,725,1420,3144
-140,60,150,702,718,1420,2991
-80,-30,-10,703,717,1420,3107
-130,-50,-110,673,747,1420,3152
70,-70,20,695,725,1420,3056
-60,-10,110,704,716,1420,3225
-130,-30,50,704,716,1420,3105
140,-50,30,687,734,1421,3211
-160,-50,60,696,725,1421,3004
-80,-40,40,685,736,1421,3223
-70,-30,-10,700,721,1421,3228
170,-10,70,698,723,1421,3210
-120,-30,-30,713,708,1421,3167
-100,-40,-20,685,736,1421,3340
110,90,110,716,706,1422,3025
-60,20,-180,718,704,1422,3049
180,90,40,716,706,1422,3025
30,90,-170,716,706,1422,3025
-90,90,-50,716,706,1422,3025
-50,90,-90,716,706,1422,3025
10,90,-150,716,706,1422,3025
90,90,130,716,706,1422,3025
-130,90,-10,716,706,1422,3025
-120,90,-20,716,706,1422,3025
-50,40,170,688,734,1422,3327
40,90,-180,716,706,1422,3025
-60,90,-80,716,706,1422,3025
-10,90,-130,716,706,1422,3025
-70,90,-70,716,706,1422,3025
-110,90,-30,716,706,1422,3025
-20,90,-120,716,706,1422,3025
-60,20,180,718,704,1422,3049
70,90,150,716,706,1422,3025
40,90,180,716,706,1422,3025
-100,90,-40,716,706,1422,3025
-40,90,-100,716,706,1422,3025
160,90,60,716,706,1422,3025
-30,90,-110,716,706,1422,3025
100,90,120,716,706,1422,3025
120,90,100,716,706,1422,3025
0,90,-140,716,706,1422,3025
60,90,160,716,706,1422,3025
50,90,170,716,706,1422,3025
-70,40,160,699,723,1422,3331
-140,90,0,716,706,1422,3025
-60,-10,160,699,723,1422,3196
-170,90,30,716,706,1422,3025
130,-70,90,694,728,1422,3013
-180,90,40,716,706,1422,3025
130,90,90,716,706,1422,3025
-80,90,-60,716,706,1422,3025
-150,90,10,716,706,1422,3025
150,90,70,716,706,1422,3025
-160,90,20,716,706,1422,3025
170,90,50,716,706,1422,3025
20,90,-160,716,706,1422,3025
140,90,80,716,706,1422,3025
80,90,140,716,706,1422,3025
150,-20,110,689,734,1423,2911
-140,30,-160,693,730,1423,3121
-60,-30,-20,713,710,1423,3217
150,-40,130,687,736,1423,2941
-120,40,170,686,737,1423,3017
-80,-30,60,692,731,1423,3169
-130,-10,-30,684,739,1423,3144
70,-50,-10,680,743,1423,3180
-60,20,90,684,739,1423,3236
-60,0,120,700,723,1423,3060
80,50,-120,697,727,1424,2938
150,0,-180,688,736,1424,3100
30,50,-160,684,740,1424,3067
-60,40,160,699,725,1424,3249
-60,50,-170,687,737,1424,3322
-40,20,-160,695,729,1424,3015
130,40,-160,688,736,1424,3254
-150,10,0,673,751,1424,3113
130,70,100,696,728,1424,3096
150,0,180,688,736,1424,3100
-60,50,-160,696,728,1424,3172
170,-20,70,706,718,1424,3062
-70,40,150,695,729,1424,3228
-150,-60,70,714,710,1424,3067
-80,60,-80,703,722,1425,3151
-110,-40,10,698,727,1425,3246
160,20,80,689,736,1425,3138
80,30,-150,682,743,1425,3218
-70,-20,100,707,718,1425,3034
20,-60,-20,703,722,1425,3032
-160,-30,50,691,735,1426,3157
-70,20,110,696,730,1426,3176
130,-50,40,694,732,1426,3167
-70,-20,90,709,717,1426,3075
-90,-40,30,702,724,1426,3276
-20,-10,-150,696,731,1427,3147
-80,30,150,713,714,1427,3216
-130,-70,-130,680,747,1427,2971
-80,-40,100,691,736,1427,3314
-50,0,40,709,718,1427,2999
40,20,-90,701,726,1427,2895
160,60,-170,702,725,1427,3057
-40,30,50,704,723,1427,3118
-140,-20,20,703,725,1428,3139
30,-20,-30,697,731,1428,3046
-130,30,-120,707,721,1428,3158
-150,0,10,703,725,1428,3243
140,10,180,673,755,1428,3286
-130,-30,-110,689,739,1428,2951
140,10,-180,673,755,1428,3286
160,-30,80,679,749,1428,3094
170,0,-170,687,742,1429,3084
-50,-10,20,705,724,1429,3115
-40,70,-110,731,698,1429,3005
-130,40,-110,694,735,1429,3175
-120,40,-90,706,723,1429,3117
-100,50,-160,704,725,1429,3162
-140,-50,70,711,718,1429,3179
-50,10,50,691,738,1429,3020
-40,-80,-50,695,734,1429,3249
-70,-60,-60,697,733,1430,3205
-120,-10,-50,698,732,1430,3215
-130,20,-120,711,719,1430,3238
-120,40,-100,703,727,1430,3130
40,20,-140,676,754,1430,3184
-150,30,-160,699,731,1430,3136
-100,50,-60,712,718,1430,3139
170,-50,170,678,752,1430,3074
-50,20,60,695,735,1430,3109
-170,-30,50,698,733,1431,3232
150,20,100,693,738,1431,3222
-140,40,-40,707,724,1431,3182
-60,0,150,692,739,1431,3304
-150,80,10,708,723,1431,3005
-110,-40,-10,693,738,1431,3321
-170,-40,-160,690,741,1431,2942
160,20,-170,693,739,1432,3337
-80,30,110,709,723,1432,3018
-60,10,170,703,729,1432,3117
30,-10,-90,688,744,1432,2923
-60,-10,120,704,728,1432,3169
-20,30,20,694,738,1432,2974
-160,30,30,713,719,1432,3283
-70,-40,110,701,732,1433,3308
-90,70,-60,722,711,1433,3115
-140,40,-20,696,737,1433,3119
-90,-40,90,702,731,1433,3303
40,20,-60,681,752,1433,3016
-120,-30,-90,702,731,1433,3166
-110,40,160,705,728,1433,3084
-110,40,-180,704,729,1433,3066
-70,20,130,708,725,1433,3103
-110,40,180,704,729,1433,3066
-90,-30,80,707,726,1433,3160
-80,30,160,721,713,1434,3261
-60,-10,130,698,736,1434,3219
-50,20,180,724,710,1434,3134
-150,10,10,709,725,1434,3277
-160,0,-150,691,743,1434,2922
-110,-30,-30,696,738,1434,3244
70,30,-150,691,743,1434,3153
-50,20,-180,724,710,1434,3134
-130,0,-70,701,733,1434,3140
150,-60,30,687,747,1434,3126
-150,0,20,709,726,1435,3216
-70,50,-130,720,715,1435,3100
150,40,90,699,736,1435,3197
100,50,140,693,742,1435,3188
60,30,-150,690,745,1435,3179
-70,30,140,704,731,1435,3072
-60,10,160,700,735,1435,3192
-110,50,140,700,735,1435,3053
0,10,-10,687,748,1435,3200
20,-50,-100,714,721,1435,3114
-80,40,160,708,728,1436,3070
-70,20,170,715,721,1436,3265
20,-20,-30,701,735,1436,3125
-30,20,30,674,762,1436,3160
-40,-80,-170,705,731,1436,3095
20,-10,-110,701,736,1437,2970
-110,-30,-20,708,729,1437,3176
60,-70,10,704,733,1437,3072
-140,-10,-20,677,760,1437,3204
-60,60,-100,720,717,1437,3078
-70,-30,50,691,746,1437,3218
-100,-50,-70,706,732,1438,3133
60,40,-170,703,735,1438,3157
-90,-40,100,721,717,1438,3255
-140,-20,30,716,723,1439,3058
40,20,-100,686,753,1439,3036
-120,40,-60,704,735,1439,3175
60,-40,-30,684,755,1439,2980
-60,-20,120,711,728,1439,3319
-60,10,110,698,741,1439,3253
120,20,180,686,754,1440,3265
-170,-30,-160,715,725,1440,3023
-70,-20,30,712,728,1440,3191
60,50,-90,696,744,1440,3023
-60,-10,140,708,732,1440,3296
80,-50,-10,699,741,1440,3298
90,70,-110,706,734,1440,3050
120,20,-180,686,754,1440,3265
90,40,-140,712,728,1440,3169
-140,50,0,700,741,1441,3218
-70,-50,-50,711,730,1441,3072
150,-40,90,702,739,1441,3187
20,-40,-100,709,732,1441,3071
-100,-70,-100,686,755,1441,3119
150,-30,130,689,752,1441,2949
-80,50,-110,722,719,1441,3172
-110,50,-100,707,734,1441,3141
-10,-20,-140,699,742,1441,3009
30,40,-40,689,752,1441,3086
180,30,-170,707,735,1442,3140
-30,-50,-30,701,741,1442,3180
-110,50,-80,717,725,1442,3184
170,-30,180,685,757,1442,3118
-130,10,-120,721,721,1442,3091
170,-30,-180,685,757,1442,3118
80,-80,40,725,717,1442,3110
-170,0,-160,704,738,1442,3086
-180,30,-170,707,735,1442,3140
-90,-30,-20,710,732,1442,3207
-140,70,0,713,729,1442,3163
40,20,-80,679,763,1442,3033
-80,-40,30,698,745,1443,3316
-90,-40,-10,692,751,1443,3275
90,60,-120,701,742,1443,2993
-80,50,-160,704,739,1443,3189
-80,-50,-50,715,728,1443,3233
-120,-40,50,711,732,1443,3305
-80,-40,110,714,729,1443,3347
-90,-30,10,698,746,1444,3273
-160,0,40,709,735,1444,3269
-160,-80,-170,718,726,1444,3232
-120,40,-80,702,742,1444,3159
160,-50,150,674,770,1444,3139
80,70,-100,705,739,1444,3110
-60,-20,60,706,738,1444,3266
-90,50,-170,701,744,1445,3256
-130,40,-120,692,753,1445,3203
50,20,-130,686,759,1445,3275
-140,-20,10,709,736,1445,3113
-140,40,-10,715,731,1446,3119
150,0,110,701,745,1446,3122
-80,-40,-30,708,738,1446,3178
-110,40,-160,700,746,1446,3242
-70,50,-140,717,729,1446,3200
-20,0,-10,701,745,1446,3164
50,60,180,718,729,1447,3023
0,-80,-20,705,742,1447,3050
120,-60,10,696,751,1447,3201
50,60,-180,718,729,1447,3023
160,0,90,707,740,1447,3177
20,60,-30,713,734,1447,3157
10,-30,-30,706,741,1447,2922
-90,-30,0,703,744,1447,3380
160,10,90,696,752,1448,3020
-120,-10,-40,706,742,1448,3062
90,40,160,725,723,1448,3270
-50,40,180,704,745,1449,3295
-130,40,180,696,753,1449,3158
-140,80,0,713,736,1449,3061
-100,-40,90,724,725,1449,3250
-50,0,170,698,751,1449,3296
-130,40,-180,696,753,1449,3158
-100,-40,20,699,750,1449,3353
140,30,110,714,735,1449,2981
-110,50,-140,712,737,1449,3290
-50,40,-180,704,745,1449,3295
-170,-10,-160,709,740,1449,2908
170,10,-170,698,752,1450,3256
-60,10,100,708,742,1450,3357
-60,10,150,726,724,1450,3304
140,-10,160,696,754,1450,3387
-70,-30,110,706,744,1450,3277
-130,-40,-110,682,768,1450,3124
140,-80,120,715,735,1450,3098
170,0,70,719,731,1450,3223
-10,-40,-30,689,761,1450,3240
-60,-10,50,703,747,1450,3253
-40,-70,-170,703,747,1450,3107
110,-80,80,708,742,1450,3163
20,70,-30,710,741,1451,3185
-60,30,80,714,737,1451,3264
-90,30,130,709,742,1451,3221
30,-60,-90,715,736,1451,3163
-80,50,-170,713,738,1451,3236
-80,-30,90,732,719,1451,3234
-10,-50,-30,706,745,1451,3257
-130,40,-50,713,738,1451,3179
-10,20,0,704,747,1451,3325
-120,40,-140,708,743,1451,3238
-180,-70,170,708,744,1452,3136
-80,30,140,718,734,1452,3254
70,-80,30,728,724,1452,3134
80,60,-110,700,752,1452,3016
180,-70,170,708,744,1452,3136
-50,-20,-180,740,712,1452,3272
-50,-20,180,740,712,1452,3272
120,40,130,702,750,1452,3187
90,-80,50,722,730,1452,3100
-120,30,-60,717,735,1452,3311
30,30,-150,712,740,1452,3148
-60,40,170,704,748,1452,3372
150,-10,110,707,746,1453,3055
-130,-10,-80,699,754,1453,3209
170,30,-170,712,741,1453,3118
-90,50,-140,722,731,1453,3303
30,80,-40,699,754,1453,3113
-60,0,110,724,729,1453,3252
-80,-30,-20,704,749,1453,3224
-130,40,-40,717,736,1453,3223
-170,-80,60,707,746,1453,3187
-60,-20,140,713,741,1454,3337
140,50,100,708,746,1454,3156
140,0,130,710,744,1454,3283
-170,40,40,705,749,1454,3101
-50,-60,-50,714,740,1454,3143
-130,-30,20,693,761,1454,3355
170,-30,60,713,741,1454,3237
-130,30,-110,707,747,1454,3228
70,50,170,713,742,1455,3246
30,-30,-30,711,744,1455,3124
-120,-30,-80,691,764,1455,3245
-120,-70,-120,702,754,1456,3049
80,-70,-40,717,739,1456,3122
10,-80,-20,708,748,1456,3042
-90,-70,-90,701,755,1456,3184
160,-10,-180,723,733,1456,3213
160,-10,180,723,733,1456,3213
-70,-20,80,714,743,1457,3220
-70,60,-90,729,728,1457,3187
10,60,-150,734,723,1457,3219
30,-70,-10,720,737,1457,3146
-60,-20,70,708,749,1457,3279
-70,30,150,721,737,1458,3259
140,-60,110,730,728,1458,3116
40,-20,-70,703,755,1458,3231
-60,-10,60,715,743,1458,3314
-120,-30,-70,706,752,1458,3305
-130,-30,40,715,743,1458,3198
-20,40,-140,729,730,1459,3114
170,20,70,725,734,1459,3316
30,30,-40,702,757,1459,3079
-80,20,130,708,751,1459,3192
-180,-30,-170,702,757,1459,3002
-100,-30,-30,713,746,1459,3270
-120,-30,-50,715,744,1459,3338
180,-30,-170,702,757,1459,3002
-50,-10,-10,740,719,1459,3084
10,80,-150,727,732,1459,3080
-150,30,20,718,741,1459,3332
150,-50,130,684,775,1459,3198
-120,30,-70,703,757,1460,3213
20,-30,-100,718,742,1460,3054
0,-20,-130,710,750,1460,2988
-50,-80,-60,708,752,1460,3198
-110,-20,-30,728,732,1460,3222
-100,-30,-40,714,746,1460,3229
160,-30,170,700,761,1461,3304
-120,40,-110,718,743,1461,3308
-110,-70,-110,705,756,1461,3120
-100,-40,80,733,729,1462,3358
-180,50,180,707,755,1462,2987
-40,0,20,713,749,1462,3011
150,-30,140,694,768,1462,3206
-110,-40,-60,705,757,1462,3258
140,-50,40,701,761,1462,3265
180,50,-180,707,755,1462,2987
-180,50,-180,707,755,1462,2987
180,50,180,707,755,1462,2987
-80,40,170,717,746,1463,3311
-10,-70,-30,723,740,1463,3222
-20,0,-150,733,730,1463,3182
40,20,-110,698,765,1463,3112
-60,-10,100,723,740,1463,3274
-150,-80,-160,723,740,1463,3270
-160,-10,-150,724,740,1464,3038
160,-50,40,704,760,1464,3330
40,30,-150,697,767,1464,3154
-50,30,-170,736,728,1464,3247
-130,10,-80,718,746,1464,3204
20,10,-140,706,758,1464,3099
90,50,150,704,761,1465,3224
100,70,-120,724,741,1465,3056
-40,70,40,733,732,1465,3015
-60,30,170,727,738,1465,3299
-130,-10,-90,702,763,1465,3260
40,-10,-40,699,767,1466,3066
-90,40,-180,712,754,1466,3336
-20,-60,-30,707,759,1466,3138
-110,-40,60,725,741,1466,3284
50,30,-150,694,772,1466,3230
-130,20,-50,725,741,1466,3256
-90,40,180,712,754,1466,3336
140,70,90,717,750,1467,3249
-140,20,-40,720,747,1467,3344
-50,-20,-20,738,729,1467,3188
-90,50,-100,725,742,1467,3272
-50,-10,0,717,750,1467,3112
-70,20,140,736,731,1467,3251
100,30,-170,697,770,1467,3250
-120,0,-60,727,740,1467,3283
-80,70,-70,742,726,1468,3256
-100,60,-50,729,739,1468,3244
0,0,-20,710,758,1468,3194
-60,-20,130,709,759,1468,3471
170,20,-170,706,762,1468,3306
-140,30,-20,717,751,1468,3199
-30,-70,-40,739,729,1468,3026
-170,-20,-160,724,745,1469,3152
-140,-10,-10,711,758,1469,3265
-20,-40,-30,718,751,1469,3351
-160,-40,-150,739,730,1469,2957
-100,50,-140,737,733,1470,3358
-40,0,10,743,727,1470,3262
-100,40,140,718,752,1470,3183
-130,-20,-20,707,763,1470,3299
-140,0,-20,714,756,1470,3247
-100,-30,70,722,748,1470,3106
-130,80,-10,730,740,1470,3147
50,40,-90,699,771,1470,3129
-130,-10,-70,708,762,1470,3153
-120,0,-50,726,745,1471,3184
-130,0,-30,710,761,1471,3258
-110,-40,80,724,747,1471,3178
-110,-20,-20,720,751,1471,3206
150,80,-160,722,749,1471,3146
80,50,160,712,759,1471,3194
20,-40,-30,709,763,1472,3086
-170,-20,50,727,745,1472,3359
40,50,-60,717,755,1472,3076
-50,-80,180,722,750,1472,3221
-120,-30,-10,719,753,1472,3255
-50,-10,10,713,759,1472,3227
-50,-80,-180,722,750,1472,3221
-60,-30,160,732,740,1472,3357
-70,-30,-20,711,761,1472,3150
90,70,140,723,750,1473,3206
-90,50,-80,724,749,1473,3166
-60,-10,80,727,746,1473,3274
-60,50,-110,744,729,1473,3249
-120,-40,60,733,740,1473,3234
0,-10,-30,713,760,1473,3084
-150,-40,60,720,753,1473,3273
-60,-10,40,702,771,1473,3278
10,70,-150,727,746,1473,3227
100,-80,60,739,734,1473,3102
170,0,80,718,755,1473,3182
60,-80,20,737,737,1474,3184
-60,20,80,709,765,1474,3298
140,-70,20,706,768,1474,3208
-20,50,20,727,747,1474,3093
30,0,-90,709,765,1474,3022
-140,30,-40,713,761,1474,3226
-40,-10,-20,724,750,1474,3206
10,-40,-30,704,770,1474,3063
-70,20,150,737,737,1474,3407
0,-50,-30,717,758,1475,3165
-130,30,-100,703,772,1475,3255
-20,20,10,719,757,1476,3205
50,-40,-60,703,773,1476,3172
-70,-40,150,753,723,1476,3321
-130,20,-90,717,759,1476,3152
-120,-30,20,729,747,1476,3372
-130,60,140,727,749,1476,3004
180,-10,60,716,760,1476,3248
110,70,-130,721,755,1476,3055
-180,-10,60,716,760,1476,3248
-90,50,-150,724,752,1476,3305
-90,-40,20,725,751,1476,3378
-70,-10,90,745,731,1476,3192
-50,70,-100,741,736,1477,3165
-130,30,-50,737,740,1477,3247
-20,60,-130,724,753,1477,3181
-70,20,-180,739,738,1477,3237
-100,-30,-10,726,751,1477,3397
10,10,-20,726,751,1477,3329
-70,20,180,739,738,1477,3237
90,50,-130,702,775,1477,3124
-90,50,110,716,761,1477,3194
-120,-60,-110,721,756,1477,3162
0,-70,-30,724,754,1478,3144
100,50,-140,713,765,1478,3212
-110,-30,-40,727,751,1478,3308
140,-10,140,714,764,1478,3203
-140,30,-30,720,758,1478,3202
-100,50,-90,740,738,1478,3298
40,20,-70,701,777,1478,3151
-120,-30,-60,718,760,1478,3307
-130,-30,30,714,765,1479,3398
-50,-50,-180,724,755,1479,3121
-130,10,-40,715,764,1479,3359
20,-10,-30,719,760,1479,3107
-50,-50,180,724,755,1479,3121
-10,10,-10,732,748,1480,3237
150,-30,110,728,752,1480,3047
150,-30,150,703,777,1480,3290
40,10,-70,693,787,1480,3193
-120,60,130,727,753,1480,2982
-60,-40,-40,726,754,1480,3175
30,-60,-20,703,777,1480,3054
30,10,-110,721,759,1480,3198
160,-10,90,743,737,1480,3354
50,60,-70,701,779,1480,3096
-120,-10,-30,723,758,1481,3291
20,80,-30,710,771,1481,3182
-90,-40,0,719,762,1481,3310
-120,40,-50,732,749,1481,3286
180,-60,50,723,758,1481,3168
-10,0,-20,733,748,1481,3291
-180,-60,50,723,758,1481,3168
-80,-30,50,725,756,1481,3226
-100,-40,-10,716,766,1482,3319
150,-10,170,718,764,1482,3318
-120,-20,-20,719,763,1482,3338
-60,-20,160,735,747,1482,3507
150,50,90,729,753,1482,3306
170,50,60,731,751,1482,3354
-150,70,150,728,754,1482,3114
140,0,170,720,762,1482,3397
-130,60,-10,741,741,1482,3321
-90,30,170,745,737,1482,3332
40,-50,-20,726,757,1483,3275
20,-30,-30,726,757,1483,3155
150,-60,130,709,775,1484,3236
-70,30,160,742,742,1484,3461
-100,50,-120,726,758,1484,3377
-160,20,-160,719,765,1484,3227
-140,40,0,732,753,1485,3253
-120,50,-30,739,746,1485,3334
-90,-40,10,712,773,1485,3401
-110,50,-90,718,767,1485,3282
90,-70,30,731,754,1485,3221
-80,-40,130,724,761,1485,3312
0,-20,-30,717,768,1485,3142
-60,-10,70,734,751,1485,3317
-80,-40,-40,724,761,1485,3308
50,-60,-10,707,778,1485,3210
-120,-40,70,737,749,1486,3248
-50,10,-180,734,752,1486,3200
-150,20,20,749,737,1486,3262
-50,10,180,734,752,1486,3200
-90,-40,-40,720,766,1486,3240
-80,20,120,719,767,1486,3146
-80,20,160,732,754,1486,3453
-120,30,-150,725,761,1486,3215
-40,40,50,725,761,1486,3357
-130,10,-110,738,749,1487,3296
-140,20,-30,736,751,1487,3343
-90,-60,130,729,758,1487,3279
40,-10,-70,715,772,1487,3264
-70,10,110,725,762,1487,3281
-120,-30,30,727,760,1487,3279
-70,40,90,737,750,1487,3127
-100,40,-170,725,762,1487,3365
50,-80,10,735,753,1488,3214
70,-70,-50,720,768,1488,3246
-110,-30,-10,714,774,1488,3374
160,-40,160,710,778,1488,3280
0,10,-20,735,753,1488,3207
30,-40,-30,723,765,1488,3329
160,30,80,724,764,1488,3194
-110,50,-130,731,758,1489,3349
-120,10,-60,747,742,1489,3192
-170,30,-170,723,766,1489,3271
-60,-20,10,722,767,1489,3405
-80,20,150,727,762,1489,3329
-130,-50,80,728,761,1489,3401
150,-70,130,714,776,1490,3319
-60,-40,170,751,739,1490,3201
130,-60,60,722,768,1490,3432
120,-80,90,726,764,1490,3216
-130,70,-10,728,762,1490,3316
0,-30,-30,718,773,1491,3091
-110,-30,-50,727,764,1491,3317
100,60,-130,719,772,1491,3122
-150,10,20,730,761,1491,3391
-70,30,170,757,734,1491,3442
10,-50,-30,722,769,1491,3270
-120,0,-40,737,755,1492,3237
110,-70,60,732,760,1492,3175
-90,-30,-30,741,751,1492,3291
-120,-30,10,733,759,1492,3427
60,50,-180,727,765,1492,3250
-120,30,-80,728,764,1492,3342
160,-40,80,724,768,1492,3278
160,40,-170,726,766,1492,3226
60,50,180,727,765,1492,3250
-110,-30,30,743,749,1492,3308
140,-70,100,739,754,1493,3096
-100,-20,-20,740,753,1493,3327
-50,-10,170,732,761,1493,3383
-160,-20,-150,746,747,1493,3297
-80,-30,30,733,760,1493,3255
-30,10,10,740,754,1494,3119
-80,50,-150,744,750,1494,3355
-20,-50,-30,744,750,1494,3244
-170,-60,-170,717,777,1494,3298
-160,-80,70,733,762,1495,3260
-70,50,-150,736,759,1495,3311
130,10,140,724,771,1495,3377
-110,40,-60,750,745,1495,3311
-80,-40,120,741,754,1495,3447
-130,40,170,720,775,1495,3230
10,-50,-110,737,758,1495,3078
-100,-30,60,729,766,1495,3182
-90,-30,50,738,757,1495,3285
-130,-10,-20,720,776,1496,3455
150,-50,70,735,761,1496,3382
-70,-10,110,733,763,1496,3343
100,-70,40,733,763,1496,3316
-60,0,100,748,748,1496,3299
10,-10,-30,727,769,1496,3171
-100,-40,10,728,769,1497,3418
-140,-80,-150,737,760,1497,3373
50,50,-170,735,762,1497,3275
-60,40,-180,728,769,1497,3613
-60,40,180,728,769,1497,3613
20,-20,-100,721,777,1498,3059
-110,40,-70,739,759,1498,3323
130,40,120,734,764,1498,3274
-30,0,-10,734,764,1498,3395
-70,-20,70,729,769,1498,3370
-130,0,-100,720,778,1498,3244
-80,-60,-70,700,798,1498,3392
-140,0,-10,717,781,1498,3243
-90,50,-160,728,770,1498,3467
-70,-30,130,727,771,1498,3462
-180,-20,60,734,764,1498,3391
180,-20,60,734,764,1498,3391
-130,20,-110,735,764,1499,3307
-10,-80,-30,731,768,1499,3152
160,-40,50,728,772,1500,3442
-150,-10,-140,735,765,1500,3304
40,10,-60,705,795,1500,3330
40,0,-50,718,782,1500,3042
150,70,80,754,746,1500,3312
-120,-20,-50,754,746,1500,3450
40,0,-70,723,777,1500,3237
-70,-20,110,750,750,1500,3348
-90,-50,-60,733,768,1501,3343
-100,-40,-50,728,773,1501,3321
-100,-30,0,725,776,1501,3523
-120,20,-60,739,762,1501,3304
-70,0,100,749,752,1501,3303
150,-80,130,714,787,1501,3253
-70,50,-100,750,752,1502,3298
170,-60,160,728,774,1502,3272
40,30,-70,706,796,1502,3189
-170,-10,50,736,766,1502,3407
-60,-50,-50,744,758,1502,3383
-80,30,170,747,755,1502,3465
-110,-40,-70,730,773,1503,3423
-150,-50,-140,715,788,1503,3124
160,70,70,742,761,1503,3373
-10,-60,-30,731,772,1503,3343
-100,-40,0,719,784,1503,3548
-140,10,-30,719,785,1504,3435
120,70,-140,738,766,1504,3098
50,-70,0,739,765,1504,3167
-70,10,140,729,775,1504,3248
-100,50,-110,749,755,1504,3378
-70,-30,140,718,786,1504,3388
-70,-20,40,736,768,1504,3366
20,0,-30,741,763,1504,3166
-40,0,-10,753,752,1505,3261
60,-70,-60,728,777,1505,3314
-120,20,-70,741,764,1505,3370
-140,40,-180,721,784,1505,3316
140,-70,110,752,753,1505,3186
-90,50,-130,740,765,1505,3393
-40,-30,-30,743,762,1505,3412
-140,-10,0,718,787,1505,3343
-180,0,60,750,755,1505,3406
20,40,-150,732,773,1505,3241
-120,-20,-60,731,774,1505,3439
-60,0,60,734,771,1505,3368
-140,40,180,721,784,1505,3316
-120,-10,-60,743,762,1505,3289
180,0,60,750,755,1505,3406
-80,50,-90,755,751,1506,3338
140,-60,90,746,760,1506,3150
170,70,180,743,763,1506,3114
-50,40,-130,763,743,1506,3339
-180,-40,50,728,778,1506,3417
170,70,-180,743,763,1506,3114
100,-60,20,721,785,1506,3386
180,-40,50,728,778,1506,3417
-160,40,30,739,767,1506,3302
-80,-20,80,759,747,1506,3297
-40,-70,-50,735,772,1507,3285
70,60,-100,727,780,1507,3170
0,-60,-30,744,763,1507,3181
-50,60,60,726,781,1507,3136
-80,50,-130,730,777,1507,3337
10,80,-20,732,775,1507,3273
160,30,-170,727,780,1507,3237
-60,-20,0,723,784,1507,3545
-40,50,50,726,781,1507,3306
-120,-50,-100,712,795,1507,3322
-20,40,20,736,772,1508,3393
-70,-40,-40,713,795,1508,3389
-60,-60,-60,732,776,1508,3269
-120,-20,-70,727,781,1508,3321
0,-40,-30,733,775,1508,3214
160,50,-170,746,762,1508,3155
180,20,-170,741,768,1509,3357
50,-40,-30,730,779,1509,3121
-180,20,-170,741,768,1509,3357
-70,50,-160,743,766,1509,3438
-130,10,-100,723,786,1509,3300
-70,10,130,732,777,1509,3366
-100,50,-150,729,781,1510,3463
-120,-10,-70,734,776,1510,3243
-70,40,170,736,774,1510,3567
140,-10,150,719,791,1510,3341
150,-30,100,737,773,1510,3341
-60,-80,-70,748,762,1510,3334
-50,-30,-30,753,757,1510,3338
-50,-40,-40,764,747,1511,3346
30,10,-130,731,780,1511,3332
-130,20,-40,736,775,1511,3414
-30,60,30,746,765,1511,3191
-140,20,-20,740,771,1511,3256
110,-70,50,726,786,1512,3392
170,60,60,754,758,1512,3356
-150,0,30,747,765,1512,3303
-70,-20,10,740,773,1513,3402
80,70,150,751,762,1513,3312
-70,-10,100,753,760,1513,3302
-100,-30,50,753,760,1513,3338
-120,80,-20,744,769,1513,3214
150,-50,80,732,782,1514,3316
0,-80,-30,732,782,1514,3183
50,-50,-20,735,779,1514,3349
110,-60,30,726,789,1515,3417
170,10,80,741,774,1515,3468
-70,10,120,737,778,1515,3337
-170,-70,60,731,784,1515,3229
-60,10,90,730,785,1515,3484
-80,20,140,749,766,1515,3486
-80,50,-140,739,776,1515,3352
-30,-40,-30,742,774,1516,3410
-30,10,0,751,765,1516,3269
-100,-50,110,763,753,1516,3403
-70,10,100,755,761,1516,3412
-110,-30,40,737,779,1516,3332
70,-60,0,736,780,1516,3302
-40,10,30,733,784,1517,3356
-50,-60,180,762,755,1517,3370
-50,-60,-180,762,755,1517,3370
-70,10,150,738,780,1518,3491
-130,20,-100,729,789,1518,3379
-120,30,-140,753,765,1518,3348
-60,10,70,719,799,1518,3455
-130,-80,-140,746,772,1518,3471
-70,-20,60,743,775,1518,3388
70,70,-90,750,768,1518,3331
60,50,-100,721,798,1519,3257
180,50,50,757,762,1519,3389
180,-50,50,741,778,1519,3330
-70,20,160,761,758,1519,3431
-140,-10,-130,748,771,1519,3303
-180,50,50,757,762,1519,3389
-70,10,160,750,769,1519,3491
-120,30,-90,762,757,1519,3300
10,-60,-30,754,765,1519,3269
-60,30,180,757,762,1519,3418
-180,-50,50,741,778,1519,3330
-60,30,-180,757,762,1519,3418
-110,40,-110,747,772,1519,3471
-130,50,150,756,763,1519,3202
160,-40,60,747,773,1520,3434
-130,10,-90,741,779,1520,3312
-170,50,40,736,784,1520,3352
-40,-50,-40,762,758,1520,3416
-140,30,-10,749,771,1520,3277
130,-60,20,737,783,1520,3419
100,40,-150,766,754,1520,3490
-90,50,-70,761,760,1521,3360
140,-60,80,723,798,1521,3362
-70,-20,20,743,778,1521,3493
140,-50,50,740,781,1521,3396
-30,-10,-20,752,769,1521,3322
-80,-30,40,740,781,1521,3344
40,-30,-70,737,784,1521,3387
-140,-20,40,773,748,1521,3300
-60,-30,-30,751,770,1521,3326
110,40,140,747,774,1521,3449
-60,0,70,738,784,1522,3370
-60,70,-90,757,765,1522,3256
160,10,100,729,793,1522,3243
70,-50,-30,718,804,1522,3497
-20,-30,-30,738,784,1522,3295
-90,30,150,741,781,1522,3516
-150,-80,80,743,779,1522,3335
110,-80,70,765,758,1523,3171
170,-10,80,740,783,1523,3258
110,30,-170,738,785,1523,3494
150,10,110,734,789,1523,3264
150,30,100,737,786,1523,3333
-60,-10,30,734,789,1523,3421
-60,0,90,754,769,1523,3387
140,60,-160,740,784,1524,3240
-170,-70,-180,733,791,1524,3379
80,-60,-30,725,799,1524,3377
-120,-50,90,759,765,1524,3314
-170,-70,180,733,791,1524,3379
150,-60,120,766,758,1524,3358
-120,10,-50,761,764,1525,3180
-110,-40,70,747,778,1525,3477
60,-40,-40,724,801,1525,3386
-100,40,130,751,774,1525,3327
-80,-30,100,757,768,1525,3549
160,-40,70,730,795,1525,3450
-50,30,60,740,786,1526,3295
-70,-30,120,755,771,1526,3584
100,30,170,729,797,1526,3437
10,20,-20,742,784,1526,3409
40,-80,0,751,775,1526,3275
-70,0,110,743,783,1526,3335
-40,10,-160,760,766,1526,3289
50,-30,-40,742,784,1526,3325
160,-20,90,770,756,1526,3381
10,-40,-110,755,771,1526,3238
100,30,-180,719,808,1527,3433
-90,-30,20,739,788,1527,3411
0,0,-140,757,770,1527,3376
100,40,150,749,778,1527,3300
-70,0,150,746,781,1527,3398
-90,30,160,754,773,1527,3445
100,30,180,719,808,1527,3433
50,50,-80,746,781,1527,3258
80,-70,20,754,773,1527,3281
0,20,-10,749,778,1527,3446
-70,10,170,748,780,1528,3494
130,20,-180,722,806,1528,3543
20,0,-120,744,784,1528,3216
40,-40,-30,735,793,1528,3328
130,20,180,722,806,1528,3543
10,70,-20,748,780,1528,3314
-120,40,-40,756,772,1528,3320
-20,20,0,752,777,1529,3330
-100,-30,40,749,780,1529,3400
60,-50,-20,735,794,1529,3403
-10,-30,-30,749,780,1529,3173
0,0,-30,744,785,1529,3253
-130,0,-90,734,795,1529,3398
-20,-80,-40,744,785,1529,3218
-120,10,-70,757,772,1529,3326
0,80,-10,751,779,1530,3353
-70,-20,0,758,772,1530,3372
160,20,90,732,798,1530,3198
30,20,-40,721,809,1530,3240
-50,30,-160,760,770,1530,3386
-70,-30,-30,754,776,1530,3448
-70,-80,-80,757,773,1530,3411
50,-70,-70,736,794,1530,3335
150,30,-170,747,783,1530,3497
-80,-30,-30,742,789,1531,3399
-80,-50,140,770,761,1531,3348
-140,70,140,759,772,1531,3229
-90,30,120,756,775,1531,3259
-10,-20,-30,755,776,1531,3240
-50,0,-10,770,761,1531,3350
50,-30,-50,722,810,1532,3426
-140,-60,80,756,776,1532,3374
-80,20,170,765,767,1532,3471
160,80,-170,742,790,1532,3290
0,80,-140,766,766,1532,3243
-130,30,-40,754,779,1533,3363
60,-50,-50,726,807,1533,3278
-50,-10,-20,769,764,1533,3324
-80,-50,-60,745,788,1533,3405
-120,-30,40,739,794,1533,3383
-80,50,-120,749,784,1533,3418
140,20,120,755,778,1533,3330
-150,40,20,769,764,1533,3434
40,30,-80,728,805,1533,3193
-120,-30,-100,746,788,1534,3283
-140,20,-150,752,782,1534,3375
-80,-20,-10,757,777,1534,3270
-50,-70,-180,747,787,1534,3349
-90,30,140,740,794,1534,3459
-120,40,-120,752,782,1534,3439
120,-60,40,732,802,1534,3351
-50,-70,180,747,787,1534,3349
10,0,-30,746,789,1535,3207
-120,20,-50,765,770,1535,3310
-130,-20,0,749,786,1535,3474
-150,10,-150,747,788,1535,3331
40,60,-170,762,773,1535,3338
-80,-20,60,763,773,1536,3345
-70,40,180,756,780,1536,3598
-70,40,-180,756,780,1536,3598
-110,-20,-40,768,768,1536,3509
170,30,70,749,787,1536,3487
-120,-30,0,763,773,1536,3577
130,10,170,749,788,1537,3444
150,-20,120,741,796,1537,3425
-120,20,-80,739,798,1537,3311
-70,0,160,757,780,1537,3342
-130,0,-80,750,787,1537,3317
-110,-20,-50,762,775,1537,3470
70,-50,-20,734,804,1538,3421
-110,40,-120,763,775,1538,3490
-110,60,120,763,775,1538,3077
-130,40,-30,750,788,1538,3417
40,40,-70,747,791,1538,3324
-20,-20,-30,745,794,1539,3403
-110,-40,-80,748,791,1539,3449
-110,-50,100,774,765,1539,3442
-80,40,-180,745,794,1539,3589
-130,50,-10,735,804,1539,3453
160,0,100,734,805,1539,3153
-80,40,180,745,794,1539,3589
150,-20,130,729,810,1539,3295
150,-50,120,757,783,1540,3392
180,-20,-170,750,790,1540,3324
-180,-20,-170,750,790,1540,3324
-120,40,160,745,795,1540,3267
50,40,-100,734,806,1540,3276
-140,20,-10,756,784,1540,3455
20,-60,-100,750,790,1540,3239
-90,20,130,748,792,1540,3452
-150,-10,40,759,782,1541,3506
-130,-20,-10,746,795,1541,3573
110,-60,20,733,808,1541,3443
-120,0,-70,748,793,1541,3306
-90,-30,40,772,769,1541,3500
20,-70,-20,761,781,1542,3369
30,10,-40,735,807,1542,3334
-160,-20,50,750,792,1542,3486
-70,70,-80,765,777,1542,3256
-60,10,80,740,802,1542,3492
-70,-10,120,763,780,1543,3532
-130,10,-140,754,789,1543,3320
-60,-80,170,757,786,1543,3328
30,10,-120,749,794,1543,3402
130,-80,100,750,793,1543,3282
-70,0,140,743,800,1543,3492
-140,10,-20,760,783,1543,3314
-160,-30,-150,787,757,1544,3281
170,70,60,770,774,1544,3429
-80,-80,-90,763,781,1544,3526
120,-80,80,773,772,1545,3214
10,-30,-110,790,755,1545,3198
-120,60,-20,767,778,1545,3468
50,40,-160,747,798,1545,3342
-80,-20,70,764,781,1545,3398
-110,40,-80,752,793,1545,3468
100,-60,10,738,808,1546,3535
90,-60,10,756,790,1546,3408
-70,60,80,758,788,1546,3394
-70,0,130,758,788,1546,3621
-50,-10,-180,768,779,1547,3452
-120,30,-100,764,783,1547,3485
140,30,-170,754,793,1547,3559
20,50,-30,744,803,1547,3362
-70,-20,50,760,787,1547,3466
-60,0,80,743,804,1547,3424
-150,-20,-140,762,785,1547,3383
-50,-10,180,768,779,1547,3452
150,-30,120,751,796,1547,3427
20,-50,-30,752,795,1547,3195
-10,10,-20,748,800,1548,3379
-70,-10,150,766,782,1548,3426
-70,30,-180,774,774,1548,3526
-70,30,180,774,774,1548,3526
-90,60,100,744,804,1548,3252
-110,-30,50,765,783,1548,3479
-110,80,-30,768,780,1548,3293
-110,-30,0,742,806,1548,3553
-30,10,-150,769,779,1548,3284
-120,30,-50,766,782,1548,3498
-30,-30,-30,758,791,1549,3295
-20,10,-10,763,786,1549,3347
-110,-50,-90,757,792,1549,3443
-70,20,100,783,766,1549,3543
-50,0,0,764,785,1549,3247
40,30,-90,747,803,1550,3262
-40,20,40,730,820,1550,3330
-80,60,90,768,782,1550,3233
-110,-20,-10,750,800,1550,3458
-120,50,140,768,782,1550,3326
-70,-60,-70,746,804,1550,3297
-70,-10,140,773,777,1550,3642
-110,40,150,751,800,1551,3359
120,-70,60,747,804,1551,3416
-110,40,-50,778,773,1551,3402
-100,-20,-10,748,803,1551,3517
150,-40,120,758,793,1551,3395
-110,50,-40,760,791,1551,3425
-20,-70,-40,757,794,1551,3327
-60,40,-170,761,790,1551,3596
-90,60,-60,768,783,1551,3467
-120,0,-80,757,794,1551,3366
-170,0,50,757,794,1551,3434
180,20,60,762,790,1552,3557
-100,-30,30,759,793,1552,3558
-130,-10,-120,741,811,1552,3397
-90,-20,-10,764,788,1552,3376
-50,0,-180,771,781,1552,3615
-50,0,180,771,781,1552,3615
-180,20,60,762,790,1552,3557
-90,40,-170,755,797,1552,3525
-60,-20,-10,768,785,1553,3461
-10,-10,-30,756,797,1553,3256
130,-60,50,745,808,1553,3302
-70,0,120,763,791,1554,3540
-120,70,-20,754,800,1554,3433
150,-50,90,758,796,1554,3335
40,-70,-80,764,791,1555,3298
-50,70,50,775,780,1555,3309
170,-20,80,736,819,1555,3408
-140,-10,10,743,812,1555,3408
10,10,-140,773,782,1555,3455
-70,-30,150,756,799,1555,3643
-110,40,-100,751,805,1556,3419
120,-70,70,770,786,1556,3273
-110,30,-60,766,790,1556,3370
-130,-40,70,771,785,1556,3435
170,-30,70,768,789,1557,3392
-70,-20,150,778,779,1557,3411
-130,30,-160,750,807,1557,3407
-100,50,-100,763,794,1557,3487
-160,40,180,775,783,1558,3393
-80,20,110,767,791,1558,3365
-160,40,-180,775,783,1558,3393
-60,-30,170,776,782,1558,3398
140,10,130,745,813,1558,3427
150,-50,40,745,813,1558,3603
150,-50,100,754,804,1558,3225
-70,-20,120,776,782,1558,3579
-120,-30,50,760,799,1559,3424
-130,-30,60,762,798,1560,3323
-100,60,110,759,801,1560,3139
70,30,-140,743,818,1561,3648
-80,30,-180,776,785,1561,3500
-80,30,180,776,785,1561,3500
40,60,-60,763,798,1561,3284
140,-60,70,762,799,1561,3538
-120,40,-130,771,791,1562,3497
150,-40,100,772,790,1562,3318
-30,30,30,742,820,1562,3342
-90,50,-120,767,795,1562,3454
-120,-10,-80,747,815,1562,3333
-10,30,0,771,791,1562,3520
-60,40,-160,762,800,1562,3552
20,40,-30,747,816,1563,3451
-130,-10,-10,756,807,1563,3632
110,30,180,747,816,1563,3453
-170,10,50,772,791,1563,3484
40,-70,-10,770,793,1563,3336
160,-30,90,764,799,1563,3347
110,30,-180,747,816,1563,3453
-140,0,0,743,820,1563,3514
150,-10,120,748,816,1564,3362
120,20,150,767,798,1565,3453
170,-20,-180,766,799,1565,3419
-20,-10,-20,758,807,1565,3393
-90,-30,30,769,796,1565,3549
-140,-80,90,762,803,1565,3440
170,-20,180,766,799,1565,3419
-120,-80,-130,766,800,1566,3518
120,20,170,762,804,1566,3580
-90,50,-110,762,804,1566,3505
-100,40,-70,780,786,1566,3347
-10,20,-10,765,802,1567,3288
-80,-20,100,774,793,1567,3533
-80,40,100,761,806,1567,3393
-30,-20,-30,749,818,1567,3359
-110,-60,-100,752,815,1567,3398
-60,0,50,774,793,1567,3400
160,-40,150,727,841,1568,3515
150,-40,110,770,798,1568,3375
150,-70,30,753,815,1568,3396
-120,-20,-10,757,811,1568,3630
-10,40,-140,785,783,1568,3425
60,70,-80,764,805,1569,3474
-20,-50,-40,774,795,1569,3427
-10,80,0,764,805,1569,3402
-30,-60,-40,777,793,1570,3369
10,-60,-110,771,799,1570,3383
-80,-20,20,757,813,1570,3415
120,40,-160,766,804,1570,3557
-160,10,40,771,799,1570,3554
180,10,60,783,788,1571,3534
-120,30,-160,769,802,1571,3400
-180,10,60,783,788,1571,3534
160,-80,140,750,821,1571,3477
-90,-30,-40,781,791,1572,3594
-110,40,-150,758,814,1572,3559
-160,-60,-160,744,828,1572,3519
-10,-70,-40,775,797,1572,3361
-90,-40,110,801,771,1572,3450
-160,-70,-170,753,819,1572,3498
-80,10,140,777,796,1573,3593
70,70,160,775,798,1573,3455
170,-40,50,759,814,1573,3748
-150,40,180,768,805,1573,3279
-150,40,-180,768,805,1573,3279
120,-60,30,753,821,1574,3549
-100,-30,10,758,816,1574,3672
60,-60,-10,761,813,1574,3591
-50,-70,-60,769,805,1574,3400
150,-20,160,761,813,1574,3659
-60,-10,0,770,804,1574,3373
110,60,-140,761,813,1574,3353
-60,-50,170,772,803,1575,3396
130,70,-150,768,807,1575,3249
-100,50,120,758,817,1575,3310
-170,40,180,779,797,1576,3392
-170,-90,170,760,816,1576,3397
-170,40,-180,779,797,1576,3392
120,30,-170,767,809,1576,3566
160,-90,140,760,816,1576,3397
-80,-30,110,770,806,1576,3555
-100,-90,-120,760,816,1576,3397
-20,-90,-40,760,816,1576,3397
180,-90,160,760,816,1576,3397
170,-90,150,760,816,1576,3397
70,-90,50,760,816,1576,3397
-30,-90,-50,760,816,1576,3397
-70,-10,80,790,786,1576,3357
-80,-90,-100,760,816,1576,3397
40,-90,20,760,816,1576,3397
130,-90,110,760,816,1576,3397
-70,-90,-90,760,816,1576,3397
90,-90,70,760,816,1576,3397
-40,-90,-60,760,816,1576,3397
80,-90,60,760,816,1576,3397
-10,-90,-30,760,816,1576,3397
10,-90,-10,760,816,1576,3397
-110,-90,-130,760,816,1576,3397
-120,-90,-140,760,816,1576,3397
30,-90,10,760,816,1576,3397
-160,-90,180,760,816,1576,3397
-90,-90,-110,760,816,1576,3397
-130,-90,-150,760,816,1576,3397
50,-90,30,760,816,1576,3397
120,-90,100,760,816,1576,3397
-110,-30,-60,786,790,1576,3565
-50,-90,-70,760,816,1576,3397
140,-90,120,760,816,1576,3397
-40,0,-160,784,792,1576,3311
0,-90,-20,760,816,1576,3397
-20,0,-20,762,814,1576,3464
20,-90,0,760,816,1576,3397
-150,-90,-170,760,816,1576,3397
150,-90,130,760,816,1576,3397
-60,-90,-80,760,816,1576,3397
-160,-90,-180,760,816,1576,3397
-180,-90,160,760,816,1576,3397
110,-90,90,760,816,1576,3397
60,-90,40,760,816,1576,3397
100,-90,80,760,816,1576,3397
-140,-90,-160,760,816,1576,3397
-90,-40,-50,774,803,1577,3570
-120,-20,-80,763,814,1577,3415
-70,40,-170,770,808,1578,3707
-10,-60,-40,790,788,1578,3340
20,10,-30,770,808,1578,3511
-80,-20,0,778,800,1578,3438
-120,10,-40,780,798,1578,3419
-10,80,-130,786,792,1578,3382
80,-60,0,767,811,1578,3610
-130,-20,10,782,797,1579,3488
30,10,-90,772,807,1579,3319
-90,-80,-100,774,805,1579,3625
40,0,-60,743,836,1579,3603
-140,10,-10,763,817,1580,3412
130,-70,70,765,815,1580,3529
170,80,-180,767,813,1580,3434
170,80,180,767,813,1580,3434
-60,-20,170,789,791,1580,3603
-110,30,-70,770,810,1580,3428
-70,-10,160,784,796,1580,3408
-40,40,-130,795,786,1581,3469
30,20,-140,754,827,1581,3478
160,40,80,770,811,1581,3556
-40,-20,-30,790,792,1582,3449
-120,-40,-100,760,822,1582,3489
130,30,-170,770,812,1582,3613
-110,-30,20,767,815,1582,3617
-10,-10,-140,789,793,1582,3527
-90,-60,-80,752,830,1582,3482
70,40,-170,769,813,1582,3484
170,60,180,764,819,1583,3427
110,30,150,763,820,1583,3529
-70,-20,140,780,803,1583,3491
170,60,-180,764,819,1583,3427
-60,40,-130,775,808,1583,3505
-130,-80,100,772,811,1583,3442
-160,50,30,779,805,1584,3428
-80,-20,90,786,798,1584,3473
40,-20,-40,761,823,1584,3426
170,20,80,770,814,1584,3555
140,-60,60,763,821,1584,3484
-50,20,-170,784,801,1585,3516
80,40,180,788,797,1585,3539
30,-80,-10,779,806,1585,3437
-40,20,-150,789,796,1585,3347
-110,40,-90,776,809,1585,3563
-70,-20,-10,774,811,1585,3537
80,40,-180,788,797,1585,3539
-110,-40,90,791,794,1585,3595
60,40,-120,762,824,1586,3389
-180,-50,-180,747,839,1586,3428
-130,0,-20,772,814,1586,3531
-180,-50,180,747,839,1586,3428
150,-50,50,781,805,1586,3664
-50,0,30,780,806,1586,3317
0,70,-140,789,797,1586,3413
180,-50,180,747,839,1586,3428
-120,20,-90,779,807,1586,3450
180,-50,-180,747,839,1586,3428
-100,40,-80,789,798,1587,3481
60,60,-90,774,813,1587,3319
-100,40,-160,774,813,1587,3643
-100,-20,-30,774,813,1587,3483
-140,0,10,784,803,1587,3593
-180,60,50,797,790,1587,3559
180,60,50,797,790,1587,3559
30,-50,-30,757,830,1587,3483
-60,40,-150,786,802,1588,3463
30,0,-40,757,831,1588,3329
160,-20,170,764,824,1588,3562
180,70,50,789,799,1588,3593
-180,70,50,789,799,1588,3593
-60,-20,-20,790,798,1588,3435
-150,-20,50,770,819,1589,3603
-60,60,70,760,829,1589,3453
-100,80,-40,786,803,1589,3350
-70,-50,-60,765,824,1589,3487
-100,-80,-110,783,806,1589,3633
-20,-60,-40,793,797,1590,3481
120,60,120,777,813,1590,3549
-140,40,170,776,814,1590,3514
150,-50,60,756,835,1591,3478
-100,-40,100,822,769,1591,3550
160,-10,100,769,822,1591,3374
-90,20,140,778,813,1591,3573
-160,60,160,765,826,1591,3409
-30,-80,-50,776,816,1592,3280
-100,-30,-50,783,809,1592,3696
0,-40,-120,793,799,1592,3396
-120,-20,-90,772,821,1593,3476
-60,0,170,786,807,1593,3579
-170,50,170,760,833,1593,3419
60,30,-130,765,828,1593,3603
-140,40,10,780,814,1594,3653
-130,40,-20,789,805,1594,3624
130,-80,90,797,797,1594,3306
-180,-60,170,767,828,1595,3392
-140,-30,60,778,817,1595,3570
150,0,120,753,842,1595,3299
180,-60,170,767,828,1595,3392
150,-20,140,782,813,1595,3418
160,-60,40,766,829,1595,3591
20,-10,-100,772,823,1595,3429
160,-50,140,746,849,1595,3436
30,50,-50,784,812,1596,3517
0,-50,-120,799,797,1596,3386
-100,30,150,789,807,1596,3540
-140,-10,20,768,828,1596,3571
-80,10,160,781,815,1596,3659
40,20,-120,770,826,1596,3585
-80,-20,30,775,821,1596,3485
-110,-80,-120,788,808,1596,3565
160,-70,140,774,823,1597,3508
-100,30,160,796,801,1597,3533
10,50,-20,765,832,1597,3403
20,20,-30,764,833,1597,3500
170,-50,160,754,844,1598,3383
10,10,-30,762,836,1598,3382
30,10,-100,790,808,1598,3530
10,60,-20,774,824,1598,3389
-140,0,-140,780,818,1598,3402
-100,-30,20,781,817,1598,3672
-60,30,-170,800,799,1599,3578
-40,50,-120,799,800,1599,3523
-120,10,-90,788,811,1599,3512
-60,10,60,782,818,1600,3516
-130,30,-30,791,809,1600,3464
-100,30,-180,785,815,1600,3560
30,-70,-90,783,817,1600,3434
-100,30,180,785,815,1600,3560
-80,10,130,772,828,1600,3616
160,-40,140,768,832,1600,3418
70,40,-130,783,817,1600,3558
-10,-80,-40,785,815,1600,3352
60,30,-140,782,819,1601,3555
90,-60,0,785,817,1602,3703
-50,40,60,770,832,1602,3440
-90,-20,-20,796,806,1602,3423
-110,-30,10,779,823,1602,3806
-170,60,40,797,805,1602,3612
-120,-80,110,791,811,1602,3512
-110,-10,-30,804,798,1602,3584
180,30,60,776,827,1603,3652
-40,30,-140,790,813,1603,3426
-130,10,-30,784,819,1603,3678
-180,30,60,776,827,1603,3652
0,-60,-120,787,816,1603,3413
-80,-20,10,779,825,1604,3537
70,-70,10,776,828,1604,3438
150,-20,150,761,843,1604,3545
-150,50,20,801,803,1604,3488
-80,10,120,781,823,1604,3420
-60,10,180,795,809,1604,3526
-60,10,-180,795,809,1604,3526
0,60,-140,806,798,1604,3530
160,-60,140,755,849,1604,3605
-90,30,-180,807,798,1605,3557
-110,50,130,787,818,1605,3497
-120,-10,-10,769,836,1605,3723
-50,50,60,767,838,1605,3434
-90,30,180,807,798,1605,3557
-70,-10,130,791,814,1605,3679
110,60,130,780,825,1605,3450
130,30,130,777,829,1606,3469
-120,-10,-20,761,845,1606,3660
-110,-30,60,801,806,1607,3635
150,60,90,797,810,1607,3541
20,30,-30,760,847,1607,3441
-110,40,-130,795,812,1607,3709
-100,30,140,787,820,1607,3629
-150,50,160,779,828,1607,3382
0,50,-10,766,842,1608,3495
40,-10,-50,777,831,1608,3380
160,-50,80,795,813,1608,3627
-140,30,0,804,804,1608,3464
-120,10,-80,787,821,1608,3424
-80,40,-170,777,831,1608,3663
140,40,110,792,816,1608,3552
-60,-70,170,796,813,1609,3536
-180,-20,70,794,815,1609,3553
180,-20,70,794,815,1609,3553
140,0,140,787,822,1609,3576
-160,-40,60,770,839,1609,3581
-160,10,-160,793,816,1609,3563
40,40,-80,771,839,1610,3407
130,60,110,792,818,1610,3605
0,30,-10,777,834,1611,3665
170,-30,80,764,847,1611,3533
150,20,110,772,839,1611,3431
-70,-80,160,801,810,1611,3466
-90,-30,90,801,810,1611,3689
140,60,100,794,817,1611,3563
-160,-70,70,786,825,1611,3505
-60,-10,10,789,822,1611,3391
50,50,-90,773,839,1612,3313
160,30,90,776,836,1612,3460
-130,-10,0,781,831,1612,3590
-110,-20,-60,796,816,1612,3666
10,-10,-120,794,818,1612,3406
-120,30,-120,775,837,1612,3673
-110,30,170,792,821,1613,3505
170,-40,170,769,844,1613,3427
120,30,140,779,834,1613,3612
-80,-40,140,806,807,1613,3673
-120,-30,60,795,818,1613,3519
-60,-60,170,801,812,1613,3599
-100,30,170,784,829,1613,3524
-110,30,-170,787,826,1613,3578
150,10,180,761,853,1614,3628
-120,20,-130,806,808,1614,3561
-110,40,140,795,819,1614,3485
-100,-40,-60,785,829,1614,3686
50,70,-70,784,830,1614,3511
150,10,-180,761,853,1614,3628
140,20,-180,773,841,1614,3827
140,20,180,773,841,1614,3827
-120,30,-110,784,830,1614,3670
-150,10,30,795,819,1614,3685
0,20,-20,775,839,1614,3526
-180,-10,70,806,809,1615,3510
-90,-20,0,782,833,1615,3614
-70,-40,-50,790,825,1615,3613
180,-10,70,806,809,1615,3510
160,-30,160,766,849,1615,3505
-100,40,-60,802,813,1615,3521
40,30,-100,797,819,1616,3380
140,-80,110,793,823,1616,3421
-110,-10,-40,807,809,1616,3583
120,20,160,789,827,1616,3657
-70,-20,130,804,812,1616,3748
130,10,160,783,833,1616,3677
70,-60,-40,783,834,1617,3606
-50,30,-150,793,824,1617,3494
130,-70,80,791,826,1617,3529
-100,-20,0,786,831,1617,3639
-140,-10,30,796,821,1617,3598
-120,-20,0,784,834,1618,3761
-120,30,-130,793,825,1618,3682
-20,80,10,783,835,1618,3454
-90,20,170,803,815,1618,3754
-160,60,30,818,800,1618,3614
-140,30,10,803,815,1618,3704
-90,-50,-70,758,860,1618,3573
-110,30,-80,788,831,1619,3592
-130,-60,90,794,825,1619,3578
0,70,-10,797,822,1619,3384
70,50,-120,791,828,1619,3355
-150,40,170,774,846,1620,3452
-90,-20,10,789,831,1620,3490
-90,80,-50,789,831,1620,3474
-110,0,-40,810,810,1620,3517
-20,80,-120,807,813,1620,3512
-30,60,-120,804,816,1620,3530
-130,20,-30,789,831,1620,3548
150,-10,130,776,844,1620,3461
-90,-20,70,793,827,1620,3478
-120,0,-30,793,827,1620,3525
-140,-20,50,787,834,1621,3681
-100,50,-50,792,829,1621,3674
-100,40,-130,819,802,1621,3684
120,30,180,789,832,1621,3685
-30,20,20,771,850,1621,3502
-70,30,90,800,821,1621,3531
120,30,-180,789,832,1621,3685
150,-70,120,808,813,1621,3521
-120,-20,-100,802,820,1622,3460
-150,-40,-140,785,837,1622,3300
-160,20,40,796,826,1622,3622
-20,-40,-40,802,821,1623,3431
-80,20,180,823,800,1623,3511
-80,20,-180,823,800,1623,3511
-60,20,70,794,829,1623,3619
-50,-20,-30,820,803,1623,3576
-100,-60,120,786,837,1623,3662
80,90,-90,786,838,1624,3476
-160,90,150,786,838,1624,3476
-10,90,0,786,838,1624,3476
-70,90,60,786,838,1624,3476
70,90,-80,786,838,1624,3476
140,90,-150,786,838,1624,3476
150,90,-160,786,838,1624,3476
-180,90,170,786,838,1624,3476
-150,90,140,786,838,1624,3476
-60,-20,-30,813,811,1624,3650
90,90,-100,786,838,1624,3476
-120,90,110,786,838,1624,3476
-80,90,70,786,838,1624,3476
50,90,-60,786,838,1624,3476
30,90,-40,786,838,1624,3476
-40,90,30,786,838,1624,3476
180,90,170,786,838,1624,3476
-170,90,160,786,838,1624,3476
10,90,-20,786,838,1624,3476
20,90,-30,786,838,1624,3476
100,90,-110,786,838,1624,3476
-60,90,50,786,838,1624,3476
-100,90,90,786,838,1624,3476
-50,90,40,786,838,1624,3476
170,90,-180,786,838,1624,3476
-20,90,10,786,838,1624,3476
120,90,-130,786,838,1624,3476
40,-60,-20,773,851,1624,3632
-30,90,20,786,838,1624,3476
110,90,-120,786,838,1624,3476
170,90,180,786,838,1624,3476
60,90,-70,786,838,1624,3476
-130,90,120,786,838,1624,3476
-140,90,130,786,838,1624,3476
40,90,-50,786,838,1624,3476
-90,-20,60,802,822,1624,3490
160,90,-170,786,838,1624,3476
-110,90,100,786,838,1624,3476
-80,-20,40,797,827,1624,3686
0,90,-10,786,838,1624,3476
-90,90,80,786,838,1624,3476
130,90,-140,786,838,1624,3476
-30,50,30,796,829,1625,3467
140,-60,30,787,838,1625,3735
-110,-20,0,781,844,1625,3753
-80,10,150,791,834,1625,3549
-70,-10,30,801,824,1625,3615
-80,-40,-50,794,832,1626,3696
150,40,-170,805,821,1626,3593
20,50,-150,796,830,1626,3538
10,0,-130,789,837,1626,3646
-130,-20,20,797,829,1626,3622
50,30,-120,775,851,1626,3603
-50,-50,-50,805,821,1626,3501
-120,-40,80,823,804,1627,3572
-180,0,70,789,838,1627,3675
-110,-80,120,796,831,1627,3575
180,0,70,789,838,1627,3675
130,10,150,785,842,1627,3628
-120,30,-40,801,827,1628,3625
-100,-50,-80,784,844,1628,3521
-100,30,130,805,824,1629,3482
-60,-10,170,813,816,1629,3692
-10,-50,-40,795,834,1629,3385
10,30,-20,798,831,1629,3602
-110,20,-60,786,843,1629,3517
150,-50,110,808,821,1629,3571
-20,30,10,789,841,1630,3525
-160,-10,50,797,833,1630,3701
140,-80,100,810,820,1630,3415
80,50,-130,791,839,1630,3481
40,-10,-60,748,882,1630,3706
180,10,-170,792,839,1631,3669
-60,40,-140,809,822,1631,3557
-80,-30,-40,781,850,1631,3538
-180,10,-170,792,839,1631,3669
160,-40,90,786,845,1631,3467
-100,-60,-90,786,846,1632,3588
-140,20,0,784,848,1632,3650
-80,-60,-80,779,853,1632,3496
30,60,-160,798,834,1632,3643
-70,0,90,819,813,1632,3633
60,70,170,798,834,1632,3638
-50,20,50,797,835,1632,3646
-130,0,-130,807,826,1633,3441
160,50,80,800,833,1633,3606
50,40,-110,792,841,1633,3401
20,-80,-20,811,822,1633,3537
-30,10,-10,818,816,1634,3749
-90,20,150,815,819,1634,3644
-80,40,-160,797,837,1634,3723
20,-70,-100,787,847,1634,3573
-50,10,40,792,843,1635,3504
150,40,100,802,833,1635,3634
-110,70,-30,800,835,1635,3605
-10,0,-30,808,827,1635,3403
150,-70,110,799,836,1635,3363
-110,-60,110,809,827,1636,3721
-110,40,-140,798,838,1636,3796
40,50,-160,804,832,1636,3630
-80,0,150,803,834,1637,3744
-100,30,-170,807,830,1637,3701
-50,30,-140,811,826,1637,3568
-110,-10,-50,812,825,1637,3648
150,-60,80,804,833,1637,3717
-70,-10,60,787,850,1637,3564
-70,40,-160,802,836,1638,3716
40,20,-130,796,842,1638,3755
-50,0,-170,820,818,1638,3564
-80,-10,110,810,828,1638,3670
-170,30,50,794,844,1638,3618
-160,30,-170,784,854,1638,3399
-70,-10,40,807,831,1638,3685
30,40,-150,793,846,1639,3604
90,-60,-10,781,858,1639,3780
-60,-10,-10,809,830,1639,3618
110,40,-160,800,839,1639,3651
20,0,-110,796,843,1639,3511
-130,30,-170,783,857,1640,3546
10,-20,-110,816,824,1640,3372
-60,-50,-60,805,835,1640,3519
-150,-70,-160,786,854,1640,3651
-40,10,0,791,849,1640,3812
-110,-10,-60,795,845,1640,3692
-130,20,-150,812,829,1641,3601
-120,10,-130,810,831,1641,3559
-110,30,-160,806,835,1641,3560
-150,60,20,811,830,1641,3670
-140,50,10,812,830,1642,3682
140,70,-160,798,844,1642,3387
140,30,120,822,820,1642,3581
-80,80,-60,808,834,1642,3536
-130,70,130,793,850,1643,3374
-120,70,120,807,836,1643,3447
50,30,-140,795,848,1643,3602
40,70,-60,809,834,1643,3598
10,-70,-30,817,826,1643,3527
-170,20,50,816,828,1644,3670
30,40,-50,804,840,1644,3567
150,-60,110,801,843,1644,3445
-60,-10,20,793,851,1644,3591
-100,-80,130,808,836,1644,3616
-110,30,160,808,837,1645,3669
-110,-30,-70,794,851,1645,3729
170,-70,150,781,864,1645,3686
-150,-60,-150,781,864,1645,3660
-130,-20,40,810,835,1645,3674
-30,-50,-40,824,821,1645,3556
-10,-40,-130,815,831,1646,3549
-100,40,-120,818,828,1646,3725
-90,-20,50,807,839,1646,3686
-130,0,-10,800,846,1646,3667
-90,20,160,803,843,1646,3672
-30,80,-110,808,838,1646,3594
-180,-30,60,814,833,1647,3917
-60,-40,-50,816,831,1647,3574
70,-60,-10,804,843,1647,3708
-20,-80,-50,809,838,1647,3479
180,-30,60,814,833,1647,3917
10,40,-20,779,868,1647,3611
-80,-20,-20,816,831,1647,3614
180,10,70,803,845,1648,3592
-90,40,-160,808,840,1648,3757
-120,20,-140,804,844,1648,3501
-180,10,70,803,845,1648,3592
170,40,70,806,842,1648,3750
-70,-10,50,789,860,1649,3623
-140,10,0,808,841,1649,3794
-60,40,-120,822,828,1650,3687
-90,-80,140,808,842,1650,3662
100,60,140,811,839,1650,3594
150,-60,100,802,848,1650,3564
180,80,170,795,855,1650,3577
-180,80,170,795,855,1650,3577
-110,60,-30,820,831,1651,3698
-130,40,160,820,831,1651,3564
170,-80,150,782,870,1652,3713
40,-40,-70,787,865,1652,3679
-110,-10,-20,805,847,1652,3755
-30,30,-140,812,840,1652,3630
-110,30,-50,829,824,1653,3597
-180,-10,-170,801,852,1653,3483
-70,-10,70,807,846,1653,3541
180,-10,-170,801,852,1653,3483
60,40,-160,787,866,1653,3711
-120,-10,-90,803,851,1654,3577
-40,-60,-50,810,844,1654,3590
-80,30,-170,822,832,1654,3713
50,-50,-30,801,853,1654,3572
-80,-80,150,822,832,1654,3621
-110,-40,-90,813,842,1655,3674
-60,-70,-70,798,857,1655,3574
60,-50,-30,789,866,1655,3601
-170,70,40,813,842,1655,3685
-170,-60,180,794,861,1655,3443
90,-70,20,782,873,1655,3671
-80,-10,100,805,850,1655,3619
-30,40,30,803,852,1655,3685
30,60,-50,809,846,1655,3412
-170,-60,-180,794,861,1655,3443
140,40,-170,818,837,1655,3712
50,-50,-60,792,864,1656,3690
-120,-60,100,817,839,1656,3638
150,0,130,800,856,1656,3628
-90,40,-80,829,827,1656,3553
-80,-20,110,821,835,1656,3842
10,-20,-40,816,840,1656,3607
-30,20,0,817,840,1657,3533
-40,-80,-60,813,844,1657,3454
30,30,-50,791,866,1657,3713
-110,20,-50,801,856,1657,3498
110,-80,-10,809,848,1657,3692
-90,40,110,817,840,1657,3580
-40,0,-20,816,841,1657,3629
-120,30,170,795,862,1657,3633
-140,-50,-130,793,865,1658,3621
-100,40,-140,813,845,1658,3782
-90,-20,80,810,848,1658,3476
-70,-20,160,832,826,1658,3712
140,0,150,812,846,1658,3744
160,-60,130,819,839,1658,3614
-110,70,110,812,846,1658,3459
-140,30,-170,797,862,1659,3558
120,60,-150,811,848,1659,3507
-90,30,-170,836,823,1659,3662
-60,70,60,825,835,1660,3606
110,-60,10,814,846,1660,3836
60,-70,0,811,849,1660,3647
-80,-20,50,821,839,1660,3712
-160,30,40,821,839,1660,3778
150,-60,90,802,858,1660,3621
130,20,140,814,847,1661,3768
180,-20,80,797,864,1661,3489
-70,0,170,816,845,1661,3666
-140,20,10,814,847,1661,3652
150,80,80,818,843,1661,3799
120,50,130,810,851,1661,3626
-180,-20,80,797,864,1661,3489
-70,-50,160,813,848,1661,3709
-170,-60,60,812,849,1661,3633
-40,-40,-40,850,811,1661,3783
180,-10,80,814,848,1662,3500
150,50,-170,816,846,1662,3506
-180,-10,80,814,848,1662,3500
180,40,-180,804,859,1663,3585
20,-60,-30,813,850,1663,3562
-120,20,-40,830,833,1663,3608
-170,20,-170,823,840,1663,3626
-30,-70,-50,805,858,1663,3517
160,-70,40,795,868,1663,3601
-50,0,10,821,842,1663,3563
-90,-50,130,826,837,1663,3617
-120,50,-20,808,855,1663,3785
-180,40,-180,804,859,1663,3585
-180,40,180,804,859,1663,3585
140,0,160,799,864,1663,3788
180,40,180,804,859,1663,3585
-150,20,30,814,849,1663,3845
80,40,-140,800,864,1664,3740
80,-60,-20,792,872,1664,3728
-130,40,-10,820,844,1664,3688
-110,0,-30,822,843,1665,3684
-180,70,170,809,856,1665,3385
-70,20,90,823,842,1665,3733
110,30,170,805,860,1665,3819
180,70,170,809,856,1665,3385
80,-70,10,787,878,1665,3694
-140,-20,-130,797,869,1666,3776
-110,30,-150,829,837,1666,3842
130,50,120,815,851,1666,3752
-20,30,0,799,867,1666,3539
40,-50,-30,800,866,1666,3678
110,30,160,819,847,1666,3638
-30,-10,-30,816,850,1666,3624
-120,40,150,831,835,1666,3659
-50,10,-170,821,845,1666,3619
-60,0,40,818,848,1666,3537
60,50,-110,794,873,1667,3572
-70,-10,0,811,856,1667,3718
120,-60,20,811,856,1667,3899
110,50,-150,813,854,1667,3611
-70,-20,-30,822,845,1667,3669
140,80,90,821,847,1668,3741
90,40,-150,812,856,1668,3740
-20,20,-10,826,843,1669,3537
-100,40,-110,811,858,1669,3715
0,-60,-40,823,846,1669,3616
-130,-20,30,824,846,1670,3748
140,-70,80,816,854,1670,3666
-130,30,-20,825,845,1670,3617
-80,-30,120,817,853,1670,3826
-80,50,-80,820,850,1670,3698
0,-50,-40,837,833,1670,3592
-70,40,-150,825,845,1670,3663
-80,10,110,826,844,1670,3747
0,-10,-130,807,863,1670,3576
-90,10,140,816,854,1670,3645
-80,60,-70,820,851,1671,3756
-110,-30,70,813,858,1671,3700
-110,-60,-110,808,863,1671,3700
-90,40,-90,823,849,1672,3673
-180,20,70,832,840,1672,3894
-120,-10,0,812,860,1672,3751
130,-60,30,802,870,1672,3796
180,20,70,832,840,1672,3894
-30,80,20,812,861,1673,3528
170,-50,50,816,857,1673,3817
-160,40,170,821,852,1673,3508
30,-10,-80,821,852,1673,3659
100,-60,0,816,857,1673,3858
40,30,-110,802,871,1673,3611
-70,-70,160,811,862,1673,3748
-160,-90,170,811,863,1674,3536
100,-90,70,811,863,1674,3536
-80,10,170,836,838,1674,3796
70,-90,40,811,863,1674,3536
-100,-90,-130,811,863,1674,3536
140,-90,110,811,863,1674,3536
-140,-70,-150,803,871,1674,3773
-80,-90,-110,811,863,1674,3536
-20,50,-130,823,851,1674,3643
150,-90,120,811,863,1674,3536
130,-90,100,811,863,1674,3536
0,-90,-30,811,863,1674,3536
-60,-90,-90,811,863,1674,3536
-50,-90,-80,811,863,1674,3536
60,-90,30,811,863,1674,3536
80,-90,50,811,863,1674,3536
90,-90,60,811,863,1674,3536
-170,-90,160,811,863,1674,3536
20,-90,-10,811,863,1674,3536
-140,10,10,817,857,1674,3791
-70,-90,-100,811,863,1674,3536
30,-90,0,811,863,1674,3536
-30,-90,-60,811,863,1674,3536
-140,-90,-170,811,863,1674,3536
160,-90,130,811,863,1674,3536
-10,-90,-40,811,863,1674,3536
10,-90,-20,811,863,1674,3536
-130,-90,-160,811,863,1674,3536
120,-90,90,811,863,1674,3536
-120,-90,-150,811,863,1674,3536
-20,-90,-50,811,863,1674,3536
50,-90,20,811,863,1674,3536
-120,0,-90,803,871,1674,3687
170,-90,140,811,863,1674,3536
40,-90,10,811,863,1674,3536
-150,-90,-180,811,863,1674,3536
-90,-90,-120,811,863,1674,3536
-110,-90,-140,811,863,1674,3536
-120,20,-100,819,855,1674,3671
-100,40,-90,825,849,1674,3805
30,-70,-20,824,850,1674,3611
-180,-90,150,811,863,1674,3536
180,-90,150,811,863,1674,3536
110,-90,80,811,863,1674,3536
-150,-90,180,811,863,1674,3536
-40,-90,-70,811,863,1674,3536
160,-50,130,815,860,1675,3627
150,10,120,819,856,1675,3478
-70,-40,-60,805,870,1675,3679
160,-30,140,792,883,1675,3519
-90,-40,120,829,847,1676,3710
160,60,80,811,865,1676,3721
120,-80,0,818,858,1676,3781
-10,50,0,800,876,1676,3698
-120,10,-100,804,872,1676,3732
-110,-20,-70,821,856,1677,3793
130,50,-160,817,860,1677,3660
-110,-30,-80,817,860,1677,3827
-150,0,40,829,848,1677,3750
-140,-40,70,811,866,1677,3756
-20,10,-20,843,834,1677,3627
80,-80,-40,823,854,1677,3670
-60,20,-170,848,830,1678,3603
-140,60,10,830,848,1678,3781
-50,0,-20,839,840,1679,3733
-100,70,-40,826,853,1679,3780
-150,-50,70,842,837,1679,3663
-140,0,20,845,834,1679,3811
-80,0,100,841,839,1680,3691
30,10,-80,821,859,1680,3592
-40,80,-100,836,844,1680,3703
100,-80,-20,826,854,1680,3684
170,-20,90,810,870,1680,3689
-110,20,-70,824,856,1680,3675
170,30,80,817,863,1680,3530
170,80,60,843,837,1680,3820
130,-60,40,804,876,1680,3787
-80,-30,140,835,846,1681,3805
-90,20,120,831,850,1681,3662
10,-10,-40,822,859,1681,3610
-120,-20,10,833,848,1681,3830
-100,-30,80,838,843,1681,3684
-100,40,-100,836,845,1681,3836
90,60,150,828,853,1681,3762
90,50,-140,830,851,1681,3620
40,40,-90,807,874,1681,3593
30,0,-80,825,856,1681,3663
-60,-30,-40,855,826,1681,3656
-170,-20,60,825,856,1681,3893
-150,20,-160,810,871,1681,3738
-100,-20,-40,830,852,1682,3692
-70,30,-170,841,841,1682,3663
100,-70,30,790,892,1682,3740
150,-80,120,831,851,1682,3616
-110,0,-50,821,861,1682,3578
-90,40,-150,823,859,1682,3760
90,-80,-30,823,859,1682,3709
-20,-10,-30,813,869,1682,3619
100,40,-160,824,858,1682,3861
-100,40,-150,813,870,1683,3909
0,10,-30,827,856,1683,3589
-110,10,-50,823,860,1683,3636
-150,60,150,803,881,1684,3586
160,-50,90,819,865,1684,3730
130,-80,10,816,868,1684,3799
160,80,70,835,849,1684,3825
160,0,-180,832,852,1684,3808
130,80,100,831,853,1684,3781
-30,0,-150,838,846,1684,3705
0,40,-10,800,884,1684,3738
160,0,180,832,852,1684,3808
50,-60,-20,814,870,1684,3814
-70,80,-70,827,857,1684,3633
-120,20,-120,836,849,1685,3807
0,-30,-120,831,854,1685,3601
-80,-30,130,819,866,1685,3700
-10,0,-140,842,843,1685,3742
-70,-60,160,842,843,1685,3756
0,50,-140,828,858,1686,3653
170,50,180,828,858,1686,3539
-10,-40,-40,834,852,1686,3572
170,50,-180,828,858,1686,3539
-80,0,140,825,861,1686,3810
10,-30,-40,809,877,1686,3628
30,-20,-40,809,877,1686,3649
-130,-50,-120,809,877,1686,3685
-100,-20,10,813,874,1687,3871
-50,-80,-70,831,856,1687,3577
-80,0,110,838,849,1687,3571
-130,-20,50,826,861,1687,3730
-30,20,10,835,852,1687,3783
-120,30,-180,830,858,1688,3687
-120,30,180,830,858,1688,3687
-10,70,0,819,869,1688,3504
-30,-40,-40,836,852,1688,3824
170,-40,80,823,865,1688,3783
-60,50,70,819,869,1688,3642
-120,40,-30,807,881,1688,3740
-150,-30,-140,853,835,1688,3708
50,60,-80,820,868,1688,3618
-110,30,-110,823,866,1689,3812
20,10,-130,829,860,1689,3801
-120,-60,-120,831,858,1689,3547
-100,-40,-70,820,869,1689,3898
170,-40,60,819,870,1689,3867
40,-20,-60,808,881,1689,3825
-70,40,-140,827,862,1689,3665
-150,-10,50,831,858,1689,3800
-180,-80,160,799,891,1690,3806
40,40,-100,802,888,1690,3504
180,-80,160,799,891,1690,3806
-70,10,90,844,846,1690,3759
140,20,130,814,876,1690,3783
180,30,70,842,849,1691,3999
-100,-20,50,839,852,1691,3823
20,20,-140,825,866,1691,3732
-180,30,70,842,849,1691,3999
70,-70,0,791,900,1691,3732
120,80,110,836,855,1691,3734
-80,-20,120,822,869,1691,3769
180,-40,-180,822,870,1692,3677
-180,-40,-180,822,870,1692,3677
180,-40,180,822,870,1692,3677
160,20,100,814,878,1692,3741
-180,-40,180,822,870,1692,3677
-90,-20,20,822,870,1692,3732
-140,50,150,828,865,1693,3768
10,-80,-30,839,854,1693,3684
-130,10,-20,820,873,1693,3833
-150,30,-170,801,892,1693,3674
-110,-30,-90,826,867,1693,3706
160,-20,100,824,869,1693,3636
-180,0,80,812,881,1693,3541
110,-70,40,806,887,1693,3882
180,0,80,812,881,1693,3541
30,20,-80,830,863,1693,3659
-70,-20,-20,834,859,1693,3760
-110,30,-90,825,869,1694,3640
0,10,-140,836,858,1694,3748
110,80,120,835,859,1694,3725
-110,-10,-70,822,873,1695,3745
-40,60,40,830,865,1695,3506
-70,-10,-10,828,867,1695,3863
160,-50,50,806,890,1696,3886
-50,80,-90,840,856,1696,3701
-10,30,-140,840,856,1696,3711
30,-10,-40,808,888,1696,3705
-100,70,100,849,847,1696,3552
70,-80,-50,827,869,1696,3672
0,-40,-40,837,860,1697,3659
90,-80,40,829,868,1697,3639
-140,-60,-140,822,875,1697,3648
140,-80,20,822,876,1698,3831
40,50,-70,825,873,1698,3594
170,-40,70,829,869,1698,3816
90,40,170,841,857,1698,3652
-90,20,-180,848,850,1698,3813
-90,-20,-30,845,853,1698,3763
-90,20,180,848,850,1698,3813
40,-30,-40,826,872,1698,3693
0,-10,-40,836,862,1698,3646
90,70,-120,819,880,1699,3535
100,80,130,847,852,1699,3781
-150,30,30,834,865,1699,3892
160,-40,100,824,875,1699,3575
70,-80,20,830,869,1699,3598
-120,10,-120,862,837,1699,3616
150,30,110,816,883,1699,3555
-70,20,-170,859,841,1700,3536
-60,80,-80,843,857,1700,3692
-10,-50,-130,832,868,1700,3635
-30,0,-20,825,875,1700,3850
150,70,-170,823,877,1700,3580
50,70,180,838,863,1701,3788
-10,-60,-130,830,871,1701,3639
-170,-10,60,838,863,1701,3753
70,60,-110,808,893,1701,3590
-50,0,20,842,859,1701,3735
50,70,-180,838,863,1701,3788
-170,-50,-170,806,895,1701,3682
-110,30,-130,833,868,1701,3957
160,40,90,835,867,1702,3760
-60,-10,-20,846,856,1702,3922
-30,-80,-60,819,883,1702,3613
80,-80,30,829,873,1702,3617
-10,20,-20,825,877,1702,3706
150,0,170,835,868,1703,3742
-80,-20,-30,828,875,1703,3872
150,60,-170,829,875,1704,3612
-130,0,0,827,877,1704,3754
-70,-40,160,846,858,1704,3731
180,80,50,852,852,1704,3867
-180,80,50,852,852,1704,3867
-70,-70,-80,835,869,1704,3719
-170,80,160,815,890,1705,3596
170,10,90,828,877,1705,3669
180,-50,170,816,889,1705,3668
-110,30,-180,830,875,1705,3708
-50,-60,-60,818,887,1705,3718
-110,30,180,830,875,1705,3708
-160,70,30,827,878,1705,3795
-180,-50,170,816,889,1705,3668
0,60,-10,812,893,1705,3615
-90,-30,-50,837,869,1706,3747
-100,-20,-50,842,864,1706,3851
110,-70,0,821,886,1707,3724
-180,40,60,835,872,1707,3870
160,-40,110,847,860,1707,3618
180,40,60,835,872,1707,3870
-130,-60,-130,833,875,1708,3599
-150,-30,60,812,896,1708,3881
50,-40,-50,800,908,1708,3797
-100,30,-160,839,869,1708,3763
-20,-70,-50,838,870,1708,3709
-70,-30,-40,833,875,1708,3752
140,-60,40,817,891,1708,3843
-40,-10,-160,861,847,1708,3673
-90,40,-140,848,860,1708,3949
-70,-50,-70,833,876,1709,3683
-110,30,-120,826,883,1709,3903
-60,10,50,832,877,1709,3564
-80,-40,-60,824,885,1709,3892
-180,-70,160,808,901,1709,3813
180,-70,160,808,901,1709,3813
90,80,140,847,862,1709,3803
10,-70,-110,821,888,1709,3703
-110,0,-60,840,869,1709,3714
-10,40,0,818,892,1710,3828
160,-30,100,826,884,1710,3634
50,50,-100,828,882,1710,3675
170,0,90,847,863,1710,3822
20,-10,-40,833,878,1711,3843
80,60,-120,815,896,1711,3571
130,20,170,838,873,1711,3879
130,20,160,820,891,1711,3747
-40,30,40,812,899,1711,3740
-120,-20,20,837,874,1711,3866
-10,70,-130,856,855,1711,3666
-40,80,30,830,881,1711,3595
-100,-10,-30,841,870,1711,3827
10,-40,-40,822,890,1712,3582
-170,40,50,841,871,1712,3831
-120,-30,70,836,876,1712,3792
130,30,-180,820,894,1714,3957
60,-80,-60,840,874,1714,3697
-10,30,-10,823,891,1714,3720
-110,-20,10,838,876,1714,4029
130,30,180,820,894,1714,3957
-50,50,-110,863,852,1715,3823
170,50,70,846,870,1716,3861
180,60,170,844,872,1716,3579
160,-40,120,845,871,1716,3655
160,-30,110,834,882,1716,3616
-80,-10,90,844,872,1716,3701
-120,10,-30,848,868,1716,3849
-100,-20,70,831,885,1716,3709
-180,60,170,844,872,1716,3579
-40,10,10,822,894,1716,3758
40,-20,-50,819,898,1717,3690
-70,-30,160,851,866,1717,3879
-60,0,-10,862,855,1717,3879
-130,10,-10,847,870,1717,3858
150,-80,110,855,862,1717,3646
-130,20,-20,839,878,1717,3674
-110,-10,-10,824,893,1717,3783
160,0,110,815,902,1717,3693
-120,20,-150,829,888,1717,3635
-130,-70,-140,825,892,1717,3878
-90,10,150,857,860,1717,3810
90,40,-170,811,907,1718,3802
80,80,-100,816,902,1718,3784
100,-70,-10,821,897,1718,3747
-100,30,-70,852,866,1718,3659
-20,-30,-40,832,887,1719,3719
-130,-10,10,833,886,1719,3797
30,20,-100,838,881,1719,3804
-70,-10,10,838,881,1719,3889
20,0,-100,844,875,1719,3713
-80,30,100,839,880,1719,3653
60,80,-80,832,888,1720,3880
80,40,-170,816,904,1720,3848
40,30,-140,819,901,1720,3876
30,-60,-30,816,904,1720,3859
-50,-30,-40,880,840,1720,3851
-110,40,-40,847,873,1720,3920
170,-60,150,812,908,1720,3789
-70,40,-110,854,866,1720,3745
-90,40,-70,862,859,1721,3842
-80,0,120,849,872,1721,3880
160,-70,130,851,870,1721,3826
-20,30,-140,833,888,1721,3748
-120,-50,-110,825,896,1721,3727
-110,30,150,840,882,1722,3772
-70,0,80,843,879,1722,3811
120,-70,50,829,893,1722,3953
-60,40,70,847,875,1722,3823
170,-30,170,829,894,1723,3770
-80,0,160,859,864,1723,3753
-170,0,60,854,869,1723,3808
-90,10,130,852,871,1723,3743
100,80,-120,828,895,1723,3827
-80,-10,-10,862,861,1723,3836
-70,40,-120,849,874,1723,3809
-140,-10,40,850,873,1723,3914
140,10,140,832,891,1723,3893
30,70,-50,841,883,1724,3666
160,-30,120,851,873,1724,3675
-10,60,0,817,907,1724,3747
-110,30,-140,854,870,1724,4018
-90,-20,-40,840,884,1724,3877
110,80,-130,835,889,1724,3877
-80,40,-150,826,898,1724,3839
-110,20,-80,849,875,1724,3765
-80,0,130,839,885,1724,3889
140,10,170,842,882,1724,3887
60,-80,10,843,881,1724,3648
0,-30,-40,830,894,1724,3695
-170,-50,60,841,884,1725,3790
-50,20,-160,857,868,1725,3823
10,20,-30,799,926,1725,3766
140,-70,90,844,881,1725,3792
160,-10,110,821,904,1725,3710
80,60,160,823,902,1725,3872
-70,10,180,845,881,1726,3801
-70,10,-180,845,881,1726,3801
110,50,140,832,894,1726,3758
-80,-70,-90,840,886,1726,3924
-120,30,-170,836,891,1727,3736
10,20,-140,838,889,1727,3727
100,-80,50,830,897,1727,3713
80,-60,-10,840,887,1727,3893
120,40,180,826,901,1727,3837
70,80,-90,819,908,1727,3783
-60,30,-160,851,876,1727,3816
-10,-30,-40,855,872,1727,3648
120,40,-180,826,901,1727,3837
-90,70,90,859,869,1728,3674
-70,70,70,854,874,1728,3658
80,70,-110,827,901,1728,3621
-100,-10,-20,861,867,1728,3852
40,50,-80,838,890,1728,3585
-160,0,50,843,885,1728,3925
30,-20,-80,840,889,1729,3831
180,0,-170,826,903,1729,3783
70,50,180,844,885,1729,3911
-60,0,-180,848,881,1729,3926
-180,0,-170,826,903,1729,3783
70,50,-180,844,885,1729,3911
-70,40,-130,848,881,1729,3825
-60,0,180,848,881,1729,3926
-90,70,-50,855,874,1729,3997
150,-60,70,834,895,1729,3855
20,-30,-40,838,891,1729,3852
170,20,90,805,925,1730,3523
160,-30,150,845,885,1730,3882
50,-70,-10,851,880,1731,3854
170,-40,90,840,891,1731,3776
170,-10,90,851,880,1731,3786
70,80,160,863,868,1731,3876
-170,-80,170,829,902,1731,3901
20,10,-40,815,916,1731,3698
-40,20,30,823,908,1731,3878
-80,40,-140,853,878,1731,3870
-30,40,-130,857,875,1732,3827
-80,40,-130,847,885,1732,3814
50,-80,-70,848,884,1732,3706
-90,40,-120,849,883,1732,3816
-110,30,-100,849,883,1732,3842
-100,20,140,853,879,1732,3853
-120,-10,-100,855,877,1732,3845
70,40,-160,825,907,1732,3925
-90,50,-60,850,883,1733,3862
0,-70,-40,848,885,1733,3758
150,-60,40,847,886,1733,4061
-10,-20,-40,865,868,1733,3808
30,-30,-40,832,901,1733,3747
-20,-60,-140,853,880,1733,3828
-170,80,40,865,869,1734,3878
-50,-10,-170,873,861,1734,3723
-100,40,-50,850,884,1734,3910
150,-80,30,833,901,1734,3875
160,-50,70,830,904,1734,3927
-130,50,0,844,890,1734,3878
-90,-20,40,860,874,1734,3979
0,40,-140,843,891,1734,3780
0,-20,-40,848,886,1734,3721
-90,40,-130,847,887,1734,3856
100,70,-130,840,894,1734,3577
110,-80,60,837,898,1735,3767
40,40,-150,838,897,1735,3844
-10,-30,-130,857,878,1735,3701
90,60,-130,836,899,1735,3631
-110,10,-40,841,894,1735,3731
90,80,-110,831,904,1735,3827
-150,-70,80,846,890,1736,3792
150,-10,140,861,875,1736,3823
160,10,110,838,898,1736,3663
-100,0,-40,862,874,1736,3739
160,-80,130,854,883,1737,3809
-130,30,180,852,885,1737,3719
-130,30,-180,852,885,1737,3719
-130,-20,-120,832,905,1737,3803
-50,-40,-50,857,880,1737,3755
-80,-20,140,852,885,1737,3886
-80,-10,150,862,875,1737,3873
50,-80,0,859,879,1738,3706
160,-50,120,846,892,1738,3828
-50,-20,-170,887,851,1738,3684
-160,-60,-170,827,911,1738,3752
170,-30,90,837,901,1738,3716
-140,10,20,863,876,1739,4019
-110,-10,0,855,884,1739,3975
170,-50,150,826,913,1739,3694
-40,10,-10,856,883,1739,3909
0,-70,-120,840,900,1740,3860
100,40,-170,837,903,1740,3830
60,-70,-10,821,919,1740,3867
-110,10,-60,839,901,1740,3707
-20,-40,-140,870,871,1741,3644
-90,30,-160,858,883,1741,3854
20,-20,-40,835,906,1741,3830
-120,-70,-130,832,909,1741,3963
-170,-30,60,865,876,1741,4021
-110,-70,-120,838,903,1741,3975
-60,-80,-80,854,887,1741,3718
-60,30,70,840,902,1742,3834
160,-50,60,865,877,1742,3916
150,-10,160,839,903,1742,4047
30,20,-90,839,904,1743,3654
120,30,170,834,909,1743,3938
-110,-20,-80,831,912,1743,3918
50,50,-110,844,899,1743,3540
-100,-50,120,861,882,1743,3921
-140,0,30,873,870,1743,3889
-100,20,150,858,886,1744,3805
-90,-20,30,854,890,1744,3956
-140,30,20,866,878,1744,3940
80,80,150,871,873,1744,3879
-100,-10,-40,867,877,1744,3850
-70,50,-90,855,889,1744,3823
120,80,-140,838,906,1744,3934
60,60,-100,829,916,1745,3619
0,20,-140,862,883,1745,3820
-60,0,0,859,886,1745,3794
30,-30,-80,837,908,1745,3941
-100,60,-40,847,898,1745,3990
-50,40,-120,859,886,1745,3864
-80,-10,40,860,885,1745,4007
100,60,-140,841,904,1745,3717
-90,-10,-30,850,896,1746,3862
-80,-50,-70,836,910,1746,3884
-120,0,-100,847,899,1746,3822
-110,20,-90,859,887,1746,3812
-20,70,10,849,898,1747,3651
-90,10,160,884,863,1747,3852
-100,-70,-110,847,900,1747,3995
80,40,-160,836,912,1748,3960
-130,60,0,865,884,1749,3970
-20,0,-30,857,892,1749,3666
160,-20,110,839,910,1749,3637
-130,50,140,870,879,1749,3790
-140,60,140,852,898,1750,3799
-120,20,-110,844,906,1750,3895
-90,-60,-90,842,908,1750,3887
160,-40,130,860,890,1750,3811
20,0,-90,854,896,1750,3815
-130,40,0,867,884,1751,3907
40,80,-60,855,896,1751,3892
-110,50,-30,859,892,1751,3886
-100,-20,20,857,894,1751,4017
-50,80,40,853,898,1751,3712
20,-70,-30,868,883,1751,3826
20,60,-40,857,894,1751,3748
150,-10,150,837,914,1751,3807
30,10,-50,853,898,1751,3743
-110,10,-70,854,897,1751,3838
-150,70,20,845,907,1752,3900
-40,-20,-160,866,886,1752,3897
-90,-30,100,857,895,1752,3902
-80,-10,0,872,880,1752,4014
-120,0,-20,850,903,1753,4032
-70,-10,20,846,907,1753,3893
-90,-10,-20,866,888,1754,3869
-140,20,20,867,887,1754,4020
160,-20,120,854,900,1754,3624
-90,-40,-60,858,896,1754,3996
160,-10,170,860,894,1754,3871
20,0,-40,827,928,1755,3792
-90,-40,130,872,883,1755,3922
120,40,-170,848,907,1755,4067
-140,40,20,879,876,1755,4049
150,20,-180,843,913,1756,3993
-40,10,20,847,909,1756,3846
140,10,160,849,907,1756,3867
-120,30,-30,862,894,1756,3804
-40,-70,-60,853,903,1756,3630
-30,30,10,864,892,1756,3820
-110,30,140,870,886,1756,3824
150,20,180,843,913,1756,3993
160,-50,110,866,890,1756,3702
-160,80,150,839,917,1756,3674
50,80,-70,856,901,1757,3952
-50,10,-10,851,906,1757,3926
-80,-60,150,877,880,1757,3954
140,50,110,875,882,1757,4114
110,40,-170,856,902,1758,3955
-60,20,60,858,900,1758,3947
130,40,-170,860,898,1758,3916
-80,20,-170,874,884,1758,3904
160,-30,130,848,910,1758,3833
90,-70,-20,849,909,1758,3775
0,-80,-40,872,886,1758,3834
-90,40,-100,873,885,1758,4068
-30,-60,-50,876,882,1758,3881
-70,-10,-20,867,892,1759,4039
-80,-10,-20,883,876,1759,3969
-80,70,80,884,875,1759,3727
-80,40,-100,876,883,1759,3875
-140,40,160,864,895,1759,3671
20,-40,-40,844,915,1759,3926
-100,-10,0,858,902,1760,3946
-80,-20,150,849,911,1760,3974
-120,-20,50,862,898,1760,3869
-100,-20,60,854,906,1760,3852
-40,-50,-50,873,887,1760,3730
-100,-10,-10,864,897,1761,4034
130,-70,60,848,913,1761,3994
120,-70,10,850,911,1761,3832
-70,0,60,853,908,1761,3862
-110,0,-70,855,906,1761,3923
70,70,-100,846,915,1761,3687
-90,-10,-10,870,892,1762,3886
120,-70,40,842,920,1762,3837
120,30,150,863,899,1762,3832
100,40,160,869,893,1762,3973
-80,-10,120,873,889,1762,3879
60,-60,-50,840,923,1763,3914
170,-40,150,850,913,1763,3766
-170,-70,170,847,916,1763,3942
-100,-30,-60,859,904,1763,4043
110,-70,30,833,930,1763,3830
130,20,150,866,897,1763,3944
-100,-40,-80,871,893,1764,3819
30,-40,-80,856,908,1764,3990
160,-10,130,850,914,1764,3859
130,80,-150,851,913,1764,3975
-130,-10,20,857,907,1764,4043
100,50,150,831,933,1764,3896
-170,10,60,871,893,1764,3932
20,-10,-90,867,898,1765,3779
-70,50,80,860,905,1765,3789
-80,-10,130,873,892,1765,3943
-110,-20,40,869,896,1765,3991
0,30,-140,876,889,1765,3816
60,-60,-20,839,926,1765,3898
50,-40,-40,859,906,1765,3969
150,-70,90,872,894,1766,3897
-100,20,-60,865,901,1766,3791
180,-30,70,866,900,1766,3951
-180,-30,70,866,900,1766,3951
-90,-70,-100,862,904,1766,3970
-30,-30,-150,896,871,1767,3921
170,-40,160,844,923,1767,3885
180,-30,80,874,893,1767,3836
20,-20,-90,864,903,1767,3867
-50,10,0,871,896,1767,3896
-180,-30,80,874,893,1767,3836
-120,-20,40,869,898,1767,3947
-110,-10,-80,860,907,1767,3847
-110,-20,30,873,895,1768,3938
60,-50,-40,857,911,1768,3944
160,-50,100,864,904,1768,3755
-150,0,-150,850,918,1768,3861
-160,-50,-160,844,924,1768,3790
110,70,-140,851,918,1769,3767
110,40,150,848,921,1769,4057
160,-80,40,857,912,1769,3906
40,-80,-10,866,904,1770,3741
170,-10,-180,879,891,1770,3862
100,40,-180,863,907,1770,3927
160,70,-180,863,907,1770,3720
-100,-20,40,863,907,1770,4006
100,40,180,863,907,1770,3927
90,40,-160,857,913,1770,3948
30,20,-50,854,916,1770,3840
-30,20,-10,877,893,1770,4074
-120,0,-10,874,896,1770,4048
80,50,170,871,899,1770,3938
170,-10,180,879,891,1770,3862
-140,70,10,866,904,1770,4042
140,-70,70,869,901,1770,3976
160,70,180,863,907,1770,3720
30,40,-60,849,922,1771,3703
-160,80,30,888,884,1772,3898
60,50,-170,872,900,1772,3970
-120,50,130,879,893,1772,3869
160,-10,120,851,921,1772,3724
-160,-80,180,850,924,1774,3994
-90,40,-110,871,903,1774,4017
-160,-80,-180,850,924,1774,3994
50,60,-90,862,912,1774,3640
-80,-50,150,888,886,1774,3999
90,40,-180,848,927,1775,4086
-110,-20,50,864,911,1775,3946
-140,-70,90,874,901,1775,3960
170,-60,50,862,913,1775,4013
90,40,180,848,927,1775,4086
-60,-40,-60,874,901,1775,3744
-100,10,-50,861,914,1775,3861
-30,-40,-150,895,880,1775,3727
180,-60,160,851,925,1776,3899
-120,-20,30,865,911,1776,4081
-120,10,-110,873,903,1776,3937
160,0,120,853,923,1776,3784
-110,-20,20,879,897,1776,3952
10,-10,-110,876,900,1776,3835
-80,-10,140,879,897,1776,4054
-60,-30,-50,882,894,1776,3786
-180,-60,160,851,925,1776,3899
-20,40,10,854,923,1777,3965
-80,-30,-50,846,931,1777,4056
-170,20,60,876,901,1777,4028
10,-60,-40,878,899,1777,3954
10,-50,-40,860,917,1777,3848
80,40,-150,851,926,1777,4057
20,20,-40,839,938,1777,3896
140,40,120,859,918,1777,3860
-60,0,30,850,927,1777,3754
-160,50,160,863,914,1777,3619
160,-60,90,869,908,1777,3905
-160,-30,60,867,910,1777,3943
-180,10,80,880,897,1777,3879
110,-80,50,865,912,1777,3881
160,-20,130,858,919,1777,3897
180,10,80,880,897,1777,3879
120,-80,70,864,914,1778,3854
-10,10,-30,874,904,1778,3758
-100,30,-80,866,912,1778,3863
-80,40,-120,876,902,1778,3925
100,-70,20,850,928,1778,3905
-90,-10,0,866,913,1779,3928
-80,-10,80,871,908,1779,3834
-60,80,50,867,912,1779,3796
120,50,-160,860,919,1779,3976
-40,-10,-30,867,912,1779,3939
40,70,-170,868,912,1780,4001
-100,0,-30,879,902,1781,3879
-100,-10,-50,877,904,1781,3916
-20,-30,-140,891,890,1781,3790
-140,-10,50,855,926,1781,4166
70,50,-130,890,891,1781,3966
20,-50,-40,862,919,1781,3985
-110,20,-130,880,902,1782,4004
0,30,-20,840,942,1782,3906
-100,20,160,879,903,1782,3984
-80,-10,60,865,917,1782,4004
-70,-30,-50,873,909,1782,3857
-110,30,-40,861,922,1783,3899
-130,40,10,893,890,1783,4073
-170,50,50,883,900,1783,4051
-70,30,-160,901,882,1783,3951
160,-70,120,861,922,1783,3789
-80,-70,150,861,922,1783,3978
-110,-30,80,873,910,1783,3866
140,10,150,869,914,1783,4005
70,60,170,856,927,1783,3964
-60,-60,-70,871,913,1784,3870
60,80,170,888,896,1784,3962
-80,30,-160,895,889,1784,4051
170,40,80,863,921,1784,3839
-130,20,-10,852,932,1784,3946
-70,-80,-90,875,910,1785,3876
-80,-10,70,881,904,1785,3980
140,-60,50,863,922,1785,4074
-100,-60,-100,861,924,1785,3979
150,10,130,869,917,1786,4014
30,30,-90,854,932,1786,3869
-20,-60,-50,887,899,1786,3796
-100,40,120,865,921,1786,3820
-180,50,60,877,910,1787,4086
-130,-30,-120,858,929,1787,3904
-70,60,-80,867,920,1787,4072
180,50,60,877,910,1787,4086
-150,80,140,850,937,1787,3802
40,-50,-70,854,933,1787,4054
-100,-40,110,891,896,1787,3910
-80,40,-110,888,899,1787,3945
-130,70,0,890,897,1787,4057
160,-20,160,857,930,1787,3879
-40,50,40,890,897,1787,3912
-70,-10,170,894,893,1787,3896
-40,60,-110,888,900,1788,3934
-40,-80,-70,864,924,1788,3771
-80,20,100,873,915,1788,3940
130,60,-160,858,930,1788,3819
-60,50,-100,887,901,1788,3847
110,40,180,862,927,1789,4025
-40,-30,-160,900,889,1789,3899
170,-70,50,862,927,1789,3882
70,-60,-20,862,927,1789,4029
-160,-70,180,865,924,1789,3955
-40,-40,-160,906,883,1789,3691
120,-80,60,871,918,1789,3872
-20,-50,-140,901,888,1789,3810
110,40,-180,862,927,1789,4025
-160,-70,-180,865,924,1789,3955
-30,-50,-50,888,902,1790,3993
-130,0,10,869,921,1790,4058
30,-80,-90,871,919,1790,3815
-130,30,-10,873,917,1790,4035
-80,40,-90,884,906,1790,3880
170,60,70,881,910,1791,3927
130,40,-180,847,944,1791,3912
20,70,-40,883,908,1791,3700
-70,0,70,866,925,1791,3898
-10,-70,-130,873,918,1791,3920
-100,20,-50,875,916,1791,3938
130,40,180,847,944,1791,3912
40,-80,-80,871,921,1792,3806
-110,-20,60,868,924,1792,3937
-100,30,-60,878,915,1793,3757
50,40,-150,860,933,1793,4022
110,60,-150,860,933,1793,3833
-160,40,40,886,907,1793,3990
-110,0,-80,886,907,1793,3901
30,80,-50,861,932,1793,3975
-80,10,100,894,900,1794,4029
-170,30,-180,866,928,1794,3969
-70,80,60,870,924,1794,3835
-140,-50,80,884,910,1794,4089
-170,30,180,866,928,1794,3969
180,-40,60,881,914,1795,4208
-100,0,-50,897,898,1795,3888
-170,-40,-170,875,920,1795,3864
-180,-40,60,881,914,1795,4208
-150,-80,-170,868,927,1795,4075
130,30,170,870,926,1796,4141
30,50,-60,879,917,1796,3858
100,-80,40,881,915,1796,3902
170,-60,140,886,910,1796,3855
30,20,-110,868,929,1797,3915
60,40,-150,853,944,1797,4017
30,20,-130,877,920,1797,4131
50,30,-130,869,928,1797,4125
-10,60,-130,907,890,1797,3972
-140,-40,-130,862,935,1797,3943
160,-20,140,863,935,1798,3928
-170,70,160,849,949,1798,3746
10,30,-140,879,919,1798,3828
-30,10,-20,879,919,1798,3940
70,-60,-30,862,936,1798,4012
150,20,120,882,916,1798,3846
90,-70,10,852,946,1798,4007
-110,10,-80,881,917,1798,3941
-80,-20,130,886,913,1799,4154
140,30,180,857,942,1799,4037
50,-70,-20,850,949,1799,3950
170,40,-180,875,924,1799,4016
140,30,-180,857,942,1799,4037
170,40,180,875,924,1799,4016
-160,-20,60,871,928,1799,4016
160,70,80,878,921,1799,4059
170,30,90,868,931,1799,3881
-100,50,-40,878,921,1799,4134
-80,50,90,880,919,1799,3761
40,40,-110,873,927,1800,3851
-10,20,-140,884,916,1800,4079
-60,30,-150,879,921,1800,4015
-180,30,-180,874,926,1800,4093
-180,30,180,874,926,1800,4093
-150,40,30,901,899,1800,4116
160,60,-180,881,919,1800,3885
-80,-30,150,892,908,1800,4055
160,60,180,881,919,1800,3885
-60,0,-20,898,902,1800,4248
180,30,180,874,926,1800,4093
-140,10,-150,861,939,1800,3989
-130,-30,70,890,910,1800,3959
40,60,-70,874,926,1800,3894
180,30,-180,874,926,1800,4093
-90,-30,110,882,918,1800,4150
70,40,-150,883,917,1800,3837
-30,70,20,875,925,1800,3756
-90,-20,90,881,920,1801,3919
90,-80,30,878,923,1801,3970
130,-70,50,856,945,1801,3963
160,-80,120,880,921,1801,3877
100,50,-150,882,919,1801,3955
-70,0,50,888,914,1802,4087
-30,30,20,878,924,1802,3811
30,0,-50,876,926,1802,3941
170,-70,140,870,933,1803,3965
-100,-10,10,890,913,1803,4042
140,80,-160,861,942,1803,4054
170,-80,140,888,915,1803,4080
130,-80,70,881,923,1804,3902
-100,-30,90,906,898,1804,4056
-160,0,-160,870,934,1804,3856
-80,-10,160,884,920,1804,3951
-10,10,-140,894,911,1805,4017
-110,-50,-100,858,947,1805,4074
30,-40,-40,856,949,1805,3925
-80,-80,-100,878,927,1805,4008
-50,-30,-170,903,902,1805,3949
30,30,-140,871,934,1805,4006
80,-70,-30,876,929,1805,3956
20,-80,-100,878,927,1805,3901
-110,-10,10,873,933,1806,4098
90,50,160,889,917,1806,3883
-170,-40,60,897,909,1806,4148
-170,0,70,881,925,1806,4055
-60,-10,180,894,912,1806,4044
-60,-10,-180,894,912,1806,4044
-120,40,-20,870,936,1806,4127
-60,30,-140,896,910,1806,3991
-30,-10,-150,894,912,1806,4135
-150,10,40,883,924,1807,4250
-100,30,-150,901,906,1807,4081
-130,-10,30,893,915,1808,4111
-130,10,0,883,925,1808,4101
0,-20,-120,905,903,1808,4024
-120,-40,90,892,916,1808,4030
-40,40,40,877,931,1808,4056
120,40,140,890,918,1808,4108
150,50,100,879,929,1808,4017
-160,10,50,884,925,1809,4120
40,-60,-30,865,944,1809,4060
60,50,-120,868,941,1809,3856
160,-60,120,877,932,1809,3929
-130,-20,60,895,914,1809,4020
30,30,-60,868,942,1810,3881
-90,-10,10,881,929,1810,4013
-80,0,170,919,891,1810,3927
-60,-20,-180,905,906,1811,3980
-60,-30,180,914,897,1811,3892
-60,-20,180,905,906,1811,3980
-90,-40,-70,902,909,1811,4101
-180,-30,90,864,947,1811,3916
-60,-30,-180,914,897,1811,3892
-10,-50,-50,908,903,1811,3929
180,-30,90,864,947,1811,3916
20,50,-40,880,931,1811,3934
160,30,100,884,927,1811,3962
-150,-60,-160,865,947,1812,3970
40,-30,-60,865,947,1812,4136
-20,50,10,849,963,1812,3956
20,40,-40,860,952,1812,3912
-100,-20,80,881,931,1812,3930
20,-30,-90,888,924,1812,4138
-90,-80,-110,884,929,1813,4100
60,60,-110,878,935,1813,3791
-80,-20,-40,885,928,1813,4086
40,-40,-40,882,931,1813,3953
150,70,90,902,911,1813,4076
-160,20,50,891,922,1813,4108
-100,20,170,888,926,1814,4105
-110,20,-140,878,936,1814,4012
-100,-20,30,894,920,1814,4095
130,40,130,883,931,1814,4002
-130,60,130,879,936,1815,3944
-70,40,-100,908,907,1815,3969
-110,20,-40,889,926,1815,4003
-50,-10,-30,905,910,1815,4155
-110,-20,-90,874,941,1815,3967
10,0,-40,886,930,1816,3808
-30,-50,-150,909,907,1816,3973
30,-80,-20,890,927,1817,3856
-120,20,-30,893,924,1817,3875
-50,-50,-60,884,933,1817,3854
150,-70,80,884,933,1817,3989
-50,10,30,871,946,1817,4013
-150,80,20,909,908,1817,4017
-130,10,10,896,921,1817,4290
-110,40,130,899,919,1818,3825
-130,-70,100,897,921,1818,4072
-120,0,-110,904,914,1818,3959
-130,-40,80,880,938,1818,4150
140,70,100,908,910,1818,4193
20,30,-40,870,948,1818,3975
-120,0,-120,907,912,1819,3847
0,20,-30,869,950,1819,3907
-80,-10,10,880,939,1819,4044
150,-60,50,869,950,1819,4010
30,30,-80,880,939,1819,3890
-120,30,160,899,920,1819,3992
-70,10,80,890,929,1819,4030
-120,10,-140,881,939,1820,3994
170,20,100,880,940,1820,3909
-130,30,170,910,910,1820,3918
40,60,-80,887,933,1820,3704
-30,-60,-150,882,938,1820,4176
150,40,110,901,919,1820,4018
70,40,-140,877,944,1821,4226
-20,60,10,873,948,1821,3909
-90,0,140,888,933,1821,4010
-110,-40,100,918,903,1821,4213
60,70,-90,864,957,1821,3804
-170,30,60,908,913,1821,4138
10,-70,-40,899,922,1821,4024
-140,-30,-130,890,932,1822,4091
-80,-10,50,889,933,1822,4205
-130,-10,40,904,918,1822,4198
-80,-40,150,899,924,1823,4002
-40,-40,-50,894,929,1823,3931
-60,-10,-30,920,903,1823,4255
-120,-20,60,880,943,1823,4042
-170,-10,70,898,925,1823,4068
40,-70,-20,888,935,1823,4121
-120,10,-20,890,933,1823,4279
-120,-70,110,885,939,1824,4177
170,70,70,891,933,1824,4164
150,0,150,869,955,1824,4146
150,30,-180,873,951,1824,4066
150,30,180,873,951,1824,4066
-110,-50,110,893,932,1825,4098
-100,30,-50,892,933,1825,4076
160,10,-180,870,955,1825,4075
160,10,180,870,955,1825,4075
-120,-10,10,888,937,1825,4263
-80,80,70,880,945,1825,3892
80,50,-140,899,926,1825,4045
40,50,-90,862,963,1825,3953
-30,30,0,892,933,1825,3973
-170,-60,170,890,935,1825,3964
20,30,-140,894,931,1825,3985
160,-60,80,872,953,1825,4099
-80,70,-60,897,929,1826,4165
-130,-40,-120,862,964,1826,4115
-140,-80,-160,888,938,1826,4138
-100,30,-140,895,931,1826,4140
130,70,110,918,909,1827,4252
-160,-60,70,900,927,1827,4016
-30,-30,-40,897,930,1827,3990
-120,50,-10,908,919,1827,4142
-70,-20,-40,915,912,1827,4032
180,20,80,908,919,1827,3952
-180,20,80,908,919,1827,3952
-100,-10,-60,899,928,1827,4170
-160,-10,-160,896,931,1827,3928
-170,10,70,888,939,1827,4048
-100,10,-60,903,925,1828,3944
-60,0,10,914,914,1828,3945
60,60,-180,883,945,1828,4034
-40,10,-150,920,908,1828,3871
70,60,-120,876,952,1828,3859
60,60,180,883,945,1828,4034
-140,-10,-140,881,947,1828,3997
-90,-20,-50,898,930,1828,4159
-160,50,40,889,939,1828,4100
160,-60,110,889,940,1829,3971
-80,-10,20,884,945,1829,4118
-160,30,-180,896,933,1829,4065
-160,30,180,896,933,1829,4065
-160,20,-170,880,949,1829,4051
120,70,120,908,922,1830,4279
-170,-50,180,877,953,1830,3905
-20,30,-10,891,939,1830,3987
-100,-20,-60,899,931,1830,4265
-170,-50,-180,877,953,1830,3905
120,70,-150,879,951,1830,3892
-130,80,120,868,963,1831,3963
20,10,-110,875,956,1831,3874
-180,50,170,909,922,1831,3952
20,60,-150,880,951,1831,4056
180,50,170,909,922,1831,3952
60,40,-130,894,937,1831,4200
150,0,140,896,936,1832,4224
-50,60,50,903,929,1832,3967
80,-80,20,890,942,1832,4054
-180,30,80,890,943,1833,3923
-140,80,130,873,960,1833,3900
-140,80,10,907,926,1833,4081
50,40,-120,887,946,1833,4033
30,0,-70,892,941,1833,4115
-60,-20,-40,921,912,1833,4090
140,-80,80,894,939,1833,3977
180,30,80,890,943,1833,3923
10,-80,-110,901,933,1834,4001
80,-70,0,886,948,1834,4115
50,80,-180,903,931,1834,4120
50,80,180,903,931,1834,4120
120,30,160,897,938,1835,4074
-80,10,-180,918,917,1835,4124
-80,10,180,918,917,1835,4124
130,-70,20,885,950,1835,4019
-90,-70,140,888,947,1835,4187
-150,-50,-150,884,951,1835,4051
-20,-50,-50,905,931,1836,3906
-120,60,-10,899,937,1836,4144
-100,-80,-120,896,940,1836,4167
-20,70,-120,916,920,1836,3924
50,60,-100,884,952,1836,4033
30,30,-100,893,943,1836,4057
-140,10,30,914,922,1836,4208
170,10,100,870,966,1836,4018
-70,0,40,896,940,1836,4073
160,20,110,871,966,1837,3887
170,-50,90,876,961,1837,4100
-90,30,110,897,940,1837,3916
-20,-70,-140,894,943,1837,4063
0,0,-40,886,951,1837,4024
-80,-30,-60,886,952,1838,4109
-80,-10,30,883,955,1838,4106
160,40,180,898,940,1838,4150
160,40,-180,898,940,1838,4150
180,-30,-180,884,954,1838,4082
180,-30,180,884,954,1838,4082
-180,-30,-180,884,954,1838,4082
-90,80,80,890,948,1838,3950
-80,-10,-30,904,934,1838,4178
30,50,-150,899,939,1838,4156
-180,-30,180,884,954,1838,4082
-90,-10,-50,906,932,1838,4098
-10,-70,-50,895,944,1839,4043
-110,10,-30,919,920,1839,4149
-60,60,-90,893,946,1839,4162
-10,-10,-40,901,938,1839,4068
-150,0,50,921,919,1840,4161
170,-80,50,894,946,1840,3948
-20,10,-30,908,932,1840,3855
140,50,-170,879,961,1840,4147
-150,50,30,900,940,1840,4157
-150,-40,70,910,930,1840,3992
-130,20,0,891,949,1840,4217
-130,30,10,916,925,1841,4248
-10,-60,-50,899,942,1841,4097
-120,10,-10,907,934,1841,4165
140,20,170,898,943,1841,4235
-100,10,-40,898,943,1841,4036
10,30,-30,860,981,1841,4139
-20,20,-20,891,951,1842,4069
-150,40,160,903,939,1842,3949
50,50,-160,896,947,1843,4081
-110,20,-150,898,945,1843,3989
170,-50,140,903,940,1843,4020
-170,60,160,906,937,1843,3849
70,70,-110,885,958,1843,3838
-130,40,150,907,937,1844,3876
-90,-10,50,892,952,1844,4134
-120,60,120,911,933,1844,4027
-10,-80,-50,909,935,1844,4023
150,80,-170,882,962,1844,4099
30,10,-70,897,947,1844,4196
130,-80,80,896,948,1844,3961
-110,20,-100,912,933,1845,4132
-90,10,120,886,959,1845,4049
-90,60,-50,891,954,1845,4231
-120,-80,-140,911,934,1845,4215
40,-30,-50,863,982,1845,4091
-80,0,90,909,936,1845,4058
-50,10,-20,917,928,1845,4082
-100,-30,-70,899,946,1845,4248
-20,-20,-40,897,949,1846,3929
-180,40,70,907,939,1846,4045
-90,0,150,915,931,1846,4092
-120,70,-10,905,941,1846,4167
180,40,70,907,939,1846,4045
-120,40,140,907,939,1846,3837
-180,-90,140,921,926,1847,4059
20,-90,-20,921,926,1847,4059
60,-90,20,921,926,1847,4059
-60,-90,-100,921,926,1847,4059
30,-90,-10,921,926,1847,4059
-150,-90,170,921,926,1847,4059
-120,80,110,884,963,1847,3977
70,-90,30,921,926,1847,4059
-90,-90,-130,921,926,1847,4059
0,-90,-40,921,926,1847,4059
-20,-90,-60,921,926,1847,4059
110,-90,70,921,926,1847,4059
20,-40,-90,894,953,1847,4178
140,-90,100,921,926,1847,4059
160,-60,50,888,959,1847,4263
-50,-90,-90,921,926,1847,4059
170,-30,150,901,946,1847,4000
150,-70,100,891,956,1847,4014
50,-90,10,921,926,1847,4059
100,-90,60,921,926,1847,4059
-160,-90,160,921,926,1847,4059
-130,-90,-170,921,926,1847,4059
-140,-90,-180,921,926,1847,4059
120,-90,80,921,926,1847,4059
150,-90,110,921,926,1847,4059
-140,-90,180,921,926,1847,4059
-120,-90,-160,921,926,1847,4059
-70,-90,-110,921,926,1847,4059
170,-90,130,921,926,1847,4059
-80,-90,-120,921,926,1847,4059
160,-90,120,921,926,1847,4059
-170,-90,150,921,926,1847,4059
80,-90,40,921,926,1847,4059
-30,-90,-70,921,926,1847,4059
-40,-90,-80,921,926,1847,4059
-110,-90,-150,921,926,1847,4059
130,-90,90,921,926,1847,4059
40,-90,0,921,926,1847,4059
-10,-90,-50,921,926,1847,4059
90,-90,50,921,926,1847,4059
-100,-90,-140,921,926,1847,4059
10,-90,-30,921,926,1847,4059
180,-90,140,921,926,1847,4059
-40,-30,-40,943,905,1848,4299
-140,30,-180,905,943,1848,4162
-140,30,180,905,943,1848,4162
180,60,60,920,928,1848,4104
-130,-50,90,898,950,1848,4161
-130,-10,50,898,950,1848,4176
50,70,-80,879,969,1848,3971
-40,20,10,905,943,1848,4044
140,30,130,894,954,1848,4175
160,50,90,917,931,1848,4069
-180,60,60,920,928,1848,4104
-50,10,-160,924,924,1848,3968
-60,10,-170,920,929,1849,4081
-90,30,-150,925,924,1849,4189
-100,0,-60,902,947,1849,4028
-110,-70,120,907,942,1849,4193
-130,30,0,919,931,1850,4332
-100,20,130,909,941,1850,3977
160,30,180,883,967,1850,4087
-130,-80,-150,903,947,1850,4206
110,50,-160,891,959,1850,4025
160,30,-180,883,967,1850,4087
-170,10,-170,902,948,1850,4122
-70,40,80,908,942,1850,3969
-30,-70,-60,900,950,1850,4059
-30,-20,-150,923,928,1851,4099
-100,80,90,889,962,1851,3992
-110,0,-20,910,941,1851,4146
-160,70,150,891,961,1852,4025
-90,20,-170,915,937,1852,4144
180,-80,150,907,946,1853,4217
-180,-80,150,907,946,1853,4217
160,-20,150,905,949,1854,4011
-80,40,-80,920,934,1854,4226
-50,20,40,893,961,1854,4020
30,20,-70,886,968,1854,4186
100,40,170,912,942,1854,4145
-50,60,-100,912,942,1854,4144
10,0,-120,900,954,1854,4014
30,-10,-50,880,974,1854,4117
-180,-20,90,894,961,1855,3901
120,60,-160,895,960,1855,4035
-40,20,0,919,936,1855,4118
20,80,-40,891,964,1855,4005
-120,-50,100,910,945,1855,4303
-140,20,30,922,933,1855,4287
20,-60,-40,877,978,1855,4132
180,-20,90,894,961,1855,3901
130,30,140,892,964,1856,4143
-90,40,-60,914,942,1856,4135
-60,40,-110,927,929,1856,4166
20,-80,-30,910,946,1856,3990
30,30,-110,908,948,1856,4120
60,-60,-30,887,969,1856,4074
-30,0,-30,912,944,1856,4073
-50,30,-130,911,945,1856,4027
-80,50,-70,921,936,1857,4101
-130,-10,-130,904,953,1857,4140
-50,-70,-70,904,953,1857,3900
-100,30,-130,901,956,1857,4143
150,-60,60,886,971,1857,4231
-130,20,10,906,951,1857,4278
-110,50,120,916,941,1857,4009
-90,-10,-40,908,950,1858,4072
-40,10,-20,914,944,1858,4103
30,70,-160,900,958,1858,4250
-160,-10,60,911,947,1858,4272
-90,-50,140,932,926,1858,4139
10,10,-40,904,955,1859,4129
-50,30,50,893,966,1859,4071
170,-30,160,888,971,1859,4025
-30,-70,-150,912,947,1859,4206
180,-50,160,886,974,1860,3978
170,30,-180,903,957,1860,4237
-180,-50,160,886,974,1860,3978
150,0,160,910,950,1860,4208
170,30,180,903,957,1860,4237
-90,-60,140,908,952,1860,4298
140,-70,60,896,964,1860,4185
-120,-30,80,922,939,1861,4127
-150,-70,-170,899,962,1861,4117
50,-60,-60,891,970,1861,4185
40,50,-100,883,978,1861,3793
-120,0,0,899,963,1862,4188
-150,20,40,917,945,1862,4294
30,20,-60,905,957,1862,4123
160,80,-180,901,961,1862,4200
-10,0,-40,920,942,1862,3900
-120,-10,-110,926,936,1862,4097
-140,20,-160,895,967,1862,4053
-130,80,0,931,931,1862,4185
160,80,180,901,961,1862,4200
-50,-80,-80,895,967,1862,3952
170,-50,60,904,959,1863,4240
-110,20,150,920,943,1863,4078
-90,0,130,910,953,1863,4136
-90,10,170,933,930,1863,4192
-110,-80,-130,916,947,1863,4228
30,30,-70,876,987,1863,4187
-120,-20,-110,930,933,1863,4133
140,60,-170,912,951,1863,4010
0,-60,-50,922,942,1864,4120
-40,-50,-160,924,940,1864,4054
160,50,180,906,959,1865,4027
70,-70,-10,908,957,1865,4282
160,-60,100,918,947,1865,4033
-100,20,-170,928,937,1865,4164
160,50,-180,906,959,1865,4027
-100,-70,130,913,953,1866,4239
10,40,-30,906,960,1866,4064
20,10,-100,914,952,1866,4188
-100,10,150,946,920,1866,4088
-120,-10,20,914,952,1866,4229
60,70,-100,895,971,1866,3915
130,60,120,908,959,1867,4135
-110,40,-30,908,959,1867,4167
-180,0,90,912,955,1867,3994
-50,-20,-40,945,922,1867,4366
180,0,90,912,955,1867,3994
-90,0,-30,936,932,1868,4014
-160,-60,180,917,951,1868,4069
-90,-30,-60,905,963,1868,4183
-160,-60,-180,917,951,1868,4069
160,-70,100,913,955,1868,4234
10,40,-140,909,959,1868,4219
20,10,-90,909,960,1869,3941
-170,40,60,919,950,1869,4271
30,40,-70,897,972,1869,4171
-90,-10,20,916,953,1869,4347
70,-80,10,914,955,1869,4217
-100,30,-90,921,948,1869,4201
-110,80,100,900,969,1869,3982
-60,30,-130,910,959,1869,4221
-40,70,30,901,969,1870,3890
-100,20,180,940,931,1871,4226
-100,20,-180,940,931,1871,4226
10,70,-30,921,950,1871,3973
-180,-70,150,907,964,1871,3989
-150,-20,60,913,958,1871,4407
180,-70,150,907,964,1871,3989
-100,-30,-80,921,950,1871,4194
-140,0,40,934,937,1871,4329
-150,30,170,914,958,1872,4034
-60,0,20,914,958,1872,4186
-70,-40,-70,912,960,1872,4085
50,-60,-30,891,982,1873,4175
120,50,-180,919,954,1873,4004
160,20,-180,912,961,1873,4220
-90,30,-60,917,956,1873,4200
-90,30,-80,930,943,1873,4054
130,70,-160,905,968,1873,3976
-100,30,-120,921,952,1873,4248
-70,-10,-30,943,930,1873,4259
120,50,180,919,954,1873,4004
-50,-40,-170,909,964,1873,3947
-110,-20,70,925,948,1873,4153
160,20,180,912,961,1873,4220
-70,10,70,912,962,1874,4277
90,70,-130,904,970,1874,3820
-180,-40,90,908,966,1874,4175
-70,20,80,923,951,1874,4185
-80,-20,-50,926,948,1874,4316
-130,0,20,931,943,1874,4298
140,20,140,895,979,1874,4201
110,70,130,924,950,1874,4356
-170,-10,80,902,972,1874,3944
180,-40,90,908,966,1874,4175
-70,-10,-40,928,946,1874,4232
-100,-10,-70,924,950,1874,4346
140,40,170,914,960,1874,4110
-90,0,-20,920,955,1875,4167
80,70,-120,894,981,1875,3838
80,60,-130,894,982,1876,3984
20,10,-120,891,985,1876,4153
-180,-80,60,919,957,1876,3962
180,-80,60,919,957,1876,3962
-70,-20,-50,926,951,1877,4137
-90,-30,130,937,941,1878,4307
170,-50,80,916,962,1878,4114
-150,50,150,897,981,1878,3865
-180,-40,170,911,968,1879,3872
180,-40,170,911,968,1879,3872
-10,30,-20,892,987,1879,4099
-110,-30,90,935,944,1879,4100
-50,20,-150,926,953,1879,4095
40,-50,-40,905,974,1879,4173
-110,20,-160,926,954,1880,4063
-150,-10,-150,929,951,1880,4231
-120,20,-20,909,971,1880,4068
180,-10,90,905,976,1881,4061
-180,-10,90,905,976,1881,4061
-70,0,-20,935,946,1881,4282
100,70,-140,906,975,1881,3970
-110,10,-90,905,976,1881,4057
30,40,-80,894,987,1881,4052
-100,10,-70,913,968,1881,4153
-120,80,-10,944,938,1882,4295
170,-80,130,913,969,1882,4197
-90,50,100,899,984,1883,4053
-70,-30,-60,923,960,1883,4055
30,-50,-80,912,971,1883,4338
-170,40,170,922,961,1883,4160
-10,-20,-130,931,952,1883,4207
-140,-20,60,925,958,1883,4265
-170,-20,70,926,957,1883,4204
-10,-40,-50,934,949,1883,4057
-140,50,20,929,955,1884,4186
-100,40,-40,932,952,1884,4316
140,20,160,916,968,1884,4186
-60,10,40,930,954,1884,4132
-120,20,-160,932,952,1884,4230
-30,-40,-50,933,952,1885,4099
140,50,120,909,976,1885,4196
160,0,130,911,974,1885,4117
-160,-50,-170,902,983,1885,4067
-20,20,-140,904,982,1886,4130
-30,60,20,906,980,1886,4089
-90,-30,120,931,955,1886,4207
160,10,120,919,968,1887,4133
-80,-40,-70,917,970,1887,4258
-160,0,60,918,969,1887,4327
-140,-60,-150,888,999,1887,4068
-120,40,-10,939,948,1887,4309
-70,10,60,917,970,1887,4157
-100,30,-110,931,957,1888,4306
30,-50,-40,900,988,1888,4264
70,-70,-40,904,984,1888,4252
-180,-90,60,931,958,1889,4161
120,-90,0,931,958,1889,4161
-170,-90,70,931,958,1889,4161
-40,-90,-160,931,958,1889,4161
130,-90,10,931,958,1889,4161
180,-90,60,931,958,1889,4161
150,-90,30,931,958,1889,4161
60,-90,-60,931,958,1889,4161
80,-90,-40,931,958,1889,4161
100,-90,-20,931,958,1889,4161
10,-90,-110,931,958,1889,4161
70,-90,-50,931,958,1889,4161
-110,-90,130,931,958,1889,4161
170,-90,50,931,958,1889,4161
-150,-90,90,931,958,1889,4161
-140,-90,100,931,958,1889,4161
-120,40,0,944,945,1889,4295
-20,-90,-140,931,958,1889,4161
-120,-90,120,931,958,1889,4161
-170,-20,80,923,966,1889,4190
20,-90,-100,931,958,1889,4161
-160,-90,80,931,958,1889,4161
-100,-90,140,931,958,1889,4161
0,-90,-120,931,958,1889,4161
110,-90,-10,931,958,1889,4161
-40,-60,-160,931,958,1889,4253
-60,-90,180,931,958,1889,4161
-130,-90,110,931,958,1889,4161
-70,-60,-80,910,979,1889,4172
40,-90,-80,931,958,1889,4161
-80,-90,160,931,958,1889,4161
-90,-90,150,931,958,1889,4161
-70,-90,170,931,958,1889,4161
-50,-90,-170,931,958,1889,4161
-30,-90,-150,931,958,1889,4161
50,-90,-70,931,958,1889,4161
40,80,-170,931,958,1889,4231
160,-90,40,931,958,1889,4161
-60,-90,-180,931,958,1889,4161
-10,-90,-130,931,958,1889,4161
90,-90,-30,931,958,1889,4161
140,-90,20,931,958,1889,4161
30,-90,-90,931,958,1889,4161
40,-70,-30,890,1000,1890,4076
140,-80,90,929,961,1890,4104
100,50,-160,906,984,1890,4226
0,-80,-120,916,974,1890,4149
170,-40,100,916,974,1890,4153
170,-30,100,907,984,1891,4095
-130,50,10,947,944,1891,4269
-30,50,20,898,993,1891,4197
-100,20,-70,928,963,1891,4062
50,60,-170,923,969,1892,4171
-80,30,-150,951,941,1892,4294
50,-50,-40,897,995,1892,4241
-60,0,-30,940,952,1892,4456
110,50,-170,907,985,1892,4184
-70,0,30,924,968,1892,4181
0,0,-130,935,958,1893,4297
-60,20,-160,945,948,1893,4239
170,0,100,907,986,1893,4145
-130,10,-150,910,983,1893,4213
-90,0,-40,949,945,1894,4220
150,-80,90,915,979,1894,4009
180,70,60,937,957,1894,4309
-180,70,60,937,957,1894,4309
-100,-20,-70,936,959,1895,4286
-90,-50,-80,900,995,1895,4276
170,60,170,926,969,1895,4020
150,50,110,932,963,1895,4101
30,-10,-70,923,973,1896,4156
140,40,180,910,986,1896,4249
120,-70,30,913,983,1896,4307
30,-20,-70,930,966,1896,4205
110,70,-150,917,979,1896,4092
140,40,-180,910,986,1896,4249
-110,60,110,935,962,1897,4064
-50,10,10,937,960,1897,4462
170,70,170,908,989,1897,4102
-70,-20,170,956,941,1897,4305
150,40,-180,920,978,1898,4225
40,70,-70,910,988,1898,4114
150,40,180,920,978,1898,4225
50,70,-90,934,964,1898,3962
-100,10,160,933,965,1898,4174
-40,20,-10,940,958,1898,4300
-120,30,-20,928,970,1898,4308
-110,20,160,942,956,1898,4260
60,-80,0,931,967,1898,4346
-130,20,20,938,960,1898,4369
-80,-10,-40,935,964,1899,4357
-80,-10,-50,949,950,1899,4319
-90,-10,40,914,985,1899,4374
-90,-10,30,924,975,1899,4431
130,30,160,917,982,1899,4185
40,30,-120,927,972,1899,4297
-180,-50,60,923,977,1900,4409
180,-50,60,923,977,1900,4409
110,40,170,918,982,1900,4225
-110,30,-30,929,971,1900,4252
120,40,170,920,980,1900,4448
-50,0,-160,958,942,1900,4107
170,-20,100,922,979,1901,4045
90,50,-150,918,983,1901,4169
-70,30,80,935,966,1901,4177
-60,-40,-180,940,961,1901,4064
-110,20,-120,929,972,1901,4249
160,-70,90,923,978,1901,4170
10,10,-130,938,963,1901,4302
130,40,170,930,971,1901,4266
30,40,-90,909,992,1901,4110
130,50,-170,922,979,1901,4097
-90,-20,-60,927,974,1901,4138
-60,-40,180,940,961,1901,4064
-30,20,-140,928,974,1902,4125
-50,-60,-170,954,948,1902,4274
170,-60,130,919,983,1902,4130
160,40,100,916,986,1902,4103
170,-70,130,919,983,1902,4119
40,-60,-70,914,988,1902,4394
30,-70,-30,920,982,1902,4372
-20,10,-140,949,954,1903,4409
10,-40,-100,937,966,1903,4125
90,60,-140,918,985,1903,4034
10,-80,-40,943,960,1903,4145
-170,-80,160,930,973,1903,4285
-100,0,-20,938,965,1903,4249
-180,-40,160,918,987,1905,3946
-150,30,-180,935,970,1905,4222
-90,30,-70,933,972,1905,4197
20,-50,-90,916,989,1905,4258
-150,30,180,935,970,1905,4222
-90,-20,140,934,971,1905,4163
180,-40,160,918,987,1905,3946
-20,-40,-50,931,974,1905,4137
-100,10,140,934,971,1905,4220
-160,10,60,931,975,1906,4236
-90,0,160,956,950,1906,4192
120,50,-170,922,984,1906,4169
-120,-40,-110,906,1000,1906,4341
-160,-40,-160,927,979,1906,4064
-90,20,110,917,991,1908,4124
-120,30,150,945,963,1908,4095
-50,-30,-50,938,970,1908,4111
170,-40,140,925,983,1908,4271
10,-10,-100,930,979,1909,4160
-120,-10,30,927,982,1909,4329
-90,0,-50,935,974,1909,4237
-80,0,40,932,977,1909,4363
-70,30,-150,950,959,1909,4293
170,80,170,937,973,1910,4286
50,-50,-50,918,992,1910,4263
-110,0,-10,930,980,1910,4371
-100,50,110,922,988,1910,4199
180,-70,60,916,994,1910,4180
-90,-10,70,928,982,1910,4244
-100,-10,20,928,982,1910,4347
-140,30,30,949,961,1910,4252
30,20,-120,930,980,1910,4339
-180,-70,60,916,994,1910,4180
100,70,140,938,973,1911,4275
-150,-60,80,943,968,1911,4244
-60,60,60,951,960,1911,4230
-130,10,20,955,957,1912,4351
-110,50,-20,946,966,1912,4334
-60,-30,-60,931,981,1912,4184
-180,-60,150,937,975,1912,4103
-70,-30,170,945,967,1912,4080
-60,-10,-40,948,964,1912,4332
-140,-70,-160,921,991,1912,4283
60,40,-140,919,993,1912,4266
180,-60,150,937,975,1912,4103
-100,-50,-90,925,987,1912,4328
140,-70,30,919,994,1913,4288
-90,-30,140,959,954,1913,4253
-170,10,80,943,971,1914,4149
150,10,170,947,967,1914,4360
170,-10,100,935,979,1914,4137
30,60,-70,925,989,1914,3974
-180,10,90,940,975,1915,4014
0,-50,-50,933,982,1915,4108
120,60,130,929,986,1915,4355
-170,30,70,941,974,1915,4274
180,10,90,940,975,1915,4014
-130,0,-140,925,990,1915,4043
-70,0,-10,951,964,1915,4303
-90,-60,-100,922,994,1916,4327
-110,70,-20,944,972,1916,4282
-80,20,-160,949,968,1917,4328
170,-20,170,930,987,1917,4400
-90,10,-50,970,947,1917,4294
100,50,-170,918,999,1917,4228
-160,30,50,954,963,1917,4213
140,60,110,947,970,1917,4311
10,80,-30,916,1001,1917,4065
-90,20,-160,947,971,1918,4352
140,70,-170,928,990,1918,4080
-10,-80,-130,938,980,1918,4285
-90,-10,60,920,998,1918,4281
150,30,120,924,995,1919,4190
-110,20,-110,936,983,1919,4282
-60,10,-10,961,958,1919,4186
-120,50,0,964,956,1920,4437
-20,0,-140,954,966,1920,4375
30,10,-60,914,1006,1920,4275
-120,0,-130,938,982,1920,4215
-40,30,30,939,982,1921,4167
-100,20,-40,946,975,1921,4273
-150,-10,60,921,1000,1921,4443
-20,40,-130,942,979,1921,4318
-140,-30,70,950,971,1921,4356
-10,40,-10,905,1016,1921,4268
0,40,-20,919,1002,1921,4204
-170,70,50,937,984,1921,4336
-110,80,-20,959,962,1921,4340
-120,10,0,958,964,1922,4373
-40,20,20,930,992,1922,4294
110,-70,20,927,995,1922,4350
-180,-60,60,931,992,1923,4413
0,-80,-50,945,978,1923,4257
-170,-30,-170,922,1001,1923,4195
-60,-70,-80,938,985,1923,4118
-40,30,-130,940,983,1923,4367
170,50,80,931,992,1923,4326
150,40,170,942,981,1923,4148
60,-60,-40,923,1000,1923,4410
180,-60,60,931,992,1923,4413
-100,30,-100,944,979,1923,4239
-80,-20,160,946,977,1923,4285
10,-20,-100,952,972,1924,4207
-90,-10,-60,934,991,1925,4328
-80,0,-20,967,958,1925,4230
30,60,-60,925,1000,1925,4172
-20,20,-30,924,1001,1925,4207
-90,-10,140,943,982,1925,4087
-170,20,70,936,989,1925,4340
-40,20,-140,945,980,1925,4284
-170,-80,70,931,994,1925,4045
150,-80,100,947,978,1925,4331
150,20,130,933,993,1926,4382
180,-40,80,945,981,1926,4266
-90,10,-60,966,960,1926,4280
-170,-30,70,938,988,1926,4276
-180,-40,80,945,981,1926,4266
-40,0,-30,965,961,1926,4135
-150,30,40,938,989,1927,4291
-30,-20,-40,935,992,1927,4191
-100,50,-30,952,975,1927,4357
-160,40,50,964,963,1927,4293
-110,-10,-90,930,997,1927,4122
-130,40,20,969,958,1927,4346
170,-50,100,934,993,1927,4268
-160,60,40,944,983,1927,4286
150,10,160,942,986,1928,4219
-50,-40,-60,937,991,1928,4200
-30,70,-110,948,981,1929,4237
-110,-10,20,935,994,1929,4434
-40,-60,-60,962,968,1930,4209
-40,-70,-160,943,987,1930,4337
170,-40,120,930,1001,1931,4251
170,-30,140,925,1006,1931,4439
-90,-40,140,970,961,1931,4396
100,60,-150,933,998,1931,4122
-120,-10,50,949,983,1932,4215
-90,50,-50,956,976,1932,4360
-140,50,140,943,989,1932,4197
-20,-10,-140,969,963,1932,4191
-170,60,50,940,992,1932,4340
-110,20,-170,947,985,1932,4307
-50,10,20,942,990,1932,4468
-120,-10,40,957,975,1932,4338
170,40,90,932,1001,1933,4238
110,40,160,950,983,1933,4371
180,-40,70,940,994,1934,4376
-70,0,-180,958,976,1934,4301
-70,0,20,947,987,1934,4252
-70,0,180,958,976,1934,4301
-20,-10,-40,942,992,1934,4258
-180,-40,70,940,994,1934,4376
-170,0,-170,928,1006,1934,4375
10,-30,-100,957,978,1935,4025
-20,-20,-140,954,981,1935,4157
-80,-60,-90,941,994,1935,4303
-140,0,50,969,966,1935,4504
-150,-50,-160,925,1011,1936,4196
-80,-50,-80,937,999,1936,4210
-30,30,-10,939,997,1936,4141
160,-10,140,947,989,1936,4501
-70,70,-70,925,1011,1936,4344
150,-70,70,940,996,1936,4330
130,60,-170,931,1006,1937,4267
-70,20,-160,986,951,1937,4346
-70,0,10,934,1003,1937,4367
30,-20,-50,916,1021,1937,4271
-90,40,-50,964,973,1937,4456
-110,60,-20,960,977,1937,4392
180,90,160,937,1001,1938,4274
-80,0,-30,964,974,1938,4350
-30,90,10,937,1001,1938,4274
-90,90,70,937,1001,1938,4274
-20,90,0,937,1001,1938,4274
-140,90,120,937,1001,1938,4274
-110,10,-20,953,985,1938,4312
60,90,-80,937,1001,1938,4274
-40,90,20,937,1001,1938,4274
-130,90,110,937,1001,1938,4274
0,90,-20,937,1001,1938,4274
130,90,-150,937,1001,1938,4274
-100,-30,100,960,978,1938,4302
30,90,-50,937,1001,1938,4274
-110,90,90,937,1001,1938,4274
10,90,-30,937,1001,1938,4274
100,90,-120,937,1001,1938,4274
160,90,-180,937,1001,1938,4274
120,90,-140,937,1001,1938,4274
-100,90,80,937,1001,1938,4274
80,90,-100,937,1001,1938,4274
-170,90,150,937,1001,1938,4274
-60,90,40,937,1001,1938,4274
90,90,-110,937,1001,1938,4274
-150,90,130,937,1001,1938,4274
-100,-20,-80,955,983,1938,4341
-100,0,-70,949,989,1938,4309
-10,90,-10,937,1001,1938,4274
-180,90,160,937,1001,1938,4274
-160,90,140,937,1001,1938,4274
20,90,-40,937,1001,1938,4274
140,90,-160,937,1001,1938,4274
-70,90,50,937,1001,1938,4274
70,90,-90,937,1001,1938,4274
40,90,-60,937,1001,1938,4274
-120,90,100,937,1001,1938,4274
50,90,-70,937,1001,1938,4274
110,90,-130,937,1001,1938,4274
150,90,-170,937,1001,1938,4274
160,90,180,937,1001,1938,4274
-80,90,60,937,1001,1938,4274
170,90,170,937,1001,1938,4274
-50,90,30,937,1001,1938,4274
-30,50,-120,956,983,1939,4302
170,-50,70,950,989,1939,4254
140,50,170,943,996,1939,4194
10,60,-30,944,995,1939,4097
30,-60,-40,940,999,1939,4215
140,30,170,931,1008,1939,4394
-90,-10,150,952,987,1939,4193
-160,-80,170,950,990,1940,4320
-160,20,60,971,969,1940,4315
-60,10,-20,968,972,1940,4558
-90,30,-140,957,983,1940,4491
0,80,-20,933,1007,1940,4101
50,-80,-10,946,994,1940,4467
-90,-10,90,938,1002,1940,4310
-100,20,-80,944,997,1941,4350
-20,-80,-60,956,985,1941,4271
170,-20,130,950,991,1941,4338
-110,20,170,946,995,1941,4319
30,50,-70,938,1003,1941,4078
-110,-50,-110,936,1005,1941,4164
20,0,-80,939,1003,1942,4442
-100,-40,120,973,969,1942,4411
-140,30,170,947,995,1942,4180
130,50,-180,928,1014,1942,4279
10,50,-140,929,1013,1942,4336
-40,30,-10,957,985,1942,4301
30,50,-80,914,1028,1942,4251
130,50,180,928,1014,1942,4279
20,20,-90,950,993,1943,4286
-90,-20,100,938,1005,1943,4413
-70,0,0,947,996,1943,4453
170,-30,110,942,1001,1943,4109
-170,-50,170,921,1022,1943,4221
110,50,-180,944,1000,1944,4189
110,50,180,944,1000,1944,4189
-160,30,170,958,986,1944,4394
-30,20,-20,956,988,1944,4247
170,0,180,953,991,1944,4492
-140,40,30,976,968,1944,4261
170,0,-180,953,991,1944,4492
-150,40,40,967,977,1944,4326
130,-70,40,922,1023,1945,4440
-170,40,70,945,1000,1945,4288
-60,-80,-90,958,987,1945,4152
-170,20,80,962,983,1945,4215
-30,40,10,953,992,1945,4195
-100,20,-160,965,980,1945,4233
-160,90,30,961,985,1946,4439
170,90,60,961,985,1946,4439
-140,90,10,961,985,1946,4439
90,90,140,961,985,1946,4439
-110,90,-20,961,985,1946,4439
-170,90,40,961,985,1946,4439
-50,90,-80,961,985,1946,4439
-150,90,20,961,985,1946,4439
40,90,-170,961,985,1946,4439
110,90,120,961,985,1946,4439
20,90,-150,961,985,1946,4439
50,90,180,961,985,1946,4439
-130,90,0,961,985,1946,4439
0,90,-130,961,985,1946,4439
-90,90,-40,961,985,1946,4439
160,90,70,961,985,1946,4439
80,90,150,961,985,1946,4439
150,90,80,961,985,1946,4439
100,90,130,961,985,1946,4439
120,90,110,961,985,1946,4439
-70,90,-60,961,985,1946,4439
130,90,100,961,985,1946,4439
180,90,50,961,985,1946,4439
-120,90,-10,961,985,1946,4439
60,90,170,961,985,1946,4439
-180,90,50,961,985,1946,4439
10,90,-140,961,985,1946,4439
-20,90,-110,961,985,1946,4439
30,90,-160,961,985,1946,4439
-100,90,-30,961,985,1946,4439
-30,90,-100,961,985,1946,4439
50,90,-180,961,985,1946,4439
140,90,90,961,985,1946,4439
-80,90,-50,961,985,1946,4439
-30,40,20,948,998,1946,4330
-10,90,-120,961,985,1946,4439
-40,90,-90,961,985,1946,4439
70,90,160,961,985,1946,4439
-150,10,-160,935,1011,1946,4270
-60,90,-70,961,985,1946,4439
30,80,-160,957,989,1946,4379
170,-60,90,942,1004,1946,4302
120,70,-160,937,1010,1947,4187
-70,30,-140,963,984,1947,4326
70,50,-170,937,1010,1947,4427
-150,-60,-170,951,996,1947,4146
-90,-20,110,948,999,1947,4397
-130,-60,-140,940,1007,1947,4261
-60,10,0,960,987,1947,4238
-120,-30,-110,949,999,1948,4361
-90,30,-50,971,977,1948,4371
0,-30,-50,953,995,1948,4208
-90,-10,120,966,982,1948,4497
-10,20,-30,941,1007,1948,4340
-160,-20,-160,933,1015,1948,4265
-90,20,-70,956,993,1949,4180
180,40,80,954,995,1949,4099
-110,10,-130,973,976,1949,4434
-90,-10,130,948,1001,1949,4257
160,0,170,930,1019,1949,4271
-80,0,70,957,992,1949,4416
60,60,-120,937,1012,1949,4239
-20,40,0,940,1009,1949,4259
-40,70,-100,944,1005,1949,4393
170,-50,130,949,1000,1949,4321
100,-70,10,942,1007,1949,4376
-20,-30,-50,957,992,1949,4263
-180,40,80,954,995,1949,4099
170,-50,120,937,1013,1950,4073
40,-40,-60,929,1021,1950,4380
160,-10,150,943,1007,1950,4258
-150,60,30,959,991,1950,4266
-130,30,20,973,977,1950,4408
150,60,100,963,987,1950,4461
-80,40,90,952,998,1950,4232
-40,0,-150,998,953,1951,4275
10,20,-40,953,998,1951,4452
-110,20,-30,959,992,1951,4494
-110,-40,-100,936,1015,1951,4325
-40,30,10,952,999,1951,4140
-140,60,20,964,987,1951,4279
-90,20,-60,983,968,1951,4243
-170,0,80,944,1007,1951,4133
160,-60,60,940,1011,1951,4383
-90,-10,80,962,990,1952,4166
-50,50,50,968,984,1952,4382
-140,40,150,960,992,1952,4246
-100,-60,-110,949,1003,1952,4520
-150,20,-170,947,1005,1952,4412
-160,60,150,947,1005,1952,4125
-80,-20,-60,957,996,1953,4545
20,40,-140,975,978,1953,4342
-90,20,-50,979,975,1954,4354
140,20,150,953,1001,1954,4420
-130,0,30,984,970,1954,4485
-50,70,40,953,1002,1955,4120
-180,-80,140,944,1011,1955,4389
170,0,110,945,1010,1955,4252
-90,0,120,957,998,1955,4385
-160,30,60,957,998,1955,4368
180,-80,140,944,1011,1955,4389
160,-60,70,932,1023,1955,4270
-130,-70,-150,948,1007,1955,4356
-110,0,-90,942,1014,1956,4380
170,-60,100,953,1003,1956,4291
-40,30,20,956,1000,1956,4427
-50,-50,-170,968,988,1956,4256
50,40,-140,942,1015,1957,4364
40,-80,-20,952,1005,1957,4588
-150,70,140,946,1011,1957,4266
-180,80,160,962,996,1958,4353
40,60,-90,936,1022,1958,4416
-80,0,-40,984,974,1958,4451
-180,50,70,951,1007,1958,4422
50,60,-110,948,1010,1958,4065
-140,30,160,957,1001,1958,4281
180,80,160,962,996,1958,4353
180,50,70,951,1007,1958,4422
10,0,-110,959,1000,1959,4154
150,60,-180,953,1006,1959,4317
150,60,180,953,1006,1959,4317
80,50,-180,949,1010,1959,4583
80,50,180,949,1010,1959,4583
-70,0,-30,978,981,1959,4466
180,-50,150,965,994,1959,4297
-130,20,-160,943,1016,1959,4468
-180,-50,150,965,994,1959,4297
160,-80,100,957,1003,1960,4190
-160,-80,80,954,1006,1960,4119
170,20,-180,952,1008,1960,4274
150,10,150,946,1014,1960,4512
170,20,180,952,1008,1960,4274
-90,30,-120,962,998,1960,4512
70,60,-130,958,1002,1960,4391
-170,-40,-180,923,1038,1961,4112
-110,-20,80,955,1006,1961,4355
40,30,-130,958,1003,1961,4467
-60,-50,-70,967,994,1961,4163
20,20,-50,956,1005,1961,4429
170,-60,120,946,1015,1961,4352
160,-10,160,948,1013,1961,4438
-170,-40,180,923,1038,1961,4112
160,50,100,963,999,1962,4318
90,-70,0,950,1012,1962,4292
-160,70,40,951,1011,1962,4418
-10,10,-40,969,993,1962,4218
-90,40,-40,987,975,1962,4412
-60,-50,180,974,988,1962,4333
-60,-50,-180,974,988,1962,4333
-70,10,-170,984,978,1962,4337
0,70,-20,953,1010,1963,4191
-40,30,0,978,985,1963,4259
-90,10,-40,970,993,1963,4316
-170,-20,-170,966,997,1963,4292
40,50,-150,959,1005,1964,4281
-120,-60,-130,940,1024,1964,4394
50,50,-120,946,1018,1964,4424
170,30,100,939,1025,1964,4161
-70,-10,-50,976,988,1964,4426
90,70,150,960,1004,1964,4420
-100,70,-30,975,989,1964,4386
-120,40,10,979,985,1964,4433
160,60,90,982,983,1965,4451
-100,20,-150,953,1012,1965,4376
100,80,-130,949,1016,1965,4303
60,-70,-20,929,1036,1965,4378
-100,-10,50,953,1012,1965,4516
-90,0,-60,972,993,1965,4410
160,30,110,933,1033,1966,4279
90,50,170,966,1000,1966,4621
-110,-60,-120,954,1012,1966,4423
-110,-10,30,945,1021,1966,4462
-80,40,-70,973,993,1966,4467
170,0,120,962,1004,1966,4258
130,30,150,962,1004,1966,4417
-180,-20,-180,955,1012,1967,4295
180,30,90,955,1012,1967,4352
180,-20,-180,955,1012,1967,4295
-180,-20,180,955,1012,1967,4295
-40,-70,-70,960,1007,1967,4485
-180,30,90,955,1012,1967,4352
180,-20,180,955,1012,1967,4295
20,-70,-40,957,1010,1967,4482
-100,30,-40,964,1004,1968,4460
-80,30,90,977,991,1968,4297
90,80,-120,941,1027,1968,4341
20,10,-80,945,1023,1968,4360
-90,-20,130,974,995,1969,4357
120,40,150,930,1039,1969,4332
-40,40,-120,967,1003,1970,4453
40,70,-80,947,1023,1970,4081
-70,-50,170,965,1005,1970,4321
40,40,-120,940,1030,1970,4353
-50,70,-90,946,1024,1970,4545
-60,30,-120,973,997,1970,4393
30,-60,-80,941,1029,1970,4468
170,-10,130,975,995,1970,4424
-20,30,-20,960,1011,1971,4258
-70,-40,170,961,1010,1971,4136
-80,0,80,966,1005,1971,4450
40,-40,-50,932,1039,1971,4363
170,-20,160,962,1009,1971,4232
90,-70,-10,951,1020,1971,4491
-20,-80,-140,953,1019,1972,4330
-80,0,-50,988,984,1972,4365
-110,20,-180,975,997,1972,4534
60,-70,-50,957,1015,1972,4462
-110,20,180,975,997,1972,4534
20,70,-150,970,1002,1972,4481
150,10,140,948,1024,1972,4352
-90,-30,-70,992,981,1973,4420
10,-50,-100,967,1006,1973,4277
90,50,-170,941,1032,1973,4345
-100,-60,130,965,1008,1973,4554
80,70,-130,964,1009,1973,4163
-160,-50,70,969,1005,1974,4372
-40,-50,-60,983,991,1974,4455
-160,40,160,958,1016,1974,4247
-100,-50,-100,967,1007,1974,4319
170,10,110,960,1014,1974,4269
110,80,-140,953,1021,1974,4325
-140,-50,-140,973,1001,1974,4324
120,-80,50,964,1011,1975,4411
-60,-90,-110,983,992,1975,4428
-100,-90,-150,983,992,1975,4428
-130,-90,180,983,992,1975,4428
-130,-90,-180,983,992,1975,4428
-110,0,0,959,1016,1975,4583
140,-90,90,983,992,1975,4428
100,-90,50,983,992,1975,4428
160,-90,110,983,992,1975,4428
-170,-90,140,983,992,1975,4428
180,-90,130,983,992,1975,4428
140,-70,50,935,1040,1975,4504
130,-90,80,983,992,1975,4428
-40,-90,-90,983,992,1975,4428
20,-90,-30,983,992,1975,4428
90,-90,40,983,992,1975,4428
-10,-90,-60,983,992,1975,4428
-160,-90,150,983,992,1975,4428
10,-90,-40,983,992,1975,4428
0,-90,-50,983,992,1975,4428
60,-90,10,983,992,1975,4428
120,-90,70,983,992,1975,4428
50,-90,0,983,992,1975,4428
70,-90,20,983,992,1975,4428
80,50,-160,950,1025,1975,4369
-150,-20,-150,946,1029,1975,4419
40,-90,-10,983,992,1975,4428
-180,-90,130,983,992,1975,4428
-110,-90,-160,983,992,1975,4428
-60,20,50,965,1010,1975,4353
-140,-90,170,983,992,1975,4428
-80,-90,-130,983,992,1975,4428
-150,-90,160,983,992,1975,4428
150,-90,100,983,992,1975,4428
-30,-90,-80,983,992,1975,4428
-50,-90,-100,983,992,1975,4428
-90,10,-30,995,980,1975,4486
-90,-90,-140,983,992,1975,4428
-120,-90,-170,983,992,1975,4428
-20,-90,-70,983,992,1975,4428
-70,-90,-120,983,992,1975,4428
170,-90,120,983,992,1975,4428
80,-90,30,983,992,1975,4428
110,-90,60,983,992,1975,4428
10,50,-30,948,1027,1975,4313
30,-90,-20,983,992,1975,4428
-180,20,90,959,1017,1976,4341
-130,60,10,967,1009,1976,4353
170,-40,110,939,1037,1976,4079
180,20,90,959,1017,1976,4341
-120,-10,-120,980,997,1977,4337
100,-70,0,948,1029,1977,4490
-20,-70,-60,966,1011,1977,4403
-90,10,110,966,1011,1977,4428
30,50,-90,958,1020,1978,4372
180,70,160,951,1027,1978,4258
-180,70,160,951,1027,1978,4258
-30,-60,-60,967,1011,1978,4375
160,-70,110,963,1015,1978,4464
-170,-60,160,963,1015,1978,4241
-110,40,-20,989,989,1978,4508
-120,20,-10,957,1021,1978,4493
-10,-30,-50,995,983,1978,4152
130,-80,60,966,1012,1978,4345
80,-70,-10,950,1029,1979,4300
-60,-20,-50,970,1009,1979,4314
110,60,-170,959,1020,1979,4180
80,80,-110,954,1025,1979,4389
170,10,-180,966,1014,1980,4510
-170,20,180,960,1020,1980,4428
180,60,160,970,1010,1980,4249
-80,-30,160,966,1014,1980,4422
170,10,180,966,1014,1980,4510
80,-70,-20,956,1024,1980,4546
-100,30,120,961,1019,1980,4437
-170,50,160,952,1028,1980,4147
110,-70,10,959,1021,1980,4488
-180,60,160,970,1010,1980,4249
-170,20,-180,960,1020,1980,4428
20,10,-50,961,1020,1981,4556
-140,-10,60,962,1019,1981,4635
0,-70,-50,976,1005,1981,4385
-60,-60,-180,993,988,1981,4399
-130,30,160,989,992,1981,4243
-30,-80,-150,949,1032,1981,4425
-100,40,-30,985,996,1981,4483
-90,20,-150,995,986,1981,4382
-60,-60,180,993,988,1981,4399
20,50,-50,948,1033,1981,4388
-100,-10,30,980,1002,1982,4600
30,0,-60,952,1030,1982,4569
10,-60,-50,959,1023,1982,4550
150,50,-180,957,1025,1982,4344
20,20,-100,951,1031,1982,4435
-80,10,90,974,1008,1982,4463
150,50,180,957,1025,1982,4344
-50,0,-30,987,995,1982,4597
140,50,-180,971,1012,1983,4300
-130,0,50,974,1009,1983,4486
140,50,180,971,1012,1983,4300
-150,10,50,972,1011,1983,4492
20,40,-50,955,1028,1983,4386
-120,30,0,990,994,1984,4625
10,-30,-50,949,1035,1984,4351
170,-50,110,954,1030,1984,4215
-90,30,-90,974,1010,1984,4410
-50,40,50,960,1024,1984,4364
0,30,-30,956,1028,1984,4558
-170,-70,160,962,1022,1984,4263
-100,10,170,982,1002,1984,4441
30,-80,-30,973,1011,1984,4661
110,60,-160,955,1029,1984,4368
-90,20,-40,975,1009,1984,4527
20,20,-130,984,1001,1985,4505
-100,0,-10,988,997,1985,4557
160,-70,80,956,1029,1985,4389
-160,10,70,975,1010,1985,4364
80,60,-140,975,1011,1986,4361
-40,60,30,958,1028,1986,4351
40,50,-110,955,1031,1986,4321
-100,80,-30,982,1005,1987,4490
-120,30,-10,990,997,1987,4632
50,40,-130,971,1016,1987,4399
-120,-50,-120,967,1020,1987,4364
-170,-20,90,965,1022,1987,4193
-100,-40,-90,953,1034,1987,4525
-90,-10,100,960,1027,1987,4445
-120,-20,70,972,1016,1988,4360
-90,-20,120,1006,982,1988,4458
110,-80,40,963,1025,1988,4422
30,70,-60,949,1039,1988,4322
30,40,-100,967,1021,1988,4096
20,20,-110,955,1033,1988,4508
20,80,-150,990,999,1989,4519
-120,0,10,963,1026,1989,4480
-150,-80,-180,970,1019,1989,4406
-150,-80,180,970,1019,1989,4406
-40,20,-20,976,1013,1989,4337
-170,50,60,956,1033,1989,4520
110,60,140,963,1026,1989,4435
-100,-50,130,987,1002,1989,4564
-30,10,-30,961,1028,1989,4343
130,60,-180,975,1015,1990,4279
-70,-80,-100,980,1010,1990,4288
-50,-70,-170,975,1015,1990,4465
130,60,180,975,1015,1990,4279
-110,60,-10,980,1011,1991,4374
160,10,130,961,1030,1991,4411
60,50,-130,962,1029,1991,4421
-160,-20,70,982,1009,1991,4574
-20,60,-120,988,1003,1991,4413
-170,-80,150,954,1038,1992,4463
-70,30,-130,993,999,1992,4506
-70,-70,-90,975,1017,1992,4334
-20,-60,-60,970,1022,1992,4488
-180,40,170,988,1004,1992,4431
180,40,170,988,1004,1992,4431
20,0,-50,956,1036,1992,4494
90,70,-140,965,1027,1992,4150
-160,-30,-160,971,1021,1992,4363
-80,30,-140,957,1035,1992,4618
-90,30,-130,964,1028,1992,4524
150,50,170,970,1023,1993,4253
140,-80,70,975,1018,1993,4428
30,-30,-70,960,1033,1993,4377
-110,20,140,986,1007,1993,4344
-80,60,-60,953,1040,1993,4560
10,-40,-50,963,1030,1993,4514
0,50,-20,961,1032,1993,4473
40,60,-100,953,1040,1993,4199
-90,-20,150,966,1027,1993,4241
160,-80,110,976,1017,1993,4561
-90,-10,110,994,999,1993,4604
170,-70,100,982,1012,1994,4448
-100,60,100,970,1024,1994,4291
-50,20,-10,987,1007,1994,4460
-90,0,170,1001,993,1994,4332
-30,-80,-70,972,1022,1994,4482
-100,0,150,996,999,1995,4399
150,70,180,957,1038,1995,4250
0,-20,-50,980,1015,1995,4187
-100,30,-30,981,1014,1995,4626
150,70,-180,957,1038,1995,4250
-150,70,30,972,1023,1995,4442
-100,20,-140,991,1004,1995,4535
170,60,80,994,1001,1995,4523
20,-40,-50,952,1044,1996,4532
170,-10,170,983,1013,1996,4584
70,80,-100,967,1029,1996,4405
-90,-50,-90,981,1015,1996,4491
-80,20,-40,997,999,1996,4579
-110,50,-10,1010,987,1997,4562
-110,10,-100,969,1028,1997,4383
-140,10,40,992,1005,1997,4658
70,-70,-30,979,1018,1997,4530
120,80,-150,964,1033,1997,4388
-170,-70,70,960,1038,1998,4404
-50,20,0,972,1026,1998,4643
-160,-30,70,984,1014,1998,4485
30,-30,-50,958,1040,1998,4382
-50,20,30,969,1029,1998,4408
30,-10,-60,956,1042,1998,4709
-180,-30,170,945,1054,1999,4222
70,50,-140,962,1037,1999,4568
140,80,100,985,1014,1999,4637
70,70,-120,975,1024,1999,4223
-80,0,-10,1005,994,1999,4570
180,-30,170,945,1054,1999,4222
-30,-50,-60,967,1032,1999,4345
-10,80,-10,971,1029,2000,4243
-80,-10,170,995,1005,2000,4376
150,-80,80,982,1018,2000,4414
-120,-30,90,998,1003,2001,4386
-110,10,-10,989,1012,2001,4450
10,-20,-50,970,1031,2001,4575
170,50,170,980,1021,2001,4449
-170,80,150,974,1027,2001,4461
-60,70,-80,952,1049,2001,4512
0,-40,-50,986,1016,2002,4358
10,30,-40,970,1032,2002,4600
160,20,120,966,1036,2002,4480
80,70,160,966,1036,2002,4593
90,-80,20,954,1048,2002,4392
30,40,-110,978,1025,2003,4326
-10,50,-130,979,1024,2003,4549
170,-10,120,973,1030,2003,4282
120,-70,20,977,1026,2003,4455
-100,-10,40,976,1027,2003,4645
-100,-10,-80,969,1034,2003,4425
-180,-70,140,964,1039,2003,4336
-170,-10,-170,962,1041,2003,4534
180,-70,140,964,1039,2003,4336
100,-80,30,966,1037,2003,4423
170,-60,60,961,1042,2003,4559
-150,0,60,991,1013,2004,4617
-120,60,0,978,1026,2004,4392
130,70,-170,963,1041,2004,4243
-100,10,-30,1002,1002,2004,4499
20,-30,-50,976,1028,2004,4504
40,60,-160,977,1027,2004,4505
80,-80,10,955,1050,2005,4417
120,40,160,971,1034,2005,4327
140,30,140,966,1039,2005,4511
-140,-80,100,971,1034,2005,4373
90,50,-160,959,1046,2005,4440
170,-30,130,959,1046,2005,4387
-170,-30,90,971,1034,2005,4430
-30,-30,-50,987,1018,2005,4292
-70,50,-80,988,1018,2006,4497
-130,40,140,983,1023,2006,4255
-180,-40,150,973,1033,2006,4331
-10,-80,-60,984,1022,2006,4460
10,-50,-50,981,1025,2006,4679
180,-40,150,973,1033,2006,4331
0,-50,-110,997,1010,2007,4372
20,30,-50,958,1049,2007,4547
30,70,-70,961,1046,2007,4325
140,40,130,977,1030,2007,4495
-90,-40,-80,989,1018,2007,4623
130,50,130,981,1027,2008,4497
-120,20,-170,999,1009,2008,4446
-130,-10,60,985,1023,2008,4455
-80,0,60,969,1039,2008,4638
160,50,170,983,1025,2008,4352
70,-70,-20,961,1047,2008,4351
-170,-50,160,997,1012,2009,4320
50,-60,-40,964,1045,2009,4372
110,50,150,958,1051,2009,4566
-80,0,20,960,1049,2009,4691
20,20,-80,956,1053,2009,4430
60,80,-90,962,1047,2009,4388
60,50,-160,957,1053,2010,4573
-40,-30,-50,982,1028,2010,4474
-140,0,-150,981,1029,2010,4498
-160,40,60,992,1018,2010,4432
0,-10,-120,982,1028,2010,4345
170,-20,140,982,1028,2010,4557
100,60,-160,973,1037,2010,4387
-160,80,40,1000,1011,2011,4510
-110,-40,110,994,1017,2011,4428
-100,-30,-90,976,1036,2012,4422
-170,-30,80,974,1038,2012,4586
-80,0,50,981,1031,2012,4711
110,-80,0,956,1056,2012,4527
-40,50,30,964,1048,2012,4451
100,50,160,962,1050,2012,4554
-170,80,50,1000,1012,2012,4493
80,50,-170,980,1033,2013,4529
140,70,-180,963,1050,2013,4315
-180,60,70,989,1024,2013,4640
140,70,180,963,1050,2013,4315
-90,70,-40,995,1018,2013,4523
-50,20,-20,967,1046,2013,4246
-100,0,140,989,1024,2013,4464
50,80,-80,964,1049,2013,4435
180,60,70,989,1024,2013,4640
40,-60,-40,972,1041,2013,4449
160,60,100,1001,1012,2013,4439
-110,30,-20,997,1016,2013,4556
-100,20,-90,980,1033,2013,4409
180,-40,100,981,1033,2014,4397
-180,-40,100,981,1033,2014,4397
-140,-80,-170,989,1025,2014,4416
-150,-40,-150,974,1040,2014,4216
-120,20,0,986,1028,2014,4717
-80,0,30,991,1023,2014,4574
-80,0,10,980,1034,2014,4813
-110,40,-10,1010,1004,2014,4456
-90,-20,-70,988,1027,2015,4445
90,60,-150,982,1033,2015,4476
170,-70,110,980,1035,2015,4488
-140,70,20,984,1031,2015,4513
-170,-10,90,965,1050,2015,4216
-150,-80,90,981,1034,2015,4282
-60,10,10,983,1032,2015,4605
170,-20,150,978,1037,2015,4499
-20,-50,-60,980,1035,2015,4410
20,40,-80,967,1048,2015,4442
-120,-70,-140,972,1043,2015,4476
0,10,-40,975,1041,2016,4414
-110,-10,50,969,1047,2016,4495
-90,10,180,1000,1016,2016,4564
160,0,160,976,1040,2016,4455
150,80,90,996,1020,2016,4654
-90,10,-180,1000,1016,2016,4564
-130,50,130,984,1032,2016,4415
150,30,130,970,1047,2017,4559
-100,60,-30,1005,1012,2017,4587
0,-30,-110,1001,1016,2017,4453
-160,0,70,978,1039,2017,4493
-140,-60,90,994,1023,2017,4512
-130,-80,110,972,1045,2017,4479
-100,-20,90,983,1035,2018,4556
-150,80,30,1006,1012,2018,4577
150,40,120,977,1041,2018,4419
-40,-80,-160,966,1052,2018,4490
-120,30,10,1016,1002,2018,4496
-180,50,80,977,1041,2018,4453
-90,50,-40,1005,1013,2018,4521
180,50,80,977,1041,2018,4453
-120,10,10,995,1023,2018,4708
-170,-40,70,1008,1011,2019,4665
90,60,160,967,1052,2019,4490
-80,30,-130,980,1039,2019,4520
100,60,150,967,1052,2019,4381
20,-10,-80,978,1041,2019,4617
-60,-70,180,983,1037,2020,4624
100,50,180,960,1060,2020,4543
170,-10,110,973,1047,2020,4440
-70,10,-30,1008,1012,2020,4438
-110,-10,40,982,1038,2020,4488
20,-80,-40,991,1029,2020,4793
20,40,-70,960,1060,2020,4303
170,10,120,1001,1019,2020,4411
100,50,-180,960,1060,2020,4543
-60,-70,-180,983,1037,2020,4624
180,-30,100,978,1043,2021,4274
150,20,170,969,1052,2021,4626
-150,20,50,1011,1010,2021,4620
-180,-30,100,978,1043,2021,4274
170,40,170,988,1033,2021,4310
-60,10,30,974,1047,2021,4552
0,60,-20,967,1054,2021,4508
20,30,-90,992,1029,2021,4508
-140,-60,-160,966,1055,2021,4340
-130,70,10,991,1030,2021,4563
170,-80,110,980,1041,2021,4345
20,30,-80,971,1051,2022,4388
-180,20,-180,979,1043,2022,4410
-180,20,180,979,1043,2022,4410
-110,-60,120,974,1048,2022,4634
180,20,-180,979,1043,2022,4410
180,20,180,979,1043,2022,4410
-20,80,0,970,1052,2022,4365
170,-20,110,977,1045,2022,4340
120,60,-170,977,1046,2023,4465
-160,20,70,991,1032,2023,4508
-70,10,-10,1010,1013,2023,4771
-70,10,50,996,1027,2023,4584
-80,20,90,973,1050,2023,4517
120,-80,10,956,1067,2023,4556
-30,30,-20,976,1047,2023,4400
30,40,-140,994,1030,2024,4496
170,-60,110,977,1047,2024,4505
-80,30,-60,1000,1024,2024,4773
150,-70,40,978,1046,2024,4597
20,60,-50,969,1055,2024,4537
-140,-40,80,989,1035,2024,4508
-80,10,-30,1010,1014,2024,4537
90,50,180,1001,1024,2025,4658
-10,50,-10,964,1061,2025,4529
10,0,-100,981,1044,2025,4398
20,50,-70,963,1062,2025,4359
-170,30,170,1003,1022,2025,4667
90,50,-180,1001,1024,2025,4658
-20,40,-10,972,1054,2026,4551
50,-70,-30,962,1064,2026,4568
60,70,-110,966,1060,2026,4344
40,40,-140,979,1047,2026,4522
20,-10,-50,965,1061,2026,4392
-10,-20,-50,993,1033,2026,4492
150,20,140,969,1057,2026,4625
160,0,140,1001,1025,2026,4672
-110,40,0,1015,1012,2027,4569
-130,0,40,1020,1007,2027,4634
20,60,-60,964,1063,2027,4389
-40,40,30,987,1040,2027,4634
-160,-10,70,996,1031,2027,4733
-60,30,60,986,1041,2027,4462
-20,50,0,961,1067,2028,4468
-20,0,-40,1010,1018,2028,4458
170,-40,130,974,1054,2028,4477
150,-70,60,965,1063,2028,4537
140,60,180,975,1053,2028,4375
-80,10,-40,1011,1017,2028,4550
140,60,-180,975,1053,2028,4375
-100,-30,110,998,1030,2028,4659
-180,-50,70,987,1042,2029,4713
180,-50,70,987,1042,2029,4713
-60,10,-30,1021,1008,2029,4743
-180,-50,90,975,1054,2029,4467
180,-50,90,975,1054,2029,4467
-130,-30,80,982,1047,2029,4556
130,50,170,994,1035,2029,4360
-110,10,150,987,1042,2029,4334
-160,-40,70,1011,1019,2030,4618
-40,-20,-40,1024,1006,2030,4674
-80,50,-60,997,1033,2030,4586
-150,30,160,989,1041,2030,4450
170,80,70,1009,1021,2030,4612
-90,-10,160,1011,1019,2030,4460
130,40,160,985,1046,2031,4440
130,-80,20,963,1068,2031,4578
-130,-80,-160,997,1034,2031,4417
-120,20,10,1000,1031,2031,4663
30,-70,-40,967,1064,2031,4471
-120,0,20,1000,1031,2031,4769
-80,-10,-60,1029,1003,2032,4611
130,80,-160,980,1052,2032,4486
130,-70,30,989,1043,2032,4611
-130,-50,-130,998,1034,2032,4482
-110,30,130,985,1047,2032,4545
180,80,60,1018,1014,2032,4549
-180,80,60,1018,1014,2032,4549
-90,0,-10,992,1040,2032,4685
160,30,170,984,1048,2032,4584
20,-20,-50,976,1056,2032,4481
-100,20,-30,986,1047,2033,4747
-110,20,-20,993,1040,2033,4786
-60,0,-170,1007,1027,2034,4592
140,60,170,999,1035,2034,4351
100,70,-150,975,1059,2034,4210
-80,-40,160,985,1049,2034,4314
130,80,110,991,1043,2034,4671
-60,0,-40,1008,1027,2035,4517
-50,-30,-60,995,1041,2036,4485
-100,50,-20,1034,1002,2036,4466
-70,10,-20,1010,1026,2036,4679
-80,-80,-110,1008,1028,2036,4391
150,30,170,987,1049,2036,4547
10,80,-140,1005,1032,2037,4573
-140,-50,-150,969,1068,2037,4357
-110,-30,-100,993,1044,2037,4581
20,-60,-90,989,1048,2037,4488
-160,-50,-180,968,1069,2037,4267
160,60,170,993,1044,2037,4455
70,50,-160,979,1058,2037,4556
-160,-50,180,968,1069,2037,4267
-160,20,180,988,1050,2038,4557
-150,40,150,990,1048,2038,4301
-150,40,50,1013,1025,2038,4500
100,-80,-10,965,1073,2038,4499
-50,20,-140,992,1046,2038,4474
-120,20,170,999,1039,2038,4363
-160,20,-180,988,1050,2038,4557
-120,10,-150,992,1046,2038,4418
-100,20,120,992,1047,2039,4575
-120,40,130,997,1042,2039,4446
10,-70,-50,989,1050,2039,4700
150,60,110,1005,1034,2039,4598
20,40,-60,992,1047,2039,4729
-80,0,-60,1005,1034,2039,4563
-60,20,-150,1002,1038,2040,4711
-70,20,70,1003,1037,2040,4580
-50,-80,-170,977,1063,2040,4585
-120,-60,110,975,1065,2040,4682
50,-70,-60,1002,1038,2040,4708
-170,50,70,1002,1038,2040,4574
-90,0,100,1000,1040,2040,4515
-140,20,-170,964,1077,2041,4525
-100,10,-80,999,1042,2041,4583
-60,20,-10,1025,1016,2041,4452
-70,-50,-80,1010,1031,2041,4534
-170,70,150,989,1052,2041,4412
-60,-40,-70,990,1051,2041,4500
70,-80,0,986,1056,2042,4405
160,70,90,999,1043,2042,4670
-90,20,-30,1017,1025,2042,4678
-100,0,-80,982,1060,2042,4503
-90,30,-110,1003,1039,2042,4616
-120,30,140,1017,1026,2043,4492
-70,-30,-70,998,1045,2043,4500
-70,0,-50,1032,1011,2043,4473
160,40,110,980,1063,2043,4490
-50,-10,-160,1010,1033,2043,4585
20,70,-50,987,1056,2043,4553
110,80,-150,1002,1041,2043,4339
170,50,90,997,1047,2044,4519
-40,-80,-80,1003,1041,2044,4660
-30,-10,-40,1013,1031,2044,4479
-170,60,60,998,1047,2045,4658
40,-50,-60,987,1058,2045,4545
-70,60,70,995,1050,2045,4493
-130,-20,70,1001,1045,2046,4618
-30,30,-130,1002,1044,2046,4517
40,80,-70,974,1072,2046,4471
0,-40,-110,1014,1032,2046,4411
70,80,-110,1001,1045,2046,4348
-50,-10,-40,1021,1025,2046,4611
-80,-70,-100,995,1051,2046,4489
-130,-40,90,991,1055,2046,4528
-130,20,-170,1007,1039,2046,4520
-100,10,-20,1031,1015,2046,4651
-90,30,-40,1020,1026,2046,4663
100,80,-140,999,1048,2047,4297
70,70,170,998,1049,2047,4666
-160,50,50,1004,1043,2047,4589
170,70,80,1015,1032,2047,4649
-140,20,40,1019,1028,2047,4840
-140,50,30,1021,1026,2047,4683
-90,80,-40,1009,1038,2047,4647
170,-60,80,984,1064,2048,4546
170,-30,120,993,1055,2048,4579
-70,10,0,1004,1044,2048,4728
-10,-60,-60,1010,1038,2048,4409
-30,40,0,1002,1046,2048,4488
-90,10,-70,1003,1046,2049,4384
-120,-40,100,1011,1038,2049,4637
-80,0,0,1015,1034,2049,4788
160,80,80,1011,1038,2049,4685
-90,0,10,1006,1043,2049,4948
-120,70,0,1006,1044,2050,4664
30,-40,-50,980,1070,2050,4477
-70,-10,180,1020,1030,2050,4537
-70,-10,-180,1020,1030,2050,4537
-110,0,10,1006,1044,2050,4809
120,50,170,1000,1050,2050,4467
-160,-70,170,982,1069,2051,4479
-90,0,0,1004,1047,2051,4790
120,80,-160,1014,1037,2051,4350
-70,10,10,995,1056,2051,4586
160,-80,90,1018,1033,2051,4480
-100,-10,60,1010,1041,2051,4517
150,50,160,998,1053,2051,4515
-160,-80,160,980,1071,2051,4577
-90,-70,-110,995,1057,2052,4495
120,80,120,1000,1052,2052,4756
-70,30,-120,1020,1032,2052,4711
-120,20,180,1010,1042,2052,4596
-120,20,-180,1010,1042,2052,4596
-150,-30,-150,997,1055,2052,4659
-70,0,-40,1021,1032,2053,4563
170,-80,120,1019,1034,2053,4742
-120,-10,60,1005,1049,2054,4563
20,70,-60,985,1069,2054,4448
-120,-20,-120,1009,1045,2054,4440
-60,70,50,994,1060,2054,4363
-60,20,-20,1017,1037,2054,4412
-100,0,10,1015,1039,2054,4894
130,40,140,980,1074,2054,4722
-90,60,90,1017,1037,2054,4437
160,0,150,992,1062,2054,4634
-90,0,110,1003,1051,2054,4528
-170,-50,70,1001,1053,2054,4727
-50,30,-120,1017,1037,2054,4594
-150,-20,70,1004,1050,2054,4577
80,80,-120,999,1056,2055,4335
-180,-50,100,994,1061,2055,4604
-50,20,10,1009,1046,2055,4666
-180,-60,140,996,1059,2055,4451
-180,70,70,1009,1046,2055,4598
180,-60,140,996,1059,2055,4451
180,-50,100,994,1061,2055,4604
-150,-30,70,1011,1044,2055,4675
180,70,70,1009,1046,2055,4598
-30,10,-140,1030,1026,2056,4582
10,0,-90,994,1062,2056,4367
-110,10,0,1014,1042,2056,4616
-160,30,70,1004,1052,2056,4650
-120,20,20,1029,1027,2056,4722
-110,10,160,1026,1030,2056,4413
-150,50,40,1019,1037,2056,4552
110,70,-160,993,1063,2056,4395
-100,0,160,1014,1042,2056,4548
-90,30,-100,1029,1027,2056,4707
-90,10,-20,1025,1032,2057,4752
-140,70,130,997,1060,2057,4580
-100,10,130,1005,1052,2057,4491
-120,-80,-150,1009,1048,2057,4449
-50,-70,-80,1009,1048,2057,4560
90,80,-130,1010,1047,2057,4303
60,80,-100,1002,1056,2058,4460
-90,-10,-70,1021,1037,2058,4654
-120,-80,120,995,1063,2058,4633
60,-80,-10,993,1065,2058,4405
-100,60,-20,1029,1029,2058,4549
-110,30,-10,1024,1034,2058,4747
-50,-20,-50,1014,1044,2058,4479
150,70,170,1001,1057,2058,4445
10,60,-140,997,1061,2058,4618
170,-70,120,1001,1058,2059,4757
140,30,160,987,1072,2059,4561
-60,10,20,1003,1056,2059,4701
-80,30,-40,1038,1021,2059,4655
-150,30,50,1029,1030,2059,4635
30,60,-80,976,1083,2059,4527
-80,30,-80,1016,1043,2059,4722
180,-30,160,989,1071,2060,4387
140,60,120,990,1070,2060,4709
-180,-30,160,989,1071,2060,4387
-120,20,160,1012,1048,2060,4468
-100,40,-20,1030,1030,2060,4675
90,-80,-20,977,1083,2060,4556
-100,-40,130,1039,1021,2060,4678
60,-70,-40,1001,1060,2061,4692
-80,-30,-70,1023,1038,2061,4849
-50,-60,-70,1000,1061,2061,4484
-140,0,60,1021,1041,2062,4811
-90,0,20,1005,1057,2062,5040
30,-20,-60,982,1080,2062,4802
20,30,-60,1004,1058,2062,4713
140,-70,40,989,1073,2062,4708
-80,30,-70,1020,1042,2062,4539
0,-20,-110,1010,1052,2062,4631
10,10,-90,991,1071,2062,4454
160,40,170,1005,1058,2063,4548
-110,10,-140,1010,1053,2063,4651
-100,-80,-130,1015,1048,2063,4464
-100,-70,-120,989,1074,2063,4516
-140,80,20,1025,1038,2063,4644
-10,-10,-130,1014,1049,2063,4531
90,60,-160,977,1086,2063,4438
130,70,120,1016,1047,2063,4656
80,50,-150,992,1072,2064,4699
140,80,-170,998,1066,2064,4530
-80,10,-50,1038,1026,2064,4707
120,60,-180,1002,1062,2064,4329
-160,10,-170,1000,1064,2064,4538
170,40,100,985,1079,2064,4544
120,60,180,1002,1062,2064,4329
-90,-80,-120,1022,1042,2064,4437
-100,0,0,1014,1050,2064,4791
-80,10,-170,1037,1028,2065,4777
160,-70,70,989,1076,2065,4745
-100,0,20,1022,1043,2065,4840
-150,-10,70,1021,1044,2065,4697
-90,30,-30,1045,1021,2066,4676
-170,30,80,1020,1046,2066,4420
-20,-80,-70,1029,1037,2066,4702
110,50,170,999,1067,2066,4637
0,20,-40,1011,1056,2067,4806
-120,0,30,1037,1030,2067,4861
180,-20,100,995,1072,2067,4385
-130,-60,100,1003,1064,2067,4694
20,-20,-80,990,1077,2067,4840
120,50,140,1021,1046,2067,4839
-150,10,60,1012,1055,2067,4724
-180,-20,100,995,1072,2067,4385
-130,-60,-150,987,1081,2068,4592
110,-80,30,998,1070,2068,4593
10,-10,-90,1009,1059,2068,4588
130,80,-170,1018,1050,2068,4373
-70,10,-40,1026,1042,2068,4555
-170,0,90,1003,1065,2068,4467
70,50,-150,989,1079,2068,4616
-10,70,-10,987,1081,2068,4539
30,80,-60,987,1082,2069,4457
-50,20,20,1032,1037,2069,4610
-50,30,0,1029,1040,2069,4448
30,60,-90,981,1088,2069,4378
-70,-20,-60,1015,1054,2069,4691
-130,20,30,1041,1028,2069,4745
20,50,-60,996,1073,2069,4585
-130,30,150,1038,1031,2069,4523
-70,40,-90,1012,1058,2070,4701
-180,-30,140,1023,1047,2070,4419
-30,80,10,989,1081,2070,4524
-20,-20,-50,1035,1035,2070,4520
180,-30,140,1023,1047,2070,4419
20,30,-70,980,1090,2070,4450
-80,-50,160,1017,1054,2071,4579
-110,-70,-130,999,1072,2071,4518
-10,20,-40,1026,1045,2071,4485
-160,80,140,996,1075,2071,4606
-10,-70,-60,1012,1059,2071,4702
-90,-30,150,1011,1061,2072,4564
-170,40,80,1023,1049,2072,4588
-160,-40,-170,995,1077,2072,4526
0,80,-130,1020,1052,2072,4703
-170,70,60,996,1076,2072,4644
140,40,140,1001,1071,2072,4674
-140,10,50,1042,1031,2073,4681
180,40,90,999,1074,2073,4473
-110,-80,-140,1019,1054,2073,4432
-180,40,90,999,1074,2073,4473
110,80,130,1009,1064,2073,4819
170,-10,160,996,1077,2073,4736
0,30,-40,1007,1066,2073,4618
-10,40,-20,986,1088,2074,4659
180,-60,130,1003,1071,2074,4483
160,10,140,1019,1055,2074,4775
-80,20,-60,1031,1043,2074,4721
-90,40,100,1003,1071,2074,4531
10,40,-40,1001,1073,2074,4845
-180,-60,130,1003,1071,2074,4483
100,-80,20,1003,1071,2074,4581
80,60,170,1002,1072,2074,4489
140,70,110,1029,1045,2074,4668
170,-60,70,987,1087,2074,4634
-110,10,170,1015,1059,2074,4723
-80,60,80,1012,1062,2074,4436
-100,20,-130,1020,1055,2075,4651
-120,10,20,1041,1034,2075,4734
-130,10,30,1039,1036,2075,4774
-160,-60,170,1016,1059,2075,4445
-10,40,-130,1022,1053,2075,4599
170,-70,90,997,1078,2075,4508
-140,-20,-140,990,1085,2075,4634
170,-10,150,1010,1065,2075,4550
180,30,170,1026,1050,2076,4729
-180,30,170,1026,1050,2076,4729
170,0,130,1018,1058,2076,4635
-130,50,20,1030,1046,2076,4750
-120,50,120,1023,1053,2076,4486
20,-50,-50,989,1088,2077,4696
30,30,-130,1017,1060,2077,4765
120,70,130,1014,1063,2077,4773
-100,40,-10,1047,1030,2077,4714
-60,-80,180,1004,1074,2078,4643
40,-90,-20,1030,1048,2078,4754
110,-90,50,1030,1048,2078,4754
140,-90,80,1030,1048,2078,4754
20,60,-70,1003,1075,2078,4574
10,-90,-50,1030,1048,2078,4754
-80,-90,-140,1030,1048,2078,4754
120,-90,60,1030,1048,2078,4754
30,-90,-30,1030,1048,2078,4754
80,-90,20,1030,1048,2078,4754
-160,-90,140,1030,1048,2078,4754
-140,-90,160,1030,1048,2078,4754
50,-90,-10,1030,1048,2078,4754
-70,-90,-130,1030,1048,2078,4754
-170,-30,180,1013,1065,2078,4512
10,-80,-50,1021,1057,2078,4850
-130,-90,170,1030,1048,2078,4754
100,-90,40,1030,1048,2078,4754
130,-90,70,1030,1048,2078,4754
70,-90,10,1030,1048,2078,4754
170,-90,110,1030,1048,2078,4754
-110,-90,-170,1030,1048,2078,4754
-150,-90,150,1030,1048,2078,4754
-10,-90,-70,1030,1048,2078,4754
150,-90,90,1030,1048,2078,4754
20,-90,-40,1030,1048,2078,4754
-180,-90,120,1030,1048,2078,4754
60,-90,0,1030,1048,2078,4754
0,-90,-60,1030,1048,2078,4754
-20,-90,-80,1030,1048,2078,4754
-50,-90,-110,1030,1048,2078,4754
-90,-90,-150,1030,1048,2078,4754
-100,-90,-160,1030,1048,2078,4754
-120,-90,-180,1030,1048,2078,4754
90,-90,30,1030,1048,2078,4754
-60,-90,-120,1030,1048,2078,4754
-120,-90,180,1030,1048,2078,4754
-170,-30,-180,1013,1065,2078,4512
-60,-80,-180,1004,1074,2078,4643
160,70,170,1000,1078,2078,4523
-40,-90,-100,1030,1048,2078,4754
-170,-90,130,1030,1048,2078,4754
160,-90,100,1030,1048,2078,4754
180,-90,120,1030,1048,2078,4754
-30,-90,-90,1030,1048,2078,4754
-40,-40,-60,1036,1043,2079,4730
90,-80,10,1000,1079,2079,4624
40,-70,-70,1006,1073,2079,4840
20,20,-70,992,1087,2079,4656
-80,0,-180,1033,1047,2080,4684
-90,60,-40,1026,1054,2080,4789
-80,0,180,1033,1047,2080,4684
170,-80,100,1036,1044,2080,4616
-180,-50,110,1015,1066,2081,4632
180,-50,110,1015,1066,2081,4632
80,-80,-30,997,1084,2081,4625
-80,20,-50,1021,1060,2081,4663
180,-80,120,1009,1073,2082,4585
-80,20,-70,1025,1057,2082,4596
120,-80,40,1005,1077,2082,4655
-110,10,-120,1043,1039,2082,4594
-100,30,-20,1022,1060,2082,4816
-110,-80,130,1007,1075,2082,4674
-180,-80,120,1009,1073,2082,4585
-130,80,10,1043,1040,2083,4678
150,40,130,1003,1080,2083,4607
50,70,-100,999,1084,2083,4532
-20,30,-30,1013,1071,2084,4598
160,30,120,1028,1056,2084,4566
0,40,-30,1005,1079,2084,4802
-10,30,-30,1004,1080,2084,4683
120,70,-170,1010,1074,2084,4563
30,30,-120,995,1089,2084,4749
150,70,100,1014,1070,2084,4649
-70,-60,170,1036,1048,2084,4556
170,30,170,1010,1075,2085,4639
-150,0,-160,1005,1080,2085,4597
-110,-20,90,1029,1056,2085,4602
100,60,-170,994,1091,2085,4445
-80,20,-150,1036,1049,2085,4714
-80,30,-120,1025,1060,2085,4672
-50,-40,-70,1022,1063,2085,4557
-80,30,-100,1026,1060,2086,4554
-110,-30,100,1046,1040,2086,4754
70,70,-130,1014,1072,2086,4523
-180,-40,140,1018,1068,2086,4589
180,-40,140,1018,1068,2086,4589
150,20,150,999,1087,2086,4766
-30,80,-100,1030,1057,2087,5000
-70,60,-70,999,1088,2087,4787
-40,-50,-70,1019,1068,2087,4773
150,-70,50,996,1091,2087,4688
-100,-10,70,1020,1067,2087,4582
-180,-10,100,1008,1079,2087,4592
10,-60,-100,1015,1072,2087,4623
180,-10,100,1008,1079,2087,4592
-40,40,-10,1021,1066,2087,4625
180,-10,-180,1010,1078,2088,4839
-110,0,20,1021,1067,2088,4934
-180,-10,180,1010,1078,2088,4839
-180,-10,-180,1010,1078,2088,4839
180,-10,180,1010,1078,2088,4839
-140,-20,70,1027,1061,2088,4747
50,80,-90,1002,1086,2088,4585
0,-10,-50,1038,1050,2088,4576
-160,-70,80,999,1089,2088,4537
20,50,-80,1010,1078,2088,4548
-80,40,-50,1050,1038,2088,4677
-120,-20,80,1015,1074,2089,4600
160,40,160,1014,1075,2089,4508
-100,-80,140,1025,1064,2089,4660
-20,80,-110,1029,1060,2089,4922
150,50,120,1028,1061,2089,4684
160,20,150,1012,1077,2089,4718
-170,-70,150,996,1093,2089,4451
140,-80,30,987,1102,2089,4680
-90,40,-30,1043,1046,2089,4626
-170,10,90,1024,1066,2090,4463
-30,20,-30,1017,1073,2090,4701
-90,0,30,1019,1071,2090,4856
160,10,150,1001,1089,2090,4762
150,80,-180,1010,1080,2090,4582
40,70,-90,1015,1075,2090,4667
150,80,180,1010,1080,2090,4582
-150,60,40,1035,1055,2090,4815
50,-80,-20,1012,1078,2090,4489
180,-60,100,998,1093,2091,4565
-180,-60,100,998,1093,2091,4565
-150,-50,-170,1004,1087,2091,4360
80,-80,0,1008,1083,2091,4611
-90,50,-30,1039,1052,2091,4619
70,-80,-40,1003,1089,2092,4700
-10,80,-120,1031,1061,2092,4810
160,70,100,1018,1074,2092,4634
-70,-70,170,1019,1073,2092,4752
-60,-10,-170,1053,1039,2092,4647
-150,60,140,1020,1072,2092,4613
-80,10,80,1036,1056,2092,4751
-60,-20,-60,1033,1059,2092,4744
-130,-20,-130,1009,1083,2092,4809
-110,40,120,1022,1071,2093,4580
170,20,110,993,1100,2093,4467
-50,30,40,1025,1069,2094,4662
-80,30,-90,1027,1067,2094,4665
20,80,-50,1006,1088,2094,4517
-40,80,20,1004,1090,2094,4572
-110,20,-10,1036,1058,2094,4753
60,-70,-30,994,1100,2094,4437
-150,-70,-180,1003,1092,2095,4625
-120,50,10,1048,1047,2095,4835
-150,-70,180,1003,1092,2095,4625
150,20,160,1013,1082,2095,4698
-10,60,-10,1006,1089,2095,4670
-30,50,10,1023,1072,2095,4723
40,-70,-40,989,1106,2095,4697
-40,-60,-70,1013,1082,2095,4764
-80,-40,-80,1046,1050,2096,4628
-140,40,40,1044,1052,2096,4668
40,-50,-50,1016,1080,2096,4612
-30,40,-20,1030,1066,2096,4540
-110,-10,-100,1043,1053,2096,4551
-90,-30,-80,1058,1038,2096,4924
-80,80,-50,1025,1071,2096,4810
170,10,130,1011,1086,2097,4581
50,60,-120,1030,1067,2097,4609
-80,40,-60,1057,1040,2097,4761
-140,30,40,1038,1059,2097,4747
-100,-10,80,1036,1061,2097,4635
170,-10,140,1033,1064,2097,4832
140,30,150,1009,1089,2098,4822
-160,40,70,1040,1058,2098,4664
-80,10,-20,1042,1056,2098,4745
-110,-50,120,1035,1063,2098,4782
-150,-80,170,997,1101,2098,4632
-160,60,50,1022,1076,2098,4786
-30,-40,-60,1030,1069,2099,4527
-80,10,-60,1043,1056,2099,4695
-10,-50,-60,1035,1064,2099,4697
50,-60,-50,1020,1079,2099,4682
20,30,-100,1010,1090,2100,4536
-130,30,30,1059,1041,2100,4749
100,50,170,1026,1074,2100,4792
-30,-70,-70,1017,1083,2100,4774
60,70,-180,1020,1080,2100,4630
150,70,110,1006,1094,2100,4721
-170,20,90,1039,1061,2100,4478
10,10,-110,1013,1087,2100,4587
60,70,180,1020,1080,2100,4630
-110,-10,60,1011,1090,2101,4637
130,-80,50,1006,1095,2101,4680
-80,30,-50,1045,1056,2101,4595
-110,10,-110,1016,1086,2102,4735
-40,10,-30,1045,1057,2102,4447
180,50,160,1033,1069,2102,4412
-170,-40,170,1001,1101,2102,4430
150,30,140,1010,1092,2102,4827
-90,0,40,1015,1087,2102,4824
-180,50,160,1033,1069,2102,4412
160,50,160,1013,1090,2103,4516
-60,20,0,1035,1068,2103,4725
-100,20,-20,1028,1075,2103,4879
180,-30,150,1021,1083,2104,4653
-160,0,80,1023,1081,2104,4412
-180,-30,150,1021,1083,2104,4653
-30,-20,-50,1030,1075,2105,4557
150,60,120,1027,1078,2105,4638
-100,10,-10,1035,1070,2105,4697
-50,0,-40,1065,1040,2105,4726
-120,20,150,1051,1054,2105,4498
-160,50,150,1024,1081,2105,4485
-140,-10,70,1036,1069,2105,4782
-170,60,150,1029,1076,2105,4547
-80,70,-50,1034,1071,2105,4710
-50,30,30,1025,1080,2105,4604
150,40,160,1030,1076,2106,4711
-170,60,70,1018,1088,2106,4689
170,60,90,1019,1087,2106,4592
-130,70,120,1023,1083,2106,4680
30,-50,-50,1004,1102,2106,4748
-50,-50,-70,1027,1079,2106,4622
80,60,-150,1003,1103,2106,4599
10,50,-40,1012,1095,2107,4881
150,-80,40,995,1112,2107,4744
10,10,-120,1036,1071,2107,4889
-160,70,50,1011,1096,2107,4708
-180,-60,90,1011,1096,2107,4737
-170,-80,130,1033,1074,2107,4703
140,80,180,1034,1073,2107,4440
60,60,-130,1024,1083,2107,4575
-50,-80,-90,1033,1074,2107,4775
180,-60,90,1011,1096,2107,4737
140,80,-180,1034,1073,2107,4440
160,80,170,1009,1098,2107,4611
-80,10,10,1023,1085,2108,4753
-110,70,-10,1032,1076,2108,4717
-20,60,0,1020,1088,2108,4707
90,60,-170,1018,1090,2108,4618
30,-70,-80,1023,1085,2108,4877
-170,-40,80,1020,1088,2108,4834
70,-80,-10,1016,1092,2108,4689
-70,-80,170,1025,1084,2109,4680
160,20,130,1024,1085,2109,4652
20,60,-80,1018,1091,2109,4578
10,70,-140,1039,1070,2109,4779
-140,60,30,1036,1073,2109,4896
170,-20,120,1011,1098,2109,4491
170,40,160,1026,1084,2110,4719
-170,40,160,1040,1070,2110,4529
-170,-60,70,1029,1082,2111,4822
-170,-50,100,1025,1086,2111,4684
-120,0,50,1039,1072,2111,4740
100,80,140,1022,1089,2111,5030
40,80,-80,1015,1096,2111,4562
-180,-70,130,1033,1078,2111,4736
-110,50,110,1031,1080,2111,4495
180,-70,130,1033,1078,2111,4736
-100,50,-10,1034,1077,2111,4759
170,0,140,1030,1081,2111,4748
60,70,-120,1023,1089,2112,4520
-70,20,60,1035,1077,2112,4669
180,-70,110,1045,1067,2112,4627
-140,-80,-180,1015,1097,2112,4679
-120,-60,-140,1015,1097,2112,4665
170,70,160,1019,1093,2112,4616
-100,-30,120,1044,1068,2112,4915
-140,-80,180,1015,1097,2112,4679
-60,-80,-100,1032,1080,2112,4818
0,10,-130,1045,1067,2112,4672
-40,40,10,1043,1069,2112,4515
-110,-50,-120,1024,1088,2112,4627
-40,40,0,1031,1081,2112,4562
-180,-70,110,1045,1067,2112,4627
30,-40,-70,1009,1103,2112,4779
-120,-50,-130,1033,1080,2113,4654
-110,30,0,1040,1073,2113,4702
-50,60,40,1025,1088,2113,4638
-80,-50,-90,1043,1070,2113,4705
-70,10,-50,1048,1065,2113,4784
-160,10,80,1024,1089,2113,4706
10,80,-40,1026,1087,2113,4563
10,40,-50,1022,1091,2113,4766
-130,60,20,1037,1076,2113,4845
-120,80,0,1052,1062,2114,4727
160,50,110,1034,1080,2114,4688
-180,-80,130,1041,1073,2114,4832
180,-80,130,1041,1073,2114,4832
180,-50,130,1020,1094,2114,4523
20,40,-90,1012,1102,2114,4774
-180,-50,130,1020,1094,2114,4523
-110,50,0,1050,1064,2114,4778
-20,70,0,1006,1108,2114,4734
-70,80,-60,1026,1089,2115,4940
20,20,-60,1015,1100,2115,4937
-110,60,0,1033,1082,2115,4785
-110,0,30,1031,1085,2116,5030
180,20,100,1023,1093,2116,4593
-110,-20,-100,1045,1071,2116,4506
150,60,170,1023,1093,2116,4482
20,-60,-50,1010,1106,2116,4724
-180,20,100,1023,1093,2116,4593
130,60,130,1033,1084,2117,4849
-70,20,-50,1074,1043,2117,4730
-50,30,-10,1052,1065,2117,4815
80,60,-160,1021,1096,2117,4644
-50,40,-110,1052,1065,2117,4800
-170,-40,100,1031,1086,2117,4630
-160,-10,80,1024,1093,2117,4503
0,-60,-110,1035,1082,2117,4533
-100,40,110,1039,1079,2118,4676
-180,-60,110,1026,1092,2118,4650
10,-20,-90,1029,1089,2118,4751
50,70,-110,1029,1089,2118,4545
180,-60,110,1026,1092,2118,4650
-140,-40,-140,1018,1100,2118,4549
30,60,-150,1044,1075,2119,4944
-120,30,20,1076,1043,2119,4728
-140,70,30,1028,1091,2119,4800
-40,80,-90,1046,1073,2119,4991
160,-70,60,1010,1109,2119,4771
-50,80,30,1012,1108,2120,4632
-90,40,-20,1037,1083,2120,4817
60,50,-150,1020,1100,2120,4672
130,60,170,1043,1077,2120,4526
130,-80,40,1022,1098,2120,4729
0,40,-40,1034,1086,2120,4626
-70,70,60,1026,1094,2120,4543
180,10,100,1031,1090,2121,4507
-40,40,20,1043,1078,2121,4650
-180,10,100,1031,1090,2121,4507
140,50,130,1030,1091,2121,4723
70,60,-140,1019,1102,2121,4682
30,-60,-50,1014,1107,2121,4880
50,-70,-40,1033,1088,2121,4633
-150,70,40,1021,1101,2122,4744
-70,-10,-60,1054,1068,2122,4680
-160,60,60,1024,1098,2122,4796
-90,-80,150,1031,1091,2122,4711
20,30,-110,1037,1085,2122,4827
160,60,110,1037,1085,2122,4706
120,-80,30,1026,1096,2122,4683
-80,-60,160,1046,1077,2123,4656
140,-80,60,1022,1101,2123,4713
-130,40,30,1074,1049,2123,4777
-110,0,-100,1039,1084,2123,4775
-60,40,60,1029,1094,2123,4675
180,0,100,1036,1087,2123,4516
-70,10,20,1026,1097,2123,4814
-60,80,-70,1042,1081,2123,5006
-110,80,-10,1056,1067,2123,4738
20,50,-140,1033,1090,2123,4656
110,50,160,1028,1095,2123,4781
40,-80,-30,1005,1118,2123,4587
-180,0,100,1036,1087,2123,4516
170,50,160,1040,1084,2124,4499
160,10,170,1017,1107,2124,4790
-160,-50,170,1038,1086,2124,4620
-150,-50,80,1053,1071,2124,4720
180,-40,110,1017,1108,2125,4499
-70,0,-60,1043,1082,2125,4607
-180,-40,110,1017,1108,2125,4499
170,10,150,1037,1088,2125,4896
-130,-80,-170,1037,1089,2126,4756
-50,10,-150,1072,1054,2126,4793
30,50,-100,1017,1109,2126,4604
-80,20,-30,1043,1083,2126,4921
-160,30,160,1054,1072,2126,4653
-80,10,0,1050,1076,2126,5045
80,70,-140,1038,1089,2127,4679
20,-70,-50,1034,1093,2127,4724
-80,-80,160,1025,1102,2127,4706
-60,50,-90,1038,1089,2127,4897
-110,70,100,1040,1087,2127,4677
120,60,140,1025,1102,2127,4876
-20,-40,-60,1040,1087,2127,4624
-100,-10,140,1050,1077,2127,4778
90,80,150,1031,1096,2127,5009
-80,10,-10,1066,1062,2128,5151
-40,50,-110,1042,1086,2128,4923
-70,50,-70,1046,1082,2128,4797
100,60,-180,1046,1082,2128,4826
10,10,-100,1034,1094,2128,4671
100,60,180,1046,1082,2128,4826
50,50,-150,1043,1085,2128,4719
-100,-20,-90,1053,1075,2128,4700
10,20,-130,1051,1077,2128,4915
-150,80,130,1020,1108,2128,4667
180,50,90,1023,1106,2129,4680
-60,50,60,1035,1094,2129,4607
-20,30,-130,1047,1082,2129,4806
-100,-50,-110,1027,1102,2129,4655
-180,50,90,1023,1106,2129,4680
-70,20,-10,1066,1064,2130,4775
-180,10,-180,1027,1103,2130,4771
-90,50,-20,1058,1072,2130,4641
180,-80,110,1062,1068,2130,4740
180,10,180,1027,1103,2130,4771
-40,-20,-50,1039,1091,2130,4594
-180,10,180,1027,1103,2130,4771
140,70,120,1022,1108,2130,4731
180,-50,140,1057,1073,2130,4741
-180,-50,140,1057,1073,2130,4741
180,10,-180,1027,1103,2130,4771
0,-70,-60,1019,1111,2130,4678
-180,-80,110,1062,1068,2130,4740
-20,10,-40,1047,1083,2130,4771
170,60,160,1025,1106,2131,4614
-170,-40,160,1020,1111,2131,4669
-80,10,70,1050,1082,2132,4848
10,70,-40,1026,1106,2132,4780
10,30,-50,1028,1104,2132,4878
170,20,120,1032,1100,2132,4763
130,40,150,1041,1092,2133,4855
170,70,90,1063,1070,2133,4645
-50,80,-80,1043,1090,2133,4970
-80,-70,160,1039,1094,2133,4823
-120,-80,-160,1037,1096,2133,4795
140,60,130,1039,1095,2134,4791
-170,-60,140,1031,1103,2134,4759
140,-80,50,1028,1106,2134,4784
-40,-10,-40,1065,1069,2134,4989
30,70,-80,1029,1105,2134,4713
-60,20,40,1048,1086,2134,4737
10,10,-80,1019,1115,2134,4678
20,20,-120,1016,1118,2134,4928
-100,20,-120,1050,1084,2134,4901
-90,0,50,1036,1098,2134,4847
40,50,-120,1029,1105,2134,4641
160,20,140,1021,1114,2135,4828
-180,-70,120,1037,1098,2135,4618
-50,40,0,1043,1092,2135,4660
-100,20,-100,1029,1106,2135,4759
180,-70,120,1037,1098,2135,4618
-90,-40,-90,1049,1086,2135,4716
-50,30,20,1048,1087,2135,4749
180,60,80,1035,1100,2135,4711
160,-70,50,1026,1109,2135,4877
-180,60,80,1035,1100,2135,4711
-120,60,10,1048,1087,2135,4826
60,-80,-50,1032,1104,2136,4860
-110,-80,-150,1044,1092,2136,4816
110,-80,20,1027,1109,2136,4667
-130,-50,-140,1043,1093,2136,4533
50,-70,-50,1043,1093,2136,4773
-70,40,-80,1046,1091,2137,4783
-100,80,-20,1065,1072,2137,4809
-60,-10,-50,1080,1057,2137,4859
-90,-50,-100,1036,1101,2137,4825
-180,40,160,1045,1092,2137,4657
180,40,160,1045,1092,2137,4657
0,-80,-60,1039,1098,2137,4943
-60,80,40,1021,1116,2137,4650
-110,10,10,1064,1074,2138,4902
50,70,-170,1059,1079,2138,4751
-150,50,50,1064,1074,2138,4825
-130,20,-180,1039,1099,2138,4794
20,-30,-80,1049,1089,2138,4828
-20,-70,-70,1053,1085,2138,4811
-70,10,-60,1034,1104,2138,4692
-170,30,90,1042,1096,2138,4545
-130,20,180,1039,1099,2138,4794
-70,10,40,1055,1084,2139,4924
-120,0,40,1059,1080,2139,4878
-80,40,-30,1058,1081,2139,4858
-170,-40,90,1037,1102,2139,4904
-170,20,170,1053,1086,2139,4876
80,80,160,1044,1095,2139,5054
20,10,-70,1026,1113,2139,4929
120,50,150,1034,1105,2139,4850
-160,50,60,1053,1086,2139,4653
-80,40,-40,1080,1060,2140,4657
-70,-20,180,1050,1090,2140,4727
-160,-70,160,1036,1104,2140,4582
70,60,-180,1040,1100,2140,4766
-70,-20,-180,1050,1090,2140,4727
-80,10,20,1033,1107,2140,4775
-100,60,-10,1052,1088,2140,4890
-180,-60,70,1033,1107,2140,4951
-110,20,10,1062,1078,2140,5015
180,-60,70,1033,1107,2140,4951
10,0,-80,1043,1097,2140,4728
70,60,180,1040,1100,2140,4766
170,80,160,1019,1122,2141,4697
140,50,160,1051,1090,2141,4741
-100,30,-10,1058,1083,2141,4821
-180,-60,120,1030,1111,2141,4648
-80,60,-50,1065,1076,2141,4781
180,-60,120,1030,1111,2141,4648
140,40,160,1026,1115,2141,4782
160,30,160,1051,1091,2142,4756
-140,30,150,1058,1084,2142,4625
110,70,140,1044,1098,2142,4931
-130,20,170,1051,1091,2142,4742
-180,-50,80,1028,1114,2142,4816
-100,-30,130,1071,1071,2142,4800
-50,-50,-80,1041,1101,2142,4749
180,-50,80,1028,1114,2142,4816
20,-70,-90,1036,1107,2143,4914
-130,0,60,1050,1094,2144,4937
110,60,180,1046,1098,2144,4520
-90,-20,160,1052,1092,2144,4825
110,60,-180,1046,1098,2144,4520
-90,30,100,1039,1105,2144,4623
-110,20,20,1077,1067,2144,4950
-70,20,-150,1061,1083,2144,4813
-70,20,0,1057,1087,2144,4661
-180,-50,120,1039,1106,2145,4562
-30,40,-10,1036,1109,2145,4711
180,-50,120,1039,1106,2145,4562
-90,10,-10,1051,1094,2145,5001
10,60,-40,1030,1115,2145,4828
-100,-80,-140,1052,1093,2145,4814
-60,20,-140,1054,1091,2145,4808
10,-10,-50,1039,1106,2145,4833
-90,10,-170,1061,1084,2145,4934
150,80,110,1048,1098,2146,4681
150,80,170,1044,1102,2146,4527
30,80,-70,1028,1118,2146,4651
-100,-10,150,1059,1087,2146,4779
-100,70,-20,1066,1080,2146,4888
-90,-80,-130,1051,1095,2146,4824
160,60,160,1026,1120,2146,4613
-140,-70,-170,1043,1103,2146,4762
-150,40,60,1073,1073,2146,4930
-150,20,170,1072,1075,2147,4751
-10,-10,-50,1055,1092,2147,4725
-70,30,-50,1073,1074,2147,4704
-30,-80,-80,1050,1097,2147,4823
-100,70,90,1040,1107,2147,4593
-180,80,70,1064,1083,2147,4907
-60,40,-100,1054,1093,2147,4731
-80,40,-20,1063,1084,2147,4734
180,80,70,1064,1083,2147,4907
-160,20,170,1050,1097,2147,4809
-70,-80,-110,1049,1099,2148,4849
-140,40,140,1048,1100,2148,4695
-90,0,-70,1047,1101,2148,4945
40,-60,-50,1035,1113,2148,4674
0,80,-30,1037,1112,2149,4731
20,10,-60,1038,1111,2149,4997
-100,0,30,1050,1099,2149,4955
10,20,-70,1049,1100,2149,4691
-150,20,180,1051,1099,2150,4952
-150,20,-180,1051,1099,2150,4952
-110,20,0,1065,1085,2150,4990
10,70,-50,1030,1121,2151,4717
-90,80,-30,1058,1093,2151,4914
-130,70,20,1051,1100,2151,4879
-90,20,-20,1048,1103,2151,4937
40,40,-130,1027,1124,2151,4876
130,50,140,1026,1125,2151,4820
180,-70,100,1036,1116,2152,4764
-60,-60,-80,1054,1098,2152,4685
-80,50,-40,1071,1081,2152,4837
20,30,-130,1042,1110,2152,4915
60,-80,-20,1029,1123,2152,4803
-50,-60,-80,1046,1106,2152,4820
-180,-70,100,1036,1116,2152,4764
-180,-20,170,1043,1110,2153,4830
-10,-60,-120,1044,1109,2153,4638
-170,-80,140,1049,1104,2153,4863
-100,10,180,1062,1091,2153,4933
-50,10,-30,1099,1054,2153,4881
180,-20,170,1043,1110,2153,4830
-70,80,50,1021,1132,2153,4614
10,20,-90,1039,1114,2153,4599
30,-30,-60,1023,1130,2153,4939
-100,10,-180,1062,1091,2153,4933
130,70,180,1042,1112,2154,4692
130,70,-180,1042,1112,2154,4692
-100,20,-110,1067,1087,2154,4828
-60,10,-160,1048,1106,2154,4875
-140,-30,-140,1028,1126,2154,4935
10,50,-50,1049,1105,2154,4708
-60,-70,-90,1052,1103,2155,4749
-110,30,10,1073,1082,2155,4816
-100,10,-90,1047,1108,2155,4862
0,50,-40,1032,1123,2155,4709
0,-60,-60,1053,1102,2155,4936
-140,80,120,1035,1120,2155,4693
130,70,130,1032,1123,2155,4773
-140,20,170,1073,1083,2156,4702
-70,20,-40,1074,1082,2156,4875
10,60,-50,1028,1128,2156,4705
130,50,160,1044,1112,2156,4830
-110,-40,120,1054,1102,2156,4989
-170,-60,150,1044,1112,2156,4678
30,50,-110,1046,1110,2156,4803
170,80,80,1066,1090,2156,4906
70,80,170,1043,1114,2157,5110
110,60,150,1035,1122,2157,4926
10,30,-80,1052,1105,2157,4793
-70,40,-50,1072,1085,2157,4890
-90,0,70,1052,1105,2157,4862
10,60,-60,1034,1123,2157,4758
-150,20,60,1079,1078,2157,4793
-90,70,80,1042,1115,2157,4622
-50,-10,-50,1061,1097,2158,4696
-60,10,-40,1065,1093,2158,4725
150,60,160,1064,1094,2158,4728
180,80,80,1040,1118,2158,4688
-60,-30,-70,1060,1098,2158,4753
-130,-10,70,1062,1096,2158,4938
-180,80,80,1040,1118,2158,4688
160,80,100,1058,1101,2159,4623
-10,40,-30,1038,1121,2159,4824
10,50,-70,1055,1104,2159,4780
-170,-70,140,1052,1107,2159,4786
170,50,100,1037,1122,2159,4764
-70,40,-30,1070,1089,2159,4844
-40,-70,-80,1051,1108,2159,4982
-110,-60,-130,1030,1130,2160,4805
170,-70,80,1039,1121,2160,4893
-170,70,70,1068,1092,2160,4863
10,50,-60,1034,1126,2160,4713
-110,-10,70,1069,1091,2160,4854
-160,50,70,1063,1097,2160,4854
90,-80,-10,1047,1113,2160,4803
110,80,150,1058,1102,2160,4803
-80,80,60,1028,1132,2160,4640
-80,30,-110,1083,1077,2160,4912
-150,0,70,1042,1118,2160,4797
100,-80,10,1032,1129,2161,4696
-90,-20,-80,1080,1081,2161,4866
-120,-50,110,1061,1100,2161,4906
30,-80,-40,1035,1126,2161,4680
150,-80,70,1038,1123,2161,4758
-160,-80,140,1044,1117,2161,4795
130,80,130,1056,1105,2161,4692
160,70,160,1061,1101,2162,4586
-80,-20,170,1060,1102,2162,4870
-80,-30,-80,1064,1098,2162,4744
-10,-80,-70,1050,1112,2162,5080
-170,50,150,1080,1082,2162,4648
-80,10,-70,1076,1086,2162,4977
40,70,-100,1050,1112,2162,4491
-70,-40,-80,1085,1078,2163,4701
40,-60,-60,1060,1103,2163,4878
20,80,-60,1039,1124,2163,4733
-90,60,-30,1057,1106,2163,4796
-20,-10,-50,1073,1091,2164,4772
-50,30,10,1064,1100,2164,4795
-120,-10,-130,1057,1107,2164,4714
140,80,120,1046,1118,2164,4728
-70,-20,-70,1051,1113,2164,4729
-40,30,-20,1051,1113,2164,4776
-80,50,-30,1075,1089,2164,4883
120,80,140,1056,1108,2164,4727
50,-80,-60,1053,1112,2165,4937
-140,-50,-160,1049,1116,2165,4536
-180,70,150,1039,1126,2165,4694
100,60,160,1040,1125,2165,4833
-10,-40,-120,1071,1094,2165,4785
-170,80,70,1060,1105,2165,4752
-80,30,-30,1093,1072,2165,4946
-80,-80,-120,1053,1112,2165,4888
180,70,150,1039,1126,2165,4694
-110,-30,110,1064,1102,2166,4887
120,70,140,1037,1129,2166,4753
-170,-70,130,1053,1113,2166,4713
160,30,140,1047,1119,2166,4837
-90,20,-80,1059,1107,2166,4834
-30,60,10,1043,1123,2166,4778
-180,-20,130,1054,1112,2166,4729
-40,-10,-150,1072,1094,2166,4991
180,-20,130,1054,1112,2166,4729
-180,-40,130,1062,1105,2167,4680
-70,90,40,1036,1131,2167,4682
-30,-60,-70,1051,1116,2167,4872
-10,90,-20,1036,1131,2167,4682
-120,90,90,1036,1131,2167,4682
110,90,-140,1036,1131,2167,4682
-150,90,120,1036,1131,2167,4682
0,90,-30,1036,1131,2167,4682
-20,90,-10,1036,1131,2167,4682
-50,90,20,1036,1131,2167,4682
-180,90,150,1036,1131,2167,4682
160,90,170,1036,1131,2167,4682
10,90,-40,1036,1131,2167,4682
50,90,-80,1036,1131,2167,4682
150,90,-180,1036,1131,2167,4682
-170,-80,120,1070,1097,2167,4940
-30,90,0,1036,1131,2167,4682
20,90,-50,1036,1131,2167,4682
-90,90,60,1036,1131,2167,4682
-170,90,140,1036,1131,2167,4682
150,30,150,1030,1137,2167,4936
-60,90,30,1036,1131,2167,4682
-130,90,100,1036,1131,2167,4682
60,90,-90,1036,1131,2167,4682
-110,90,80,1036,1131,2167,4682
100,90,-130,1036,1131,2167,4682
-100,90,70,1036,1131,2167,4682
-80,90,50,1036,1131,2167,4682
-140,90,110,1036,1131,2167,4682
130,90,-160,1036,1131,2167,4682
-70,30,-30,1088,1079,2167,4810
-90,-60,150,1052,1115,2167,4874
180,80,150,1037,1130,2167,4739
180,90,150,1036,1131,2167,4682
170,90,160,1036,1131,2167,4682
30,90,-60,1036,1131,2167,4682
-180,80,150,1037,1130,2167,4739
-160,90,130,1036,1131,2167,4682
80,90,-110,1036,1131,2167,4682
120,90,-150,1036,1131,2167,4682
180,-40,130,1062,1105,2167,4680
70,90,-100,1036,1131,2167,4682
90,90,-120,1036,1131,2167,4682
40,90,-70,1036,1131,2167,4682
-40,90,10,1036,1131,2167,4682
140,90,-170,1036,1131,2167,4682
150,90,180,1036,1131,2167,4682
-100,10,0,1080,1088,2168,4982
-140,50,40,1090,1078,2168,4869
-90,70,-30,1081,1087,2168,4993
-80,50,-50,1082,1086,2168,4910
170,20,140,1065,1103,2168,4827
170,20,150,1060,1108,2168,4870
-10,-50,-120,1066,1102,2168,4702
120,50,160,1050,1118,2168,4784
-90,10,10,1086,1083,2169,5072
160,30,150,1059,1110,2169,4854
170,80,90,1055,1114,2169,4599
-120,-70,-150,1036,1133,2169,4726
-80,70,70,1045,1124,2169,4649
-70,10,30,1058,1111,2169,4989
160,10,160,1045,1124,2169,4906
-100,-20,110,1064,1106,2170,5030
-160,-30,-170,1043,1127,2170,4812
160,80,160,1044,1126,2170,4608
-50,50,40,1052,1118,2170,4769
-180,70,80,1071,1099,2170,4804
-70,40,-20,1116,1054,2170,4933
180,70,80,1071,1099,2170,4804
30,-40,-60,1027,1143,2170,4957
-110,10,20,1076,1095,2171,5131
110,-80,10,1042,1129,2171,4889
100,-80,0,1042,1129,2171,4810
100,80,-150,1028,1143,2171,4557
180,-20,160,1064,1107,2171,4828
180,30,160,1071,1100,2171,4818
-180,30,160,1071,1100,2171,4818
-110,40,10,1085,1086,2171,4900
-60,20,10,1045,1126,2171,4979
-160,70,140,1056,1115,2171,4655
10,40,-60,1053,1118,2171,4779
-180,-20,160,1064,1107,2171,4828
-20,40,-20,1045,1126,2171,4913
-110,0,150,1085,1087,2172,4836
120,80,130,1063,1109,2172,4919
-140,-50,90,1071,1101,2172,4826
-40,50,20,1078,1094,2172,4992
-130,10,50,1069,1104,2173,5051
180,0,110,1074,1099,2173,4689
-70,70,-60,1067,1106,2173,4891
-160,-20,80,1058,1115,2173,4921
170,30,150,1063,1110,2173,4859
-180,0,110,1074,1099,2173,4689
150,50,130,1067,1107,2174,4788
-180,0,180,1036,1138,2174,5004
-180,0,-180,1036,1138,2174,5004
-170,-50,90,1055,1119,2174,4901
130,80,120,1062,1112,2174,4888
-80,-10,-70,1077,1097,2174,4916
180,0,-180,1036,1138,2174,5004
180,-20,140,1076,1098,2174,4697
180,0,180,1036,1138,2174,5004
-170,-60,120,1054,1120,2174,4716
170,-70,70,1028,1146,2174,4889
170,30,110,1035,1139,2174,4773
-180,-20,140,1076,1098,2174,4697
-170,80,60,1074,1100,2174,4979
160,80,90,1074,1101,2175,4914
-40,50,-10,1060,1115,2175,4747
160,40,150,1060,1115,2175,4914
150,-80,60,1049,1126,2175,4889
0,50,-30,1052,1123,2175,5045
90,70,-150,1073,1102,2175,4851
-60,60,-80,1038,1137,2175,5160
-100,20,0,1082,1093,2175,4959
170,0,170,1022,1154,2176,5008
130,50,150,1059,1117,2176,4869
-70,20,-20,1104,1072,2176,4931
-170,-30,100,1054,1122,2176,4562
100,70,-160,1059,1117,2176,4858
40,-70,-50,1049,1127,2176,4756
-70,30,-100,1073,1103,2176,4729
-90,-70,150,1070,1106,2176,4882
80,70,-160,1047,1129,2176,4867
-100,-60,-120,1036,1140,2176,4944
-70,30,-110,1076,1100,2176,4868
170,0,150,1055,1121,2176,4996
-90,80,70,1045,1132,2177,4626
-130,-20,80,1078,1099,2177,4976
0,-10,-110,1060,1117,2177,4848
10,80,-50,1046,1131,2177,4785
-30,50,-20,1059,1118,2177,4620
70,60,-150,1045,1132,2177,4763
120,60,170,1069,1109,2178,4895
-60,-50,-80,1054,1124,2178,4788
-10,-70,-70,1053,1125,2178,4864
0,50,-70,1072,1106,2178,4778
160,20,170,1037,1141,2178,5040
-70,-50,-90,1050,1128,2178,4594
170,10,140,1054,1124,2178,4920
-50,-20,-160,1081,1097,2178,4846
-140,-30,80,1071,1108,2179,4971
50,50,-130,1042,1137,2179,4845
90,-80,0,1037,1142,2179,4777
-160,20,80,1081,1098,2179,4749
50,-80,-30,1047,1132,2179,4848
-50,50,-100,1053,1126,2179,4967
-100,10,10,1089,1090,2179,5085
-20,20,-40,1075,1104,2179,4922
-80,80,-40,1077,1103,2180,5029
-130,-70,-160,1043,1137,2180,4779
10,0,-50,1070,1110,2180,5141
-90,-40,150,1071,1109,2180,4731
-10,40,-40,1079,1101,2180,4694
-80,-20,-70,1094,1086,2180,5004
-10,50,-50,1079,1101,2180,4802
170,0,160,1048,1132,2180,4866
-140,20,50,1093,1087,2180,5090
170,30,160,1068,1112,2180,4929
-70,30,70,1050,1131,2181,4926
140,40,150,1048,1133,2181,4967
-100,20,-10,1070,1111,2181,4920
0,40,-130,1069,1112,2181,4886
150,80,100,1068,1114,2182,4864
-100,50,100,1069,1113,2182,4670
-40,-80,-90,1075,1107,2182,4942
-160,-80,150,1066,1116,2182,4877
-130,20,160,1057,1125,2182,4729
-80,20,10,1082,1100,2182,4838
0,20,-130,1075,1107,2182,5011
140,80,110,1061,1121,2182,4851
-50,-20,-60,1086,1097,2183,4948
10,40,-80,1063,1120,2183,4776
-180,-10,130,1072,1111,2183,4828
-120,20,140,1069,1114,2183,4741
-150,30,60,1073,1110,2183,4831
0,40,-50,1048,1135,2183,4725
180,-10,130,1072,1111,2183,4828
-170,30,160,1084,1099,2183,4742
-30,40,-120,1063,1120,2183,4989
10,90,-130,1078,1106,2184,5055
60,90,-180,1078,1106,2184,5055
-140,90,20,1078,1106,2184,5055
130,90,110,1078,1106,2184,5055
-130,90,10,1078,1106,2184,5055
-60,90,-60,1078,1106,2184,5055
50,90,-170,1078,1106,2184,5055
100,90,140,1078,1106,2184,5055
170,90,70,1078,1106,2184,5055
160,90,80,1078,1106,2184,5055
70,90,170,1078,1106,2184,5055
-180,-30,110,1063,1121,2184,4639
-120,70,110,1068,1116,2184,4680
-10,90,-110,1078,1106,2184,5055
160,-80,50,1039,1145,2184,4901
-180,90,60,1078,1106,2184,5055
-120,90,0,1078,1106,2184,5055
-80,90,-40,1078,1106,2184,5055
-100,10,20,1089,1095,2184,5179
90,80,170,1057,1127,2184,4847
180,90,60,1078,1106,2184,5055
-120,40,20,1097,1087,2184,4862
20,90,-140,1078,1106,2184,5055
0,90,-120,1078,1106,2184,5055
-70,90,-50,1078,1106,2184,5055
-140,0,70,1070,1114,2184,4970
-90,90,-30,1078,1106,2184,5055
-110,90,-10,1078,1106,2184,5055
-160,90,40,1078,1106,2184,5055
30,-70,-50,1034,1150,2184,4903
90,90,150,1078,1106,2184,5055
-20,90,-100,1078,1106,2184,5055
-30,90,-90,1078,1106,2184,5055
-150,90,30,1078,1106,2184,5055
110,90,130,1078,1106,2184,5055
-50,-80,-100,1075,1109,2184,4994
-40,90,-80,1078,1106,2184,5055
30,90,-150,1078,1106,2184,5055
60,90,180,1078,1106,2184,5055
140,90,100,1078,1106,2184,5055
-170,90,50,1078,1106,2184,5055
120,90,120,1078,1106,2184,5055
-50,90,-70,1078,1106,2184,5055
-100,90,-20,1078,1106,2184,5055
150,90,90,1078,1106,2184,5055
180,-30,110,1063,1121,2184,4639
80,90,160,1078,1106,2184,5055
40,90,-160,1078,1106,2184,5055
20,40,-100,1062,1123,2185,4769
-100,10,120,1047,1138,2185,4780
90,60,170,1045,1140,2185,4953
-100,0,130,1031,1154,2185,4875
170,50,150,1069,1116,2185,4792
-120,-20,90,1099,1086,2185,4982
-70,20,-30,1072,1113,2185,4891
-70,20,-60,1070,1116,2186,4682
-80,20,80,1072,1114,2186,4992
-60,-20,-170,1084,1102,2186,4811
-10,40,-60,1081,1105,2186,4790
100,80,160,1062,1124,2186,4829
100,70,170,1088,1098,2186,4808
150,30,160,1059,1127,2186,4951
70,-80,-30,1056,1130,2186,4837
-100,20,20,1093,1093,2186,5093
-160,30,80,1071,1116,2187,4778
-170,10,180,1064,1123,2187,4847
-20,50,-30,1087,1100,2187,4727
0,60,-40,1045,1142,2187,4879
-70,-30,180,1086,1101,2187,4805
-70,-30,-180,1086,1101,2187,4805
-10,80,-20,1057,1130,2187,4821
-110,10,140,1088,1099,2187,4735
-170,10,-180,1064,1123,2187,4847
-170,-70,120,1070,1118,2188,4904
-70,30,-40,1081,1107,2188,4767
180,30,100,1061,1127,2188,4838
-180,30,100,1061,1127,2188,4838
40,-70,-60,1071,1117,2188,4859
110,70,150,1048,1140,2188,4899
-180,20,170,1066,1122,2188,4942
110,80,-160,1037,1151,2188,4557
180,20,170,1066,1122,2188,4942
-70,-60,-90,1052,1136,2188,4747
10,20,-80,1050,1138,2188,4878
-50,30,-20,1061,1127,2188,4745
-110,20,130,1080,1108,2188,4830
10,30,-70,1071,1117,2188,4727
-150,-70,90,1057,1131,2188,4710
-90,10,20,1082,1106,2188,4979
10,40,-70,1081,1108,2189,4791
-160,-40,80,1082,1107,2189,4975
-90,0,90,1078,1111,2189,4921
-150,-60,180,1054,1135,2189,4655
-150,50,140,1078,1111,2189,4934
-170,30,150,1083,1106,2189,4760
70,60,-160,1058,1131,2189,4859
-150,80,40,1071,1118,2189,5029
-150,-60,-180,1054,1135,2189,4655
-90,60,-20,1085,1104,2189,5042
-20,40,-30,1072,1117,2189,4655
-160,-10,-170,1066,1123,2189,4876
-10,60,-30,1060,1129,2189,4876
-170,-20,100,1058,1131,2189,4681
-30,30,-30,1058,1132,2190,5017
140,70,170,1066,1124,2190,4744
-10,50,-30,1054,1136,2190,4849
-150,-40,-160,1074,1116,2190,4750
-60,-10,-60,1094,1096,2190,4999
0,70,-30,1051,1139,2190,4977
-90,-50,150,1070,1120,2190,4897
-180,10,110,1090,1101,2191,4697
90,80,-140,1043,1148,2191,4615
20,70,-70,1056,1135,2191,4745
70,70,-150,1055,1136,2191,4883
-120,20,30,1081,1110,2191,5077
-120,50,20,1098,1093,2191,5051
110,70,-170,1063,1128,2191,4857
-130,30,140,1073,1118,2191,4750
60,60,-170,1065,1126,2191,4925
-150,50,60,1074,1117,2191,4958
130,60,140,1052,1139,2191,4980
-20,50,-10,1047,1144,2191,4923
180,10,110,1090,1101,2191,4697
110,-90,40,1081,1111,2192,4831
-90,-90,-160,1081,1111,2192,4831
-130,-90,160,1081,1111,2192,4831
140,-90,70,1081,1111,2192,4831
-180,-90,110,1081,1111,2192,4831
0,-90,-70,1081,1111,2192,4831
30,50,-140,1085,1107,2192,4769
-100,-70,-130,1041,1151,2192,4686
120,-90,50,1081,1111,2192,4831
150,-90,80,1081,1111,2192,4831
-110,-90,180,1081,1111,2192,4831
60,-90,-10,1081,1111,2192,4831
-110,-90,-180,1081,1111,2192,4831
170,-90,100,1081,1111,2192,4831
-170,-90,120,1081,1111,2192,4831
-100,-90,-170,1081,1111,2192,4831
20,-90,-50,1081,1111,2192,4831
-140,-90,150,1081,1111,2192,4831
-160,-90,130,1081,1111,2192,4831
80,-90,10,1081,1111,2192,4831
50,-90,-20,1081,1111,2192,4831
-30,-90,-100,1081,1111,2192,4831
-60,30,-10,1102,1090,2192,4781
30,-90,-40,1081,1111,2192,4831
-50,-90,-120,1081,1111,2192,4831
-60,-90,-130,1081,1111,2192,4831
10,-90,-60,1081,1111,2192,4831
100,-90,30,1081,1111,2192,4831
180,-90,110,1081,1111,2192,4831
110,60,170,1054,1138,2192,4935
-150,-90,140,1081,1111,2192,4831
130,-90,60,1081,1111,2192,4831
160,-90,90,1081,1111,2192,4831
90,-90,20,1081,1111,2192,4831
-130,80,110,1065,1127,2192,4755
-70,-90,-140,1081,1111,2192,4831
-80,-90,-150,1081,1111,2192,4831
-10,-90,-80,1081,1111,2192,4831
-120,-90,170,1081,1111,2192,4831
-10,-30,-120,1078,1114,2192,4793
-40,-90,-110,1081,1111,2192,4831
10,-30,-90,1080,1112,2192,4946
10,20,-100,1053,1139,2192,4807
-20,-90,-90,1081,1111,2192,4831
80,80,-130,1048,1144,2192,4678
40,-90,-30,1081,1111,2192,4831
70,-90,0,1081,1111,2192,4831
-80,40,-10,1109,1084,2193,4874
-160,60,140,1086,1107,2193,4645
-90,50,-10,1095,1098,2193,4842
-10,50,-40,1073,1120,2193,4830
-80,-60,-100,1055,1138,2193,4756
-160,80,50,1077,1116,2193,5029
-110,-70,-140,1050,1143,2193,4710
-170,-40,150,1083,1110,2193,4599
-130,10,40,1087,1106,2193,5121
-100,10,-140,1109,1085,2194,4978
-40,-30,-60,1077,1117,2194,4775
20,70,-80,1048,1146,2194,4835
-90,10,100,1059,1135,2194,4966
-150,10,-170,1053,1141,2194,4824
0,50,-50,1065,1129,2194,5039
0,0,-120,1053,1141,2194,4910
-150,-10,-160,1074,1120,2194,4843
-40,0,-40,1092,1102,2194,4994
20,-80,-50,1064,1131,2195,4786
-20,-60,-70,1063,1132,2195,4785
180,-10,110,1077,1118,2195,4754
140,50,140,1073,1122,2195,4947
-100,80,80,1054,1141,2195,4700
80,-80,-20,1062,1133,2195,4846
-180,-10,110,1077,1118,2195,4754
-30,0,-40,1084,1111,2195,4978
-160,70,60,1084,1112,2196,4935
-120,70,10,1073,1123,2196,5026
10,50,-80,1067,1129,2196,4749
100,60,170,1069,1127,2196,4942
-60,30,-110,1091,1105,2196,5065
-10,50,-20,1071,1125,2196,4882
-110,10,-150,1097,1099,2196,4808
-110,0,40,1069,1127,2196,4979
-170,-60,100,1063,1133,2196,4823
-120,10,30,1101,1095,2196,5040
40,-80,-70,1065,1132,2197,5056
20,30,-120,1054,1143,2197,4936
100,80,150,1061,1136,2197,4989
-170,-50,80,1050,1147,2197,5180
10,30,-90,1065,1132,2197,4818
180,-10,160,1082,1115,2197,4999
-180,-10,160,1082,1115,2197,4999
-150,-80,150,1072,1126,2198,4856
-140,80,30,1082,1116,2198,5027
-130,80,20,1077,1121,2198,4974
-140,10,-160,1070,1128,2198,4977
170,70,150,1081,1117,2198,4740
-130,-50,100,1058,1140,2198,4953
60,-80,-40,1052,1146,2198,4935
0,-50,-60,1069,1129,2198,4986
10,20,-50,1066,1132,2198,5075
-170,-10,100,1071,1128,2199,4813
120,-80,20,1049,1150,2199,5008
60,50,-140,1045,1154,2199,4978
-130,0,-150,1058,1141,2199,4917
10,30,-60,1051,1148,2199,4892
-30,50,0,1064,1135,2199,4843
110,80,140,1067,1132,2199,4982
-70,30,-20,1118,1081,2199,4935
-40,10,-140,1091,1108,2199,4783
-10,50,-60,1096,1103,2199,4788
-90,10,0,1092,1108,2200,5193
30,-50,-70,1066,1134,2200,4964
-180,-20,110,1069,1131,2200,4781
110,70,180,1082,1118,2200,4944
-60,-60,-90,1055,1145,2200,4741
-100,-20,100,1079,1121,2200,4987
-100,0,-90,1078,1122,2200,4788
90,60,-180,1069,1131,2200,5073
90,60,180,1069,1131,2200,5073
180,-20,110,1069,1131,2200,4781
110,70,-180,1082,1118,2200,4944
-60,20,30,1091,1109,2200,4989
160,30,130,1097,1103,2200,4915
-90,-10,170,1103,1098,2201,4909
-60,30,-20,1090,1111,2201,4693
-170,-60,130,1059,1142,2201,4863
180,-30,130,1095,1106,2201,4690
130,60,150,1068,1133,2201,4908
-130,50,30,1122,1079,2201,4900
-170,50,80,1076,1125,2201,4876
100,70,150,1054,1147,2201,5111
-90,20,100,1081,1120,2201,4897
-160,80,60,1073,1128,2201,4810
-150,30,150,1088,1113,2201,4882
-30,0,-140,1093,1108,2201,4930
-70,-30,-80,1092,1109,2201,4841
-180,-30,130,1095,1106,2201,4690
170,40,150,1082,1119,2201,4806
20,50,-90,1057,1145,2202,4838
80,60,180,1066,1136,2202,5165
10,60,-70,1065,1137,2202,4815
80,60,-180,1066,1136,2202,5165
-160,-30,80,1072,1130,2202,5087
-10,70,-40,1095,1108,2203,4843
-160,-50,80,1100,1103,2203,4871
70,-80,-20,1045,1158,2203,4865
-80,20,-80,1077,1126,2203,4856
-120,0,-140,1062,1141,2203,4950
0,60,-50,1088,1115,2203,4847
80,-80,-10,1048,1156,2204,4797
-90,20,-10,1083,1121,2204,4985
110,70,160,1069,1135,2204,4856
10,-80,-60,1075,1129,2204,4881
-170,-50,140,1080,1124,2204,4794
-110,50,10,1086,1118,2204,5091
-80,10,30,1075,1129,2204,4992
-120,-40,110,1088,1117,2205,4882
-100,-10,160,1080,1125,2205,4811
-120,-30,100,1097,1108,2205,4867
-60,20,-130,1066,1139,2205,4914
-90,30,-20,1086,1119,2205,5049
-170,40,150,1090,1116,2206,4784
-10,0,-130,1098,1108,2206,5004
60,80,180,1061,1145,2206,5197
-90,20,-140,1086,1120,2206,5021
-150,-70,170,1063,1143,2206,4789
60,80,-180,1061,1145,2206,5197
-100,0,50,1076,1130,2206,4990
-100,-10,90,1075,1131,2206,4979
-20,-60,-130,1085,1121,2206,4863
-10,60,-50,1078,1128,2206,4696
10,10,-50,1063,1143,2206,5241
-100,-10,-90,1075,1131,2206,4733
-50,40,40,1076,1131,2207,4956
10,-70,-100,1069,1138,2207,4949
160,-80,80,1044,1163,2207,4874
80,60,-170,1069,1138,2207,5038
-90,20,0,1102,1105,2207,5169
10,30,-130,1076,1132,2208,5012
140,70,130,1071,1137,2208,5010
-120,80,10,1082,1126,2208,5000
-160,-10,90,1066,1142,2208,4689
-180,-70,90,1077,1131,2208,4997
180,-70,90,1077,1131,2208,4997
150,40,150,1073,1135,2208,4945
-50,10,-40,1112,1096,2208,4950
-110,0,50,1084,1124,2208,4963
10,-60,-60,1063,1145,2208,4889
-140,10,60,1082,1127,2209,5043
30,70,-90,1054,1155,2209,4685
-100,-40,-100,1085,1124,2209,4879
-90,0,80,1080,1129,2209,5073
120,80,-170,1048,1161,2209,4630
-130,-10,-140,1085,1125,2210,5047
-60,30,-30,1115,1095,2210,4915
0,60,-30,1070,1140,2210,4991
180,40,150,1082,1128,2210,4692
120,60,150,1060,1150,2210,4983
120,60,160,1069,1141,2210,4825
20,0,-60,1064,1146,2210,4999
110,60,160,1064,1146,2210,4990
100,70,-170,1086,1124,2210,4873
-180,40,150,1082,1128,2210,4692
0,80,-40,1064,1146,2210,4845
-30,-50,-70,1099,1112,2211,4971
-180,0,120,1098,1113,2211,4887
90,70,-160,1082,1129,2211,4873
-60,30,40,1061,1150,2211,4751
-150,70,50,1075,1136,2211,4967
100,70,160,1056,1155,2211,5012
-120,80,100,1073,1138,2211,4813
-20,80,-10,1069,1142,2211,4901
-80,20,0,1068,1143,2211,5153
10,40,-90,1086,1125,2211,4928
-170,-50,120,1069,1142,2211,4752
-10,30,-40,1083,1128,2211,4774
180,0,120,1098,1113,2211,4887
130,-80,30,1057,1155,2212,5092
40,60,-110,1078,1134,2212,4937
-20,-80,-80,1086,1126,2212,5186
10,-70,-60,1073,1139,2212,4866
150,40,140,1066,1146,2212,5016
180,-40,120,1064,1148,2212,4773
-60,-40,-80,1058,1154,2212,4768
-180,-40,120,1064,1148,2212,4773
180,-20,150,1089,1124,2213,4933
-50,40,10,1095,1118,2213,4907
0,50,-130,1077,1136,2213,5099
-70,20,10,1100,1113,2213,4876
-180,-20,150,1089,1124,2213,4933
-130,-70,110,1043,1170,2213,4987
-100,30,0,1090,1123,2213,5024
-80,-50,-100,1076,1137,2213,4785
180,20,160,1095,1118,2213,4920
-180,20,160,1095,1118,2213,4920
-110,70,0,1099,1114,2213,5067
-140,60,130,1075,1139,2214,4966
150,70,120,1085,1129,2214,4937
-100,0,40,1068,1146,2214,4969
90,80,160,1074,1140,2214,5040
170,20,170,1077,1137,2214,5017
170,60,100,1092,1122,2214,4743
10,20,-110,1067,1148,2215,4928
-90,-70,-120,1049,1166,2215,4788
-70,20,-130,1087,1128,2215,4855
-10,60,-20,1066,1149,2215,5150
0,70,-50,1087,1128,2215,4830
-150,60,50,1082,1133,2215,4981
-80,10,60,1076,1139,2215,5039
50,60,-160,1093,1122,2215,5020
-130,-30,90,1100,1115,2215,5027
-160,-70,140,1083,1133,2216,4715
180,20,150,1079,1137,2216,4920
-50,-70,-90,1080,1136,2216,5040
-50,20,-30,1105,1111,2216,4805
-50,-30,-70,1092,1124,2216,4796
-160,20,160,1079,1137,2216,4863
0,40,-70,1098,1118,2216,4894
-150,80,50,1087,1129,2216,4816
-180,20,150,1079,1137,2216,4920
-150,-80,160,1086,1130,2216,4958
-140,50,50,1093,1123,2216,5176
-130,-30,-130,1070,1147,2217,4933
-70,-10,-70,1088,1129,2217,4787
-30,80,0,1068,1149,2217,4948
-50,20,-130,1093,1124,2217,4992
160,70,110,1097,1120,2217,4943
-70,20,50,1077,1140,2217,4914
0,40,-60,1086,1131,2217,4921
50,50,-140,1069,1148,2217,4909
-30,-30,-60,1091,1126,2217,4844
90,70,-170,1072,1145,2217,4987
-150,-30,80,1080,1138,2218,5170
-50,40,20,1099,1119,2218,4736
-10,-40,-60,1092,1126,2218,4904
-160,-20,90,1081,1137,2218,4868
180,60,150,1070,1148,2218,4952
-180,60,150,1070,1148,2218,4952
170,80,150,1058,1160,2218,4756
40,70,-160,1100,1118,2218,4952
-50,60,-90,1069,1149,2218,5224
-20,60,-30,1096,1122,2218,4909
-100,20,10,1103,1115,2218,5242
130,70,140,1083,1136,2219,4968
-180,30,150,1091,1128,2219,4758
-150,10,70,1079,1140,2219,4828
-60,20,-30,1108,1111,2219,4882
-110,0,-110,1090,1129,2219,5085
180,30,150,1091,1128,2219,4758
-110,-10,80,1096,1123,2219,4915
-40,60,20,1062,1157,2219,4858
-70,40,-70,1092,1127,2219,5089
-100,-10,130,1098,1122,2220,4921
30,-80,-80,1077,1143,2220,5099
70,80,-120,1065,1155,2220,4752
-10,80,-30,1063,1157,2220,4947
180,-60,80,1066,1154,2220,4957
-180,-60,80,1066,1154,2220,4957
-70,40,-40,1112,1108,2220,5029
-160,0,-170,1070,1150,2220,4974
-100,70,-10,1097,1123,2220,5053
0,70,-40,1071,1150,2221,4968
-10,40,-50,1099,1122,2221,4780
-110,80,90,1080,1141,2221,4779
50,-80,-50,1061,1160,2221,5085
-160,-70,150,1074,1147,2221,4959
-80,70,-40,1094,1127,2221,5056
10,70,-60,1067,1154,2221,4894
-100,90,0,1092,1130,2222,4949
40,90,-140,1092,1130,2222,4949
150,90,110,1092,1130,2222,4949
0,90,-100,1092,1130,2222,4949
-30,90,-70,1092,1130,2222,4949
100,90,160,1092,1130,2222,4949
-150,90,50,1092,1130,2222,4949
-80,90,-20,1092,1130,2222,4949
70,90,-170,1092,1130,2222,4949
130,90,130,1092,1130,2222,4949
50,90,-150,1092,1130,2222,4949
-140,90,40,1092,1130,2222,4949
10,90,-110,1092,1130,2222,4949
-160,-40,-180,1083,1139,2222,4771
180,90,80,1092,1130,2222,4949
-170,90,70,1092,1130,2222,4949
-120,90,20,1092,1130,2222,4949
140,90,120,1092,1130,2222,4949
0,0,-50,1090,1132,2222,4986
-130,90,30,1092,1130,2222,4949
-10,90,-90,1092,1130,2222,4949
20,90,-120,1092,1130,2222,4949
-90,90,-10,1092,1130,2222,4949
-110,90,10,1092,1130,2222,4949
-20,90,-80,1092,1130,2222,4949
-30,70,10,1052,1170,2222,4940
-40,90,-60,1092,1130,2222,4949
120,90,140,1092,1130,2222,4949
-180,90,80,1092,1130,2222,4949
110,90,150,1092,1130,2222,4949
-170,-50,150,1103,1119,2222,4967
-70,90,-30,1092,1130,2222,4949
60,90,-160,1092,1130,2222,4949
-60,30,-40,1093,1129,2222,4944
30,90,-130,1092,1130,2222,4949
-50,90,-50,1092,1130,2222,4949
170,90,90,1092,1130,2222,4949
-160,90,60,1092,1130,2222,4949
90,90,170,1092,1130,2222,4949
-120,-30,-120,1064,1158,2222,4769
0,50,-60,1101,1121,2222,4830
80,90,-180,1092,1130,2222,4949
-30,60,-110,1083,1139,2222,5084
80,90,180,1092,1130,2222,4949
-160,-40,180,1083,1139,2222,4771
160,90,100,1092,1130,2222,4949
-60,90,-40,1092,1130,2222,4949
-180,10,150,1089,1134,2223,4985
10,20,-120,1069,1154,2223,5083
130,80,180,1059,1164,2223,4689
180,50,150,1087,1136,2223,4851
-30,-70,-80,1100,1123,2223,4968
-180,50,150,1087,1136,2223,4851
-60,-20,-70,1085,1138,2223,4900
180,10,150,1089,1134,2223,4985
130,80,-180,1059,1164,2223,4689
-110,80,0,1084,1139,2223,5031
-100,-10,120,1085,1139,2224,4925
80,80,180,1074,1150,2224,4875
-100,40,0,1121,1103,2224,4952
80,80,-180,1074,1150,2224,4875
-170,80,140,1061,1163,2224,4818
-70,80,-50,1103,1121,2224,5021
-120,-10,70,1088,1136,2224,5066
-60,20,20,1083,1142,2225,5026
140,-80,40,1070,1155,2225,5121
170,-70,60,1078,1147,2225,5197
-50,40,30,1081,1144,2225,4954
0,30,-60,1092,1133,2225,4850
-170,20,160,1100,1125,2225,4761
180,-30,120,1083,1142,2225,4776
-180,-30,120,1083,1142,2225,4776
-110,0,160,1110,1116,2226,4908
-40,-60,-80,1096,1130,2226,5118
-110,-70,130,1085,1141,2226,4971
20,0,-70,1054,1172,2226,5008
10,-10,-80,1076,1150,2226,5065
-90,-60,-110,1066,1160,2226,4975
-60,-80,-110,1076,1151,2227,5013
180,0,150,1070,1157,2227,4947
-180,0,150,1070,1157,2227,4947
140,60,140,1080,1147,2227,4999
120,70,180,1065,1162,2227,4915
140,60,160,1093,1134,2227,4846
60,60,-150,1075,1152,2227,4931
30,-60,-60,1079,1148,2227,4984
120,70,-180,1065,1162,2227,4915
170,30,140,1098,1129,2227,4983
-10,70,-20,1061,1166,2227,5072
-160,40,150,1101,1127,2228,4834
160,-80,70,1074,1154,2228,4994
-90,20,10,1107,1121,2228,5144
40,-80,-40,1069,1159,2228,4933
-70,30,-10,1108,1120,2228,4806
-30,-10,-50,1096,1132,2228,4847
20,-50,-60,1088,1140,2228,5022
-160,-80,130,1103,1125,2228,5085
130,70,170,1076,1152,2228,4944
-100,-70,140,1107,1122,2229,4884
-140,20,-180,1091,1138,2229,5079
170,60,150,1069,1160,2229,4772
-140,20,180,1091,1138,2229,5079
-60,30,0,1099,1130,2229,4897
170,70,100,1103,1126,2229,4912
-10,60,-40,1109,1120,2229,4923
60,70,-140,1079,1150,2229,4894
0,-80,-70,1091,1138,2229,4934
20,-80,-90,1085,1144,2229,5084
170,10,160,1100,1129,2229,5103
-40,20,-30,1090,1139,2229,4825
20,-40,-80,1084,1145,2229,4967
-60,0,-50,1107,1122,2229,4947
-90,40,-10,1116,1114,2230,4886
-130,-40,-130,1094,1136,2230,5078
-90,-10,-80,1105,1125,2230,5015
-10,-20,-120,1091,1139,2230,4836
-40,-40,-70,1102,1128,2230,4841
-20,50,-20,1077,1153,2230,5095
70,60,-170,1078,1152,2230,5206
-170,-60,90,1080,1150,2230,5125
-80,20,-140,1110,1121,2231,5028
-150,-20,-160,1082,1149,2231,5088
0,60,-60,1071,1161,2232,4838
-90,30,-10,1098,1134,2232,4998
-100,50,0,1094,1138,2232,5039
60,80,-160,1080,1152,2232,4965
-80,-40,-90,1101,1131,2232,4860
-120,10,150,1094,1138,2232,4866
10,-40,-60,1098,1135,2233,4989
-100,80,-10,1088,1145,2233,5077
170,20,130,1088,1145,2233,4954
-70,60,-60,1096,1137,2233,5082
120,70,150,1082,1151,2233,5070
0,-10,-100,1084,1150,2234,4897
-90,20,-130,1091,1143,2234,5110
-80,60,-40,1098,1136,2234,4925
-120,30,130,1101,1133,2234,4971
-100,-20,120,1106,1128,2234,5174
20,-10,-60,1064,1170,2234,5096
-140,-70,100,1078,1156,2234,4831
-140,70,40,1081,1153,2234,4942
70,80,-170,1078,1156,2234,4941
-140,-20,80,1106,1128,2234,5113
-20,30,-40,1093,1141,2234,5104
90,70,160,1080,1155,2235,5061
-140,-80,160,1083,1153,2236,5031
-20,70,-30,1113,1123,2236,4893
0,30,-50,1072,1164,2236,4814
-60,80,-60,1112,1124,2236,5062
-170,-50,110,1089,1147,2236,4936
150,60,130,1084,1152,2236,5091
-70,-70,-100,1070,1166,2236,4871
-20,60,-40,1100,1137,2237,4768
130,60,160,1097,1140,2237,5050
-150,-40,80,1108,1129,2237,5046
60,80,-110,1069,1168,2237,4802
-80,20,-20,1105,1132,2237,4947
-100,0,120,1091,1147,2238,4907
60,60,-140,1073,1165,2238,4950
-150,-50,-180,1077,1161,2238,4862
30,-80,-50,1078,1160,2238,4963
-120,-40,-120,1091,1147,2238,5130
160,50,150,1088,1150,2238,4966
-20,70,-10,1064,1174,2238,5089
-130,10,-160,1089,1149,2238,5196
-150,-50,180,1077,1161,2238,4862
-120,-70,120,1078,1161,2239,5021
180,-10,120,1108,1131,2239,4850
-180,-10,120,1108,1131,2239,4850
-60,60,50,1089,1150,2239,5053
30,40,-120,1082,1157,2239,5046
-160,40,80,1119,1120,2239,4856
-140,60,40,1103,1137,2240,4973
-100,-20,150,1097,1143,2240,5079
-40,80,10,1074,1166,2240,4960
-130,20,150,1094,1146,2240,4905
40,60,-130,1099,1141,2240,4892
-80,30,-20,1128,1112,2240,4801
-70,-20,-80,1123,1117,2240,5026
-180,-70,80,1063,1178,2241,5078
180,-70,80,1063,1178,2241,5078
40,80,-90,1066,1175,2241,4950
-50,0,-50,1100,1141,2241,4852
-170,-10,180,1088,1153,2241,5042
-70,50,-40,1106,1135,2241,5070
-150,30,70,1117,1124,2241,5040
-170,-10,-180,1088,1153,2241,5042
-160,-60,80,1089,1152,2241,5003
-70,40,70,1093,1148,2241,5046
170,-80,60,1051,1190,2241,5025
160,40,120,1102,1140,2242,4928
-70,30,-60,1101,1141,2242,5058
-80,-30,170,1093,1149,2242,4986
-80,20,-10,1098,1144,2242,5219
-80,50,80,1085,1157,2242,5007
80,70,170,1077,1165,2242,5046
-60,30,20,1092,1150,2242,5100
-160,-60,140,1084,1158,2242,4814
60,-80,-30,1061,1181,2242,4938
-160,10,-180,1101,1142,2243,5021
-40,-10,-50,1096,1147,2243,4797
180,-80,100,1075,1168,2243,4920
30,-50,-60,1066,1177,2243,4994
-60,30,50,1086,1157,2243,5014
170,-80,90,1070,1173,2243,4972
30,80,-130,1086,1157,2243,5114
-180,-80,100,1075,1168,2243,4920
-160,10,180,1101,1142,2243,5021
80,70,-150,1085,1159,2244,4986
-140,-80,170,1094,1150,2244,4968
-90,0,60,1099,1145,2244,5194
100,70,-180,1101,1143,2244,5119
-120,0,60,1109,1135,2244,5173
50,70,-130,1088,1156,2244,4983
100,70,180,1101,1143,2244,5119
50,80,-100,1068,1177,2245,4916
-170,-50,130,1081,1164,2245,4858
-70,20,20,1107,1138,2245,5087
-160,0,90,1091,1154,2245,4752
-140,40,60,1108,1137,2245,4974
-150,-20,80,1113,1132,2245,5070
30,80,-80,1073,1172,2245,4990
-120,60,20,1107,1138,2245,4990
150,50,140,1088,1157,2245,5059
-100,0,170,1112,1133,2245,4804
30,-70,-60,1078,1167,2245,5049
50,80,-170,1072,1173,2245,5250
-150,20,160,1111,1134,2245,4915
-80,60,-30,1116,1129,2245,5064
160,40,130,1108,1137,2245,5059
150,50,150,1100,1145,2245,4969
-100,90,-10,1090,1156,2246,4912
-90,90,-20,1090,1156,2246,4912
-60,90,-50,1090,1156,2246,4912
-50,90,-60,1090,1156,2246,4912
-120,90,10,1090,1156,2246,4912
60,90,-170,1090,1156,2246,4912
-40,90,-70,1090,1156,2246,4912
10,90,-120,1090,1156,2246,4912
50,90,-160,1090,1156,2246,4912
40,90,-150,1090,1156,2246,4912
160,90,90,1090,1156,2246,4912
30,90,-140,1090,1156,2246,4912
-150,90,40,1090,1156,2246,4912
-160,90,50,1090,1156,2246,4912
-180,90,70,1090,1156,2246,4912
-70,90,-40,1090,1156,2246,4912
20,90,-130,1090,1156,2246,4912
100,90,150,1090,1156,2246,4912
110,90,140,1090,1156,2246,4912
170,90,80,1090,1156,2246,4912
-170,90,60,1090,1156,2246,4912
90,90,160,1090,1156,2246,4912
20,-10,-70,1081,1165,2246,5088
70,90,180,1090,1156,2246,4912
-110,90,0,1090,1156,2246,4912
-130,90,20,1090,1156,2246,4912
80,90,170,1090,1156,2246,4912
140,90,110,1090,1156,2246,4912
-20,90,-90,1090,1156,2246,4912
130,90,120,1090,1156,2246,4912
-10,90,-100,1090,1156,2246,4912
150,90,100,1090,1156,2246,4912
-140,90,30,1090,1156,2246,4912
70,90,-180,1090,1156,2246,4912
50,80,-150,1089,1157,2246,5025
-30,90,-80,1090,1156,2246,4912
120,90,130,1090,1156,2246,4912
0,90,-110,1090,1156,2246,4912
180,90,70,1090,1156,2246,4912
-80,90,-30,1090,1156,2246,4912
-180,-20,120,1098,1149,2247,4778
-170,-60,110,1079,1168,2247,4932
-170,70,140,1080,1167,2247,4940
180,-20,120,1098,1149,2247,4778
-70,0,-70,1116,1131,2247,4976
-80,0,-70,1105,1143,2248,4964
-70,20,-140,1101,1147,2248,4932
20,80,-120,1089,1159,2248,5098
-50,40,-10,1095,1153,2248,5032
-140,-60,-170,1084,1164,2248,4923
40,-80,-60,1085,1163,2248,5091
-160,60,70,1096,1152,2248,4954
-70,50,-60,1136,1113,2249,5037
-70,50,70,1083,1166,2249,4965
-70,50,-50,1106,1143,2249,5053
50,60,-140,1078,1171,2249,4946
-20,-30,-60,1113,1136,2249,5022
-140,20,160,1101,1148,2249,4951
180,80,140,1071,1178,2249,4843
-80,20,-130,1105,1144,2249,5088
-180,80,140,1071,1178,2249,4843
-110,-20,100,1106,1143,2249,5069
-90,80,-20,1095,1154,2249,5102
160,50,120,1105,1145,2250,4963
120,70,160,1096,1155,2251,5185
-100,10,-170,1119,1132,2251,5161
-30,-80,-90,1096,1155,2251,5222
-80,-70,-110,1061,1190,2251,4898
-20,-40,-130,1112,1139,2251,5012
-100,-20,140,1094,1157,2251,5078
-40,70,20,1073,1178,2251,5032
-20,50,-120,1095,1156,2251,5256
40,80,-140,1096,1155,2251,5058
-170,-40,110,1098,1153,2251,4943
0,-40,-60,1095,1156,2251,5017
0,30,-80,1085,1166,2251,4892
-40,30,-120,1098,1153,2251,5103
-70,10,-160,1112,1140,2252,5262
-170,10,160,1111,1141,2252,5063
90,70,-180,1110,1142,2252,4988
-130,-50,-150,1079,1173,2252,4677
-30,40,-30,1083,1169,2252,5182
90,70,180,1110,1142,2252,4988
150,70,160,1096,1156,2252,4846
-70,-80,-120,1084,1168,2252,5077
-130,-80,-180,1099,1154,2253,5010
60,70,-150,1097,1156,2253,5052
-130,-80,180,1099,1154,2253,5010
-90,0,180,1133,1120,2253,5004
-140,80,40,1111,1142,2253,4852
-90,0,-180,1133,1120,2253,5004
-60,-50,-90,1088,1165,2253,4851
-40,20,-130,1096,1157,2253,5005
-80,50,-20,1109,1144,2253,5058
-170,-60,80,1099,1154,2253,5143
0,70,-130,1100,1153,2253,5116
-90,20,20,1114,1139,2253,5117
50,70,-140,1096,1158,2254,5053
10,-80,-100,1097,1157,2254,5053
-160,80,130,1074,1180,2254,4888
0,-20,-100,1090,1164,2254,4825
70,70,-140,1096,1159,2255,5054
-40,60,-100,1096,1159,2255,5149
-170,90,130,1092,1163,2255,5011
150,90,170,1092,1163,2255,5011
-10,90,-30,1092,1163,2255,5011
130,90,-170,1092,1163,2255,5011
80,90,-120,1092,1163,2255,5011
-160,90,120,1092,1163,2255,5011
-30,90,-10,1092,1163,2255,5011
70,90,-110,1092,1163,2255,5011
140,90,-180,1092,1163,2255,5011
-140,90,100,1092,1163,2255,5011
-10,70,-30,1098,1157,2255,4980
160,90,160,1092,1163,2255,5011
10,90,-50,1092,1163,2255,5011
-120,90,80,1092,1163,2255,5011
50,90,-90,1092,1163,2255,5011
180,90,140,1092,1163,2255,5011
-90,90,50,1092,1163,2255,5011
120,90,-160,1092,1163,2255,5011
140,90,180,1092,1163,2255,5011
-110,90,70,1092,1163,2255,5011
-20,90,-20,1092,1163,2255,5011
-100,90,60,1092,1163,2255,5011
-60,70,-70,1111,1144,2255,5102
-80,90,40,1092,1163,2255,5011
170,30,120,1087,1168,2255,5047
-130,90,90,1092,1163,2255,5011
-50,90,10,1092,1163,2255,5011
40,90,-80,1092,1163,2255,5011
-40,90,0,1092,1163,2255,5011
-180,90,140,1092,1163,2255,5011
-80,30,80,1099,1156,2255,4974
60,90,-100,1092,1163,2255,5011
100,90,-140,1092,1163,2255,5011
90,90,-130,1092,1163,2255,5011
20,90,-60,1092,1163,2255,5011
0,0,-110,1098,1157,2255,4945
-150,90,110,1092,1163,2255,5011
110,90,-150,1092,1163,2255,5011
170,90,150,1092,1163,2255,5011
-70,90,30,1092,1163,2255,5011
-60,90,20,1092,1163,2255,5011
0,90,-40,1092,1163,2255,5011
30,90,-70,1092,1163,2255,5011
-170,-30,170,1066,1190,2256,4977
170,10,170,1078,1178,2256,5200
30,40,-130,1091,1165,2256,5104
-80,-20,-80,1132,1124,2256,5192
180,60,90,1127,1129,2256,4881
-180,60,90,1127,1129,2256,4881
50,60,-130,1081,1175,2256,5067
140,80,170,1083,1173,2256,4773
10,-30,-60,1103,1153,2256,5059
10,-50,-60,1090,1166,2256,4984
0,-70,-110,1099,1158,2257,4938
-70,40,-60,1123,1134,2257,5209
-140,-10,-150,1101,1156,2257,5079
-160,-60,150,1080,1177,2257,4962
40,60,-120,1092,1166,2258,5060
-150,0,80,1085,1173,2258,4855
-40,40,-20,1091,1167,2258,5118
-50,80,-70,1113,1145,2258,5089
160,-80,60,1084,1174,2258,5067
-150,-10,80,1104,1155,2259,5106
-110,30,20,1122,1137,2259,5189
-40,-20,-150,1113,1146,2259,5141
-60,20,-40,1101,1158,2259,4944
-130,20,140,1094,1165,2259,4876
-10,10,-130,1124,1136,2260,4992
-10,-80,-80,1114,1146,2260,5060
-60,30,10,1121,1139,2260,5245
-80,40,80,1102,1158,2260,5066
-110,10,30,1115,1145,2260,5238
20,80,-70,1087,1173,2260,4963
-20,40,-50,1119,1141,2260,4961
-90,10,-80,1104,1156,2260,4962
0,20,-50,1102,1159,2261,4833
0,20,-70,1130,1131,2261,5092
-120,10,160,1108,1153,2261,5120
-150,20,80,1110,1151,2261,4899
150,-80,50,1089,1172,2261,5076
180,0,130,1092,1170,2262,5035
0,20,-80,1106,1156,2262,4896
-180,0,130,1092,1170,2262,5035
70,70,180,1104,1158,2262,5131
70,70,-180,1104,1158,2262,5131
-150,40,70,1121,1141,2262,5035
-130,40,130,1095,1167,2262,4881
10,20,-60,1070,1192,2262,5033
-170,60,80,1101,1161,2262,4899
-170,20,150,1108,1154,2262,4946
-110,60,10,1113,1150,2263,4985
-160,50,140,1117,1146,2263,4878
10,70,-70,1079,1184,2263,4937
-30,70,-20,1117,1146,2263,4940
-70,30,-90,1118,1145,2263,5101
-80,30,-10,1126,1137,2263,5131
-130,70,30,1104,1159,2263,5029
-90,10,30,1103,1160,2263,5129
-30,60,-20,1096,1168,2264,4955
-170,-20,180,1080,1184,2264,5124
-170,-20,-180,1080,1184,2264,5124
180,10,160,1087,1177,2264,5205
-140,-40,90,1114,1150,2264,5092
10,10,-70,1082,1182,2264,5101
-180,10,160,1087,1177,2264,5205
-30,70,0,1089,1176,2265,5081
-160,20,150,1111,1154,2265,4938
0,10,-70,1105,1160,2265,5043
-50,80,20,1079,1186,2265,4954
10,80,-60,1090,1175,2265,4929
-40,80,-70,1113,1153,2266,5114
-20,50,-40,1114,1152,2266,4887
30,-70,-70,1110,1156,2266,5096
-20,80,-20,1091,1175,2266,5001
-30,-60,-140,1116,1150,2266,5005
170,-80,80,1092,1174,2266,5078
-130,60,30,1108,1158,2266,5014
-90,70,-20,1122,1144,2266,5037
-10,30,-60,1130,1137,2267,4919
-110,20,30,1121,1146,2267,5196
-140,-70,180,1104,1163,2267,4883
140,50,150,1090,1177,2267,5179
-110,0,-120,1111,1156,2267,4998
-140,-70,-180,1104,1163,2267,4883
30,70,-120,1110,1157,2267,5107
-80,10,40,1105,1162,2267,5098
-90,50,90,1085,1182,2267,5053
0,60,-70,1124,1144,2268,4874
-130,80,30,1122,1146,2268,4868
-180,0,160,1113,1155,2268,5188
-180,70,140,1082,1186,2268,4739
-30,80,-80,1101,1167,2268,5139
-80,30,0,1143,1125,2268,5190
-70,-40,180,1114,1154,2268,4904
-10,-60,-70,1103,1165,2268,5138
-70,-40,-180,1114,1154,2268,4904
-150,60,60,1114,1154,2268,5056
180,70,140,1082,1186,2268,4739
180,0,160,1113,1155,2268,5188
-130,60,120,1108,1160,2268,5110
-160,-20,-170,1106,1162,2268,5048
-70,30,0,1124,1145,2269,5204
-40,-30,-150,1124,1145,2269,5063
90,70,170,1096,1173,2269,5080
-30,60,0,1093,1176,2269,5135
0,-80,-110,1107,1162,2269,5072
80,80,170,1087,1182,2269,5170
-80,80,-30,1110,1159,2269,5069
-10,-70,-120,1109,1160,2269,5017
-150,-80,140,1118,1151,2269,5116
-50,50,30,1139,1130,2269,5084
-50,70,30,1084,1186,2270,5006
-170,-70,90,1112,1158,2270,5063
-100,30,110,1094,1176,2270,4964
-170,-70,100,1115,1155,2270,5106
-10,30,-50,1111,1159,2270,4995
50,-80,-40,1075,1195,2270,5040
-120,-80,-170,1104,1166,2270,5019
-160,-60,130,1098,1172,2270,4974
0,30,-90,1102,1168,2270,5042
-20,70,-20,1112,1158,2270,5110
150,80,160,1092,1179,2271,4837
130,70,150,1102,1169,2271,5092
-40,60,-10,1101,1170,2271,5035
-30,-30,-140,1128,1143,2271,4974
-100,-20,130,1110,1161,2271,5068
0,60,-130,1129,1142,2271,5178
-170,-70,110,1097,1174,2271,5027
-20,60,-20,1092,1179,2271,5136
-10,30,-130,1120,1152,2272,5272
-140,60,50,1125,1147,2272,5002
0,0,-100,1090,1182,2272,5072
-60,-30,-170,1124,1148,2272,5068
-20,60,-10,1092,1180,2272,5175
60,60,-160,1096,1177,2273,5178
-60,10,-50,1133,1140,2273,5038
-160,-50,100,1104,1169,2273,5149
-160,10,90,1113,1160,2273,4899
0,20,-60,1119,1154,2273,5008
-10,-30,-60,1106,1167,2273,4999
-120,60,110,1124,1149,2273,5057
-110,-40,-110,1115,1158,2273,5074
-20,50,-50,1118,1155,2273,4995
-130,60,40,1138,1135,2273,5066
-120,70,20,1109,1164,2273,5048
70,80,-130,1104,1170,2274,4999
-180,-10,140,1116,1158,2274,5056
180,-10,140,1116,1158,2274,5056
80,80,-140,1097,1177,2274,5041
-30,10,-40,1114,1160,2274,5090
170,20,160,1100,1174,2274,5147
-150,70,130,1101,1173,2274,4887
-160,-60,160,1102,1172,2274,4957
-70,30,-70,1113,1161,2274,5227
0,10,-50,1100,1175,2275,5007
20,70,-110,1103,1172,2275,5093
-10,20,-60,1126,1149,2275,4992
170,40,110,1100,1175,2275,5110
-90,-80,-140,1102,1173,2275,5055
40,80,-160,1090,1185,2275,5352
60,70,-130,1113,1162,2275,5165
160,40,140,1128,1148,2276,5051
20,60,-90,1101,1175,2276,4986
180,10,140,1098,1178,2276,4995
110,70,170,1110,1166,2276,5247
140,70,140,1110,1166,2276,5096
160,60,150,1114,1162,2276,4959
0,80,-50,1094,1182,2276,4922
-50,70,-80,1120,1156,2276,5359
-70,0,-170,1129,1147,2276,5223
-110,0,-130,1115,1161,2276,5049
-20,-70,-130,1110,1166,2276,5091
-30,60,-30,1129,1147,2276,4931
-160,-40,100,1094,1182,2276,5052
-180,10,140,1098,1178,2276,4995
-140,50,130,1116,1161,2277,5073
10,80,-110,1102,1175,2277,5097
-120,60,30,1121,1156,2277,5098
-90,-50,-110,1085,1192,2277,5006
40,50,-140,1098,1179,2277,5002
-80,-80,-130,1096,1182,2278,5087
-130,20,40,1136,1142,2278,5253
-180,0,140,1105,1173,2278,5000
-60,40,-50,1129,1149,2278,5030
180,-10,170,1088,1190,2278,5147
20,-40,-60,1098,1180,2278,5041
-20,30,-50,1118,1160,2278,4974
-20,-50,-130,1101,1177,2278,5017
120,70,170,1116,1162,2278,5221
-90,20,-90,1126,1152,2278,5223
-140,40,50,1118,1160,2278,5120
-180,-10,170,1088,1190,2278,5147
180,0,140,1105,1173,2278,5000
0,-30,-60,1117,1161,2278,5167
-130,-40,100,1101,1177,2278,5001
-50,60,30,1102,1176,2278,4941
-60,30,30,1122,1157,2279,5083
-110,10,130,1109,1170,2279,5030
-40,-20,-60,1123,1156,2279,5087
-40,80,-80,1116,1163,2279,5171
50,80,-140,1101,1178,2279,5117
-10,0,-50,1133,1146,2279,5020
0,70,-60,1104,1175,2279,4870
-160,30,150,1127,1152,2279,4922
-110,70,10,1108,1172,2280,5076
180,-10,150,1110,1170,2280,5028
40,70,-130,1112,1168,2280,5116
-180,-10,150,1110,1170,2280,5028
-150,80,120,1096,1184,2280,4935
-110,30,120,1117,1163,2280,5060
-170,-80,110,1113,1167,2280,5042
-60,-70,-100,1107,1173,2280,5213
-120,80,20,1118,1163,2281,4985
-150,40,140,1122,1159,2281,5035
40,60,-150,1126,1155,2281,5091
-90,-30,-90,1133,1148,2281,5309
130,80,140,1122,1159,2281,5189
140,60,150,1105,1176,2281,5293
-50,50,0,1123,1158,2281,5085
-30,20,-130,1127,1154,2281,5182
-130,50,50,1128,1153,2281,5109
10,-40,-90,1114,1167,2281,5169
30,80,-120,1121,1160,2281,5114
10,30,-100,1088,1193,2281,5048
-180,-70,70,1105,1176,2281,5322
180,-70,70,1105,1176,2281,5322
170,-90,60,1098,1184,2282,5240
-30,-90,-140,1098,1184,2282,5240
-180,70,90,1121,1161,2282,4995
20,-90,-90,1098,1184,2282,5240
80,-90,-30,1098,1184,2282,5240
-10,-90,-120,1098,1184,2282,5240
-150,-90,100,1098,1184,2282,5240
-120,-90,130,1098,1184,2282,5240
-20,80,-90,1111,1171,2282,5144
-60,-90,-170,1098,1184,2282,5240
-160,-70,130,1112,1170,2282,5164
-50,-90,-160,1098,1184,2282,5240
-170,-90,80,1098,1184,2282,5240
180,70,90,1121,1161,2282,4995
20,60,-140,1117,1165,2282,5247
0,-90,-110,1098,1184,2282,5240
-40,-90,-150,1098,1184,2282,5240
-20,-70,-80,1106,1176,2282,5076
150,-90,40,1098,1184,2282,5240
130,-90,20,1098,1184,2282,5240
60,-90,-50,1098,1184,2282,5240
-110,-90,140,1098,1184,2282,5240
120,-90,10,1098,1184,2282,5240
-90,-90,160,1098,1184,2282,5240
10,-90,-100,1098,1184,2282,5240
-130,-90,120,1098,1184,2282,5240
-80,-90,170,1098,1184,2282,5240
90,-90,-20,1098,1184,2282,5240
50,-90,-60,1098,1184,2282,5240
40,-90,-70,1098,1184,2282,5240
30,-90,-80,1098,1184,2282,5240
-70,-90,-180,1098,1184,2282,5240
-20,-90,-130,1098,1184,2282,5240
160,-90,50,1098,1184,2282,5240
180,-90,70,1098,1184,2282,5240
100,-90,-10,1098,1184,2282,5240
70,-90,-40,1098,1184,2282,5240
140,-90,30,1098,1184,2282,5240
-70,-90,180,1098,1184,2282,5240
-100,-90,150,1098,1184,2282,5240
110,-90,0,1098,1184,2282,5240
-140,-90,110,1098,1184,2282,5240
-180,-90,70,1098,1184,2282,5240
-160,-90,90,1098,1184,2282,5240
-20,70,-40,1128,1155,2283,5052
-140,30,50,1144,1139,2283,5161
-80,-10,180,1128,1155,2283,5084
-80,-10,-180,1128,1155,2283,5084
80,70,-170,1122,1161,2283,5101
-90,10,-160,1138,1145,2283,5253
-160,-30,90,1112,1172,2284,5143
180,60,140,1110,1174,2284,4886
-150,10,80,1103,1181,2284,4808
-50,-30,-160,1118,1166,2284,5195
40,70,-120,1106,1178,2284,4945
-180,60,140,1110,1174,2284,4886
-110,-10,-110,1123,1161,2284,5142
-150,-60,90,1108,1177,2285,5103
0,80,-110,1122,1163,2285,5067
-60,30,-50,1126,1159,2285,5007
-120,40,120,1136,1149,2285,5075
-30,50,-10,1108,1177,2285,5054
-120,-50,-140,1101,1184,2285,4998
60,80,-150,1112,1173,2285,5162
20,-20,-70,1091,1194,2285,5139
-20,40,-40,1114,1172,2286,5052
-110,10,-180,1133,1153,2286,5196
-10,80,-40,1096,1190,2286,4982
-90,0,-80,1118,1168,2286,5145
0,40,-80,1103,1183,2286,4994
-110,10,180,1133,1153,2286,5196
-50,0,-150,1146,1140,2286,5000
-140,-40,-150,1092,1194,2286,4932
-140,30,140,1113,1173,2286,4973
0,30,-70,1139,1147,2286,5142
-60,40,20,1127,1159,2286,4927
-90,-30,160,1115,1171,2286,5135
-20,0,-50,1110,1176,2286,5081
-140,-20,-150,1101,1186,2287,5165
-60,80,30,1091,1196,2287,4963
-150,20,70,1105,1182,2287,5152
-10,20,-50,1116,1171,2287,5188
20,40,-110,1115,1172,2287,5237
-180,10,130,1104,1183,2287,5034
-20,-30,-130,1111,1176,2287,5065
-170,40,90,1117,1170,2287,4898
-130,-70,-170,1118,1169,2287,4978
180,10,130,1104,1183,2287,5034
-100,10,-130,1128,1160,2288,5256
70,70,-160,1128,1160,2288,5126
-70,-40,-90,1116,1172,2288,4816
120,80,150,1111,1177,2288,5131
20,-70,-60,1096,1193,2289,5103
-60,-30,-80,1124,1165,2289,4877
60,80,-120,1096,1193,2289,5009
-50,80,-60,1118,1171,2289,5083
20,80,-110,1123,1166,2289,5206
20,-60,-60,1087,1202,2289,5137
20,50,-100,1103,1186,2289,5304
0,-70,-70,1117,1173,2290,5142
-70,40,-10,1124,1166,2290,4996
-160,-40,90,1103,1187,2290,5244
110,80,160,1104,1186,2290,5161
-20,-80,-90,1125,1165,2290,5059
30,80,-140,1115,1175,2290,5155
0,0,-90,1104,1186,2290,4872
40,80,-130,1111,1179,2290,5093
-110,-80,-160,1117,1173,2290,5020
-160,-50,130,1103,1188,2291,4959
-120,10,140,1127,1164,2291,5081
40,-80,-50,1089,1202,2291,5035
0,-10,-90,1106,1185,2291,4970
40,70,-110,1111,1180,2291,5167
-80,10,50,1115,1176,2291,5256
0,10,-100,1101,1190,2291,5123
50,80,-110,1099,1192,2291,4998
10,-20,-80,1106,1186,2292,5148
20,-80,-60,1109,1183,2292,5119
-180,-80,70,1079,1213,2292,5143
20,80,-130,1118,1174,2292,5131
180,-80,70,1079,1213,2292,5143
160,20,160,1100,1192,2292,5217
-100,60,0,1135,1158,2293,5016
10,80,-120,1122,1171,2293,5064
-150,-70,150,1105,1188,2293,5045
-70,70,-50,1141,1152,2293,5257
-110,-20,-110,1139,1154,2293,5052
20,80,-80,1106,1187,2293,5049
-20,40,-60,1140,1153,2293,5102
170,-80,70,1101,1192,2293,5063
-90,40,0,1141,1152,2293,5067
-30,-60,-80,1122,1172,2294,5058
40,50,-130,1101,1193,2294,5081
-120,40,30,1136,1158,2294,5246
-70,30,-80,1106,1188,2294,5217
30,70,-150,1129,1165,2294,5253
-50,30,-30,1136,1158,2294,4943
70,80,-160,1112,1182,2294,5181
-110,-10,-120,1128,1167,2295,5089
50,60,-150,1113,1182,2295,5171
-180,20,110,1113,1182,2295,4997
180,20,110,1113,1182,2295,4997
-120,10,-160,1133,1162,2295,5122
-130,-80,170,1106,1189,2295,5235
100,80,170,1106,1189,2295,5163
-170,70,130,1107,1188,2295,4820
0,-30,-100,1122,1173,2295,4956
-80,20,70,1128,1167,2295,5106
70,80,180,1092,1203,2295,5247
-40,-80,-100,1124,1171,2295,5240
70,80,-180,1092,1203,2295,5247
30,70,-110,1119,1176,2295,4987
-140,20,140,1136,1159,2295,5037
-160,-30,-180,1104,1192,2296,5097
-130,50,40,1125,1171,2296,5232
180,50,140,1115,1181,2296,5045
-180,10,120,1126,1170,2296,5059
180,10,120,1126,1170,2296,5059
-60,40,0,1146,1150,2296,5064
-160,-30,180,1104,1192,2296,5097
-100,-80,-150,1110,1186,2296,5037
-180,50,140,1115,1181,2296,5045
150,80,120,1143,1153,2296,5204
-120,50,40,1121,1176,2297,5101
50,80,-160,1097,1200,2297,5163
40,80,-150,1111,1186,2297,5177
-100,70,0,1122,1175,2297,5089
-10,-80,-120,1109,1188,2297,5089
-60,0,-60,1142,1155,2297,5030
10,40,-130,1117,1180,2297,5180
170,30,130,1128,1170,2298,5151
-30,70,-10,1125,1173,2298,5150
-10,80,-100,1119,1179,2298,5169
-10,80,-110,1124,1175,2299,5455
-60,40,-40,1152,1147,2299,5111
90,80,-150,1116,1183,2299,5052
-170,0,100,1131,1168,2299,5074
0,0,-80,1120,1179,2299,5006
30,60,-120,1126,1173,2299,5011
20,-20,-60,1108,1191,2299,5188
-110,80,10,1131,1168,2299,5026
-160,70,130,1111,1188,2299,5136
-20,80,-30,1112,1188,2300,5062
140,80,130,1148,1152,2300,5240
-40,30,-30,1112,1188,2300,5142
-40,50,-20,1122,1178,2300,5220
-150,-60,150,1106,1194,2300,4954
-60,40,-30,1158,1142,2300,5113
-60,20,-50,1142,1158,2300,5015
-70,20,-70,1132,1168,2300,5345
-140,-80,150,1124,1176,2300,5132
-170,-30,160,1118,1182,2300,5105
140,-90,60,1120,1181,2301,5140
100,-90,20,1120,1181,2301,5140
-150,-90,130,1120,1181,2301,5140
40,-90,-40,1120,1181,2301,5140
-110,-90,170,1120,1181,2301,5140
-140,-90,140,1120,1181,2301,5140
-80,-90,-160,1120,1181,2301,5140
20,-70,-80,1106,1195,2301,5204
-130,-90,150,1120,1181,2301,5140
-30,-90,-110,1120,1181,2301,5140
20,-90,-60,1120,1181,2301,5140
110,-90,30,1120,1181,2301,5140
10,-90,-70,1120,1181,2301,5140
80,-90,0,1120,1181,2301,5140
-60,-90,-140,1120,1181,2301,5140
-10,-90,-90,1120,1181,2301,5140
-40,-90,-120,1120,1181,2301,5140
-100,-90,180,1120,1181,2301,5140
60,-90,-20,1120,1181,2301,5140
150,-90,70,1120,1181,2301,5140
70,-90,-10,1120,1181,2301,5140
-90,-90,-170,1120,1181,2301,5140
30,60,-100,1115,1186,2301,5091
-100,-90,-180,1120,1181,2301,5140
50,-90,-30,1120,1181,2301,5140
-20,-90,-100,1120,1181,2301,5140
-160,-50,160,1112,1189,2301,5091
90,-90,10,1120,1181,2301,5140
30,-90,-50,1120,1181,2301,5140
180,-90,100,1120,1181,2301,5140
-70,-90,-150,1120,1181,2301,5140
160,-90,80,1120,1181,2301,5140
-160,-90,120,1120,1181,2301,5140
170,-90,90,1120,1181,2301,5140
-120,-90,160,1120,1181,2301,5140
-180,-90,100,1120,1181,2301,5140
0,-90,-80,1120,1181,2301,5140
130,-90,50,1120,1181,2301,5140
120,-90,40,1120,1181,2301,5140
-50,-90,-130,1120,1181,2301,5140
-170,-90,110,1120,1181,2301,5140
-40,-70,-90,1132,1169,2301,5107
-30,-50,-140,1115,1187,2302,5149
-60,70,40,1093,1209,2302,5078
-30,-20,-60,1139,1163,2302,5054
-60,-40,-170,1133,1169,2302,5090
90,80,-180,1121,1182,2303,5169
-80,10,-80,1128,1175,2303,5005
-130,10,140,1126,1177,2303,4989
0,30,-130,1124,1179,2303,5193
-150,-70,160,1111,1192,2303,5153
10,-80,-70,1120,1183,2303,5261
90,80,180,1121,1182,2303,5169
-100,10,30,1130,1173,2303,5411
30,-80,-70,1119,1184,2303,5212
-10,30,-70,1142,1161,2303,5029
-130,-60,-160,1116,1188,2304,5019
-60,40,-20,1132,1172,2304,5076
-30,80,-10,1112,1192,2304,5163
-70,80,-40,1128,1176,2304,5123
-100,-60,140,1123,1182,2305,5142
-180,-80,80,1109,1196,2305,5081
-110,40,110,1141,1164,2305,5134
-100,80,0,1122,1183,2305,5071
180,-80,80,1109,1196,2305,5081
-130,40,40,1123,1182,2305,5190
-50,10,-50,1141,1164,2305,5062
40,80,-100,1115,1190,2305,4987
30,80,-90,1115,1190,2305,5046
0,80,-100,1115,1190,2305,5130
-30,80,-90,1119,1187,2306,5311
180,-80,90,1119,1187,2306,5171
-160,-30,100,1103,1203,2306,5197
-50,-40,-160,1138,1168,2306,5128
-180,-80,90,1119,1187,2306,5171
-170,80,130,1102,1204,2306,4932
-160,10,160,1134,1173,2307,5113
-170,-80,80,1085,1222,2307,5229
-150,-30,-160,1128,1179,2307,5171
30,-60,-70,1101,1206,2307,5191
60,80,-170,1102,1205,2307,5194
-20,60,-80,1132,1175,2307,5107
-30,50,-30,1121,1187,2308,5157
-70,-60,-100,1098,1210,2308,4979
-40,50,0,1134,1174,2308,4983
-100,30,10,1156,1152,2308,5192
-170,-40,130,1122,1186,2308,5077
-50,50,10,1132,1176,2308,5052
-60,80,-50,1128,1180,2308,5087
-100,30,20,1145,1163,2308,5317
30,60,-110,1115,1194,2309,5122
150,60,140,1122,1187,2309,5408
160,80,110,1148,1161,2309,5200
-130,10,60,1153,1156,2309,5307
-160,80,120,1109,1200,2309,5029
-10,-10,-120,1127,1182,2309,5054
-100,0,60,1148,1161,2309,5325
-160,-80,120,1121,1188,2309,5107
80,70,180,1125,1185,2310,5173
-50,50,-10,1115,1195,2310,5217
-100,10,-150,1144,1166,2310,5101
-120,50,30,1131,1179,2310,5283
30,80,-150,1117,1193,2310,5393
-90,30,0,1133,1177,2310,5279
-150,0,90,1124,1186,2310,5037
80,70,-180,1125,1185,2310,5173
-160,-20,100,1121,1189,2310,5097
-140,10,70,1136,1174,2310,5109
-50,20,-40,1138,1172,2310,5117
10,70,-100,1122,1189,2311,5123
-70,80,40,1115,1196,2311,5047
-170,-30,110,1115,1196,2311,5019
-170,-40,120,1114,1197,2311,5097
-130,40,50,1141,1170,2311,5138
-60,50,-80,1116,1195,2311,5160
-30,70,-30,1153,1158,2311,5093
-60,0,-160,1140,1171,2311,5181
-120,10,40,1144,1167,2311,5533
-170,-10,130,1124,1187,2311,5139
-120,30,30,1150,1161,2311,5337
-10,10,-50,1126,1186,2312,5248
10,10,-60,1105,1207,2312,5036
-140,20,150,1132,1180,2312,5227
80,80,-170,1121,1191,2312,5159
-70,20,30,1131,1182,2313,5212
-140,10,-170,1138,1175,2313,5220
-180,20,140,1121,1192,2313,5033
-110,-10,90,1149,1164,2313,5387
-100,20,30,1143,1170,2313,5322
180,20,140,1121,1192,2313,5033
-40,50,10,1120,1193,2313,5119
-140,50,60,1134,1179,2313,5130
-60,40,-10,1135,1178,2313,5133
-60,50,20,1146,1168,2314,5084
-70,40,10,1132,1182,2314,5155
-10,30,-80,1147,1167,2314,5124
170,80,100,1138,1176,2314,5260
-170,-20,110,1120,1194,2314,5146
-100,-40,140,1140,1174,2314,5268
-170,-80,90,1105,1209,2314,5136
10,50,-90,1143,1171,2314,5195
-10,20,-130,1140,1174,2314,5213
-40,70,-90,1138,1176,2314,5444
-110,0,140,1130,1185,2315,5219
-140,10,140,1160,1155,2315,4942
-130,30,40,1144,1171,2315,5238
10,60,-80,1135,1180,2315,5096
-20,80,-100,1122,1193,2315,5394
20,-80,-70,1117,1198,2315,5101
0,80,-60,1132,1183,2315,5078
-120,10,50,1147,1168,2315,5371
-80,40,0,1150,1165,2315,5168
20,60,-110,1143,1173,2316,5040
160,70,150,1125,1191,2316,5043
-170,-30,150,1145,1171,2316,5073
-170,-10,110,1138,1178,2316,5138
-20,80,-80,1137,1179,2316,5152
-100,-50,140,1142,1174,2316,5086
-100,40,20,1145,1171,2316,5282
-40,70,-10,1142,1174,2316,5062
-150,20,150,1142,1174,2316,5150
-90,30,10,1150,1166,2316,5295
-60,40,50,1138,1179,2317,5270
20,-50,-80,1114,1203,2317,5207
-40,-60,-150,1134,1183,2317,5197
-30,70,-100,1155,1162,2317,5375
-40,60,10,1111,1206,2317,5246
-80,-40,170,1131,1186,2317,5024
10,80,-70,1125,1192,2317,5126
-40,10,-40,1141,1176,2317,5159
-100,-10,100,1117,1200,2317,5254
-30,50,-40,1137,1181,2318,5084
-20,30,-60,1144,1174,2318,5044
-50,-80,-110,1148,1170,2318,5255
-110,60,20,1147,1171,2318,5152
-10,70,-90,1121,1197,2318,5215
50,70,-120,1133,1185,2318,5264
-90,50,0,1140,1178,2318,5207
-110,60,100,1147,1171,2318,5216
20,70,-100,1136,1182,2318,5252
-10,70,-120,1131,1187,2318,5368
-150,-40,-170,1131,1188,2319,4986
-170,0,130,1135,1184,2319,5103
180,40,100,1109,1210,2319,5068
140,70,160,1140,1179,2319,4994
-180,40,100,1109,1210,2319,5068
-60,60,-70,1140,1179,2319,5337
-70,60,-40,1158,1161,2319,5088
-40,70,10,1126,1193,2319,5133
-70,-70,-110,1112,1207,2319,5296
-100,40,10,1144,1175,2319,5133
-150,-80,130,1126,1194,2320,5185
-50,-60,-90,1120,1200,2320,5305
160,80,150,1113,1207,2320,5015
0,10,-80,1140,1180,2320,4942
-110,50,30,1127,1193,2320,5130
-80,50,-10,1156,1164,2320,5189
-90,20,-120,1131,1189,2320,5353
-110,40,20,1142,1178,2320,5264
-150,50,70,1143,1177,2320,5252
-30,80,-70,1142,1178,2320,5213
-80,70,-30,1136,1185,2321,5118
180,0,170,1127,1194,2321,5263
0,-60,-70,1122,1199,2321,5088
-60,40,10,1141,1180,2321,5076
-180,0,170,1127,1194,2321,5263
70,70,-170,1126,1195,2321,5200
-30,20,-40,1133,1188,2321,5126
-30,-70,-140,1126,1195,2321,5170
-90,70,-10,1146,1176,2322,5094
-120,-80,-180,1119,1203,2322,5405
0,10,-110,1105,1217,2322,5172
10,60,-100,1126,1196,2322,5099
-130,0,70,1155,1167,2322,5221
0,10,-60,1140,1182,2322,5259
-40,60,-20,1134,1188,2322,5305
-60,30,-60,1179,1143,2322,5206
-120,-80,180,1119,1203,2322,5405
-70,30,10,1144,1179,2323,5215
-70,30,30,1126,1197,2323,5166
-160,-50,90,1109,1214,2323,5301
-90,20,-110,1146,1177,2323,5304
-90,40,90,1112,1211,2323,5151
-30,-70,-90,1131,1192,2323,5289
-50,70,20,1121,1202,2323,5238
-90,60,-10,1140,1183,2323,5181
-10,70,-50,1136,1187,2323,5012
-170,0,110,1133,1191,2324,5128
-150,-30,-170,1143,1181,2324,5108
0,-10,-80,1118,1206,2324,5171
-30,80,-20,1136,1188,2324,5056
-160,70,120,1121,1203,2324,4896
-120,10,170,1142,1182,2324,5136
20,40,-130,1125,1199,2324,5370
-160,-50,140,1136,1188,2324,5077
-60,20,-60,1152,1172,2324,5176
-150,-40,90,1126,1199,2325,5242
0,80,-120,1129,1196,2325,5512
30,70,-100,1142,1183,2325,5147
10,-20,-60,1143,1182,2325,5250
-60,50,0,1124,1201,2325,5190
-140,-80,140,1123,1202,2325,5249
30,-80,-60,1115,1211,2326,5117
0,10,-90,1130,1196,2326,5048
-170,60,140,1114,1212,2326,5082
-30,-80,-100,1141,1185,2326,5200
10,-70,-70,1116,1210,2326,5320
120,90,-170,1112,1215,2327,5072
-180,90,130,1112,1215,2327,5072
-60,90,10,1112,1215,2327,5072
-170,90,120,1112,1215,2327,5072
-90,90,40,1112,1215,2327,5072
-40,80,-10,1130,1197,2327,5074
180,90,130,1112,1215,2327,5072
-40,-50,-80,1132,1195,2327,5295
-160,90,110,1112,1215,2327,5072
-80,90,30,1112,1215,2327,5072
130,90,180,1112,1215,2327,5072
20,90,-70,1112,1215,2327,5072
110,90,-160,1112,1215,2327,5072
-120,90,70,1112,1215,2327,5072
140,90,170,1112,1215,2327,5072
100,90,-150,1112,1215,2327,5072
-140,90,90,1112,1215,2327,5072
-10,90,-40,1112,1215,2327,5072
170,90,140,1112,1215,2327,5072
-50,90,0,1112,1215,2327,5072
10,90,-60,1112,1215,2327,5072
90,90,-140,1112,1215,2327,5072
130,90,-180,1112,1215,2327,5072
0,90,-50,1112,1215,2327,5072
-40,90,-10,1112,1215,2327,5072
80,90,-130,1112,1215,2327,5072
70,90,-120,1112,1215,2327,5072
-170,-80,100,1136,1191,2327,5209
-140,-50,-170,1130,1197,2327,5061
-110,90,60,1112,1215,2327,5072
150,90,160,1112,1215,2327,5072
-100,90,50,1112,1215,2327,5072
-70,90,20,1112,1215,2327,5072
-150,90,100,1112,1215,2327,5072
30,90,-80,1112,1215,2327,5072
40,90,-90,1112,1215,2327,5072
-40,0,-50,1145,1182,2327,5082
60,90,-110,1112,1215,2327,5072
-130,90,80,1112,1215,2327,5072
160,90,150,1112,1215,2327,5072
-20,90,-30,1112,1215,2327,5072
50,90,-100,1112,1215,2327,5072
-30,90,-20,1112,1215,2327,5072
-10,80,-90,1131,1196,2327,5132
-80,10,-160,1160,1168,2328,5345
-70,50,-30,1144,1184,2328,5166
-180,30,140,1134,1194,2328,5139
-160,-40,170,1113,1215,2328,5173
-80,-70,-120,1118,1210,2328,5172
-40,70,0,1143,1185,2328,5231
80,80,-160,1127,1201,2328,5258
-170,10,150,1136,1192,2328,5057
-120,-60,120,1144,1184,2328,5228
-20,-50,-70,1126,1202,2328,5126
-170,0,160,1131,1197,2328,5216
-40,-40,-150,1139,1189,2328,5201
100,80,-160,1124,1204,2328,5122
-80,20,20,1157,1171,2328,5269
180,30,140,1134,1194,2328,5139
-60,10,-60,1133,1195,2328,5181
-30,-80,-140,1127,1202,2329,5213
20,80,-140,1129,1200,2329,5485
10,80,-100,1142,1187,2329,5227
20,60,-100,1141,1188,2329,5139
-70,10,-70,1163,1166,2329,5394
-10,0,-70,1154,1175,2329,5223
-30,-40,-70,1149,1180,2329,5234
-90,20,-100,1128,1201,2329,5283
170,70,140,1133,1196,2329,5123
-80,80,50,1138,1192,2330,5135
-40,80,0,1125,1205,2330,5178
20,-30,-70,1107,1223,2330,5327
-50,80,0,1138,1192,2330,5090
-90,80,-10,1138,1192,2330,5158
-100,-60,-130,1111,1219,2330,5126
0,70,-90,1136,1194,2330,5158
-150,30,140,1151,1179,2330,5065
-70,60,-50,1155,1175,2330,5191
-50,60,0,1123,1207,2330,5328
170,50,140,1123,1208,2331,5055
-20,-80,-130,1128,1203,2331,5162
-160,30,140,1156,1175,2331,5211
20,-30,-60,1101,1231,2332,5237
-50,80,-50,1166,1166,2332,5147
20,-70,-70,1118,1214,2332,5216
-20,-20,-130,1135,1197,2332,5170
-20,70,-110,1145,1187,2332,5453
-10,20,-80,1142,1191,2333,5138
-120,-70,-160,1136,1197,2333,5049
-100,-30,140,1146,1187,2333,5177
-90,-70,-130,1132,1201,2333,5096
-150,60,130,1152,1181,2333,5005
-20,20,-50,1149,1184,2333,5200
-40,60,0,1124,1209,2333,5211
0,-40,-100,1142,1192,2334,5168
-120,-20,-130,1130,1204,2334,5229
-10,-50,-70,1147,1187,2334,5246
-110,50,20,1139,1195,2334,5326
-90,40,10,1166,1168,2334,5226
-110,-50,-130,1122,1212,2334,5248
60,70,-170,1142,1192,2334,5264
-150,80,110,1127,1208,2335,5112
-10,10,-60,1163,1172,2335,5244
170,40,140,1140,1195,2335,5160
-60,40,30,1156,1179,2335,5090
0,70,-100,1128,1207,2335,5220
-40,70,-20,1170,1165,2335,5142
-160,-80,100,1109,1226,2335,5221
-10,40,-70,1146,1189,2335,5103
110,-90,20,1128,1208,2336,5045
40,-90,-50,1128,1208,2336,5045
-100,-90,170,1128,1208,2336,5045
-90,-90,-180,1128,1208,2336,5045
140,-90,50,1128,1208,2336,5045
170,-90,80,1128,1208,2336,5045
-160,-90,110,1128,1208,2336,5045
10,-90,-80,1128,1208,2336,5045
-90,-90,180,1128,1208,2336,5045
-140,-90,130,1128,1208,2336,5045
20,-90,-70,1128,1208,2336,5045
0,-90,-90,1128,1208,2336,5045
100,-90,10,1128,1208,2336,5045
90,-90,0,1128,1208,2336,5045
180,-90,90,1128,1208,2336,5045
-110,-80,-170,1125,1211,2336,5446
-120,-60,-150,1136,1200,2336,4971
-110,-90,160,1128,1208,2336,5045
-170,-90,100,1128,1208,2336,5045
-30,-40,-140,1158,1178,2336,5078
30,-90,-60,1128,1208,2336,5045
-50,-90,-140,1128,1208,2336,5045
-20,-90,-110,1128,1208,2336,5045
-70,-90,-160,1128,1208,2336,5045
120,-90,30,1128,1208,2336,5045
-150,-90,120,1128,1208,2336,5045
70,-90,-20,1128,1208,2336,5045
160,-90,70,1128,1208,2336,5045
60,-90,-30,1128,1208,2336,5045
-70,20,40,1143,1193,2336,5266
-70,40,30,1141,1195,2336,5050
-120,-90,150,1128,1208,2336,5045
50,-90,-40,1128,1208,2336,5045
80,-90,-10,1128,1208,2336,5045
-40,-90,-130,1128,1208,2336,5045
-60,-90,-150,1128,1208,2336,5045
-10,-90,-100,1128,1208,2336,5045
-180,-90,90,1128,1208,2336,5045
-30,-90,-120,1128,1208,2336,5045
-170,-20,130,1134,1202,2336,5304
-130,-90,140,1128,1208,2336,5045
10,50,-130,1137,1199,2336,5237
-80,-90,-170,1128,1208,2336,5045
-160,20,90,1151,1185,2336,4996
130,-90,40,1128,1208,2336,5045
150,-90,60,1128,1208,2336,5045
-170,-10,120,1164,1173,2337,5185
-60,20,-120,1152,1185,2337,5306
-90,50,10,1144,1193,2337,5099
-160,-50,110,1153,1184,2337,5180
-100,50,10,1148,1189,2337,5199
-150,-60,170,1139,1198,2337,5193
-130,-80,160,1148,1189,2337,5209
-60,10,-150,1162,1175,2337,5267
10,70,-110,1126,1212,2338,5277
20,-60,-80,1129,1209,2338,5317
-50,-40,-80,1144,1194,2338,5060
-100,-20,-100,1159,1179,2338,5032
-10,-70,-80,1144,1194,2338,5280
30,50,-130,1126,1212,2338,5435
-130,30,130,1138,1200,2338,5153
-100,10,-100,1130,1208,2338,5229
-170,0,-180,1137,1201,2338,5302
-160,-70,110,1163,1175,2338,5379
-170,0,180,1137,1201,2338,5302
-170,-20,170,1138,1200,2338,5322
-70,20,-120,1155,1183,2338,5255
-80,60,-20,1155,1183,2338,5187
-150,-30,90,1139,1199,2338,5174
-70,60,60,1144,1195,2339,5416
-50,-70,-100,1146,1193,2339,5211
120,80,-180,1140,1199,2339,5225
130,70,160,1134,1205,2339,5419
180,80,90,1148,1191,2339,5240
120,80,180,1140,1199,2339,5225
-180,80,90,1148,1191,2339,5240
10,80,-130,1138,1202,2340,5512
-40,80,-60,1171,1169,2340,5161
-160,-60,110,1158,1182,2340,5329
-170,-20,140,1147,1193,2340,5070
20,60,-120,1120,1220,2340,5290
70,80,-150,1127,1213,2340,5246
150,70,130,1131,1209,2340,5340
60,80,-140,1126,1214,2340,5254
-160,-40,110,1142,1198,2340,5089
-100,-30,-100,1162,1179,2341,5192
-140,-10,80,1164,1177,2341,5332
-160,-60,100,1137,1204,2341,5231
-160,-80,90,1108,1233,2341,5297
-70,50,10,1130,1211,2341,5206
-130,50,120,1139,1202,2341,5343
-60,80,-40,1145,1196,2341,5179
-10,60,-60,1149,1193,2342,5149
-80,70,-20,1166,1176,2342,5201
-170,-10,160,1133,1209,2342,5274
-140,20,60,1148,1194,2342,5343
-40,-80,-150,1133,1209,2342,5219
150,60,150,1126,1217,2343,5181
-110,-60,130,1150,1193,2343,5201
-130,20,130,1157,1186,2343,5277
-160,10,150,1159,1184,2343,5156
20,-60,-70,1130,1213,2343,5307
-130,-20,-140,1130,1213,2343,5366
-20,40,-120,1142,1201,2343,5285
-170,-40,140,1145,1198,2343,5008
-170,-10,140,1128,1215,2343,5097
-80,30,10,1146,1197,2343,5362
-170,20,100,1148,1195,2343,5048
-60,70,-60,1152,1192,2344,5349
-140,30,130,1153,1191,2344,5102
-60,-80,-120,1158,1186,2344,5331
0,60,-90,1134,1210,2344,5257
-70,80,-30,1149,1195,2344,5221
-90,-60,-120,1108,1236,2344,5095
-70,70,50,1126,1218,2344,5074
-110,-10,140,1163,1181,2344,5372
-160,10,170,1143,1201,2344,5161
20,70,-120,1124,1221,2345,5372
170,60,140,1142,1203,2345,5199
-110,0,60,1147,1198,2345,5420
-120,0,150,1156,1189,2345,5204
150,70,150,1159,1186,2345,5184
-170,10,170,1143,1202,2345,5345
-30,40,-50,1158,1187,2345,5300
-50,40,-20,1129,1216,2345,5315
-110,-70,-150,1147,1199,2346,5083
-90,-40,-100,1159,1187,2346,5195
-140,-70,170,1132,1214,2346,5182
90,80,-170,1145,1201,2346,5261
-60,-10,-70,1155,1191,2346,5155
-50,-60,-160,1145,1201,2346,5320
-50,70,0,1148,1199,2347,5117
0,-50,-70,1138,1209,2347,5257
-170,-30,140,1143,1204,2347,5193
-160,-70,100,1145,1202,2347,5106
-170,60,130,1141,1206,2347,4947
-100,50,20,1154,1193,2347,5166
-140,70,120,1132,1215,2347,5073
-100,-50,-120,1112,1235,2347,5139
-160,40,140,1161,1187,2348,5133
-140,-40,-160,1128,1220,2348,5118
-110,-60,-140,1135,1213,2348,4983
0,20,-90,1141,1207,2348,5162
-80,80,-20,1150,1199,2349,5228
-50,60,-10,1148,1201,2349,5297
-110,-10,150,1159,1190,2349,5272
-80,20,-90,1169,1180,2349,5410
-20,20,-130,1153,1196,2349,5433
-10,10,-70,1155,1194,2349,5010
-100,0,80,1152,1197,2349,5471
-140,80,110,1137,1212,2349,5039
-10,80,-50,1143,1206,2349,5158
20,-80,-80,1134,1216,2350,5277
-90,40,20,1168,1182,2350,5164
60,70,-160,1151,1199,2350,5273
-170,0,150,1161,1189,2350,5116
-130,-10,80,1168,1182,2350,5413
-50,40,-50,1159,1191,2350,5300
-150,10,150,1159,1191,2350,5152
-140,80,100,1135,1215,2350,5216
-60,-60,-100,1130,1220,2350,5424
0,0,-70,1152,1198,2350,5302
-90,30,20,1151,1199,2350,5292
-110,0,130,1158,1193,2351,5313
-150,-50,140,1128,1223,2351,4990
-100,-70,-140,1143,1208,2351,5031
-50,80,10,1141,1210,2351,5214
-60,50,-40,1159,1192,2351,5183
-20,-20,-60,1176,1175,2351,5171
-100,20,110,1153,1198,2351,5231
-10,60,-80,1154,1197,2351,5230
0,80,-90,1148,1203,2351,5309
-170,80,80,1166,1186,2352,5246
-10,-90,-110,1120,1232,2352,5285
-180,-90,80,1120,1232,2352,5285
80,-90,-20,1120,1232,2352,5285
130,-90,30,1120,1232,2352,5285
-50,-90,-150,1120,1232,2352,5285
-110,-90,150,1120,1232,2352,5285
60,-90,-40,1120,1232,2352,5285
30,50,-120,1115,1237,2352,5314
-170,-90,90,1120,1232,2352,5285
-120,-90,140,1120,1232,2352,5285
-100,-90,160,1120,1232,2352,5285
-160,-90,100,1120,1232,2352,5285
30,-90,-70,1120,1232,2352,5285
0,-90,-100,1120,1232,2352,5285
50,-90,-50,1120,1232,2352,5285
120,-90,20,1120,1232,2352,5285
-70,-90,-170,1120,1232,2352,5285
-20,-90,-120,1120,1232,2352,5285
-150,-90,110,1120,1232,2352,5285
0,-20,-60,1146,1206,2352,5421
70,-90,-30,1120,1232,2352,5285
-60,-90,-160,1120,1232,2352,5285
160,-90,60,1120,1232,2352,5285
100,-90,0,1120,1232,2352,5285
-150,-20,90,1160,1192,2352,5289
140,-90,40,1120,1232,2352,5285
180,-90,80,1120,1232,2352,5285
110,-90,10,1120,1232,2352,5285
10,-90,-90,1120,1232,2352,5285
-130,-90,130,1120,1232,2352,5285
20,-90,-80,1120,1232,2352,5285
90,-90,-10,1120,1232,2352,5285
-10,50,-90,1167,1185,2352,5077
-80,-90,-180,1120,1232,2352,5285
-140,-90,120,1120,1232,2352,5285
-20,70,-80,1129,1223,2352,5210
-80,-90,180,1120,1232,2352,5285
40,-90,-60,1120,1232,2352,5285
-110,-30,-110,1161,1191,2352,5227
150,-90,50,1120,1232,2352,5285
-90,-90,170,1120,1232,2352,5285
-40,-90,-140,1120,1232,2352,5285
-30,-90,-130,1120,1232,2352,5285
170,-90,70,1120,1232,2352,5285
-50,70,-70,1156,1197,2353,5298
-30,70,-80,1149,1204,2353,5327
-50,60,10,1133,1220,2353,5253
-60,60,40,1145,1208,2353,5177
110,80,-170,1137,1216,2353,5193
-100,60,10,1154,1199,2353,5319
10,-60,-70,1139,1214,2353,5330
-170,20,140,1158,1195,2353,5190
-180,10,170,1134,1220,2354,5465
-90,10,-140,1184,1170,2354,5330
-10,-20,-60,1154,1200,2354,5341
20,-50,-70,1122,1232,2354,5347
-110,10,-160,1146,1208,2354,5363
180,10,170,1134,1220,2354,5465
-100,-10,110,1153,1201,2354,5398
-10,50,-120,1156,1198,2354,5358
10,30,-110,1138,1216,2354,5346
-100,10,110,1150,1204,2354,5279
-60,50,-60,1176,1178,2354,5389
-80,20,30,1155,1200,2355,5379
-70,40,0,1168,1187,2355,5305
-180,20,120,1157,1198,2355,5293
160,50,140,1156,1199,2355,5404
-180,20,130,1137,1218,2355,5177
-150,-50,90,1142,1213,2355,5233
180,20,120,1157,1198,2355,5293
180,20,130,1137,1218,2355,5177
-60,50,50,1145,1210,2355,5173
30,70,-130,1128,1227,2355,5341
-40,-50,-150,1151,1204,2355,5332
50,70,-150,1153,1203,2356,5285
-160,-60,90,1134,1222,2356,5281
-60,70,10,1152,1204,2356,5231
-160,-80,110,1158,1198,2356,5267
0,20,-100,1114,1242,2356,5155
-100,-80,-160,1133,1223,2356,5453
-40,-10,-60,1176,1180,2356,5301
-90,80,60,1141,1215,2356,5219
-20,20,-60,1158,1198,2356,5203
-110,60,30,1153,1204,2357,5241
-150,-60,140,1125,1232,2357,5097
-180,40,140,1135,1222,2357,5209
-80,-80,-140,1147,1210,2357,5457
0,50,-90,1135,1222,2357,5269
-150,10,170,1184,1173,2357,5393
-150,20,140,1169,1188,2357,5120
180,40,140,1135,1222,2357,5209
100,80,-180,1143,1215,2358,5265
-10,70,-80,1158,1200,2358,5238
-120,-80,170,1165,1193,2358,5272
100,80,180,1143,1215,2358,5265
-10,60,-90,1150,1208,2358,5202
10,0,-70,1125,1233,2358,5421
-70,-70,-120,1162,1196,2358,5343
-70,-80,-130,1161,1197,2358,5409
0,60,-100,1139,1219,2358,5177
-60,50,-50,1162,1197,2359,5382
-170,30,100,1168,1191,2359,5142
-30,60,-10,1135,1224,2359,5257
40,70,-140,1145,1214,2359,5369
-50,70,-50,1179,1180,2359,5201
0,-80,-80,1131,1228,2359,5384
-100,-20,160,1168,1192,2360,5320
-130,-20,90,1183,1177,2360,5425
-130,80,100,1144,1217,2361,5117
100,80,-170,1145,1216,2361,5385
0,-70,-80,1148,1213,2361,5318
-170,10,100,1153,1208,2361,5097
0,40,-90,1154,1207,2361,5242
-10,50,-100,1148,1213,2361,5317
-60,40,-90,1165,1196,2361,5557
-130,10,160,1149,1212,2361,5281
50,80,-130,1131,1231,2362,5216
-170,70,80,1155,1207,2362,5015
-170,-20,120,1168,1194,2362,5226
-100,10,-160,1168,1194,2362,5378
-120,-20,100,1146,1216,2362,5193
-90,30,90,1156,1206,2362,5303
-60,-70,-110,1157,1205,2362,5344
-120,50,110,1163,1199,2362,5353
-80,40,10,1159,1203,2362,5270
-20,40,-80,1171,1191,2362,5137
-50,-50,-160,1142,1221,2363,5310
-100,-30,150,1170,1193,2363,5280
-140,-70,160,1145,1218,2363,5253
-30,70,-70,1150,1213,2363,5353
-120,-70,-170,1134,1229,2363,5290
-130,20,50,1159,1204,2363,5445
-150,-60,160,1147,1217,2364,5273
-60,-50,-170,1152,1212,2364,5267
-70,-50,180,1157,1207,2364,5171
-170,-30,130,1155,1209,2364,5096
170,80,140,1134,1230,2364,5146
-80,50,0,1146,1218,2364,5136
120,80,160,1141,1223,2364,5294
-10,30,-90,1151,1213,2364,5239
-90,-20,-90,1179,1185,2364,5475
-30,30,-120,1157,1207,2364,5233
-70,-50,-180,1157,1207,2364,5171
10,60,-110,1152,1213,2365,5218
-40,-30,-70,1168,1197,2365,5187
10,-30,-80,1134,1231,2365,5302
90,80,-160,1149,1216,2365,5357
-30,30,-40,1143,1222,2365,5356
160,60,120,1149,1217,2366,5309
140,80,160,1168,1198,2366,5294
10,-80,-80,1149,1217,2366,5236
10,-10,-60,1142,1224,2366,5356
10,60,-90,1154,1212,2366,5274
-170,50,140,1150,1217,2367,5225
-110,-70,-160,1148,1219,2367,5328
-70,50,-20,1188,1179,2367,5185
-120,-10,80,1182,1185,2367,5335
-90,10,90,1166,1201,2367,5395
0,10,-120,1146,1221,2367,5498
-60,80,10,1150,1217,2367,5130
-130,80,90,1152,1215,2367,5269
20,40,-120,1131,1236,2367,5354
-140,-60,160,1151,1216,2367,5158
-180,30,110,1158,1210,2368,5391
-10,-80,-90,1137,1231,2368,5460
-50,70,10,1148,1220,2368,5279
-30,60,-40,1174,1194,2368,5235
-160,80,70,1177,1191,2368,5268
130,80,170,1164,1204,2368,5271
-110,10,40,1158,1210,2368,5487
-110,0,170,1167,1201,2368,5165
-10,40,-80,1162,1206,2368,5270
-20,50,-80,1176,1192,2368,5144
-170,0,140,1145,1223,2368,5083
-70,-80,-140,1160,1208,2368,5335
180,30,110,1158,1210,2368,5391
-20,30,-80,1183,1185,2368,5229
10,40,-100,1137,1232,2369,5432
-80,70,60,1139,1230,2369,5274
-30,0,-50,1160,1209,2369,5144
-40,-70,-100,1157,1212,2369,5446
-40,-60,-90,1171,1198,2369,5236
-70,30,50,1157,1213,2370,5067
-70,60,0,1155,1215,2370,5234
-30,-20,-140,1164,1206,2370,5318
-150,-10,90,1150,1220,2370,5289
-60,0,-70,1140,1230,2370,5221
-90,-80,-150,1136,1234,2370,5513
-100,-70,-150,1151,1219,2370,5352
-160,-50,120,1152,1218,2370,5122
-160,30,90,1156,1214,2370,5363
-110,-80,-180,1173,1198,2371,5322
-120,60,40,1155,1216,2371,5309
-10,20,-70,1172,1199,2371,5222
-150,10,90,1163,1208,2371,5257
-30,-80,-110,1158,1213,2371,5326
-60,60,10,1155,1216,2371,5444
-110,-80,180,1173,1198,2371,5322
-140,30,70,1164,1207,2371,5090
-170,-20,160,1157,1214,2371,5103
-160,-60,120,1157,1214,2371,5275
-80,-30,-90,1184,1188,2372,5392
-70,-10,-170,1159,1213,2372,5285
-20,-10,-130,1173,1199,2372,5455
-120,-30,110,1154,1218,2372,5287
-20,-80,-100,1156,1216,2372,5399
-140,20,130,1170,1202,2372,5137
-70,50,-10,1161,1211,2372,5254
-70,20,-80,1178,1194,2372,5231
-110,-40,-120,1135,1237,2372,5113
-40,70,-80,1164,1208,2372,5328
-160,-70,120,1140,1232,2372,5270
-10,0,-60,1170,1203,2373,5416
-50,-80,-160,1148,1225,2373,5325
-60,40,40,1161,1212,2373,5224
-160,80,110,1155,1218,2373,5139
-160,-40,160,1167,1206,2373,5093
-110,-20,110,1162,1211,2373,5364
-70,-60,-110,1140,1233,2373,5526
-140,0,140,1178,1195,2373,5105
-140,-60,100,1146,1227,2373,5248
-90,60,0,1166,1207,2373,5357
-50,-10,-60,1176,1197,2373,5297
20,70,-140,1161,1213,2374,5482
180,80,130,1149,1225,2374,5208
10,-50,-70,1149,1225,2374,5295
-20,20,-70,1181,1193,2374,5280
-180,80,130,1149,1225,2374,5208
-80,20,60,1162,1212,2374,5379
-80,-80,-150,1161,1213,2374,5319
-170,-70,80,1143,1232,2375,5407
0,-20,-80,1138,1237,2375,5308
-90,-70,-140,1156,1219,2375,5373
-100,80,70,1140,1235,2375,5245
-30,30,-70,1181,1194,2375,5295
-120,0,-150,1151,1224,2375,5323
-160,0,150,1164,1211,2375,5046
10,70,-90,1154,1221,2375,5306
-150,10,140,1169,1206,2375,5069
-90,-80,-160,1167,1209,2376,5323
-70,70,20,1147,1229,2376,5333
160,50,130,1165,1211,2376,5414
110,80,180,1147,1229,2376,5422
110,80,-180,1147,1229,2376,5422
-20,40,-70,1169,1207,2376,5319
-150,10,160,1187,1189,2376,5299
-100,0,70,1157,1220,2377,5407
-70,30,20,1179,1198,2377,5479
-100,-80,-170,1171,1206,2377,5331
20,50,-110,1159,1218,2377,5343
-70,30,60,1125,1252,2377,5346
-140,20,70,1156,1221,2377,5122
-150,-70,140,1155,1222,2377,5313
70,80,-140,1142,1235,2377,5376
-40,-80,-110,1158,1220,2378,5311
-30,60,-80,1164,1214,2378,5316
-50,-80,-120,1163,1215,2378,5266
40,60,-140,1141,1237,2378,5449
-60,80,20,1157,1221,2378,5257
-30,-10,-140,1182,1196,2378,5373
-70,70,-40,1155,1223,2378,5302
-50,-20,-70,1179,1199,2378,5337
-10,-70,-90,1163,1215,2378,5252
110,80,170,1143,1235,2378,5303
-20,70,-90,1166,1213,2379,5271
-30,50,-70,1191,1188,2379,5216
-170,10,140,1165,1214,2379,5148
-150,10,-180,1168,1211,2379,5393
-170,-10,170,1133,1246,2379,5493
40,80,-120,1138,1241,2379,5253
-150,10,180,1168,1211,2379,5393
-150,-80,100,1141,1239,2380,5418
0,0,-60,1161,1219,2380,5447
-130,-70,-180,1150,1230,2380,5299
-160,-30,110,1161,1219,2380,5304
-20,10,-130,1174,1206,2380,5404
-70,60,-30,1168,1212,2380,5248
-60,-80,-130,1162,1218,2380,5326
-130,-70,180,1150,1230,2380,5299
-60,70,20,1161,1219,2380,5301
0,-20,-90,1150,1230,2380,5343
-130,-60,110,1148,1232,2380,5429
10,30,-120,1149,1231,2380,5344
60,80,-130,1155,1226,2381,5346
-60,70,30,1138,1243,2381,5282
-140,40,130,1176,1205,2381,5184
-90,10,40,1142,1239,2381,5389
-10,60,-70,1152,1229,2381,5327
10,70,-80,1152,1229,2381,5328
-150,80,60,1173,1208,2381,5298
-50,70,-10,1172,1210,2382,5376
-20,-60,-80,1170,1212,2382,5351
-50,60,-70,1177,1205,2382,5302
-20,-70,-90,1165,1217,2382,5328
80,80,-150,1157,1225,2382,5359
-20,50,-90,1175,1207,2382,5255
-10,50,-70,1162,1220,2382,5328
-100,60,20,1159,1223,2382,5240
0,-50,-100,1183,1200,2383,5266
30,60,-130,1151,1232,2383,5446
20,50,-130,1173,1210,2383,5316
-100,-40,-110,1143,1240,2383,5183
-80,-70,-130,1174,1209,2383,5360
-130,-40,-140,1151,1232,2383,5272
-140,-30,-160,1153,1231,2384,5327
-180,70,130,1162,1222,2384,5193
-50,10,-140,1185,1199,2384,5274
180,50,100,1157,1227,2384,5338
-90,10,80,1165,1219,2384,5389
-80,-60,-110,1128,1256,2384,5139
-30,30,-80,1183,1201,2384,5217
-180,50,100,1157,1227,2384,5338
0,50,-80,1173,1211,2384,5405
180,70,130,1162,1222,2384,5193
-110,-30,120,1171,1214,2385,5333
20,-40,-70,1144,1241,2385,5426
10,-80,-90,1148,1237,2385,5414
-50,20,-50,1154,1231,2385,5195
-60,60,20,1160,1225,2385,5359
-60,60,-60,1180,1205,2385,5399
-110,80,80,1150,1235,2385,5228
-70,70,-30,1190,1195,2385,5287
-40,60,-30,1161,1225,2386,5286
0,20,-120,1170,1216,2386,5570
-50,30,-110,1181,1205,2386,5355
-30,10,-50,1158,1228,2386,5225
-160,-40,130,1164,1222,2386,5334
-30,40,-70,1172,1214,2386,5165
-10,40,-120,1181,1205,2386,5348
-140,0,-160,1144,1243,2387,5450
-80,20,-120,1184,1203,2387,5366
0,70,-80,1159,1228,2387,5261
-40,-70,-150,1148,1239,2387,5256
0,50,-100,1152,1235,2387,5055
-160,70,70,1171,1216,2387,5189
-30,20,-80,1195,1192,2387,5282
-140,-30,-150,1147,1240,2387,5363
-150,-80,110,1141,1246,2387,5289
20,70,-90,1160,1227,2387,5315
130,80,150,1167,1220,2387,5376
10,90,-100,1155,1233,2388,5283
150,90,120,1155,1233,2388,5283
40,80,-110,1164,1224,2388,5313
90,90,-180,1155,1233,2388,5283
-60,90,-30,1155,1233,2388,5283
50,90,-140,1155,1233,2388,5283
-180,90,90,1155,1233,2388,5283
-120,90,30,1155,1233,2388,5283
40,90,-130,1155,1233,2388,5283
-170,90,80,1155,1233,2388,5283
-100,90,10,1155,1233,2388,5283
-150,90,60,1155,1233,2388,5283
-40,90,-50,1155,1233,2388,5283
10,-70,-90,1158,1230,2388,5364
90,90,180,1155,1233,2388,5283
-140,90,50,1155,1233,2388,5283
100,90,170,1155,1233,2388,5283
-160,90,70,1155,1233,2388,5283
-80,90,-10,1155,1233,2388,5283
120,90,150,1155,1233,2388,5283
-50,90,-40,1155,1233,2388,5283
20,90,-110,1155,1233,2388,5283
-130,90,40,1155,1233,2388,5283
160,90,110,1155,1233,2388,5283
30,90,-120,1155,1233,2388,5283
140,90,130,1155,1233,2388,5283
70,90,-160,1155,1233,2388,5283
60,90,-150,1155,1233,2388,5283
-10,80,-80,1164,1224,2388,5380
-10,90,-80,1155,1233,2388,5283
-70,90,-20,1155,1233,2388,5283
-60,50,-70,1202,1186,2388,5313
110,90,160,1155,1233,2388,5283
-140,10,150,1177,1211,2388,5306
-110,90,20,1155,1233,2388,5283
-30,90,-60,1155,1233,2388,5283
80,90,-170,1155,1233,2388,5283
-100,10,40,1159,1229,2388,5638
-20,90,-70,1155,1233,2388,5283
170,90,100,1155,1233,2388,5283
-90,90,0,1155,1233,2388,5283
0,90,-90,1155,1233,2388,5283
180,90,90,1155,1233,2388,5283
130,90,140,1155,1233,2388,5283
-60,60,-50,1173,1216,2389,5359
-160,50,80,1184,1205,2389,5257
-120,80,90,1143,1246,2389,5184
-60,-80,-170,1157,1232,2389,5328
0,50,-110,1171,1218,2389,5404
-80,0,-170,1184,1206,2390,5436
-160,-40,120,1167,1223,2390,5057
-70,-30,-90,1174,1216,2390,5335
-60,30,-100,1207,1183,2390,5518
10,0,-60,1138,1252,2390,5314
-90,-40,160,1166,1224,2390,5091
-170,80,120,1163,1227,2390,5223
-50,0,-60,1177,1214,2391,5327
-100,0,180,1201,1190,2391,5263
0,-80,-90,1164,1227,2391,5350
-120,40,40,1163,1228,2391,5467
-100,0,-180,1201,1190,2391,5263
-50,50,-50,1161,1230,2391,5364
-130,10,150,1170,1221,2391,5393
140,70,150,1158,1233,2391,5556
-150,-50,170,1153,1238,2391,5207
-100,70,80,1157,1234,2391,5344
-110,70,90,1162,1230,2392,5271
-60,60,-40,1195,1197,2392,5262
-20,80,-40,1170,1222,2392,5271
10,-50,-90,1167,1225,2392,5414
-20,70,-70,1183,1209,2392,5283
-30,40,-40,1152,1240,2392,5473
-100,0,110,1169,1223,2392,5299
-110,-20,150,1214,1178,2392,5330
-160,10,140,1172,1221,2393,5098
-80,80,40,1163,1230,2393,5321
50,80,-120,1159,1234,2393,5344
-110,80,70,1170,1223,2393,5375
-140,10,80,1179,1214,2393,5237
-130,-80,150,1153,1240,2393,5369
-10,10,-80,1171,1222,2393,5279
150,80,150,1170,1224,2394,5311
-120,10,180,1190,1204,2394,5470
170,50,110,1165,1229,2394,5424
120,80,170,1155,1239,2394,5492
-150,-80,120,1176,1218,2394,5313
-40,70,-60,1186,1208,2394,5269
-120,70,100,1177,1217,2394,5235
-120,10,-180,1190,1204,2394,5470
-60,70,-40,1192,1202,2394,5313
-110,10,-170,1173,1221,2394,5394
-70,70,40,1155,1240,2395,5285
-100,10,-110,1157,1238,2395,5542
-170,40,140,1169,1226,2395,5157
-130,10,-170,1175,1220,2395,5539
-70,70,30,1174,1221,2395,5326
0,60,-80,1163,1232,2395,5361
-120,0,70,1166,1229,2395,5468
180,30,120,1181,1215,2396,5315
-180,30,120,1181,1215,2396,5315
-130,0,150,1176,1220,2396,5331
-70,80,30,1163,1233,2396,5332
-50,40,-30,1190,1206,2396,5302
-100,40,100,1143,1253,2396,5278
-150,-20,140,1159,1237,2396,5167
-160,-20,180,1179,1218,2397,5430
-40,-80,-120,1170,1227,2397,5380
-130,60,50,1169,1228,2397,5453
-120,80,80,1168,1229,2397,5390
-160,-20,-180,1179,1218,2397,5430
-60,50,10,1166,1232,2398,5374
-140,-30,90,1183,1215,2398,5382
-40,80,-50,1173,1225,2398,5320
-140,-10,140,1185,1213,2398,5226
-60,40,-70,1209,1189,2398,5550
160,70,140,1171,1227,2398,5294
-90,10,60,1181,1217,2398,5458
10,50,-100,1154,1244,2398,5309
-150,50,130,1193,1205,2398,5142
-80,30,30,1201,1197,2398,5421
-140,-80,110,1155,1244,2399,5492
-160,-10,100,1146,1253,2399,5153
20,50,-120,1148,1251,2399,5329
-90,10,70,1177,1222,2399,5397
150,70,140,1161,1238,2399,5665
-40,70,-70,1167,1232,2399,5334
-90,10,-150,1190,1209,2399,5325
-60,60,0,1164,1235,2399,5284
-30,80,-30,1185,1214,2399,5350
-100,10,-120,1172,1227,2399,5621
-80,-40,-100,1176,1223,2399,5257
-30,70,-90,1173,1226,2399,5483
-30,40,-60,1199,1201,2400,5365
-30,50,-80,1171,1229,2400,5531
-160,-10,140,1172,1228,2400,5251
0,-10,-60,1160,1240,2400,5540
-20,60,-50,1183,1217,2400,5339
-160,-20,140,1165,1235,2400,5338
-10,-40,-70,1199,1201,2400,5450
30,60,-140,1161,1240,2401,5321
-50,40,-40,1190,1211,2401,5269
-130,70,110,1170,1231,2401,5209
-60,40,-80,1181,1220,2401,5528
-30,50,-50,1178,1223,2401,5469
-50,30,-50,1199,1202,2401,5277
10,40,-110,1160,1241,2401,5409
-150,70,60,1177,1225,2402,5239
-120,20,130,1154,1248,2402,5488
-90,70,70,1159,1243,2402,5388
-10,-30,-110,1180,1222,2402,5261
-50,60,20,1146,1256,2402,5386
-30,-70,-100,1186,1217,2403,5352
-100,40,30,1193,1210,2403,5438
-10,-10,-80,1178,1225,2403,5257
-80,30,20,1198,1205,2403,5461
-60,50,40,1189,1214,2403,5321
0,-40,-70,1181,1222,2403,5502
-80,60,10,1171,1232,2403,5289
-110,20,120,1171,1232,2403,5585
-40,20,-40,1187,1216,2403,5324
-80,70,40,1179,1224,2403,5334
-60,70,-50,1183,1220,2403,5325
-150,-50,150,1176,1228,2404,5271
-170,-10,150,1159,1245,2404,5282
-10,40,-90,1186,1218,2404,5329
-170,50,130,1167,1237,2404,5187
-160,-70,90,1149,1255,2404,5485
-40,40,-110,1170,1235,2405,5621
-170,70,120,1172,1233,2405,5321
-40,40,-30,1154,1251,2405,5496
-60,70,0,1185,1220,2405,5423
-20,10,-50,1177,1228,2405,5374
-50,50,-90,1177,1228,2405,5478
-10,-10,-60,1182,1224,2406,5394
-30,50,-60,1179,1227,2406,5300
160,70,120,1174,1232,2406,5456
10,40,-120,1179,1228,2407,5604
-60,-40,-90,1162,1245,2407,5298
-20,80,-70,1173,1234,2407,5399
160,60,140,1179,1228,2407,5237
-120,0,140,1182,1225,2407,5490
-10,20,-90,1163,1244,2407,5290
-140,-60,-180,1170,1237,2407,5336
-140,-60,180,1170,1237,2407,5336
-60,80,-30,1191,1216,2407,5416
-100,0,-100,1185,1223,2408,5457
-110,40,30,1172,1236,2408,5583
10,-70,-80,1160,1248,2408,5445
-50,-80,-130,1172,1236,2408,5369
-140,-50,100,1163,1245,2408,5330
-100,-10,170,1204,1205,2409,5414
-170,30,140,1179,1230,2409,5342
-110,-20,140,1202,1207,2409,5488
-160,60,130,1178,1231,2409,5198
50,70,-160,1163,1247,2410,5454
-90,60,10,1185,1225,2410,5277
-130,40,60,1189,1221,2410,5392
-50,30,-40,1187,1223,2410,5342
-20,60,-90,1176,1234,2410,5353
30,80,-110,1163,1247,2410,5257
-150,30,80,1167,1243,2410,5235
-90,-50,-120,1162,1248,2410,5265
-100,80,10,1211,1199,2410,5552
-10,60,-120,1190,1220,2410,5690
-20,20,-90,1176,1234,2410,5378
-10,-40,-110,1181,1229,2410,5291
-80,50,20,1164,1246,2410,5454
-20,-50,-80,1196,1215,2411,5554
-20,30,-70,1201,1210,2411,5254
130,80,160,1167,1244,2411,5534
-10,-20,-90,1184,1227,2411,5192
-100,80,60,1180,1231,2411,5375
-120,0,160,1198,1213,2411,5358
-140,10,170,1203,1208,2411,5531
-60,60,-10,1167,1244,2411,5260
-150,0,-170,1174,1237,2411,5413
-50,60,-20,1180,1232,2412,5320
-50,80,-40,1183,1229,2412,5369
-40,50,-30,1179,1233,2412,5441
-70,70,10,1191,1221,2412,5444
-30,-10,-60,1196,1216,2412,5373
170,40,120,1174,1239,2413,5446
-150,-70,130,1170,1243,2413,5486
-50,50,-20,1163,1250,2413,5531
-150,0,140,1180,1234,2414,5231
-130,0,140,1171,1243,2414,5412
-70,80,20,1174,1240,2414,5233
-40,40,-50,1221,1193,2414,5286
-90,80,50,1174,1240,2414,5356
-10,-60,-80,1168,1246,2414,5383
-10,50,-80,1173,1241,2414,5413
-60,-80,-140,1177,1237,2414,5332
10,-60,-90,1171,1244,2415,5407
-140,80,50,1188,1227,2415,5440
-140,-70,150,1170,1245,2415,5378
-110,0,70,1182,1233,2415,5438
0,-30,-90,1170,1245,2415,5365
-160,0,140,1172,1244,2416,5163
-80,80,-10,1201,1215,2416,5494
-60,50,-30,1184,1233,2417,5331
-170,50,90,1178,1239,2417,5396
-150,-20,-170,1187,1230,2417,5460
-130,10,170,1179,1238,2417,5435
-20,-70,-100,1172,1245,2417,5380
-140,-80,130,1179,1238,2417,5368
-70,-50,-100,1165,1252,2417,5344
-90,80,0,1209,1208,2417,5530
-50,30,-60,1173,1244,2417,5453
-130,-80,120,1169,1248,2417,5624
-60,-10,-160,1206,1211,2417,5267
0,-80,-100,1162,1255,2417,5554
-70,50,30,1181,1237,2418,5181
20,80,-100,1177,1241,2418,5297
-70,40,20,1187,1231,2418,5446
-20,40,-90,1191,1227,2418,5196
-170,10,130,1164,1254,2418,5284
-70,30,40,1182,1236,2418,5373
-140,30,60,1176,1242,2418,5447
-160,-50,150,1156,1262,2418,5293
-90,20,30,1200,1218,2418,5598
-70,10,-150,1194,1225,2419,5578
0,70,-70,1161,1258,2419,5367
-20,60,-70,1192,1227,2419,5407
-20,30,-120,1210,1209,2419,5481
-10,-30,-90,1182,1238,2420,5334
-130,80,40,1195,1225,2420,5530
-60,70,-30,1201,1219,2420,5382
-50,-70,-160,1168,1252,2420,5365
-10,-10,-90,1176,1244,2420,5233
-50,70,-60,1182,1238,2420,5222
-10,-80,-100,1174,1247,2421,5434
-100,30,30,1190,1231,2421,5560
-10,-20,-100,1182,1239,2421,5363
-50,-50,-90,1174,1247,2421,5488
-150,80,100,1171,1250,2421,5266
-10,70,-70,1161,1260,2421,5397
-120,50,50,1191,1230,2421,5353
-50,-30,-80,1165,1257,2422,5470
-150,70,120,1161,1261,2422,5311
-110,80,20,1209,1213,2422,5541
-180,60,130,1174,1248,2422,5247
-30,30,-60,1205,1217,2422,5330
10,50,-110,1180,1242,2422,5369
180,60,130,1174,1248,2422,5247
-90,60,20,1176,1247,2423,5308
-30,60,-70,1187,1236,2423,5313
-140,0,80,1174,1249,2423,5434
-110,70,20,1195,1229,2424,5471
-170,90,110,1171,1253,2424,5305
-40,90,-20,1171,1253,2424,5305
10,-60,-80,1163,1261,2424,5510
-60,-60,-170,1174,1250,2424,5456
-70,-80,-180,1176,1248,2424,5421
-30,80,-60,1187,1237,2424,5382
-160,90,100,1171,1253,2424,5305
-10,60,-100,1196,1228,2424,5487
110,90,-170,1171,1253,2424,5305
-50,90,-10,1171,1253,2424,5305
-140,90,80,1171,1253,2424,5305
-80,90,20,1171,1253,2424,5305
80,90,-140,1171,1253,2424,5305
120,90,180,1171,1253,2424,5305
-130,90,70,1171,1253,2424,5305
10,90,-70,1171,1253,2424,5305
-20,50,-60,1181,1243,2424,5507
140,90,160,1171,1253,2424,5305
90,90,-150,1171,1253,2424,5305
40,90,-100,1171,1253,2424,5305
20,90,-80,1171,1253,2424,5305
30,90,-90,1171,1253,2424,5305
-60,90,0,1171,1253,2424,5305
70,90,-130,1171,1253,2424,5305
60,90,-120,1171,1253,2424,5305
0,90,-60,1171,1253,2424,5305
-20,90,-40,1171,1253,2424,5305
50,90,-110,1171,1253,2424,5305
-70,-80,180,1176,1248,2424,5421
160,90,140,1171,1253,2424,5305
130,90,170,1171,1253,2424,5305
100,90,-160,1171,1253,2424,5305
120,90,-180,1171,1253,2424,5305
-120,90,60,1171,1253,2424,5305
-90,90,30,1171,1253,2424,5305
-100,90,40,1171,1253,2424,5305
0,50,-120,1186,1238,2424,5477
-30,90,-30,1171,1253,2424,5305
170,90,130,1171,1253,2424,5305
-150,90,90,1171,1253,2424,5305
-80,70,30,1171,1253,2424,5460
-70,90,10,1171,1253,2424,5305
180,90,120,1171,1253,2424,5305
150,90,150,1171,1253,2424,5305
-110,90,50,1171,1253,2424,5305
160,80,140,1171,1253,2424,5365
-10,90,-50,1171,1253,2424,5305
-180,90,120,1171,1253,2424,5305
-90,70,50,1186,1238,2424,5346
-40,30,-40,1191,1233,2424,5307
-140,70,50,1187,1238,2425,5377
-160,0,160,1203,1222,2425,5385
-40,50,-60,1191,1234,2425,5425
-150,-60,110,1197,1228,2425,5557
-170,-30,120,1162,1263,2425,5452
-160,60,120,1171,1254,2425,5164
-80,70,50,1181,1245,2426,5362
180,50,130,1172,1254,2426,5296
-180,50,130,1172,1254,2426,5296
-110,20,40,1203,1223,2426,5574
0,30,-100,1161,1265,2426,5406
-60,-20,-80,1208,1218,2426,5348
-80,-50,-110,1173,1253,2426,5294
-160,20,140,1192,1235,2427,5255
-40,10,-50,1189,1238,2427,5351
-40,40,-40,1209,1218,2427,5392
-90,10,50,1190,1237,2427,5649
0,40,-110,1193,1234,2427,5368
-140,10,160,1194,1233,2427,5226
0,-40,-90,1163,1264,2427,5413
-80,40,20,1186,1241,2427,5511
-50,50,20,1192,1236,2428,5380
-30,-60,-90,1205,1223,2428,5557
-70,60,10,1169,1259,2428,5321
-80,-50,170,1187,1241,2428,5367
-10,-20,-110,1186,1242,2428,5337
-120,-40,-130,1178,1250,2428,5430
-90,60,30,1192,1236,2428,5253
-50,50,-30,1202,1227,2429,5332
-150,-70,120,1191,1238,2429,5531
-90,-20,170,1167,1262,2429,5471
-170,0,120,1192,1237,2429,5328
0,-70,-100,1191,1239,2430,5566
-120,80,30,1205,1225,2430,5564
-40,80,-20,1191,1239,2430,5399
-110,0,-140,1184,1246,2430,5452
-50,20,-120,1197,1233,2430,5472
170,40,130,1193,1237,2430,5583
140,80,140,1192,1238,2430,5382
-10,70,-100,1180,1250,2430,5383
-40,0,-60,1213,1217,2430,5411
-160,0,100,1193,1237,2430,5277
-20,70,-100,1194,1237,2431,5560
170,60,110,1184,1247,2431,5468
-100,70,10,1209,1222,2431,5474
-60,10,-70,1213,1218,2431,5267
-140,80,90,1166,1265,2431,5376
-170,20,130,1182,1249,2431,5514
-50,70,-40,1181,1250,2431,5339
170,70,130,1184,1247,2431,5339
-100,60,90,1194,1237,2431,5435
-80,80,30,1183,1249,2432,5322
-80,20,50,1198,1234,2432,5440
-50,-70,-110,1203,1229,2432,5488
-130,10,70,1184,1248,2432,5474
-10,0,-80,1189,1243,2432,5327
-20,-10,-60,1201,1231,2432,5372
-110,-80,170,1191,1242,2433,5507
-60,40,-60,1227,1206,2433,5519
-120,20,40,1208,1225,2433,5629
10,60,-130,1181,1252,2433,5625
-120,-80,160,1187,1246,2433,5473
-10,10,-90,1192,1241,2433,5460
-20,10,-60,1180,1253,2433,5428
-10,-10,-100,1171,1262,2433,5284
-80,60,-10,1221,1212,2433,5443
-130,-50,-160,1178,1255,2433,5344
-50,50,-40,1215,1218,2433,5324
-150,-10,140,1182,1252,2434,5296
-20,-40,-70,1203,1231,2434,5498
-110,50,100,1178,1256,2434,5395
-130,-30,100,1178,1256,2434,5502
-110,-10,100,1174,1260,2434,5473
-110,30,30,1193,1241,2434,5757
-80,-80,170,1185,1250,2435,5452
0,-60,-80,1177,1258,2435,5409
-20,30,-90,1188,1248,2436,5314
-100,0,100,1187,1249,2436,5541
-60,60,-30,1217,1219,2436,5513
-100,-10,-100,1198,1238,2436,5465
-40,30,-60,1204,1232,2436,5464
-180,30,130,1172,1265,2437,5376
180,30,130,1172,1265,2437,5376
-70,10,-80,1204,1233,2437,5453
-60,30,-90,1191,1246,2437,5533
-70,20,-100,1230,1207,2437,5567
-110,-50,130,1175,1262,2437,5372
-130,-70,170,1186,1251,2437,5320
-30,60,-60,1200,1237,2437,5330
-80,20,-110,1214,1223,2437,5528
-20,50,-70,1193,1244,2437,5473
-20,60,-60,1192,1246,2438,5597
-100,0,90,1195,1243,2438,5518
-30,10,-80,1216,1222,2438,5398
-70,20,-90,1186,1252,2438,5432
10,70,-130,1192,1246,2438,5686
-150,-70,100,1167,1272,2439,5568
0,60,-110,1203,1236,2439,5602
-10,20,-100,1177,1262,2439,5247
-70,50,0,1191,1248,2439,5561
-140,-20,-160,1193,1246,2439,5546
0,40,-120,1203,1236,2439,5453
-50,20,-60,1195,1244,2439,5408
-130,70,40,1197,1242,2439,5467
-40,50,-40,1200,1239,2439,5464
160,80,120,1212,1228,2440,5453
10,-50,-80,1185,1255,2440,5477
20,60,-130,1185,1255,2440,5527
10,50,-120,1190,1250,2440,5486
-160,-30,140,1187,1253,2440,5388
-40,0,-140,1233,1207,2440,5574
-80,70,-10,1212,1228,2440,5372
140,80,150,1179,1261,2440,5613
-80,20,-100,1204,1236,2440,5741
-50,60,-60,1210,1230,2440,5311
-160,-10,150,1184,1256,2440,5336
-10,-50,-110,1195,1246,2441,5510
-80,0,-80,1217,1224,2441,5451
150,80,130,1202,1239,2441,5457
-40,60,-80,1201,1240,2441,5368
-50,-10,-150,1207,1234,2441,5468
-90,70,60,1187,1254,2441,5348
170,80,130,1181,1260,2441,5358
0,40,-100,1184,1258,2442,5433
-70,80,-20,1200,1242,2442,5474
-10,-60,-110,1207,1235,2442,5455
-80,70,20,1210,1232,2442,5498
-120,70,30,1203,1239,2442,5517
-70,20,-110,1210,1232,2442,5516
-90,70,0,1215,1227,2442,5482
170,80,110,1214,1228,2442,5486
-150,-60,130,1182,1261,2443,5505
-60,50,-10,1176,1267,2443,5572
-50,-60,-100,1201,1243,2444,5545
-40,30,-50,1222,1222,2444,5358
-150,-50,100,1184,1260,2444,5613
-150,70,110,1171,1273,2444,5294
-80,-20,-180,1181,1264,2445,5520
-70,-80,-150,1193,1252,2445,5398
-180,40,110,1182,1263,2445,5595
180,40,110,1182,1263,2445,5595
-10,70,-60,1198,1247,2445,5462
-80,-20,180,1181,1264,2445,5520
-10,-80,-110,1176,1270,2446,5652
-40,-40,-80,1207,1239,2446,5541
-60,30,-80,1194,1252,2446,5696
30,80,-100,1194,1253,2447,5400
-150,-10,-170,1205,1242,2447,5544
-160,70,110,1197,1250,2447,5409
-120,10,60,1209,1238,2447,5647
-130,-70,160,1188,1259,2447,5361
-30,20,-70,1218,1229,2447,5404
-160,-20,110,1169,1278,2447,5368
-130,-60,-170,1195,1252,2447,5431
-40,20,-70,1212,1235,2447,5589
-110,-10,160,1201,1246,2447,5402
-120,-10,90,1215,1232,2447,5531
-20,10,-80,1191,1257,2448,5527
-120,10,-170,1204,1244,2448,5710
0,-60,-100,1190,1258,2448,5477
10,-40,-70,1182,1266,2448,5419
-60,50,-20,1207,1241,2448,5323
-130,30,50,1202,1246,2448,5594
-100,-80,-180,1187,1262,2449,5500
-30,50,-110,1204,1245,2449,5752
-70,-40,-100,1209,1240,2449,5329
-100,-80,180,1187,1262,2449,5500
-90,50,30,1180,1269,2449,5562
-70,60,20,1181,1268,2449,5676
-50,60,-40,1202,1247,2449,5465
-60,70,-10,1214,1235,2449,5337
-150,-30,100,1193,1257,2450,5463
-80,30,70,1191,1259,2450,5546
-40,-20,-70,1206,1244,2450,5434
-90,50,20,1190,1260,2450,5561
-50,60,-50,1204,1246,2450,5448
-140,-40,100,1187,1263,2450,5487
-10,-10,-70,1221,1229,2450,5558
-170,0,170,1180,1270,2450,5497
-50,80,-10,1206,1245,2451,5450
-40,60,-70,1212,1239,2451,5445
-120,-10,150,1204,1247,2451,5368
-90,-10,-180,1220,1231,2451,5458
-90,-10,180,1220,1231,2451,5458
-70,40,40,1223,1228,2451,5362
40,70,-150,1169,1282,2451,5621
150,80,140,1171,1281,2452,5634
-30,-30,-70,1211,1241,2452,5479
-170,10,110,1202,1250,2452,5563
-70,40,60,1180,1272,2452,5513
10,80,-90,1202,1250,2452,5401
160,60,130,1187,1265,2452,5831
-10,-20,-80,1195,1257,2452,5539
-120,40,50,1205,1248,2453,5350
-40,60,-50,1208,1245,2453,5377
-70,70,-20,1208,1245,2453,5435
-80,-80,-160,1196,1257,2453,5437
-50,50,-70,1218,1235,2453,5568
-110,-10,-130,1204,1249,2453,5342
-90,60,80,1192,1262,2454,5555
-140,-80,120,1187,1267,2454,5450
-50,10,-60,1209,1245,2454,5581
-50,60,-80,1188,1266,2454,5634
-20,10,-70,1218,1236,2454,5435
-90,20,90,1187,1267,2454,5476
10,-40,-80,1181,1273,2454,5508
-130,-30,-140,1186,1268,2454,5533
-80,60,70,1184,1270,2454,5553
10,60,-120,1203,1252,2455,5676
-20,20,-80,1209,1246,2455,5371
10,-10,-70,1163,1292,2455,5455
-160,-40,140,1182,1273,2455,5312
-90,-80,160,1186,1269,2455,5585
-120,-50,120,1206,1249,2455,5401
-70,60,-20,1223,1232,2455,5572
-60,80,0,1210,1245,2455,5443
-80,50,10,1185,1271,2456,5610
-140,-70,140,1189,1267,2456,5628
-170,-20,150,1192,1264,2456,5441
-20,-80,-110,1195,1261,2456,5446
-10,-40,-90,1190,1267,2457,5603
-140,10,180,1211,1246,2457,5768
-30,30,-50,1209,1248,2457,5518
-140,40,70,1211,1246,2457,5441
-10,30,-120,1213,1244,2457,5636
-140,10,-180,1211,1246,2457,5768
-20,-60,-90,1207,1250,2457,5543
-90,80,40,1199,1259,2458,5417
-90,20,40,1214,1244,2458,5727
-130,40,120,1211,1247,2458,5595
-90,-80,-170,1198,1260,2458,5470
-70,50,60,1194,1264,2458,5460
-140,-60,150,1182,1276,2458,5179
-90,-10,-90,1210,1248,2458,5385
-110,50,40,1199,1259,2458,5379
-20,0,-60,1198,1261,2459,5590
-150,-70,110,1192,1267,2459,5492
-180,70,120,1184,1275,2459,5378
-40,60,-60,1206,1253,2459,5454
-30,20,-50,1206,1253,2459,5453
-160,-10,-180,1203,1256,2459,5661
20,80,-90,1183,1276,2459,5468
-90,-30,-100,1206,1253,2459,5616
-120,30,120,1229,1230,2459,5572
-10,-70,-110,1204,1255,2459,5640
-160,-10,180,1203,1256,2459,5661
-80,60,20,1186,1273,2459,5284
180,70,120,1184,1275,2459,5378
-80,70,10,1213,1247,2460,5384
-140,60,60,1193,1267,2460,5636
-150,0,150,1209,1251,2460,5369
-30,-50,-80,1214,1246,2460,5278
-60,60,30,1198,1262,2460,5550
-10,-40,-80,1201,1259,2460,5781
-40,-70,-110,1221,1239,2460,5397
-70,60,30,1199,1262,2461,5442
-140,-60,170,1183,1278,2461,5485
-40,30,-70,1218,1243,2461,5528
-150,40,130,1194,1267,2461,5320
-10,0,-120,1182,1279,2461,5728
-40,40,-60,1224,1237,2461,5484
-130,10,180,1213,1249,2462,5785
-100,50,40,1186,1276,2462,5564
-130,10,-180,1213,1249,2462,5785
-120,20,50,1206,1256,2462,5643
-90,70,40,1189,1274,2463,5602
-10,40,-100,1197,1266,2463,5300
180,80,120,1195,1268,2463,5504
-180,80,120,1195,1268,2463,5504
-100,70,60,1199,1264,2463,5389
-120,-80,130,1186,1277,2463,5753
-130,20,60,1193,1270,2463,5583
-140,20,80,1185,1278,2463,5424
-80,60,0,1223,1240,2463,5408
-110,60,40,1193,1271,2464,5431
-20,10,-90,1193,1271,2464,5337
-160,-40,150,1190,1274,2464,5605
-160,-30,170,1191,1273,2464,5429
-120,0,170,1207,1258,2465,5409
-20,70,-50,1215,1250,2465,5451
-10,-50,-80,1223,1242,2465,5539
0,20,-110,1170,1295,2465,5447
-130,80,80,1200,1265,2465,5467
-150,-40,100,1202,1263,2465,5649
-160,0,130,1201,1264,2465,5514
-130,-10,150,1216,1249,2465,5279
-120,10,130,1192,1273,2465,5580
-110,-40,130,1222,1243,2465,5599
0,-10,-70,1194,1271,2465,5545
-110,-40,-130,1193,1274,2467,5258
-130,10,130,1228,1239,2467,5545
-100,-40,-120,1204,1263,2467,5372
170,70,110,1220,1247,2467,5597
-100,60,40,1206,1261,2467,5350
-110,-20,-120,1219,1248,2467,5550
-50,40,-60,1202,1265,2467,5720
-130,-30,-150,1191,1276,2467,5502
-50,50,-80,1211,1256,2467,5645
-160,0,170,1215,1252,2467,5613
-130,-40,-150,1179,1289,2468,5258
-30,70,-60,1209,1259,2468,5352
-40,20,-80,1209,1259,2468,5440
-140,60,120,1212,1256,2468,5545
-70,-20,-170,1222,1246,2468,5485
-80,40,30,1215,1253,2468,5428
-40,10,-80,1229,1240,2469,5436
0,-20,-70,1209,1260,2469,5764
-110,40,40,1210,1259,2469,5492
-40,20,-60,1220,1249,2469,5484
-10,-10,-110,1195,1275,2470,5477
-60,-10,-80,1227,1243,2470,5447
-150,-20,100,1199,1271,2470,5434
-60,-70,-170,1195,1275,2470,5573
-10,70,-110,1218,1252,2470,5618
-50,-70,-120,1225,1245,2470,5481
-160,-30,120,1202,1268,2470,5465
-130,-80,130,1200,1270,2470,5613
-100,50,30,1208,1263,2471,5475
-150,-40,-180,1185,1286,2471,5600
-70,0,-80,1220,1251,2471,5565
170,60,130,1191,1280,2471,5390
-150,-40,180,1185,1286,2471,5600
-100,-30,160,1234,1237,2471,5511
160,80,130,1186,1285,2471,5694
-120,-70,180,1196,1276,2472,5491
-120,-70,-180,1196,1276,2472,5491
-50,40,-100,1207,1265,2472,5867
-10,-30,-100,1213,1259,2472,5352
-50,70,-20,1223,1249,2472,5451
-120,-10,140,1223,1249,2472,5552
0,80,-80,1213,1259,2472,5506
-100,80,50,1208,1265,2473,5517
-150,-20,150,1207,1266,2473,5446
-40,70,-50,1196,1277,2473,5454
-20,-60,-120,1225,1248,2473,5635
-90,70,30,1228,1245,2473,5573
-140,70,100,1197,1276,2473,5466
-140,0,150,1229,1245,2474,5290
-30,40,-80,1215,1259,2474,5446
-90,10,-90,1215,1259,2474,5593
-110,10,50,1232,1242,2474,5889
-70,80,10,1217,1257,2474,5496
-140,-20,90,1228,1246,2474,5604
-80,80,20,1217,1257,2474,5550
-120,-40,-140,1199,1276,2475,5477
-90,40,30,1209,1266,2475,5665
-10,30,-100,1211,1264,2475,5436
0,-30,-70,1206,1270,2476,5833
-150,-50,110,1209,1267,2476,5552
-70,-10,-80,1233,1243,2476,5548
-100,60,30,1195,1281,2476,5386
-100,0,-110,1224,1252,2476,5516
-70,50,20,1184,1292,2476,5606
-80,20,40,1227,1249,2476,5759
-150,10,130,1215,1261,2476,5520
-20,-40,-100,1209,1268,2477,5502
-30,-80,-120,1204,1273,2477,5507
-130,20,70,1208,1269,2477,5413
-110,-80,140,1184,1293,2477,5780
-150,0,160,1219,1258,2477,5557
-140,-50,150,1192,1285,2477,5198
0,70,-120,1216,1262,2478,5707
-130,30,60,1216,1262,2478,5624
-110,-10,130,1218,1261,2479,5559
-10,0,-110,1189,1290,2479,5465
-170,40,100,1210,1269,2479,5590
-20,70,-60,1198,1281,2479,5533
-160,10,100,1229,1250,2479,5527
-140,-70,110,1198,1281,2479,5692
-60,20,-110,1235,1245,2480,5549
-50,0,-70,1218,1262,2480,5750
-150,-60,120,1222,1258,2480,5645
-80,10,-150,1219,1262,2481,5652
-10,-50,-90,1198,1283,2481,5712
-170,40,130,1196,1285,2481,5362
-120,40,110,1229,1252,2481,5543
-140,-10,90,1253,1228,2481,5556
-80,10,-140,1241,1240,2481,5621
-60,-70,-130,1224,1258,2482,5567
-10,0,-90,1205,1277,2482,5505
-70,-60,-180,1207,1275,2482,5558
-70,-60,180,1207,1275,2482,5558
0,30,-120,1214,1268,2482,5611
-140,-20,140,1203,1279,2482,5443
-40,50,-50,1221,1261,2482,5532
-180,60,100,1230,1253,2483,5525
180,60,100,1230,1253,2483,5525
-10,-30,-70,1213,1270,2483,5734
-130,-80,140,1201,1282,2483,5425
-10,-20,-70,1218,1265,2483,5747
-70,70,0,1211,1273,2484,5337
-110,0,80,1227,1257,2484,5668
-40,10,-60,1219,1265,2484,5484
-100,30,100,1201,1283,2484,5592
0,-70,-90,1207,1278,2485,5683
-120,-60,-160,1222,1263,2485,5538
-140,0,90,1220,1265,2485,5539
-30,-70,-110,1205,1280,2485,5666
-80,-10,-80,1245,1241,2486,5790
-50,10,-70,1227,1259,2486,5679
-40,-60,-100,1240,1246,2486,5631
-90,80,30,1228,1258,2486,5621
-170,60,120,1215,1271,2486,5486
-80,40,40,1207,1279,2486,5477
-30,-10,-70,1246,1240,2486,5590
10,80,-80,1194,1293,2487,5544
-160,50,130,1203,1284,2487,5509
-170,80,110,1201,1286,2487,5460
-100,70,70,1224,1263,2487,5412
-160,40,90,1224,1263,2487,5529
-50,50,-60,1231,1257,2488,5740
-30,60,-50,1208,1280,2488,5603
-140,-40,150,1198,1290,2488,5293
10,-20,-70,1183,1305,2488,5702
-120,30,40,1214,1274,2488,5912
-30,-60,-100,1235,1253,2488,5578
170,50,130,1210,1278,2488,5613
0,30,-110,1221,1268,2489,5625
-40,70,-30,1221,1268,2489,5483
180,40,130,1209,1280,2489,5578
-180,40,130,1209,1280,2489,5578
160,70,130,1217,1273,2490,5823
-40,-80,-130,1210,1280,2490,5568
30,70,-140,1187,1303,2490,5850
-150,70,100,1206,1284,2490,5599
-90,70,20,1220,1270,2490,5446
-130,30,120,1228,1262,2490,5754
-110,-10,120,1217,1274,2491,5580
-130,-20,150,1224,1267,2491,5315
0,70,-110,1196,1295,2491,5584
-20,-80,-120,1199,1292,2491,5830
-110,30,40,1216,1275,2491,5796
-110,80,60,1210,1282,2492,5536
-150,60,70,1198,1294,2492,5568
-50,-80,-140,1214,1278,2492,5611
-170,70,110,1209,1284,2493,5507
-60,10,-140,1221,1272,2493,5519
-60,30,-70,1254,1239,2493,5698
-120,70,80,1214,1279,2493,5520
-170,30,130,1205,1288,2493,5452
-120,60,50,1216,1278,2494,5579
-150,-40,150,1207,1287,2494,5510
-80,70,0,1208,1286,2494,5699
-110,0,90,1221,1273,2494,5782
-160,20,130,1228,1266,2494,5522
-10,10,-100,1188,1307,2495,5492
-120,-70,170,1217,1278,2495,5486
-180,80,100,1235,1260,2495,5513
180,80,100,1235,1260,2495,5513
10,70,-120,1203,1292,2495,5773
-110,-80,160,1214,1281,2495,5514
-40,10,-70,1242,1253,2495,5617
-70,-80,-160,1208,1288,2496,5609
-10,-60,-90,1215,1281,2496,5641
-110,30,110,1214,1282,2496,5564
-150,30,130,1225,1271,2496,5524
-10,40,-110,1218,1278,2496,5656
-40,50,-70,1213,1283,2496,5582
-150,-60,100,1204,1292,2496,5575
0,-50,-90,1198,1298,2496,5525
-60,50,30,1235,1261,2496,5644
180,70,100,1231,1265,2496,5506
-30,-20,-70,1252,1244,2496,5470
-180,70,100,1231,1265,2496,5506
-90,30,30,1244,1253,2497,5747
-30,60,-90,1225,1272,2497,5646
-130,-50,110,1216,1281,2497,5495
-120,80,70,1215,1282,2497,5543
-130,-40,110,1225,1272,2497,5604
-20,-50,-90,1236,1261,2497,5842
-110,60,50,1233,1264,2497,5493
-80,-60,-120,1219,1278,2497,5627
-100,-50,-130,1213,1285,2498,5511
-130,50,60,1229,1269,2498,5539
-50,40,-90,1221,1277,2498,5792
-130,-10,-150,1191,1308,2499,5636
-60,20,-70,1245,1254,2499,5577
-100,70,50,1218,1282,2500,5682
-130,-20,-150,1207,1293,2500,5577
-100,-80,150,1196,1304,2500,5701
-120,-80,140,1221,1279,2500,5671
-50,-10,-70,1231,1270,2501,5569
-20,0,-130,1237,1264,2501,5689
-120,-80,150,1211,1290,2501,5505
-140,-20,150,1213,1288,2501,5522
-160,-20,150,1216,1285,2501,5610
-100,70,20,1202,1299,2501,5596
-10,-30,-80,1218,1283,2501,5820
-120,-10,-140,1231,1270,2501,5816
-40,50,-80,1232,1269,2501,5563
-90,70,10,1207,1295,2502,5591
-110,-20,120,1216,1286,2502,5562
-40,0,-70,1222,1280,2502,5704
-150,-30,150,1212,1290,2502,5550
-160,-10,160,1207,1295,2502,5617
-170,10,120,1221,1282,2503,5597
-50,70,-30,1230,1273,2503,5703
0,-30,-80,1204,1299,2503,5696
-90,10,-130,1239,1264,2503,5793
-70,60,50,1214,1289,2503,5463
-110,70,70,1218,1285,2503,5450
-60,-80,-150,1219,1285,2504,5641
20,70,-130,1187,1317,2504,5864
-20,-60,-100,1201,1303,2504,5741
-10,0,-100,1203,1301,2504,5568
-110,-20,130,1236,1268,2504,5643
-60,0,-150,1250,1254,2504,5658
-110,10,120,1208,1297,2505,5656
-70,-70,180,1216,1290,2506,5693
-40,20,-50,1226,1280,2506,5505
-140,10,130,1243,1263,2506,5393
-70,-70,-180,1216,1290,2506,5693
-90,10,-100,1218,1288,2506,5663
-80,30,40,1225,1281,2506,5557
-100,70,30,1221,1285,2506,5504
-60,-50,-100,1196,1311,2507,5714
-90,-80,180,1203,1304,2507,5590
-160,-10,130,1220,1287,2507,5519
-80,-80,-170,1204,1303,2507,5646
-40,40,-70,1226,1281,2507,5663
-90,-80,-180,1203,1304,2507,5590
-80,60,40,1222,1285,2507,5584
-150,-40,110,1215,1292,2507,5511
-70,60,40,1240,1267,2507,5659
-60,60,-20,1222,1286,2508,5682
-70,40,50,1233,1275,2508,5591
-100,80,40,1237,1271,2508,5633
10,-30,-70,1206,1302,2508,5791
-140,-50,-180,1213,1296,2509,5650
-30,20,-60,1230,1279,2509,5528
-140,-50,180,1213,1296,2509,5650
-110,70,60,1235,1274,2509,5720
-70,60,-10,1221,1288,2509,5584
-150,-10,150,1224,1285,2509,5401
-50,90,-30,1231,1279,2510,5576
140,90,140,1231,1279,2510,5576
-120,90,40,1231,1279,2510,5576
170,90,110,1231,1279,2510,5576
-30,90,-50,1231,1279,2510,5576
10,90,-90,1231,1279,2510,5576
150,90,130,1231,1279,2510,5576
70,90,-150,1231,1279,2510,5576
-70,90,-10,1231,1279,2510,5576
-10,90,-70,1231,1279,2510,5576
-110,70,30,1207,1303,2510,5609
180,90,100,1231,1279,2510,5576
-20,90,-60,1231,1279,2510,5576
-100,90,20,1231,1279,2510,5576
-110,90,30,1231,1279,2510,5576
-160,90,80,1231,1279,2510,5576
20,90,-100,1231,1279,2510,5576
-40,90,-40,1231,1279,2510,5576
-170,90,90,1231,1279,2510,5576
60,90,-140,1231,1279,2510,5576
-130,90,50,1231,1279,2510,5576
90,90,-170,1231,1279,2510,5576
160,90,120,1231,1279,2510,5576
80,90,-160,1231,1279,2510,5576
130,90,150,1231,1279,2510,5576
50,90,-130,1231,1279,2510,5576
100,90,-180,1231,1279,2510,5576
0,80,-70,1210,1300,2510,5608
0,90,-80,1231,1279,2510,5576
-150,90,70,1231,1279,2510,5576
-110,40,100,1217,1293,2510,5467
-80,90,0,1231,1279,2510,5576
-90,90,10,1231,1279,2510,5576
40,90,-120,1231,1279,2510,5576
-140,90,60,1231,1279,2510,5576
-40,60,-90,1219,1291,2510,5770
-150,40,80,1224,1286,2510,5707
100,90,180,1231,1279,2510,5576
-180,90,100,1231,1279,2510,5576
110,90,170,1231,1279,2510,5576
30,90,-110,1231,1279,2510,5576
120,90,160,1231,1279,2510,5576
-60,90,-20,1231,1279,2510,5576
170,80,120,1212,1299,2511,5750
-160,-30,150,1227,1284,2511,5654
-100,-80,170,1208,1303,2511,5618
-160,60,80,1222,1290,2512,5702
-100,70,40,1249,1263,2512,5637
-30,30,-90,1232,1280,2512,5527
-170,20,110,1219,1293,2512,5656
-20,0,-70,1223,1289,2512,5744
-60,70,-20,1230,1282,2512,5675
-120,-70,160,1227,1286,2513,5681
-150,-50,160,1207,1306,2513,5605
-160,0,-180,1253,1260,2513,5635
-160,0,180,1253,1260,2513,5635
-50,30,-70,1241,1272,2513,5689
-50,10,-130,1256,1257,2513,5687
0,-60,-90,1222,1291,2513,5622
-160,-20,130,1242,1271,2513,5525
-40,-10,-70,1227,1286,2513,5606
-30,70,-40,1230,1283,2513,5574
-30,-50,-100,1231,1283,2514,5694
-40,10,-130,1234,1280,2514,5819
-150,-40,170,1222,1292,2514,5502
-10,50,-110,1224,1290,2514,5813
-10,20,-120,1249,1265,2514,5876
-80,-20,-90,1239,1275,2514,5629
-130,70,90,1229,1286,2515,5578
0,-50,-80,1213,1302,2515,5787
-100,-60,-140,1221,1294,2515,5815
-30,0,-80,1240,1275,2515,5716
-10,-60,-100,1200,1315,2515,5650
-160,10,130,1223,1292,2515,5464
-130,-10,140,1216,1299,2515,5569
-100,20,40,1228,1288,2516,5983
-40,30,-80,1257,1259,2516,5594
-50,20,-70,1239,1277,2516,5633
-20,-70,-120,1229,1287,2516,5715
-40,70,-40,1219,1297,2516,5741
-110,-30,150,1255,1261,2516,5520
-40,60,-40,1235,1282,2517,5643
-120,-10,160,1260,1257,2517,5571
-170,60,90,1226,1291,2517,5599
-30,50,-90,1222,1295,2517,5720
-70,-70,-140,1236,1281,2517,5600
-100,10,70,1216,1301,2517,5859
-30,10,-60,1253,1264,2517,5711
-120,-40,120,1233,1285,2518,5669
-110,-10,110,1215,1303,2518,5792
-90,20,80,1221,1297,2518,5658
-30,70,-50,1213,1305,2518,5620
-100,60,70,1233,1285,2518,5428
-110,0,120,1209,1309,2518,5650
-30,0,-60,1254,1264,2518,5563
-40,50,-100,1205,1313,2518,5836
-110,80,50,1241,1277,2518,5597
-110,-60,-150,1228,1291,2519,5686
-130,-60,-180,1218,1301,2519,5613
-110,60,90,1252,1267,2519,5611
-130,-60,160,1218,1301,2519,5525
-160,30,130,1226,1293,2519,5640
-160,40,130,1239,1280,2519,5666
-130,-60,180,1218,1301,2519,5613
-40,20,-120,1245,1275,2520,5642
-10,30,-110,1249,1271,2520,5680
-30,0,-70,1245,1275,2520,5716
-140,-50,160,1212,1308,2520,5556
-90,-40,-110,1250,1270,2520,5444
-150,-40,140,1221,1299,2520,5422
-30,80,-40,1230,1291,2521,5537
-20,-40,-90,1242,1279,2521,5860
-70,70,-10,1222,1299,2521,5700
-160,-30,160,1251,1270,2521,5608
-130,-70,150,1226,1295,2521,5691
-110,-30,130,1219,1302,2521,5788
-120,-50,-150,1224,1298,2522,5515
-10,80,-70,1237,1285,2522,5589
-170,80,90,1236,1286,2522,5509
-110,-30,-120,1234,1288,2522,5696
-170,20,120,1212,1310,2522,5620
-140,-30,100,1225,1298,2523,5719
-150,60,110,1202,1321,2523,5520
-130,-60,170,1220,1303,2523,5511
-100,10,50,1248,1275,2523,5920
-20,-40,-120,1259,1265,2524,5469
-60,-70,-120,1232,1292,2524,5719
-80,-10,-170,1237,1287,2524,5658
-120,20,120,1238,1286,2524,5748
-120,-20,-140,1245,1279,2524,5718
-10,80,-60,1213,1311,2524,5597
-10,-50,-100,1208,1317,2525,5655
-80,60,30,1225,1300,2525,5829
-80,50,40,1234,1291,2525,5519
-140,-70,120,1222,1303,2525,5759
-120,0,80,1250,1275,2525,5792
-90,0,-90,1229,1296,2525,5756
-20,0,-80,1237,1288,2525,5736
-30,80,-50,1232,1293,2525,5683
-30,40,-90,1230,1296,2526,5726
-140,-60,110,1213,1313,2526,5827
-20,40,-100,1231,1296,2527,5825
-110,0,-150,1244,1283,2527,5709
-120,30,50,1235,1292,2527,5655
170,50,120,1221,1306,2527,5786
-20,-50,-120,1236,1292,2528,5626
-160,-10,170,1220,1308,2528,5857
-130,0,80,1241,1287,2528,5726
0,60,-120,1220,1308,2528,5891
-20,-30,-100,1229,1299,2528,5532
-90,-50,160,1235,1293,2528,5683
-150,-10,160,1239,1289,2528,5696
-20,-30,-90,1221,1307,2528,5751
-80,-70,-150,1240,1289,2529,5624
-160,80,100,1215,1314,2529,5443
-120,70,40,1217,1312,2529,5594
-120,60,100,1229,1301,2530,5636
-120,60,60,1256,1274,2530,5600
-50,80,-20,1234,1296,2530,5585
-130,-10,90,1243,1287,2530,5924
-90,40,40,1226,1304,2530,5503
-110,10,60,1255,1276,2531,6050
-110,70,80,1235,1296,2531,5516
-150,-30,110,1216,1315,2531,5484
-90,60,60,1232,1299,2531,5573
-150,20,90,1263,1269,2532,5741
-30,20,-90,1249,1283,2532,5545
-20,-20,-90,1226,1306,2532,5628
-150,-10,130,1225,1307,2532,5623
-50,60,-30,1230,1302,2532,5802
-40,80,-30,1234,1298,2532,5538
-20,50,-100,1245,1288,2533,5845
-20,80,-50,1231,1302,2533,5557
-100,10,100,1226,1307,2533,5724
-160,-10,110,1229,1304,2533,5638
-30,10,-130,1246,1287,2533,5790
-140,-10,150,1229,1304,2533,5467
-160,50,120,1225,1309,2534,5413
-40,-70,-120,1236,1298,2534,5813
-130,60,60,1219,1315,2534,5734
180,80,110,1222,1312,2534,5807
-50,-20,-80,1214,1320,2534,5726
-180,80,110,1222,1312,2534,5807
-110,70,40,1223,1312,2535,5601
-140,80,80,1231,1304,2535,5591
-110,-70,-170,1221,1314,2535,5617
-100,-40,150,1246,1289,2535,5750
-10,-40,-100,1228,1307,2535,5604
-100,20,100,1218,1317,2535,5657
-150,-30,140,1231,1305,2536,5416
-140,70,90,1241,1295,2536,5629
-60,-60,-110,1217,1319,2536,5769
-20,20,-100,1236,1300,2536,5694
-140,-70,130,1231,1305,2536,5693
-30,10,-70,1263,1273,2536,5643
-130,0,160,1254,1282,2536,5549
-140,40,120,1237,1300,2537,5914
-160,-30,130,1227,1310,2537,5692
-60,80,-10,1236,1301,2537,5697
-150,20,130,1256,1281,2537,5548
-120,0,130,1242,1295,2537,5773
-170,70,90,1253,1284,2537,5541
-120,-30,-130,1230,1307,2537,5723
-20,-40,-80,1242,1296,2538,5801
-20,30,-100,1258,1280,2538,5651
-150,-10,100,1256,1282,2538,5543
-20,60,-110,1214,1325,2539,6061
-80,30,50,1253,1286,2539,5685
-20,80,-60,1229,1310,2539,5648
-110,-10,170,1255,1285,2540,5675
-110,50,50,1240,1300,2540,5690
-100,0,-130,1260,1280,2540,5773
-100,50,90,1229,1311,2540,5636
-100,40,90,1217,1323,2540,5634
-100,40,40,1231,1309,2540,5787
-60,0,-80,1254,1287,2541,5665
-90,30,40,1263,1278,2541,5800
-130,-50,160,1234,1307,2541,5473
-90,0,-170,1274,1267,2541,5798
-70,10,-130,1240,1301,2541,5715
-130,80,70,1248,1293,2541,5655
-140,10,90,1256,1286,2542,5692
-160,80,80,1237,1305,2542,5573
-30,-80,-130,1222,1320,2542,5927
-90,60,40,1241,1301,2542,5821
0,-40,-80,1219,1324,2543,5970
-100,0,-120,1256,1287,2543,5824
-60,20,-100,1250,1293,2543,5846
-20,60,-100,1251,1293,2544,5927
-90,-70,-160,1248,1296,2544,5668
170,60,120,1234,1310,2544,5958
-110,-20,160,1249,1296,2545,5778
-130,70,50,1224,1321,2545,5666
-120,70,50,1232,1313,2545,5715
-160,-20,160,1212,1333,2545,5643
-150,-30,180,1224,1322,2546,5661
-120,80,60,1253,1293,2546,5605
-150,-30,-180,1224,1322,2546,5661
-130,-70,120,1229,1317,2546,5859
-20,50,-110,1243,1304,2547,5744
-100,-30,-110,1263,1284,2547,5739
-180,60,120,1232,1315,2547,5736
-20,-30,-70,1255,1292,2547,5704
-150,-50,130,1216,1331,2547,5696
180,60,120,1232,1315,2547,5736
-150,60,120,1232,1316,2548,5514
180,40,120,1243,1305,2548,5749
-110,-70,170,1241,1307,2548,5700
-180,40,120,1243,1305,2548,5749
-110,-70,180,1253,1295,2548,5555
-80,60,50,1246,1302,2548,5712
-110,-70,-180,1253,1295,2548,5555
-150,0,130,1236,1312,2548,5642
-80,-60,170,1241,1307,2548,5795
-80,-30,180,1239,1310,2549,5687
-90,20,70,1252,1297,2549,5815
-70,10,-140,1243,1306,2549,5755
-80,-30,-180,1239,1310,2549,5687
-130,-20,100,1239,1310,2549,5664
-120,70,70,1247,1302,2549,5716
180,50,120,1227,1322,2549,5862
-180,50,120,1227,1322,2549,5862
-160,60,110,1244,1305,2549,5798
-110,-80,150,1237,1313,2550,5777
-80,50,30,1239,1311,2550,5773
170,90,120,1231,1320,2551,5789
150,90,140,1231,1320,2551,5789
120,90,170,1231,1320,2551,5789
-30,90,-40,1231,1320,2551,5789
-120,90,50,1231,1320,2551,5789
-60,90,-10,1231,1320,2551,5789
180,90,110,1231,1320,2551,5789
10,90,-80,1231,1320,2551,5789
-80,10,-130,1255,1296,2551,5722
-90,90,20,1231,1320,2551,5789
30,90,-100,1231,1320,2551,5789
-130,90,60,1231,1320,2551,5789
50,90,-120,1231,1320,2551,5789
-80,90,10,1231,1320,2551,5789
60,90,-130,1231,1320,2551,5789
80,90,-150,1231,1320,2551,5789
-20,90,-50,1231,1320,2551,5789
110,90,-180,1231,1320,2551,5789
-160,70,100,1226,1325,2551,5740
-50,90,-20,1231,1320,2551,5789
20,90,-90,1231,1320,2551,5789
-160,90,90,1231,1320,2551,5789
70,90,-140,1231,1320,2551,5789
140,90,150,1231,1320,2551,5789
110,90,180,1231,1320,2551,5789
-180,90,110,1231,1320,2551,5789
160,90,130,1231,1320,2551,5789
90,90,-160,1231,1320,2551,5789
100,90,-170,1231,1320,2551,5789
130,90,160,1231,1320,2551,5789
-150,90,80,1231,1320,2551,5789
-110,90,40,1231,1320,2551,5789
-70,90,0,1231,1320,2551,5789
0,90,-70,1231,1320,2551,5789
-10,90,-60,1231,1320,2551,5789
-150,80,90,1225,1326,2551,5598
-140,90,70,1231,1320,2551,5789
40,90,-110,1231,1320,2551,5789
-170,90,100,1231,1320,2551,5789
-100,90,30,1231,1320,2551,5789
-100,-10,-110,1253,1298,2551,5696
-40,90,-30,1231,1320,2551,5789
-130,60,110,1243,1309,2552,5812
-160,-20,170,1213,1339,2552,5871
-30,40,-110,1242,1310,2552,5913
-110,40,50,1237,1315,2552,5758
-100,30,40,1276,1276,2552,5788
-20,40,-110,1261,1292,2553,5764
-40,80,-40,1240,1313,2553,5747
-70,-60,-120,1219,1334,2553,5814
-70,80,-10,1232,1321,2553,5751
-110,70,50,1266,1287,2553,5739
-80,40,70,1254,1300,2554,5719
-60,20,-80,1277,1277,2554,5797
-110,20,110,1239,1315,2554,5832
-80,-70,170,1230,1324,2554,5881
-70,-20,-90,1247,1307,2554,5746
-100,10,60,1251,1303,2554,5868
-150,30,90,1250,1305,2555,5756
-30,-50,-90,1267,1288,2555,5795
-60,80,-20,1236,1319,2555,5661
-50,40,-80,1276,1279,2555,5787
-140,30,120,1249,1306,2555,5729
-70,50,50,1253,1302,2555,5574
-30,60,-100,1249,1307,2556,5890
-130,10,80,1270,1286,2556,5759
-100,60,50,1256,1300,2556,5888
-130,20,120,1273,1283,2556,5865
-130,-10,160,1271,1285,2556,5397
-90,20,60,1242,1314,2556,5852
-110,-50,-140,1248,1308,2556,5618
-150,0,170,1257,1299,2556,5801
-60,10,-130,1257,1300,2557,5785
-70,0,-160,1251,1306,2557,5947
-20,-10,-80,1247,1310,2557,5864
-20,-50,-110,1257,1300,2557,5710
-20,-50,-100,1228,1330,2558,5843
-130,30,70,1246,1312,2558,5735
-90,10,-120,1265,1293,2558,5875
-140,-10,-160,1251,1307,2558,5724
-10,10,-110,1203,1356,2559,5775
-70,-70,-130,1244,1315,2559,5842
-30,-70,-130,1249,1310,2559,5894
-10,20,-110,1257,1302,2559,5800
-90,-70,160,1238,1321,2559,5952
-150,70,70,1236,1323,2559,5741
-150,-50,120,1254,1305,2559,5719
-140,-30,150,1231,1329,2560,5591
-100,-70,-170,1255,1305,2560,5670
-160,70,80,1246,1314,2560,5678
-70,-80,-170,1245,1315,2560,5972
-160,20,100,1264,1296,2560,5762
-20,-30,-80,1256,1304,2560,5856
-90,-60,-130,1252,1308,2560,5753
-40,40,-80,1253,1308,2561,5899
170,70,120,1255,1306,2561,6057
-140,-50,170,1236,1325,2561,5749
-100,60,80,1256,1306,2562,5727
-120,-60,170,1241,1321,2562,5636
-60,20,-90,1269,1293,2562,5774
-50,80,-30,1241,1322,2563,5763
-90,-70,-170,1245,1318,2563,5629
-90,-70,-150,1237,1326,2563,5911
-80,30,60,1269,1294,2563,5863
-120,10,70,1258,1306,2564,5551
-80,80,10,1257,1307,2564,5848
-140,70,110,1247,1317,2564,5647
-90,-80,170,1251,1314,2565,5921
-150,80,70,1249,1316,2565,5606
-140,0,-170,1243,1322,2565,5792
-110,60,70,1265,1301,2566,5739
-30,-50,-110,1231,1335,2566,5688
-130,70,80,1242,1324,2566,5758
-90,60,70,1244,1322,2566,5659
-150,-40,160,1224,1342,2566,5758
-140,-40,-170,1240,1326,2566,5660
-130,-40,160,1249,1317,2566,5610
-120,50,60,1252,1315,2567,5725
-70,80,0,1252,1315,2567,5806
-50,-40,-90,1227,1340,2567,5838
-170,60,110,1242,1325,2567,5829
-120,70,60,1270,1297,2567,5824
-20,-20,-80,1255,1313,2568,5931
-30,-30,-100,1245,1323,2568,5781
-40,-60,-110,1265,1303,2568,5688
-30,20,-100,1267,1301,2568,5845
-100,-80,160,1251,1317,2568,5899
-130,60,70,1267,1301,2568,5804
-130,40,70,1264,1304,2568,5646
-140,0,160,1244,1324,2568,5547
-80,-40,-110,1248,1321,2569,5557
-60,-20,-160,1254,1315,2569,5730
-90,80,10,1232,1337,2569,5731
-130,-20,140,1263,1306,2569,5616
-80,80,0,1234,1336,2570,5752
-110,60,80,1283,1287,2570,5490
-10,60,-110,1272,1298,2570,6001
-30,-40,-100,1250,1320,2570,5686
-140,70,60,1231,1339,2570,5761
-50,10,-80,1277,1293,2570,5782
-100,-70,-160,1240,1331,2571,5850
-100,80,20,1245,1326,2571,5715
-170,50,120,1247,1324,2571,5695
-90,60,50,1270,1301,2571,5689
-80,-80,-180,1249,1323,2572,5977
-100,-30,-120,1261,1311,2572,5647
-150,0,100,1265,1307,2572,5653
-140,-20,160,1254,1318,2572,5719
-150,50,80,1246,1326,2572,5826
-120,-60,-170,1250,1322,2572,5711
-30,-10,-80,1263,1309,2572,5989
-120,-20,110,1254,1318,2572,5831
-80,-80,180,1249,1323,2572,5977
-130,40,110,1293,1280,2573,5892
-20,10,-100,1229,1344,2573,5698
-110,30,100,1258,1315,2573,5646
-80,-70,-140,1249,1324,2573,5912
-60,-80,-160,1240,1333,2573,6072
-20,-40,-110,1252,1321,2573,5718
-140,30,80,1256,1317,2573,5892
-130,70,60,1252,1322,2574,5854
-120,-20,140,1261,1314,2575,5606
-140,50,120,1258,1317,2575,5845
-40,0,-80,1275,1300,2575,5886
-150,0,180,1251,1324,2575,5720
-150,0,-180,1251,1324,2575,5720
-120,-20,150,1264,1312,2576,5791
-100,-70,180,1244,1332,2576,5718
-10,10,-120,1254,1322,2576,6062
-40,-80,-140,1236,1340,2576,6032
-100,-70,-180,1244,1332,2576,5718
-50,-80,-150,1237,1339,2576,6066
-100,0,-140,1291,1286,2577,5781
-90,-30,170,1263,1314,2577,5832
-170,80,100,1240,1337,2577,5970
-80,40,50,1263,1314,2577,5686
-30,0,-90,1261,1316,2577,5743
-50,40,-70,1276,1302,2578,5923
-20,30,-110,1265,1313,2578,5865
-130,0,-160,1248,1331,2579,5921
-20,-30,-110,1274,1305,2579,5692
-130,-50,170,1267,1312,2579,5776
-30,-50,-130,1263,1316,2579,5810
-30,10,-90,1282,1297,2579,5753
-120,80,40,1249,1331,2580,5716
-20,-60,-110,1249,1331,2580,5832
-60,-30,-90,1263,1317,2580,5700
-120,30,110,1276,1304,2580,5685
-10,-70,-100,1250,1330,2580,5811
-120,-20,160,1287,1294,2581,5748
-30,-60,-130,1278,1303,2581,5989
-40,-60,-120,1263,1318,2581,5811
-50,-70,-130,1240,1341,2581,5932
-90,50,40,1247,1335,2582,5916
-30,-60,-110,1245,1337,2582,5871
-30,30,-100,1272,1310,2582,5779
-140,-20,100,1276,1306,2582,5772
-100,-70,150,1258,1324,2582,5955
-160,40,100,1266,1316,2582,5894
-40,-30,-80,1243,1339,2582,5828
-120,10,120,1251,1332,2583,5772
-120,-30,120,1274,1309,2583,5883
-120,20,60,1286,1297,2583,5680
-60,-70,-140,1254,1329,2583,5883
-160,-20,120,1255,1328,2583,5716
-150,-30,160,1256,1327,2583,5817
-170,30,110,1263,1320,2583,5751
-80,-10,-90,1277,1307,2584,5848
-20,0,-90,1282,1302,2584,5522
-70,-30,-170,1251,1333,2584,5831
-100,10,80,1254,1330,2584,6052
-140,-10,160,1251,1333,2584,5602
-40,-10,-80,1269,1315,2584,5879
-170,30,120,1246,1338,2584,5712
-110,80,30,1247,1337,2584,5742
-130,80,50,1260,1324,2584,5698
-20,-20,-70,1278,1306,2584,5967
-110,-30,140,1271,1314,2585,5895
-120,-10,130,1271,1314,2585,5763
-110,-20,-130,1259,1326,2585,5673
-30,20,-120,1276,1309,2585,5869
-40,-30,-110,1262,1324,2586,5584
-70,-50,-110,1245,1341,2586,6067
-180,50,110,1258,1328,2586,5870
180,50,110,1258,1328,2586,5870
-30,-20,-80,1280,1306,2586,5863
-50,-60,-110,1292,1295,2587,5836
-100,60,60,1290,1297,2587,5706
-50,0,-80,1267,1320,2587,5747
-80,60,60,1240,1347,2587,5689
-40,-50,-90,1256,1331,2587,5777
-140,50,70,1270,1317,2587,5658
-40,-50,-110,1270,1317,2587,5723
-130,60,90,1278,1310,2588,5750
-120,60,80,1277,1311,2588,5705
-140,60,80,1259,1329,2588,5896
-120,-60,-180,1244,1345,2589,5820
-120,-60,180,1244,1345,2589,5820
-130,-30,150,1284,1306,2590,5687
-90,10,-110,1265,1325,2590,5840
-80,50,70,1242,1348,2590,5772
-140,-60,140,1259,1331,2590,5966
-80,-70,-160,1257,1333,2590,5701
-20,-20,-100,1262,1328,2590,5722
-140,60,70,1266,1325,2591,5748
-130,50,70,1273,1318,2591,5704
-140,80,60,1265,1326,2591,5627
-30,-30,-110,1266,1325,2591,5781
-90,80,20,1268,1323,2591,5862
-120,50,100,1274,1318,2592,5764
-130,-40,-160,1245,1347,2592,5764
-90,30,80,1257,1335,2592,5732
-160,50,90,1271,1321,2592,5744
-90,0,-100,1269,1323,2592,5836
-120,70,90,1246,1347,2593,5816
-130,70,70,1285,1309,2594,5874
-50,-10,-80,1260,1334,2594,5771
-110,0,-180,1282,1313,2595,5808
-90,40,50,1269,1326,2595,5727
-110,0,180,1282,1313,2595,5808
-150,40,120,1257,1339,2596,5686
-140,70,80,1271,1325,2596,5783
-150,-10,180,1268,1328,2596,5911
-150,-10,-180,1268,1328,2596,5911
-60,10,-80,1308,1289,2597,5821
-110,-70,140,1270,1327,2597,6044
-110,50,90,1277,1320,2597,5626
-140,-30,160,1238,1359,2597,5906
-110,60,60,1282,1316,2598,5997
-160,50,100,1267,1331,2598,5899
-170,50,110,1251,1347,2598,5958
-140,-50,110,1255,1343,2598,5961
-50,30,-90,1286,1312,2598,6064
-140,-40,160,1266,1332,2598,5881
-80,-60,-130,1261,1338,2599,5770
-50,-60,-120,1254,1345,2599,5791
-160,60,100,1257,1342,2599,5875
-140,0,180,1277,1322,2599,5990
-140,0,-180,1277,1322,2599,5990
-160,40,120,1237,1362,2599,5690
-150,-20,160,1236,1364,2600,5833
-150,70,90,1269,1331,2600,5697
-140,0,130,1284,1316,2600,5788
-140,40,80,1268,1333,2601,5782
-150,-20,130,1258,1343,2601,5709
-100,-20,-110,1283,1318,2601,5798
-90,50,80,1260,1342,2602,5951
-160,0,110,1282,1320,2602,5988
-170,40,110,1268,1334,2602,5946
-80,-30,-100,1297,1305,2602,5856
-70,10,-90,1274,1328,2602,5883
-80,10,-90,1279,1324,2603,5913
-170,50,100,1266,1337,2603,5920
-150,60,100,1272,1331,2603,5906
-140,60,100,1276,1327,2603,5704
-70,-70,-150,1267,1336,2603,5781
-40,-70,-140,1274,1329,2603,6033
-30,-30,-80,1291,1313,2604,5881
-110,10,70,1268,1336,2604,5859
-30,-50,-120,1296,1308,2604,5817
-20,0,-100,1267,1337,2604,5848
-30,-40,-80,1284,1320,2604,5852
-70,50,40,1298,1306,2604,5913
-150,60,80,1259,1345,2604,5830
-130,70,100,1263,1341,2604,5893
-130,-70,130,1267,1338,2605,5945
-150,-40,130,1254,1351,2605,5811
-140,-60,120,1269,1336,2605,5979
-20,-10,-70,1283,1322,2605,6006
-160,30,100,1269,1337,2606,5793
-50,-20,-150,1292,1314,2606,5861
-180,70,110,1264,1342,2606,6062
-120,-70,130,1251,1355,2606,5926
-110,-30,-130,1245,1361,2606,5770
180,70,110,1264,1342,2606,6062
-130,-50,-170,1249,1357,2606,5839
-150,40,90,1283,1323,2606,5815
-110,-60,-160,1263,1343,2606,5914
-110,0,110,1250,1357,2607,6040
-110,-60,180,1282,1325,2607,5787
-40,0,-90,1297,1310,2607,5772
-110,-60,-180,1282,1325,2607,5787
-30,-10,-90,1305,1303,2608,5935
-150,50,90,1276,1332,2608,5903
-120,40,100,1289,1320,2609,5713
-120,-50,170,1279,1330,2609,5827
-20,20,-120,1275,1335,2610,6148
-90,-20,-100,1291,1320,2611,5930
-20,-30,-120,1281,1330,2611,5907
-130,-60,120,1269,1342,2611,5981
-120,50,90,1291,1321,2612,5751
-50,20,-80,1302,1310,2612,5907
-120,40,60,1284,1328,2612,5792
-140,-30,-170,1260,1352,2612,5803
-120,-30,-140,1262,1350,2612,5888
-40,10,-90,1298,1316,2614,5950
-30,-40,-90,1280,1334,2614,5936
-90,-40,170,1280,1334,2614,5757
-40,-50,-120,1281,1333,2614,5794
-40,50,-90,1277,1337,2614,6048
-30,40,-100,1264,1350,2614,6014
-150,-20,110,1261,1354,2615,5782
-60,-60,-120,1300,1315,2615,5817
-140,50,80,1288,1327,2615,5822
-160,80,90,1262,1353,2615,6040
-170,40,120,1263,1352,2615,5758
-40,30,-110,1267,1348,2615,5997
-140,-30,140,1280,1335,2615,5723
-110,10,80,1303,1313,2616,6197
-120,-10,100,1253,1363,2616,5922
-130,0,170,1293,1323,2616,5768
-20,-10,-120,1272,1344,2616,6020
-150,-10,170,1270,1346,2616,6030
-20,-20,-120,1277,1340,2617,6009
-30,-20,-100,1280,1337,2617,5696
-80,-50,-180,1283,1334,2617,5900
-80,-50,180,1283,1334,2617,5900
-20,-20,-110,1272,1346,2618,5730
-90,40,80,1259,1359,2618,5822
-100,-10,180,1299,1320,2619,5755
-40,-20,-80,1269,1350,2619,5969
-130,-50,-180,1260,1359,2619,5959
-90,-40,-120,1274,1345,2619,5847
-130,-50,180,1260,1359,2619,5959
-100,-10,-180,1299,1320,2619,5755
-20,-70,-110,1257,1362,2619,5886
-30,-40,-110,1277,1343,2620,5807
-20,20,-110,1287,1333,2620,6063
-120,20,70,1293,1327,2620,5895
-60,-40,-100,1269,1351,2620,5967
-90,-60,-140,1264,1356,2620,5858
-100,80,30,1283,1338,2621,5976
-110,80,40,1278,1343,2621,6014
-100,-60,-150,1268,1354,2622,6014
-140,0,170,1304,1318,2622,5906
-120,-70,150,1268,1355,2623,5896
-120,0,90,1306,1317,2623,6042
-80,-40,180,1299,1325,2624,5861
-80,-40,-180,1299,1325,2624,5861
-120,-30,140,1267,1357,2624,5789
-140,-60,130,1280,1344,2624,6019
-130,-30,160,1273,1351,2624,5771
-90,-10,-100,1304,1321,2625,5889
-70,-10,-90,1319,1306,2625,6117
-130,-20,160,1273,1352,2625,5697
-90,-60,160,1304,1323,2627,5986
-40,20,-90,1302,1325,2627,5954
-130,-70,140,1273,1354,2627,5838
-140,-40,110,1263,1365,2628,6009
-120,60,90,1304,1324,2628,5802
-50,0,-140,1309,1319,2628,5996
-120,-50,180,1292,1336,2628,5931
-120,-50,-180,1292,1336,2628,5931
-140,70,70,1268,1361,2629,6037
-160,-10,120,1280,1349,2629,6067
-100,-40,-130,1278,1351,2629,5757
-150,80,80,1275,1354,2629,6141
-40,-60,-130,1274,1355,2629,5947
-100,-10,-120,1290,1339,2629,5932
-110,40,90,1293,1336,2629,5713
-30,-70,-120,1274,1355,2629,5916
-130,-30,110,1278,1352,2630,5907
-140,80,70,1276,1354,2630,6159
-150,50,110,1273,1357,2630,5952
-70,-60,-130,1303,1327,2630,5724
-110,20,50,1305,1325,2630,6185
-130,-50,120,1279,1352,2631,6046
-150,50,120,1266,1365,2631,5832
-50,-60,-130,1278,1354,2632,6012
-150,-20,180,1253,1379,2632,5991
-150,-20,-180,1253,1379,2632,5991
-60,-60,-140,1274,1359,2633,6120
-120,80,50,1290,1344,2634,6126
-30,-60,-120,1270,1365,2635,5935
-50,-50,-100,1268,1367,2635,5764
-40,-10,-140,1323,1313,2636,6057
-100,50,50,1280,1356,2636,6052
-20,-10,-90,1295,1341,2636,5960
-100,-50,150,1287,1349,2636,6026
-120,0,-160,1287,1349,2636,6105
-50,-40,-100,1287,1349,2636,5907
-140,60,90,1304,1334,2638,6051
-40,-50,-140,1294,1344,2638,5872
-130,50,110,1296,1343,2639,5925
180,60,110,1269,1370,2639,6021
-180,60,110,1269,1370,2639,6021
-100,-40,160,1297,1343,2640,5794
-130,0,90,1297,1343,2640,5954
-60,-60,-130,1282,1358,2640,5842
-70,-60,-150,1297,1345,2642,5982
-40,-60,-140,1293,1349,2642,6086
-160,60,90,1272,1370,2642,6173
-140,-40,140,1283,1360,2643,5878
-120,-20,120,1289,1354,2643,6022
-70,-30,-100,1281,1362,2643,5834
-60,-50,-110,1280,1363,2643,5873
-40,30,-90,1313,1330,2643,6119
-80,10,-110,1312,1332,2644,6000
-160,0,120,1281,1363,2644,6101
-120,0,120,1287,1357,2644,5856
-120,-30,160,1319,1325,2644,5809
-150,60,90,1277,1367,2644,5971
-170,70,100,1268,1376,2644,6150
-30,-30,-130,1300,1344,2644,6004
-110,-30,160,1314,1330,2644,6017
-110,-60,-170,1276,1368,2644,5917
-110,-70,160,1287,1358,2645,6011
-100,-20,170,1310,1335,2645,6022
-80,10,-100,1299,1347,2646,6145
-140,-40,170,1279,1367,2646,6036
-60,-30,-160,1267,1380,2647,5945
-30,-10,-100,1316,1331,2647,6014
-50,30,-80,1313,1334,2647,6093
-140,20,90,1293,1354,2647,6059
-30,10,-100,1297,1350,2647,6030
-60,-60,-160,1288,1359,2647,6175
-130,80,60,1293,1354,2647,6170
-40,-70,-130,1295,1352,2647,6022
-80,-60,-140,1299,1349,2648,5720
-100,-60,-170,1299,1350,2649,5834
-150,70,80,1280,1369,2649,6141
-40,-40,-110,1304,1345,2649,5752
-120,-40,170,1288,1361,2649,5818
-100,40,50,1283,1366,2649,5837
-60,-50,-120,1300,1350,2650,5686
-120,-50,-160,1277,1373,2650,5941
-160,10,120,1295,1355,2650,6118
-140,-30,110,1267,1383,2650,5973
-130,0,-170,1305,1345,2650,6042
-170,60,100,1276,1375,2651,6186
-50,-30,-90,1278,1373,2651,5954
-40,-50,-100,1317,1334,2651,5934
-70,-50,-170,1291,1360,2651,5891
-90,30,50,1294,1357,2651,6029
-50,-70,-150,1296,1356,2652,6133
-130,-30,-160,1288,1364,2652,5993
-120,-30,150,1335,1317,2652,5992
-20,10,-110,1299,1353,2652,6005
-50,30,-100,1297,1355,2652,6195
-110,30,50,1313,1340,2653,5993
-120,-40,160,1305,1348,2653,5849
-110,10,110,1297,1357,2654,6154
-120,-20,130,1285,1370,2655,5980
-80,0,-90,1294,1361,2655,5954
-90,50,50,1283,1373,2656,5971
-40,40,-90,1294,1363,2657,6273
-70,-40,-170,1285,1372,2657,5836
-90,-60,-150,1291,1366,2657,5804
-140,-20,-170,1299,1358,2657,5932
-150,-40,120,1283,1374,2657,6023
-100,20,70,1331,1326,2657,5994
-160,70,90,1274,1384,2658,6251
-20,10,-120,1312,1347,2659,6326
-30,0,-130,1310,1349,2659,6066
-100,-60,-160,1272,1387,2659,5871
-40,-40,-90,1301,1358,2659,5991
-130,-40,120,1307,1353,2660,6007
-130,0,130,1313,1347,2660,6069
-20,-10,-100,1292,1368,2660,5877
-100,30,90,1302,1358,2660,5934
-90,-50,170,1302,1359,2661,5983
-50,-50,-150,1306,1355,2661,5854
-40,-10,-90,1307,1354,2661,6037
-70,10,-110,1308,1353,2661,6212
-30,50,-100,1290,1371,2661,6077
-50,-60,-150,1302,1359,2661,6162
-90,-60,-160,1304,1359,2663,5946
-70,-10,-160,1330,1333,2663,5914
-160,10,110,1278,1385,2663,6094
-20,-10,-110,1289,1374,2663,5914
-120,10,80,1325,1339,2664,5986
-130,20,80,1296,1368,2664,6066
-80,-60,180,1285,1379,2664,6012
-80,-60,-180,1285,1379,2664,6012
-40,-20,-90,1316,1348,2664,5966
-40,40,-100,1274,1390,2664,6134
-30,30,-110,1312,1353,2665,6152
-50,-50,-110,1323,1342,2665,5931
-150,-20,170,1270,1395,2665,6042
-110,-50,-150,1287,1378,2665,5977
-50,20,-110,1320,1346,2666,6149
-130,0,180,1316,1350,2666,6175
-130,0,-180,1316,1350,2666,6175
-150,-30,170,1282,1384,2666,5966
-120,-10,170,1316,1350,2666,5872
-40,-30,-90,1323,1343,2666,5810
-30,-40,-130,1293,1374,2667,5947
-100,10,90,1298,1369,2667,6157
-150,-30,130,1295,1372,2667,5943
-80,-50,-120,1285,1382,2667,6127
-80,-60,-160,1332,1335,2667,5925
-120,-60,130,1301,1366,2667,6038
-50,-70,-140,1311,1357,2668,6015
-110,0,100,1289,1379,2668,6137
-70,10,-100,1298,1370,2668,5982
-150,-10,110,1304,1364,2668,5999
-110,-40,140,1313,1356,2669,6029
-130,-10,100,1304,1365,2669,5930
-70,-50,-120,1289,1380,2669,5940
-140,-10,130,1289,1380,2669,5976
-120,0,180,1309,1360,2669,6278
-120,0,-180,1309,1360,2669,6278
-100,-70,170,1289,1381,2670,6052
-50,-60,-140,1322,1349,2671,6017
-100,0,-150,1312,1359,2671,6086
-110,20,80,1326,1346,2672,6113
-60,-40,-160,1302,1371,2673,5879
-130,50,100,1313,1360,2673,6062
-110,-40,150,1332,1341,2673,5870
-100,50,80,1309,1365,2674,5885
-40,-40,-100,1316,1358,2674,6021
-120,30,60,1306,1368,2674,6011
-30,-30,-90,1317,1358,2675,6110
-120,-70,140,1292,1384,2676,6196
-160,50,110,1295,1381,2676,6096
-160,20,120,1279,1397,2676,5965
-140,-10,100,1311,1365,2676,5842
-100,0,-170,1317,1360,2677,6162
-80,-70,-170,1295,1382,2677,6061
-150,30,120,1281,1396,2677,5934
-120,-40,-150,1309,1369,2678,6061
-120,60,70,1308,1370,2678,6168
-110,-50,-180,1306,1372,2678,5881
-110,-50,180,1306,1372,2678,5881
-90,30,60,1297,1381,2678,6165
-100,-60,150,1325,1353,2678,6159
-130,-60,150,1290,1389,2679,6167
-100,-20,-120,1304,1375,2679,5994
-120,-50,-170,1306,1373,2679,6000
-80,0,-160,1292,1387,2679,6140
-110,20,70,1319,1360,2679,6022
-110,-10,-140,1302,1378,2680,6079
-70,-60,-140,1305,1376,2681,5984
-60,-70,-150,1309,1372,2681,6114
-110,50,80,1323,1359,2682,6003
-60,-70,-160,1315,1367,2682,6211
-100,20,50,1317,1365,2682,6297
-110,20,60,1336,1346,2682,6221
-140,50,110,1284,1398,2682,6188
-60,-20,-90,1317,1366,2683,5933
-70,0,-90,1323,1360,2683,6140
-100,-50,160,1315,1368,2683,5930
-130,-30,120,1340,1345,2685,6039
-50,-50,-130,1308,1377,2685,6073
-140,-10,-170,1312,1373,2685,6088
-50,0,-90,1332,1353,2685,6097
-130,-30,140,1301,1384,2685,6030
-70,-60,-170,1308,1377,2685,6052
-110,0,-160,1320,1366,2686,6356
-130,-20,110,1326,1360,2686,5945
-90,20,50,1321,1366,2687,6225
-50,-50,-120,1302,1385,2687,5874
-60,-10,-150,1330,1357,2687,6049
-110,10,90,1333,1354,2687,6212
-130,-40,170,1298,1390,2688,6054
-120,-10,110,1303,1385,2688,6142
-100,30,50,1303,1385,2688,6099
-130,-10,130,1305,1383,2688,6031
-120,20,110,1302,1387,2689,5905
-20,0,-110,1294,1395,2689,6096
-30,-20,-90,1327,1362,2689,6167
-80,-20,-170,1328,1362,2690,6057
-90,0,-110,1320,1370,2690,6084
-140,-40,180,1300,1391,2691,6023
-140,-40,-180,1300,1391,2691,6023
-80,40,60,1296,1395,2691,6198
-140,20,120,1308,1384,2692,6104
-80,-60,-150,1306,1386,2692,5976
-140,-50,140,1292,1400,2692,6054
-30,-20,-110,1310,1382,2692,6110
-130,-40,150,1306,1386,2692,5919
-110,-20,170,1337,1355,2692,5932
-100,-30,170,1321,1372,2693,6077
-120,-10,120,1305,1389,2694,6196
-100,-10,-130,1321,1374,2695,6095
-90,0,-140,1328,1367,2695,6152
-70,-70,-160,1312,1384,2696,6117
-90,-70,180,1298,1398,2696,6101
-90,-70,-180,1298,1398,2696,6101
-50,-40,-150,1305,1392,2697,5959
-30,0,-100,1315,1383,2698,6083
-70,-40,-110,1316,1383,2699,6014
-40,-30,-140,1312,1387,2699,6082
-90,-50,-130,1313,1386,2699,6092
-160,30,120,1288,1411,2699,6149
-90,-60,-170,1334,1366,2700,5982
-100,-50,-140,1317,1383,2700,6034
-140,-10,170,1330,1370,2700,6234
-90,-20,180,1332,1368,2700,6115
-90,-20,-180,1332,1368,2700,6115
-100,-60,180,1325,1375,2700,6170
-30,-20,-130,1319,1381,2700,6146
-100,-60,-180,1325,1375,2700,6170
-120,-60,160,1310,1393,2703,6128
-70,10,-120,1316,1388,2704,6314
-50,-10,-90,1325,1379,2704,6190
-130,60,80,1314,1390,2704,6193
-50,-30,-150,1297,1408,2705,6207
-150,10,100,1321,1384,2705,6130
-90,-70,170,1319,1387,2706,6330
-110,-40,-140,1341,1366,2707,6036
-50,-30,-100,1342,1365,2707,5992
-110,-50,-170,1314,1394,2708,6044
-60,10,-110,1364,1344,2708,6179
-110,20,90,1316,1392,2708,6157
-50,-40,-110,1326,1383,2709,5903
-40,-30,-120,1316,1393,2709,6024
-120,-30,-150,1300,1409,2709,6123
-50,-40,-130,1350,1360,2710,6184
-110,-70,150,1305,1405,2710,6256
-60,-50,-130,1313,1397,2710,5878
-50,10,-90,1356,1354,2710,6157
-40,-20,-110,1336,1375,2711,6070
-50,20,-90,1347,1365,2712,6370
-60,10,-120,1330,1382,2712,6233
-130,-20,-160,1334,1378,2712,6178
-110,30,90,1312,1400,2712,6076
-20,0,-120,1321,1391,2712,6357
-60,10,-100,1332,1381,2713,6033
-120,-10,-150,1320,1394,2714,6162
-40,-20,-140,1336,1378,2714,6212
-140,-10,180,1323,1392,2715,6175
-140,-50,130,1318,1397,2715,6162
-140,-10,-180,1323,1392,2715,6175
-80,50,50,1338,1377,2715,6042
-60,-40,-110,1318,1397,2715,5955
-110,-50,170,1326,1390,2716,6160
-150,-30,120,1303,1413,2716,6159
-130,60,100,1328,1388,2716,6131
-140,-30,170,1306,1410,2716,6124
-110,-60,140,1331,1385,2716,6193
-80,10,-120,1344,1373,2717,6147
-110,-60,170,1319,1398,2717,6203
-50,-30,-120,1342,1375,2717,6147
-90,30,70,1351,1366,2717,6340
-40,-40,-120,1330,1387,2717,6101
-60,10,-90,1334,1384,2718,6245
-100,20,80,1340,1378,2718,6227
-110,20,100,1308,1410,2718,5952
-60,-60,-150,1341,1377,2718,6141
-120,-20,170,1332,1387,2719,5872
-60,-10,-90,1337,1382,2719,6201
-50,-40,-120,1340,1379,2719,5943
-50,10,-120,1346,1373,2719,6192
-100,50,70,1343,1377,2720,6109
-140,-50,120,1309,1411,2720,6225
-40,20,-100,1348,1372,2720,6145
-130,20,90,1325,1397,2722,6225
-120,-20,-150,1314,1409,2723,6290
-40,30,-100,1304,1419,2723,6191
-80,-70,-180,1331,1392,2723,6337
-80,-70,180,1331,1392,2723,6337
-150,20,100,1327,1396,2723,6180
-110,-20,-140,1331,1393,2724,6194
-130,-40,-180,1316,1408,2724,5995
-130,-40,180,1316,1408,2724,5995
-40,10,-120,1351,1373,2724,6261
-110,50,60,1329,1395,2724,6289
-100,40,60,1325,1400,2725,6071
-120,-50,160,1325,1402,2727,6218
-60,-50,-140,1333,1394,2727,6048
-90,0,-120,1347,1381,2728,6095
-160,20,110,1318,1410,2728,6232
-100,20,60,1361,1368,2729,6278
-60,-50,-160,1324,1406,2730,6018
-30,20,-110,1355,1375,2730,6216
-90,0,-160,1341,1390,2731,6281
-120,-40,180,1325,1407,2732,6139
-80,-50,-130,1312,1420,2732,6113
-120,-40,-180,1325,1407,2732,6139
-130,30,110,1346,1386,2732,6200
-30,-40,-120,1334,1399,2733,6001
-70,-70,-170,1340,1394,2734,6288
-110,30,70,1333,1402,2735,6233
-120,20,80,1344,1391,2735,6265
-120,-50,130,1346,1390,2736,6301
-40,-30,-100,1323,1413,2736,6206
-140,60,110,1321,1415,2736,6112
-140,-40,120,1318,1418,2736,6221
-40,-40,-140,1324,1412,2736,6061
-100,20,90,1322,1414,2736,6120
-40,-20,-100,1360,1377,2737,6244
-60,0,-90,1357,1380,2737,6240
-80,50,60,1336,1401,2737,6077
-50,20,-100,1340,1398,2738,6205
-70,-60,-160,1343,1396,2739,6159
-30,-30,-120,1332,1407,2739,6081
-130,50,90,1349,1390,2739,6242
-130,10,90,1335,1404,2739,6102
-50,-20,-90,1331,1408,2739,6004
-120,50,70,1336,1404,2740,6255
-100,-20,-130,1314,1426,2740,6169
-140,50,90,1351,1389,2740,6240
-120,-40,-170,1334,1406,2740,6148
-30,-10,-130,1338,1403,2741,6164
-90,50,70,1340,1402,2742,6070
-130,50,80,1354,1388,2742,6162
-120,-30,130,1334,1409,2743,6201
-100,-30,-130,1329,1414,2743,6080
-150,20,120,1322,1421,2743,6247
-140,-20,170,1318,1425,2743,6168
-130,-60,140,1334,1410,2744,6230
-70,-50,-140,1346,1400,2746,5935
-120,30,100,1340,1406,2746,6109
-130,-50,150,1316,1430,2746,6127
-90,-10,-170,1363,1384,2747,6202
-140,-20,130,1330,1417,2747,6141
-140,30,90,1368,1380,2748,6211
-150,40,110,1319,1429,2748,6322
-60,-30,-100,1335,1413,2748,6116
-100,-70,160,1332,1417,2749,6309
-40,-50,-130,1348,1401,2749,6089
-40,20,-110,1359,1390,2749,6374
-30,10,-110,1367,1382,2749,6356
-120,-40,-160,1344,1405,2749,6175
-130,10,120,1333,1417,2750,6276
-140,40,110,1330,1420,2750,6215
-110,-50,140,1346,1406,2752,6377
-90,-30,-110,1349,1403,2752,6181
-110,-10,-180,1350,1403,2753,6179
-110,-10,180,1350,1403,2753,6179
-90,-60,170,1331,1423,2754,6216
-90,-50,-160,1333,1421,2754,6236
-100,30,60,1348,1407,2755,6208
-130,0,100,1332,1423,2755,6223
-100,-40,170,1352,1403,2755,6479
-70,0,-150,1353,1402,2755,6320
-110,0,-170,1354,1402,2756,6499
-90,-50,-180,1347,1410,2757,6244
-40,-10,-100,1354,1403,2757,6150
-110,-40,160,1370,1387,2757,6244
-150,50,100,1345,1412,2757,6454
-110,-40,170,1371,1386,2757,6115
-90,-50,180,1347,1410,2757,6244
-140,-20,110,1332,1425,2757,6271
-100,30,80,1337,1421,2758,6314
-110,10,100,1332,1426,2758,6303
-110,-60,160,1338,1420,2758,6183
-160,40,110,1327,1431,2758,6244
-140,50,100,1349,1409,2758,6347
-90,50,60,1351,1408,2759,6294
-140,0,100,1362,1397,2759,6206
-110,-60,150,1359,1400,2759,6402
-150,30,100,1336,1424,2760,6418
-120,10,90,1364,1396,2760,6339
-120,30,80,1339,1421,2760,6466
-80,-50,-150,1353,1408,2761,6135
-110,40,60,1330,1431,2761,6324
-30,0,-110,1336,1426,2762,6269
-80,-40,-120,1346,1417,2763,6110
-80,0,-100,1344,1419,2763,6046
-130,-30,170,1330,1433,2763,6264
-150,-20,120,1344,1420,2764,6226
-150,0,120,1338,1427,2765,6416
-100,-60,170,1342,1423,2765,6305
-30,10,-120,1369,1397,2766,6449
-110,-50,-160,1335,1431,2766,6187
-70,-50,-130,1335,1431,2766,6018
-120,-40,130,1344,1423,2767,6388
-100,30,70,1380,1387,2767,6280
-130,-10,170,1359,1408,2767,6092
-70,-50,-150,1364,1403,2767,6161
-80,-50,-170,1341,1426,2767,6125
-160,30,110,1350,1418,2768,6268
-100,0,-160,1364,1405,2769,6585
-40,10,-100,1369,1401,2770,6254
-100,-50,-170,1339,1431,2770,6111
-130,-60,130,1339,1432,2771,6370
-130,-40,-170,1340,1431,2771,6210
-90,-10,-120,1373,1398,2771,6308
-100,-50,-180,1347,1424,2771,6125
-100,-50,180,1347,1424,2771,6125
-120,40,90,1362,1410,2772,6305
-100,50,60,1355,1417,2772,6272
-130,-20,130,1328,1444,2772,6144
-110,-50,150,1360,1412,2772,6279
-130,-10,-160,1336,1438,2774,6429
-70,0,-100,1380,1394,2774,6096
-30,-10,-110,1360,1415,2775,6092
-130,30,80,1342,1433,2775,6473
-90,-50,-170,1341,1434,2775,6189
-120,-60,150,1347,1430,2777,6257
-90,-30,-120,1363,1414,2777,6064
-140,-40,130,1348,1430,2778,6214
-40,0,-100,1357,1422,2779,6352
-70,-20,-100,1370,1409,2779,6271
-120,-30,170,1348,1431,2779,6089
-130,-50,140,1350,1429,2779,6258
-90,0,-130,1386,1394,2780,6404
-130,0,120,1342,1439,2781,6261
-90,-10,-110,1346,1436,2782,6196
-140,10,100,1358,1424,2782,6389
-80,0,-140,1357,1426,2783,6446
-150,-10,120,1338,1445,2783,6355
-130,40,100,1373,1410,2783,6195
-50,-10,-100,1380,1403,2783,6512
-100,-50,-160,1352,1432,2784,6183
-120,0,-170,1348,1437,2785,6453
-80,-10,-100,1364,1421,2785,6263
-90,-60,180,1346,1439,2785,6372
-110,30,60,1361,1424,2785,6146
-90,40,60,1354,1431,2785,6349
-140,10,120,1352,1433,2785,6400
-50,-50,-140,1381,1404,2785,6225
-90,-60,-180,1346,1439,2785,6372
-110,-30,170,1384,1402,2786,6324
-80,-50,-140,1343,1443,2786,6135
-110,30,80,1371,1418,2789,6212
-150,0,110,1348,1441,2789,6359
-50,-20,-100,1370,1419,2789,6394
-120,30,70,1341,1449,2790,6406
-80,-60,-170,1354,1436,2790,6288
-50,10,-110,1391,1402,2793,6349
-120,50,80,1378,1415,2793,6368
-140,-20,180,1339,1454,2793,6293
-150,10,120,1342,1451,2793,6375
-140,-20,-180,1339,1454,2793,6293
-130,-50,130,1366,1427,2793,6421
-60,-40,-130,1357,1436,2793,6092
-110,-50,160,1372,1422,2794,6430
-90,-50,-150,1368,1427,2795,6242
-80,-50,-160,1355,1441,2796,6241
-100,40,80,1361,1435,2796,6282
-90,-20,-110,1364,1433,2797,6212
-60,-40,-140,1379,1420,2799,6294
-60,0,-140,1380,1419,2799,6503
-60,-40,-120,1362,1438,2800,6300
-100,-50,-150,1344,1456,2800,6281
-140,40,90,1376,1425,2801,6269
-100,-60,160,1362,1439,2801,6443
-40,0,-130,1380,1421,2801,6480
-120,-40,150,1362,1439,2801,6379
-30,-20,-120,1372,1430,2802,6295
-140,-30,130,1360,1443,2803,6285
-110,40,80,1376,1428,2804,6397
-110,-40,180,1371,1433,2804,6174
-110,-40,-180,1371,1433,2804,6174
-110,-40,-170,1347,1459,2806,6264
-130,-20,170,1373,1433,2806,6367
-130,30,90,1350,1456,2806,6593
-80,0,-110,1397,1410,2807,6364
-80,-30,-170,1375,1432,2807,6349
-90,-30,180,1356,1453,2809,6433
-90,-30,-180,1356,1453,2809,6433
-100,-50,170,1377,1433,2810,6301
-50,-10,-140,1399,1412,2811,6496
-90,0,-150,1377,1435,2812,6588
-120,0,100,1360,1452,2812,6263
-150,40,100,1367,1445,2812,6580
-110,-40,-150,1355,1457,2812,6361
-140,-30,-180,1341,1472,2813,6322
-140,-30,180,1341,1472,2813,6322
-90,-40,-180,1387,1427,2814,6417
-50,10,-100,1382,1432,2814,6316
-120,0,110,1344,1470,2814,6385
-90,-40,180,1387,1427,2814,6417
-40,10,-110,1402,1413,2815,6517
-130,-40,140,1352,1463,2815,6233
-120,40,70,1364,1452,2816,6538
-60,-50,-150,1382,1434,2816,6272
-120,-60,140,1385,1432,2817,6298
-70,-20,-160,1392,1425,2817,6348
-50,-30,-110,1356,1462,2818,6386
-90,-40,-130,1384,1434,2818,6226
-120,10,110,1359,1460,2819,6361
-130,40,80,1368,1452,2820,6472
-90,-50,-140,1361,1460,2821,6326
-50,-30,-130,1390,1432,2822,6394
-50,0,-130,1393,1430,2823,6499
-130,40,90,1388,1435,2823,6430
-80,-30,-110,1392,1433,2825,6461
-40,-40,-130,1376,1449,2825,6345
-60,0,-130,1391,1435,2826,6515
-120,-40,140,1368,1459,2827,6374
-70,-10,-100,1428,1400,2828,6385
-110,50,70,1391,1437,2828,6393
-70,-40,-120,1381,1448,2829,6489
-120,20,100,1385,1445,2830,6461
-130,30,100,1390,1440,2830,6596
-130,20,110,1375,1456,2831,6395
-110,-30,-140,1377,1454,2831,6485
-130,-10,110,1381,1452,2833,6522
-120,-50,140,1383,1450,2833,6483
-70,-50,-160,1390,1443,2833,6229
-40,-30,-130,1387,1446,2833,6277
-120,30,90,1365,1469,2834,6541
-60,-20,-100,1383,1452,2835,6502
-80,-20,-100,1410,1425,2835,6474
-140,30,110,1367,1468,2835,6496
-100,40,70,1400,1435,2835,6407
-60,-30,-110,1390,1446,2836,6491
-130,-20,120,1405,1432,2837,6396
-30,0,-120,1380,1457,2837,6691
-140,-30,120,1378,1461,2839,6404
-140,20,100,1385,1456,2841,6468
-110,-40,-160,1386,1457,2843,6487
-130,-10,120,1395,1450,2845,6340
-110,40,70,1395,1450,2845,6477
-30,-10,-120,1395,1452,2847,6663
-120,20,90,1376,1473,2849,6533
-130,-10,-170,1393,1458,2851,6562
-120,-50,150,1386,1466,2852,6432
-80,-40,-170,1394,1463,2857,6408
-140,40,100,1381,1476,2857,6618
-50,-40,-140,1398,1459,2857,6398
-120,-30,180,1395,1463,2858,6558
-120,-30,-180,1395,1463,2858,6558
-70,0,-140,1396,1462,2858,6544
-100,-40,-180,1394,1464,2858,6583
-100,-40,180,1394,1464,2858,6583
-130,-30,180,1378,1481,2859,6317
-130,-30,-180,1378,1481,2859,6317
-50,-20,-110,1404,1457,2861,6514
-90,-20,-170,1398,1463,2861,6561
-130,20,100,1404,1458,2862,6640
-100,-40,-140,1396,1467,2863,6581
-60,0,-100,1408,1456,2864,6446
-120,40,80,1397,1468,2865,6646
-80,0,-150,1387,1478,2865,6732
-70,-30,-110,1393,1472,2865,6370
-150,30,110,1377,1488,2865,6589
-40,0,-110,1428,1437,2865,6626
-50,0,-100,1402,1463,2865,6360
-130,-30,-170,1370,1496,2866,6479
-120,-30,-160,1379,1489,2868,6456
-130,-10,180,1411,1458,2869,6597
-130,-10,-180,1411,1458,2869,6597
-140,30,100,1391,1478,2869,6611
-80,-10,-160,1423,1447,2870,6552
-130,10,110,1402,1469,2871,6606
-110,-10,-150,1398,1474,2872,6765
-90,40,70,1408,1465,2873,6637
-40,-20,-120,1401,1473,2874,6528
-120,-10,-160,1402,1472,2874,6638
-130,10,100,1399,1476,2875,6498
-80,0,-120,1410,1466,2876,6632
-140,-10,110,1404,1474,2878,6489
-70,-40,-140,1396,1483,2879,6466
-130,-40,130,1396,1483,2879,6373
-120,10,100,1394,1487,2881,6576
-100,-20,-180,1408,1475,2883,6393
-100,-20,180,1408,1475,2883,6393
-60,-20,-150,1408,1475,2883,6628
-130,-20,-170,1398,1485,2883,6726
-130,-20,180,1405,1479,2884,6593
-130,-20,-180,1405,1479,2884,6593
-70,-40,-160,1401,1484,2885,6490
-80,-40,-160,1392,1493,2885,6443
-100,-40,-160,1427,1459,2886,6522
-110,-30,-180,1394,1492,2886,6453
-110,-30,180,1394,1492,2886,6453
-150,10,110,1396,1490,2886,6614
-40,-10,-110,1406,1481,2887,6600
-130,0,110,1404,1483,2887,6607
-70,-40,-150,1402,1489,2891,6415
-130,-30,130,1381,1512,2893,6583
-100,-40,-170,1401,1492,2893,6576
-100,-10,-140,1410,1486,2896,6632
-80,-20,-110,1424,1472,2896,6492
-100,-30,180,1395,1502,2897,6507
-100,-30,-180,1395,1502,2897,6507
-60,0,-120,1454,1443,2897,6611
-70,0,-110,1429,1468,2897,6538
-90,-40,-170,1427,1471,2898,6504
-60,-10,-100,1406,1493,2899,6694
-150,20,110,1389,1510,2899,6770
-140,20,110,1396,1504,2900,6688
-70,-30,-160,1392,1513,2905,6511
-80,0,-130,1426,1481,2907,6790
-60,-40,-150,1404,1503,2907,6484
-140,-20,120,1406,1501,2907,6613
-90,-30,-130,1416,1494,2910,6505
-140,-10,120,1392,1518,2910,6666
-90,-40,-160,1413,1498,2911,6685
-90,-10,-130,1439,1473,2912,6817
-140,0,120,1407,1505,2912,6653
-70,-40,-130,1423,1489,2912,6534
-120,-10,180,1422,1492,2914,6703
-120,-10,-180,1422,1492,2914,6703
-90,-20,-130,1423,1491,2914,6720
-60,0,-110,1450,1468,2918,6490
-50,0,-110,1431,1489,2920,6670
-100,-40,-150,1421,1500,2921,6759
-120,-20,-160,1421,1503,2924,6793
-80,-40,-130,1412,1515,2927,6646
-60,-30,-150,1402,1525,2927,6687
-80,-30,-120,1429,1499,2928,6643
-80,-40,-150,1418,1510,2928,6623
-40,-20,-130,1445,1484,2929,6695
-50,-30,-140,1417,1513,2930,6698
-80,-40,-140,1449,1482,2931,6552
-90,-40,-150,1439,1492,2931,6592
-80,-10,-110,1437,1497,2934,6631
-40,-10,-130,1454,1480,2934,6720
-60,-30,-130,1446,1488,2934,6643
-110,-20,-150,1432,1503,2935,6866
-110,-30,-150,1410,1528,2938,6657
-140,0,110,1421,1522,2943,6699
-100,-20,-140,1428,1516,2944,6859
-50,-20,-120,1444,1501,2945,6628
-90,-30,-170,1436,1511,2947,6702
-50,-10,-110,1430,1517,2947,6781
-90,-40,-140,1416,1531,2947,6726
-100,-30,-140,1429,1520,2949,6780
-120,-30,-170,1429,1521,2950,6674
-50,-20,-140,1440,1510,2950,6824
-60,-30,-120,1440,1513,2953,6823
-110,-20,180,1443,1511,2954,6575
-100,-30,-170,1433,1521,2954,6745
-110,-20,-180,1443,1511,2954,6575
-60,-10,-140,1456,1500,2956,6878
-40,-10,-120,1442,1516,2958,6748
-70,0,-120,1473,1485,2958,6746
-110,-10,-170,1457,1503,2960,6849
-90,-20,-120,1445,1515,2960,6592
-70,-10,-150,1458,1503,2961,6776
-60,-10,-110,1460,1502,2962,6841
-60,-20,-110,1447,1519,2966,6859
-70,0,-130,1443,1523,2966,6826
-120,-20,180,1456,1511,2967,6677
-120,-20,-180,1456,1511,2967,6677
-100,-10,-170,1469,1500,2969,6674
-50,0,-120,1467,1502,2969,6756
-70,-10,-110,1469,1504,2973,6683
-60,-30,-140,1449,1525,2974,6729
-100,-10,-150,1474,1501,2975,6935
-70,-30,-120,1446,1531,2977,6895
-40,0,-120,1467,1511,2978,6834
-80,-20,-160,1471,1508,2979,6897
-140,10,110,1438,1542,2980,6892
-90,-20,-140,1454,1532,2986,6807
-70,-30,-140,1455,1543,2998,6946
-70,-30,-130,1457,1544,3001,6938
-80,-30,-130,1438,1568,3006,6880
-80,-30,-160,1473,1534,3007,6878
-70,-20,-150,1480,1529,3009,6887
-70,-20,-110,1445,1567,3012,6994
-120,-10,-170,1472,1540,3012,6929
-90,-30,-140,1442,1572,3014,6892
-70,-30,-150,1453,1562,3015,6797
-110,-10,-160,1481,1539,3020,7081
-90,-10,-140,1469,1555,3024,7139
-110,-30,-170,1452,1572,3024,6929
-110,-30,-160,1457,1573,3030,6951
-50,-10,-130,1493,1538,3031,7060
-60,-20,-120,1464,1567,3031,7014
-90,-10,-160,1464,1568,3032,7046
-50,-20,-130,1470,1566,3036,6932
-80,-10,-130,1512,1532,3044,7061
-80,-10,-140,1472,1572,3044,6974
-70,-10,-120,1507,1540,3047,6816
-60,-10,-120,1495,1553,3048,7050
-50,-10,-120,1498,1550,3048,7059
-80,-30,-150,1476,1575,3051,6896
-60,-20,-140,1502,1550,3052,6996
-100,-20,-150,1492,1563,3055,7095
-110,-20,-160,1485,1574,3059,7121
-80,-30,-140,1490,1572,3062,6993
-70,-10,-140,1484,1581,3065,7231
-80,-20,-130,1489,1577,3066,7027
-80,-10,-120,1504,1563,3067,6977
-90,-30,-160,1486,1583,3069,7127
-100,-20,-170,1491,1587,3078,7165
-60,-10,-130,1511,1567,3078,7181
-80,-20,-140,1497,1581,3078,7099
-100,-10,-160,1522,1557,3079,7149
-70,-20,-120,1500,1582,3082,7037
-100,-30,-150,1493,1595,3088,7119
-120,-20,-170,1500,1594,3094,7192
-90,-30,-150,1518,1580,3098,7345
-60,-20,-130,1515,1591,3106,7130
-80,-20,-120,1525,1582,3107,7142
-100,-30,-160,1498,1617,3115,7240
-90,-20,-160,1526,1592,3118,7196
-100,-20,-160,1530,1591,3121,7365
-90,-20,-150,1541,1586,3127,7384
-70,-20,-130,1520,1612,3132,7376
-110,-20,-170,1532,1608,3140,7376
-70,-10,-130,1529,1611,3140,7312
-90,-10,-150,1547,1605,3152,7368
-70,-20,-140,1528,1626,3154,7360
-80,-10,-150,1542,1625,3167,7379
-80,-20,-150,1538,1650,3188,7346
