alpha,beta,gamma,ENZ_CA,SUB_CA,TOT_CA,clashes
150,10,100,7,5,12,9
160,10,100,8,10,18,12
150,-10,90,8,10,18,16
150,0,90,8,11,19,24
150,0,100,11,12,23,17
150,20,100,14,9,23,17
160,20,100,13,11,24,18
160,0,100,14,12,26,23
150,10,90,13,13,26,29
60,70,-150,14,13,27,24
50,70,-140,14,14,28,26
90,70,-170,17,12,29,30
80,70,-160,16,14,30,33
140,-10,90,14,16,30,35
150,20,110,17,14,31,39
140,-20,90,15,17,32,29
70,70,-160,17,15,32,29
100,70,-180,18,15,33,36
70,70,-150,18,15,33,36
100,70,180,18,15,33,36
150,-10,100,16,18,34,32
150,-20,90,13,21,34,37
40,70,-130,17,17,34,32
110,70,180,18,16,34,39
80,70,-170,19,15,34,30
70,-50,-20,15,19,34,51
160,-10,100,15,19,34,35
110,70,-180,18,16,34,39
50,70,-120,17,17,34,45
40,60,-130,15,20,35,41
50,70,-130,17,18,35,40
100,70,-170,18,17,35,39
40,10,-110,18,18,36,57
50,60,-140,17,19,36,40
120,70,170,19,17,36,41
60,70,-140,18,18,36,37
140,0,90,19,18,37,44
110,70,170,20,17,37,38
160,20,110,20,17,37,41
140,10,100,19,18,37,41
90,80,-180,20,18,38,37
90,80,180,20,18,38,37
90,80,-160,20,18,38,67
20,60,-110,17,21,38,41
30,20,-110,20,18,38,55
150,30,110,19,19,38,45
30,70,-110,19,19,38,52
30,70,-120,20,18,38,36
90,70,-160,20,18,38,41
40,70,-120,17,21,38,49
140,0,100,20,18,38,45
120,70,160,21,17,38,45
40,70,-110,19,19,38,54
100,80,170,21,18,39,39
80,-50,-10,15,24,39,50
60,60,-150,19,20,39,38
80,70,-150,19,20,39,42
150,10,110,21,18,39,44
30,60,-120,18,21,39,42
40,10,-120,18,21,39,58
40,-30,-70,15,24,39,63
150,40,120,23,17,40,45
20,80,-110,20,20,40,51
-10,80,-80,22,18,40,61
40,80,-130,20,20,40,44
140,-30,80,21,19,40,35
60,70,-130,21,19,40,46
70,60,-160,21,19,40,42
30,80,-120,20,20,40,48
100,80,-170,21,19,40,70
90,70,180,23,17,40,36
160,0,90,21,19,40,43
90,70,-180,23,17,40,36
20,70,-100,20,20,40,54
50,80,-140,21,20,41,42
70,70,-140,21,20,41,46
10,70,-90,20,21,41,63
60,80,-150,21,20,41,39
110,80,180,22,19,41,69
120,80,170,22,19,41,71
50,10,-120,20,21,41,58
110,80,-180,22,19,41,69
80,80,-150,21,20,41,65
70,80,-160,21,20,41,38
0,80,-90,23,18,41,59
100,80,-180,19,22,41,61
60,-50,-30,20,21,41,62
100,80,180,19,22,41,61
110,80,160,22,19,41,45
130,80,160,21,21,42,74
80,80,-170,23,19,42,37
100,70,170,26,16,42,39
150,-20,100,21,21,42,44
90,80,-170,20,22,42,62
120,60,160,22,20,42,38
20,70,-110,20,22,42,46
20,40,-110,22,20,42,59
130,70,150,22,20,42,50
50,-30,-70,15,27,42,54
80,80,-160,20,22,42,61
70,-40,-20,18,24,42,66
40,60,-120,19,23,42,48
110,70,160,23,19,42,42
150,50,120,24,19,43,61
130,70,160,25,18,43,50
130,60,150,23,20,43,37
160,30,110,21,22,43,44
140,-20,80,19,24,43,61
70,80,-140,21,22,43,65
20,30,-110,25,18,43,69
10,70,-100,20,23,43,50
80,-40,0,16,27,43,58
110,80,170,20,23,43,61
80,-40,10,19,24,43,70
30,10,-100,23,20,43,49
10,60,-100,21,22,43,47
160,30,100,22,22,44,49
80,60,-170,22,22,44,52
130,60,160,23,21,44,46
30,70,-100,23,21,44,64
110,60,170,24,20,44,42
120,60,150,23,21,44,45
70,80,-150,22,22,44,67
160,10,110,22,22,44,53
10,80,-100,24,20,44,60
50,60,-130,21,23,44,50
-20,80,-70,23,21,44,65
20,20,-100,26,18,44,59
140,40,130,25,19,44,48
140,70,150,24,20,44,62
30,20,-100,19,25,44,57
60,80,-130,21,23,44,70
60,80,-140,23,22,45,68
90,60,-170,22,23,45,51
160,40,110,22,23,45,57
50,80,-120,23,22,45,71
130,-10,90,23,22,45,87
40,20,-120,22,23,45,69
40,-40,-60,21,24,45,84
120,80,150,26,19,45,48
70,60,-150,22,23,45,46
60,80,-160,21,24,45,48
140,80,150,22,23,45,83
20,60,-100,20,26,46,58
80,-40,-10,19,27,46,57
10,80,-110,22,24,46,53
50,80,-150,20,26,46,50
30,80,-130,21,25,46,52
120,80,160,23,23,46,66
140,-10,80,20,26,46,50
10,80,-90,22,24,46,78
10,60,-90,23,23,46,57
130,-20,80,22,24,46,66
150,80,140,22,24,46,94
40,80,-110,23,23,46,74
40,80,-140,20,26,46,52
20,80,-120,22,25,47,54
140,60,150,23,24,47,55
20,40,-100,25,22,47,65
150,40,110,22,25,47,55
30,50,-110,24,23,47,64
30,40,-110,25,22,47,64
30,20,-120,25,22,47,78
80,60,-160,23,24,47,48
50,80,-130,24,23,47,69
70,80,-170,22,25,47,53
140,60,140,23,24,47,48
20,80,-100,23,24,47,76
10,40,-100,24,24,48,53
70,-60,-20,24,24,48,73
150,40,130,26,22,48,50
50,-30,-60,18,30,48,68
120,70,150,24,24,48,52
30,60,-110,19,29,48,54
40,-30,-60,22,26,48,84
110,60,160,24,24,48,53
0,70,-90,25,23,48,62
170,10,100,23,25,48,43
20,10,-100,23,25,48,60
0,70,-80,24,25,49,75
100,60,-180,26,23,49,48
10,50,-100,23,26,49,55
130,-10,80,23,26,49,81
130,80,150,25,24,49,71
70,70,-170,22,27,49,57
40,50,-130,24,25,49,63
140,40,120,28,21,49,60
80,80,-180,23,26,49,54
100,60,180,26,23,49,48
150,30,100,24,25,49,57
80,80,180,23,26,49,54
30,50,-120,25,24,49,61
20,70,-120,23,26,49,60
50,50,-140,24,25,49,60
-30,80,-60,25,24,49,75
60,60,-140,21,28,49,51
0,80,-80,25,25,50,84
30,60,-100,25,25,50,63
80,70,180,22,28,50,60
30,80,-110,25,25,50,76
160,80,130,23,27,50,100
160,40,100,23,27,50,54
20,30,-100,28,22,50,71
80,70,-180,22,28,50,60
50,-40,-50,24,26,50,84
80,-50,0,21,29,50,73
40,80,-120,25,25,50,70
140,-50,50,26,24,50,88
-10,80,-90,26,24,50,51
160,-10,90,25,25,50,68
150,60,130,23,27,50,63
40,20,-110,23,27,50,64
100,-50,20,22,28,50,93
140,80,140,25,25,50,78
140,20,100,27,23,50,57
20,70,-90,26,24,50,76
70,-40,-40,21,30,51,78
20,60,-90,24,27,51,75
80,-60,-10,24,27,51,67
160,50,110,27,24,51,80
20,50,-110,25,26,51,62
30,-30,-80,24,27,51,86
0,80,-100,26,25,51,56
20,50,-100,24,27,51,67
30,40,-120,24,27,51,70
150,50,110,25,26,51,71
150,70,140,30,21,51,82
150,80,130,25,26,51,83
40,50,-120,27,24,51,64
90,-50,10,21,30,51,92
90,-50,0,23,28,51,63
30,30,-110,28,23,51,72
140,80,130,27,24,51,57
100,-50,10,24,27,51,66
140,-10,100,27,24,51,59
30,80,-100,24,27,51,83
130,80,140,28,23,51,56
30,70,-130,24,27,51,59
50,-50,-40,25,26,51,81
130,-40,70,29,23,52,61
150,50,130,31,21,52,55
0,90,-80,26,26,52,90
100,90,-180,26,26,52,90
50,90,-130,26,26,52,90
100,90,180,26,26,52,90
-30,90,-50,26,26,52,90
110,90,170,26,26,52,90
-150,90,70,26,26,52,90
-80,90,0,26,26,52,90
150,90,130,26,26,52,90
-140,90,60,26,26,52,90
90,60,-180,26,26,52,59
40,30,-120,24,28,52,80
140,70,140,26,26,52,65
-130,90,50,26,26,52,90
10,50,-90,24,28,52,61
-50,90,-30,26,26,52,90
40,90,-120,26,26,52,90
140,90,140,26,26,52,90
120,90,160,26,26,52,90
-180,90,100,26,26,52,90
90,60,180,26,26,52,59
-90,90,10,26,26,52,90
140,50,130,27,25,52,50
70,90,-150,26,26,52,90
60,-50,-40,26,26,52,89
80,90,-160,26,26,52,90
170,90,110,26,26,52,90
-70,90,-10,26,26,52,90
60,90,-140,26,26,52,90
-160,90,80,26,26,52,90
160,90,120,26,26,52,90
30,90,-110,26,26,52,90
80,60,180,26,26,52,70
80,60,-180,26,26,52,70
20,90,-100,26,26,52,90
-120,90,40,26,26,52,90
10,90,-90,26,26,52,90
-110,90,30,26,26,52,90
130,-30,70,28,24,52,51
180,90,100,26,26,52,90
-170,90,90,26,26,52,90
170,20,100,26,26,52,43
-60,90,-20,26,26,52,90
-40,90,-40,26,26,52,90
130,0,100,26,26,52,111
-20,90,-60,26,26,52,90
130,90,150,26,26,52,90
130,0,90,26,26,52,98
40,-30,-80,24,28,52,70
-10,90,-70,26,26,52,90
90,90,-170,26,26,52,90
-100,90,20,26,26,52,90
50,-40,-60,20,33,53,78
40,90,-130,27,26,53,68
150,90,120,27,26,53,68
60,-40,-30,25,28,53,78
100,90,170,27,26,53,68
60,90,-150,27,26,53,68
160,50,120,27,26,53,77
130,90,140,27,26,53,68
-100,90,10,27,26,53,68
20,90,-110,27,26,53,68
-60,90,-30,27,26,53,68
0,90,-90,27,26,53,68
-110,90,20,27,26,53,68
-80,90,-10,27,26,53,68
140,60,130,29,24,53,54
160,90,110,27,26,53,68
90,70,170,22,31,53,62
100,60,170,26,27,53,57
-10,90,-80,27,26,53,68
-70,90,-20,27,26,53,68
140,70,130,28,25,53,65
130,-50,50,26,27,53,111
-160,90,70,27,26,53,68
-20,90,-70,27,26,53,68
30,90,-120,27,26,53,68
-50,90,-40,27,26,53,68
80,90,-170,27,26,53,68
120,60,170,26,27,53,53
90,90,180,27,26,53,68
-40,90,-50,27,26,53,68
50,-50,-50,25,28,53,96
90,90,-180,27,26,53,68
180,90,90,27,26,53,68
-180,90,90,27,26,53,68
70,50,-160,27,26,53,79
70,90,-160,27,26,53,68
-170,90,80,27,26,53,68
-90,90,0,27,26,53,68
110,90,160,27,26,53,68
170,90,100,27,26,53,68
130,60,140,29,24,53,50
40,-40,-50,26,27,53,89
-130,90,40,27,26,53,68
-140,90,50,27,26,53,68
-120,90,30,27,26,53,68
50,90,-140,27,26,53,68
120,90,150,27,26,53,68
140,90,130,27,26,53,68
40,40,-120,29,24,53,79
10,90,-100,27,26,53,68
-150,90,60,27,26,53,68
-30,90,-60,27,26,53,68
-40,80,-50,28,26,54,79
30,-30,-70,22,32,54,106
40,70,-140,25,29,54,68
80,50,-180,27,27,54,87
50,-40,-40,29,25,54,76
50,70,-150,24,30,54,70
90,-60,0,25,29,54,64
110,50,160,28,26,54,87
50,50,-130,29,25,54,67
40,-50,-60,23,31,54,102
70,-40,-10,25,29,54,78
110,50,170,30,24,54,85
130,-50,40,29,25,54,91
150,-30,90,28,26,54,66
80,50,180,27,27,54,87
60,-40,-40,29,25,54,71
60,-30,-60,20,34,54,68
120,-40,40,30,24,54,109
160,80,120,28,27,55,85
170,40,100,27,28,55,60
60,70,-160,25,30,55,63
140,-20,100,25,30,55,62
-10,70,-80,29,26,55,71
90,60,170,25,30,55,73
130,70,140,28,27,55,57
90,80,170,25,30,55,64
130,50,130,30,25,55,75
150,70,130,26,29,55,78
100,60,160,25,30,55,65
30,50,-100,28,27,55,70
100,70,160,26,29,55,68
160,-20,100,30,26,56,79
40,20,-130,28,28,56,82
160,70,130,31,25,56,97
40,30,-110,30,26,56,71
10,70,-80,28,28,56,82
60,-40,-50,23,33,56,80
140,50,120,31,25,56,77
140,10,90,29,27,56,63
30,10,-110,27,29,56,85
80,50,-170,29,27,56,87
-170,80,70,30,26,56,65
170,80,120,27,29,56,107
40,40,-130,26,30,56,74
50,10,-110,31,25,56,71
150,0,110,25,31,56,67
100,80,160,27,29,56,66
10,40,-90,26,30,56,74
80,60,170,31,26,57,76
100,50,160,25,32,57,88
80,50,170,29,28,57,98
150,20,120,29,28,57,70
20,20,-110,32,25,57,92
20,80,-90,27,30,57,86
170,80,110,29,28,57,94
90,60,160,29,28,57,75
110,60,150,26,31,57,65
0,60,-80,29,28,57,76
140,-60,50,26,31,57,85
30,10,-120,25,32,57,81
70,-60,-10,30,27,57,98
90,-40,20,26,31,57,91
70,60,-170,29,28,57,69
30,30,-120,29,28,57,87
130,-60,40,27,30,57,80
60,-60,-30,27,30,57,94
130,70,130,32,25,57,77
150,70,120,31,26,57,77
150,30,120,28,29,57,68
110,-50,20,27,30,57,78
30,0,-100,26,31,57,85
50,-50,-60,23,34,57,90
120,-50,30,28,29,57,91
20,90,-120,27,31,58,67
-100,90,0,27,31,58,67
90,-40,0,26,32,58,67
-110,90,10,27,31,58,67
160,10,90,29,29,58,53
80,90,180,27,31,58,67
80,90,-180,27,31,58,67
130,90,130,27,31,58,67
150,70,150,32,26,58,65
-50,90,-50,27,31,58,67
-10,90,-90,27,31,58,67
170,90,90,27,31,58,67
-80,90,-20,27,31,58,67
160,90,100,27,31,58,67
150,90,110,27,31,58,67
160,0,110,30,28,58,84
140,30,120,31,27,58,76
110,60,-180,29,29,58,66
-160,90,60,27,31,58,67
110,90,150,27,31,58,67
120,-50,40,29,29,58,121
70,90,-170,27,31,58,67
-90,90,-10,27,31,58,67
-150,90,50,27,31,58,67
180,90,80,27,31,58,67
10,70,-110,28,30,58,74
120,-60,30,28,30,58,74
-120,90,20,27,31,58,67
30,90,-130,27,31,58,67
150,80,120,30,28,58,66
50,40,-140,29,29,58,90
120,60,140,32,26,58,76
-180,90,80,27,31,58,67
70,-50,-30,26,32,58,94
-30,90,-70,27,31,58,67
10,90,-110,27,31,58,67
120,90,140,27,31,58,67
50,90,-150,27,31,58,67
-130,90,30,27,31,58,67
110,60,180,29,29,58,66
-140,90,40,27,31,58,67
160,40,120,26,32,58,72
60,90,-160,27,31,58,67
90,90,170,27,31,58,67
40,90,-140,27,31,58,67
140,90,120,27,31,58,67
-170,90,70,27,31,58,67
150,60,120,35,23,58,76
-40,90,-60,27,31,58,67
-70,90,-30,27,31,58,67
-20,90,-80,27,31,58,67
-60,90,-40,27,31,58,67
100,90,160,27,31,58,67
0,90,-100,27,31,58,67
110,70,150,30,28,58,73
60,-30,-70,27,32,59,80
70,-30,-60,27,32,59,96
160,70,110,33,26,59,76
130,10,100,30,29,59,105
160,70,140,29,30,59,73
130,70,170,32,27,59,70
40,30,-130,28,31,59,89
120,-60,40,30,29,59,105
120,-40,60,37,22,59,71
90,60,150,30,29,59,96
150,60,140,31,28,59,85
100,50,180,28,31,59,99
70,-40,0,23,36,59,89
160,60,110,33,26,59,90
70,50,-170,31,28,59,91
130,50,140,30,29,59,76
140,-40,80,32,27,59,81
130,-60,50,29,30,59,112
50,20,-120,31,28,59,71
130,40,120,32,27,59,84
130,60,130,32,27,59,88
-20,80,-80,33,26,59,59
100,50,-180,28,31,59,99
110,80,150,30,29,59,68
100,60,150,32,28,60,84
180,80,110,30,30,60,109
20,0,-100,30,30,60,73
60,-50,-50,23,37,60,91
100,-60,10,28,32,60,76
160,40,130,31,29,60,78
170,0,100,29,31,60,66
120,50,160,30,30,60,86
-180,80,110,30,30,60,109
-10,80,-70,30,30,60,94
110,-50,30,27,33,60,115
140,60,120,32,28,60,101
120,70,140,32,28,60,77
160,80,110,31,29,60,70
100,-60,20,28,33,61,103
10,60,-80,29,32,61,94
70,-50,-10,25,36,61,91
20,-30,-80,30,31,61,123
120,-40,50,35,26,61,83
40,60,-110,29,32,61,76
130,40,130,34,27,61,85
60,50,-150,32,29,61,72
80,-50,10,25,36,61,100
-10,70,-70,28,33,61,81
130,-40,40,34,27,61,90
160,50,130,32,29,61,71
20,50,-90,30,31,61,92
0,70,-100,30,31,61,84
0,60,-90,29,32,61,67
120,70,180,30,32,62,69
150,60,110,32,30,62,100
70,-40,-30,28,34,62,75
90,50,180,30,32,62,100
140,10,110,34,28,62,76
140,50,140,31,31,62,75
60,60,-160,30,32,62,81
90,50,-180,30,32,62,100
120,70,-180,30,32,62,69
180,80,100,31,31,62,101
50,10,-130,32,30,62,87
30,-20,-80,29,33,62,94
-180,80,100,31,31,62,101
140,30,110,35,27,62,73
140,70,160,35,27,62,62
90,70,160,32,30,62,94
130,-20,90,29,33,62,88
-50,80,-40,32,30,62,85
130,30,120,32,30,62,106
-60,80,-30,32,30,62,82
140,-30,90,32,30,62,81
10,30,-100,35,27,62,74
130,40,110,34,28,62,97
100,-50,30,32,30,62,104
170,70,120,30,32,62,112
10,80,-80,29,33,62,97
50,-60,-40,27,35,62,105
120,50,140,31,31,62,82
70,-40,10,28,34,62,82
160,60,120,31,31,62,84
120,50,150,30,32,62,86
80,50,-160,34,28,62,95
170,30,100,29,34,63,63
100,50,170,31,32,63,99
170,60,100,36,27,63,88
180,80,80,35,28,63,77
-160,80,60,34,29,63,72
-180,80,80,35,28,63,77
140,40,110,32,31,63,65
-30,80,-70,35,28,63,64
30,-40,-60,29,34,63,115
90,50,170,30,33,63,93
110,50,150,31,32,63,84
-20,70,-70,32,31,63,92
130,80,130,32,31,63,76
140,-40,70,32,31,63,100
80,-40,-20,29,34,63,81
170,-10,110,33,30,63,108
20,60,-120,30,33,63,85
50,-20,-70,27,36,63,81
80,60,160,33,30,63,96
-130,90,60,32,32,64,105
140,70,120,37,27,64,86
-150,90,80,32,32,64,105
-30,90,-40,32,32,64,105
-10,90,-60,32,32,64,105
130,-30,80,30,34,64,89
120,50,130,31,33,64,94
-160,90,90,32,32,64,105
160,90,130,32,32,64,105
-90,90,20,32,32,64,105
150,-60,60,29,35,64,94
-140,90,70,32,32,64,105
90,90,-160,32,32,64,105
-170,90,100,32,32,64,105
90,50,160,29,35,64,92
90,-50,20,30,34,64,109
-40,80,-60,34,30,64,64
140,80,120,32,32,64,78
30,90,-100,32,32,64,105
-40,90,-30,32,32,64,105
160,30,120,29,35,64,80
-20,90,-50,32,32,64,105
80,90,-150,32,32,64,105
70,90,-140,32,32,64,105
-150,80,50,34,30,64,72
40,0,-120,32,32,64,89
180,90,110,32,32,64,105
30,60,-130,29,35,64,78
-50,90,-20,32,32,64,105
160,80,100,36,28,64,79
-180,90,110,32,32,64,105
140,90,150,32,32,64,105
160,60,130,34,30,64,82
110,-60,20,31,33,64,83
-90,80,0,34,30,64,86
170,90,120,32,32,64,105
90,50,-170,33,31,64,114
-80,80,-10,34,30,64,82
20,90,-90,32,32,64,105
100,90,-170,32,32,64,105
-60,90,-10,32,32,64,105
-110,90,40,32,32,64,105
10,90,-80,32,32,64,105
150,90,140,32,32,64,105
-170,80,90,31,33,64,103
120,80,140,33,31,64,81
-80,90,10,32,32,64,105
110,90,-180,32,32,64,105
150,80,110,33,31,64,79
-100,90,30,32,32,64,105
-120,90,50,32,32,64,105
30,-10,-100,33,31,64,83
40,-40,-70,28,36,64,100
170,80,100,35,29,64,75
110,-60,30,31,33,64,105
-70,90,0,32,32,64,105
-50,80,-50,34,30,64,58
0,90,-70,32,32,64,105
120,90,170,32,32,64,105
130,90,160,32,32,64,105
140,-60,60,30,34,64,118
110,90,180,32,32,64,105
40,90,-110,32,32,64,105
50,90,-120,32,32,64,105
60,90,-130,32,32,64,105
-60,80,-40,34,30,64,58
-20,80,-60,31,33,64,97
40,-20,-70,29,36,65,92
-70,80,-20,34,31,65,85
70,50,-180,34,31,65,99
50,30,-120,32,33,65,97
160,-20,110,33,32,65,119
100,70,150,36,29,65,99
10,60,-110,31,34,65,73
70,50,180,34,31,65,99
120,60,130,32,33,65,109
-160,80,80,31,34,65,99
180,70,110,31,34,65,124
40,10,-130,32,33,65,92
70,60,-180,32,33,65,85
110,-50,40,34,31,65,114
10,30,-90,32,33,65,87
-180,70,110,31,34,65,124
40,40,-110,35,30,65,80
110,60,140,34,31,65,93
110,50,140,33,32,65,89
70,60,180,32,33,65,85
100,-40,20,30,36,66,98
100,-40,30,34,32,66,97
160,60,100,33,33,66,104
0,40,-90,37,29,66,69
120,80,180,32,34,66,93
150,40,100,34,32,66,61
30,-50,-70,30,36,66,119
-100,80,10,35,31,66,91
120,80,-180,32,34,66,93
170,70,130,32,34,66,93
80,-60,0,31,35,66,100
30,-40,-70,27,39,66,121
60,60,-130,34,32,66,78
40,-20,-80,31,35,66,91
70,-30,0,33,33,66,73
70,-40,-50,27,39,66,82
110,80,-170,34,32,66,93
60,50,-160,33,33,66,99
180,80,90,36,30,66,78
-180,80,90,36,30,66,78
40,60,-140,29,37,66,79
160,70,120,30,36,66,97
30,30,-100,31,35,66,82
40,50,-110,32,34,66,78
170,80,90,37,29,66,78
-30,80,-50,32,34,66,99
130,80,170,32,35,67,98
130,-50,60,36,31,67,110
60,-40,-60,27,40,67,78
70,-50,0,27,40,67,104
130,-20,70,34,33,67,88
20,40,-90,30,37,67,96
90,-40,10,30,37,67,94
50,-40,-70,28,39,67,98
120,-70,40,33,34,67,115
110,-40,50,37,30,67,90
40,-50,-50,32,35,67,99
100,-40,10,31,36,67,87
90,-60,10,31,36,67,100
40,-50,-70,28,39,67,112
-160,80,70,36,31,67,83
170,0,110,35,32,67,100
170,20,110,30,37,67,76
80,70,170,32,35,67,97
50,0,-120,35,32,67,81
100,-70,20,34,34,68,109
80,80,-140,31,37,68,93
100,60,140,36,32,68,103
90,60,-160,33,35,68,80
160,-10,110,38,30,68,109
40,50,-140,26,42,68,89
-140,80,40,35,33,68,79
-140,80,50,36,32,68,83
60,-70,-30,31,37,68,118
110,-70,30,34,34,68,116
-70,80,-30,36,32,68,65
40,20,-100,32,36,68,84
150,-40,90,36,32,68,107
50,60,-150,32,36,68,91
80,-40,20,30,38,68,93
40,10,-100,34,34,68,103
170,60,120,33,35,68,110
150,-10,110,33,35,68,92
-110,80,20,37,31,68,90
-170,80,80,37,31,68,77
120,-10,80,33,35,68,140
120,40,120,35,33,68,114
170,50,100,35,33,68,112
-120,80,30,36,32,68,91
140,20,110,35,33,68,88
0,50,-90,35,34,69,76
0,50,-80,33,36,69,85
120,40,130,34,35,69,110
140,0,110,34,35,69,87
110,-40,30,33,36,69,118
-170,80,100,34,35,69,121
70,70,180,31,38,69,98
140,-30,70,34,35,69,95
70,-60,-30,33,36,69,119
160,-20,90,35,34,69,92
80,-40,-40,31,38,69,95
150,70,110,40,29,69,96
130,50,120,33,36,69,92
30,-10,-90,32,37,69,104
160,20,120,34,35,69,87
90,50,150,34,35,69,103
130,30,130,36,33,69,107
30,40,-100,34,35,69,91
70,70,-180,31,38,69,98
90,-70,10,34,35,69,115
70,50,-150,37,32,69,89
140,80,160,33,36,69,98
170,70,110,29,40,69,110
100,60,-170,31,38,69,81
30,-30,-60,32,37,69,115
-130,80,40,37,32,69,91
60,-30,-50,30,40,70,102
0,60,-100,34,36,70,88
130,-70,50,34,36,70,113
160,70,100,42,28,70,100
70,-70,-20,33,37,70,111
80,60,-150,35,35,70,83
20,50,-120,33,37,70,88
40,-60,-50,35,35,70,115
170,30,110,32,38,70,79
50,-30,-50,35,35,70,103
10,-20,-90,34,36,70,122
10,20,-100,38,32,70,79
150,-20,80,34,36,70,104
50,60,-120,34,36,70,91
0,70,-70,35,35,70,104
40,-10,-100,32,38,70,118
60,70,-170,32,38,70,100
-10,70,-90,36,34,70,91
110,70,-170,33,37,70,94
60,-60,-20,34,36,70,115
20,-20,-80,32,38,70,127
170,70,100,39,32,71,90
50,50,-150,32,39,71,113
50,20,-130,36,35,71,93
-80,80,-20,35,36,71,71
80,-50,-20,30,41,71,90
150,-60,70,34,37,71,119
30,-50,-60,33,38,71,129
100,80,150,37,34,71,94
60,-50,-20,29,42,71,112
30,-20,-70,35,36,71,127
130,-40,60,35,36,71,106
80,50,160,38,33,71,111
170,40,110,35,36,71,99
100,80,-160,34,37,71,100
-150,80,60,38,33,71,90
110,70,140,39,33,72,111
120,-40,30,40,32,72,104
10,50,-110,31,41,72,89
80,-70,0,35,37,72,122
50,30,-130,38,34,72,108
-90,80,-10,34,38,72,78
90,-50,-10,33,39,72,90
-150,80,70,34,38,72,106
50,40,-130,38,34,72,96
-170,70,100,33,39,72,132
-160,70,80,36,36,72,115
0,80,-70,34,38,72,110
90,80,160,37,35,72,93
100,50,150,34,38,72,95
-100,80,0,35,38,73,87
-180,70,90,40,33,73,100
80,-60,-20,36,37,73,102
170,60,110,38,35,73,113
120,-50,50,40,33,73,106
50,-50,-30,34,39,73,112
130,50,150,35,38,73,88
150,-30,100,37,36,73,96
-40,80,-40,33,40,73,104
70,80,-130,35,38,73,97
140,-50,60,35,38,73,136
70,60,-140,39,34,73,83
110,-40,40,39,34,73,116
50,40,-120,38,35,73,106
170,-10,100,39,34,73,97
180,70,90,40,33,73,100
150,-40,80,39,34,73,112
70,-70,-10,34,40,74,136
50,-60,-50,31,43,74,127
80,40,180,37,37,74,142
130,30,110,36,38,74,126
110,-30,50,38,36,74,92
70,-50,-40,29,45,74,105
80,40,-180,37,37,74,142
90,40,170,36,38,74,149
30,40,-130,32,42,74,98
-90,80,10,35,39,74,113
130,-10,100,37,37,74,135
50,20,-110,32,42,74,107
90,-70,0,34,40,74,118
-20,70,-60,33,41,74,100
20,40,-120,33,41,74,99
110,60,130,39,35,74,105
-180,70,100,36,39,75,117
60,-70,-20,34,41,75,144
130,-40,50,41,34,75,124
90,80,-150,35,40,75,99
40,-50,-40,34,41,75,125
150,50,140,40,35,75,111
100,-40,40,38,37,75,102
110,80,140,39,36,75,99
180,70,100,36,39,75,117
150,80,150,37,38,75,103
130,-70,40,33,42,75,103
30,50,-130,33,42,75,102
80,-70,-10,37,38,75,116
140,30,130,36,39,75,93
120,50,170,36,39,75,110
120,-50,20,37,38,75,94
100,-60,30,36,39,75,123
130,60,120,40,35,75,118
130,20,100,35,40,75,126
20,-40,-80,34,41,75,151
170,10,110,38,37,75,100
100,50,140,35,40,75,109
60,10,-130,36,39,75,124
-160,80,90,37,39,76,129
110,-40,20,40,36,76,103
20,-30,-70,35,41,76,152
10,50,-80,34,42,76,120
170,50,110,39,37,76,119
170,50,120,40,36,76,113
160,20,90,32,44,76,106
170,-20,110,40,36,76,133
160,50,100,33,43,76,103
-140,80,60,37,39,76,112
90,-40,-10,31,45,76,90
-10,60,-90,39,37,76,119
60,50,-140,36,40,76,91
120,30,120,34,42,76,143
-120,80,40,35,41,76,113
-120,80,20,37,39,76,86
-50,80,-30,35,41,76,106
100,40,160,38,38,76,153
-100,80,20,36,40,76,114
40,-60,-40,35,41,76,140
80,80,170,39,37,76,102
-180,-10,110,40,36,76,155
80,-60,10,38,38,76,129
140,60,160,35,41,76,80
50,70,-160,34,42,76,111
90,-60,20,37,39,76,125
120,-50,60,40,36,76,112
-110,80,10,37,39,76,89
-130,80,50,36,40,76,112
120,-70,30,33,43,76,104
60,-60,-40,32,44,76,130
60,60,-170,38,38,76,103
180,-10,110,40,36,76,155
120,-30,70,41,36,77,127
150,-70,60,35,42,77,118
100,-70,10,33,44,77,114
-160,70,70,42,35,77,107
120,-30,60,42,35,77,99
-130,80,30,38,39,77,86
150,-30,80,42,35,77,101
150,20,90,34,43,77,88
110,-30,40,41,36,77,102
50,-20,-80,36,41,77,115
130,-40,80,42,35,77,110
20,20,-90,36,41,77,110
90,40,180,35,42,77,156
90,40,-180,35,42,77,156
120,80,130,40,37,77,105
-110,80,30,36,41,77,114
10,10,-100,40,37,77,103
30,60,-90,32,46,78,118
90,40,160,39,39,78,152
70,40,-170,37,41,78,140
100,40,150,40,38,78,156
50,50,-120,37,41,78,103
-180,70,120,37,41,78,121
20,0,-90,33,45,78,111
140,50,110,37,41,78,103
50,-70,-40,37,41,78,129
40,40,-140,34,44,78,111
-70,80,-10,37,41,78,109
90,-30,-10,36,42,78,80
10,20,-90,39,39,78,114
90,-30,0,37,41,78,95
50,30,-140,41,37,78,114
0,40,-100,40,38,78,106
60,-40,-20,34,44,78,125
80,40,170,37,41,78,138
80,-30,0,38,40,78,84
30,0,-110,36,42,78,156
140,-70,50,35,43,78,110
110,-70,20,33,45,78,111
-60,80,-20,36,42,78,113
170,60,90,44,34,78,115
180,70,120,37,41,78,121
80,-40,-30,35,43,78,114
130,-60,30,33,46,79,91
-170,70,80,46,33,79,107
70,80,-180,39,40,79,108
50,-60,-30,34,45,79,133
-30,70,-60,39,40,79,102
20,30,-120,39,40,79,107
150,10,120,39,40,79,108
0,50,-100,41,38,79,101
120,40,140,37,42,79,145
140,-70,60,37,42,79,123
-10,60,-70,38,41,79,103
-150,70,70,39,40,79,110
70,80,180,39,40,79,108
40,-10,-90,38,41,79,137
140,40,140,40,39,79,108
130,-50,70,40,39,79,115
-180,70,80,42,38,80,121
50,-70,-30,36,44,80,150
70,-30,-50,38,42,80,119
-80,80,0,39,41,80,114
30,-50,-50,35,45,80,147
110,40,130,40,40,80,143
-10,50,-80,43,37,80,94
160,80,140,41,39,80,108
-180,60,100,41,39,80,123
120,70,130,42,38,80,122
180,70,80,42,38,80,121
80,-50,20,38,42,80,117
100,70,-160,35,45,80,95
120,50,120,37,43,80,126
60,80,-170,39,41,80,111
170,-20,100,40,40,80,126
150,-20,110,39,41,80,120
0,30,-90,41,39,80,85
70,60,170,42,38,80,117
50,30,-110,42,38,80,107
180,60,100,41,39,80,123
90,-40,30,40,41,81,101
50,20,-140,42,39,81,118
-180,60,110,36,45,81,145
10,30,-110,44,37,81,116
90,70,-150,42,39,81,103
140,80,110,43,38,81,113
160,-30,100,42,39,81,132
170,70,90,45,36,81,119
80,40,-170,40,41,81,150
-10,60,-80,40,41,81,97
40,0,-110,35,46,81,155
-10,80,-60,38,43,81,129
120,-60,50,42,39,81,130
130,80,120,43,38,81,113
180,60,110,36,45,81,145
100,-50,40,44,37,81,125
130,70,120,46,35,81,121
-170,70,90,40,41,81,118
10,-30,-90,36,46,82,160
-150,80,80,38,44,82,127
170,40,90,41,41,82,100
130,50,160,34,48,82,124
130,50,110,34,48,82,123
-180,60,90,45,37,82,114
160,-60,70,40,42,82,116
60,80,-120,40,42,82,107
110,-60,40,43,39,82,129
40,-70,-40,35,47,82,148
110,-50,10,35,47,82,107
10,-20,-80,39,43,82,165
180,60,90,45,37,82,114
140,70,110,45,37,82,130
20,10,-90,39,43,82,125
20,10,-110,40,42,82,132
140,50,150,39,43,82,133
70,40,180,40,42,82,152
20,-40,-70,36,46,82,153
100,40,170,42,40,82,149
-20,80,-50,38,44,82,129
150,60,150,41,41,82,108
70,40,-180,40,42,82,152
120,0,90,38,44,82,173
20,-50,-80,40,42,82,149
60,-20,-70,39,44,83,120
70,-60,0,39,44,83,130
110,40,140,41,42,83,155
100,-70,30,42,41,83,150
-160,70,90,38,45,83,134
30,-40,-80,37,46,83,146
80,-70,10,42,41,83,155
80,70,-140,44,39,83,97
0,-20,-90,44,39,83,145
170,40,120,39,44,83,122
140,60,110,45,38,83,127
60,-50,-60,35,48,83,112
110,-50,50,47,36,83,128
40,-40,-40,39,44,83,132
120,60,120,40,43,83,123
10,40,-110,41,42,83,108
120,-30,30,48,35,83,117
10,10,-90,42,41,83,121
120,-20,80,38,45,83,149
150,60,100,42,41,83,120
20,-20,-90,39,44,83,131
10,-30,-80,41,42,83,163
90,-30,10,41,42,83,119
-140,80,70,39,45,84,133
130,10,90,45,39,84,128
30,-60,-60,40,44,84,158
130,20,110,37,47,84,146
90,-40,-40,36,48,84,122
40,-60,-60,39,45,84,150
-180,40,100,37,47,84,135
30,-60,-50,37,47,84,158
60,50,-170,44,40,84,129
130,-50,30,42,42,84,93
180,40,100,37,47,84,135
80,-40,-50,37,47,84,122
110,-40,10,38,46,84,107
160,40,90,44,40,84,98
60,40,-150,39,45,84,134
-170,70,70,46,38,84,126
120,-60,20,40,44,84,105
100,-50,0,43,41,84,109
30,-50,-80,39,45,84,149
140,30,100,43,41,84,96
50,80,-160,40,44,84,108
140,-50,70,45,40,85,140
110,70,130,46,39,85,142
80,-30,-10,40,45,85,114
20,-40,-60,42,43,85,167
110,-70,40,43,42,85,155
130,-60,60,44,41,85,140
-20,70,-80,41,44,85,115
160,-40,90,44,41,85,155
120,-30,40,45,40,85,115
110,40,170,40,45,85,166
40,70,-150,39,47,86,137
20,-30,-90,41,45,86,123
150,30,130,40,46,86,106
40,-70,-50,39,47,86,153
110,40,150,43,43,86,161
150,-10,80,43,43,86,103
70,40,-160,42,44,86,150
130,40,140,40,46,86,138
90,-50,30,44,42,86,118
10,40,-80,41,45,86,141
20,-10,-90,39,47,86,136
160,-70,70,43,43,86,137
90,40,150,41,45,86,153
120,-40,70,46,40,86,101
160,-30,90,41,45,86,142
20,-20,-70,40,46,86,161
140,-50,80,45,42,87,135
150,80,100,44,43,87,118
110,-60,10,38,49,87,124
-180,90,70,44,43,87,111
50,90,-160,44,43,87,111
-170,70,110,39,48,87,131
100,90,150,44,43,87,111
80,90,170,44,43,87,111
30,90,-140,44,43,87,111
180,90,70,44,43,87,111
60,20,-130,45,42,87,138
-20,60,-80,47,40,87,131
-30,90,-80,44,43,87,111
-120,90,10,44,43,87,111
90,-70,20,43,44,87,153
10,90,-120,44,43,87,111
-150,90,40,44,43,87,111
110,90,140,44,43,87,111
-60,90,-50,44,43,87,111
-40,90,-70,44,43,87,111
-10,90,-100,44,43,87,111
50,60,-160,39,48,87,138
60,20,-120,45,42,87,125
-20,90,-90,44,43,87,111
-80,90,-30,44,43,87,111
90,90,160,44,43,87,111
-100,90,-10,44,43,87,111
-170,90,60,44,43,87,111
130,90,120,44,43,87,111
20,90,-130,44,43,87,111
0,90,-110,44,43,87,111
-110,90,0,44,43,87,111
150,90,100,44,43,87,111
120,-10,90,40,47,87,165
110,50,130,43,44,87,122
-90,90,-20,44,43,87,111
-140,90,30,44,43,87,111
60,90,-170,44,43,87,111
70,90,-180,44,43,87,111
70,90,180,44,43,87,111
-160,90,50,44,43,87,111
170,90,80,44,43,87,111
120,90,130,44,43,87,111
160,90,90,44,43,87,111
-70,90,-40,44,43,87,111
-130,90,20,44,43,87,111
140,90,110,44,43,87,111
-50,90,-60,44,43,87,111
40,90,-150,44,43,87,111
100,-30,40,42,45,87,123
30,30,-130,43,45,88,112
140,-10,110,39,49,88,117
30,50,-90,40,48,88,131
160,80,90,46,42,88,118
-30,70,-70,44,44,88,121
180,80,120,43,45,88,120
40,80,-150,40,48,88,111
70,-70,0,44,44,88,163
140,-40,60,40,48,88,194
140,20,120,42,46,88,128
100,40,140,44,44,88,163
0,40,-80,43,45,88,108
90,-60,-10,42,46,88,119
70,50,170,44,44,88,128
-180,80,120,43,45,88,120
-130,80,60,44,44,88,138
160,-60,80,44,44,88,146
60,10,-120,41,47,88,110
40,30,-140,41,47,88,114
40,60,-100,40,48,88,129
50,-40,-30,39,49,88,129
-170,80,110,43,46,89,128
-30,80,-40,44,45,89,136
160,60,140,44,45,89,125
130,10,110,47,42,89,164
180,50,90,44,45,89,141
120,-70,50,46,43,89,163
80,-30,10,42,47,89,112
70,70,-130,47,42,89,103
0,60,-70,46,43,89,135
140,0,80,41,48,89,109
-180,50,90,44,45,89,141
170,80,130,44,46,90,114
-70,90,10,41,49,90,144
120,-20,70,43,47,90,151
110,90,-170,41,49,90,144
150,-70,70,42,48,90,154
-40,90,-20,41,49,90,144
-80,90,20,41,49,90,144
-120,90,60,41,49,90,144
100,90,-160,41,49,90,144
170,90,130,41,49,90,144
-130,90,70,41,49,90,144
-160,90,100,41,49,90,144
-150,70,80,43,47,90,141
30,90,-90,41,49,90,144
160,-40,100,47,43,90,152
100,-60,0,41,49,90,128
180,90,120,41,49,90,144
20,90,-80,41,49,90,144
-150,90,90,41,49,90,144
70,90,-130,41,49,90,144
150,90,150,41,49,90,144
-110,90,50,41,49,90,144
170,50,90,41,49,90,130
130,90,170,41,49,90,144
30,-40,-50,39,51,90,134
0,20,-90,48,42,90,122
-170,90,110,41,49,90,144
40,0,-100,41,49,90,166
170,30,120,43,47,90,117
60,-70,-10,43,47,90,166
-60,90,0,41,49,90,144
-90,90,30,41,49,90,144
50,90,-110,41,49,90,144
10,90,-70,41,49,90,144
-140,90,80,41,49,90,144
40,-40,-80,43,47,90,151
80,90,-140,41,49,90,144
0,90,-60,41,49,90,144
140,90,160,41,49,90,144
160,90,140,41,49,90,144
-30,90,-30,41,49,90,144
70,-50,-50,36,54,90,115
90,90,-150,41,49,90,144
-180,90,120,41,49,90,144
-50,80,-20,44,46,90,144
-50,90,-10,41,49,90,144
-10,90,-50,41,49,90,144
40,90,-100,41,49,90,144
120,90,-180,41,49,90,144
90,70,150,48,42,90,144
50,80,-110,44,46,90,114
-70,80,0,44,46,90,141
120,90,180,41,49,90,144
-100,90,40,41,49,90,144
-20,90,-40,41,49,90,144
60,90,-120,41,49,90,144
100,-40,0,44,47,91,119
40,50,-100,39,52,91,137
160,10,120,47,44,91,115
-170,60,100,43,48,91,150
40,30,-100,44,47,91,116
20,30,-90,44,47,91,144
120,-40,20,47,44,91,120
40,-60,-30,42,49,91,167
170,-40,100,47,44,91,172
110,40,120,43,48,91,149
110,40,160,44,47,91,168
60,-50,-10,40,51,91,153
40,-30,-50,41,50,91,136
150,70,100,48,43,91,142
170,0,90,48,43,91,104
170,60,130,45,46,91,126
90,-30,20,46,45,91,135
20,-50,-70,42,49,91,174
-10,70,-60,44,47,91,135
-20,60,-70,48,44,92,126
150,-50,60,45,47,92,149
140,-40,90,50,42,92,127
100,70,140,49,43,92,143
140,40,100,46,46,92,105
100,40,180,42,50,92,174
170,80,80,46,46,92,118
20,20,-120,47,45,92,155
20,50,-80,41,51,92,139
30,-70,-50,39,53,92,157
30,-70,-60,43,49,92,173
100,40,-180,42,50,92,174
130,-30,60,39,53,92,138
-40,80,-30,45,47,92,144
20,-10,-80,44,48,92,162
-60,80,-10,45,47,92,146
130,-70,60,49,44,93,171
110,50,-180,44,49,93,156
30,-60,-70,43,50,93,176
40,80,-100,46,47,93,117
40,70,-100,47,46,93,121
120,0,100,44,49,93,184
20,60,-80,41,52,93,141
150,50,100,41,52,93,132
140,-40,50,49,44,93,153
80,-50,-40,35,58,93,143
120,70,120,49,44,93,142
70,-40,-60,38,55,93,134
-80,80,10,44,49,93,142
180,-20,110,51,42,93,169
-180,-20,110,51,42,93,169
40,-10,-80,44,49,93,158
110,-30,30,51,42,93,137
-40,70,-60,46,47,93,125
110,50,180,44,49,93,156
60,70,-120,47,46,93,115
170,-70,80,46,48,94,160
150,40,140,47,47,94,128
120,30,130,40,54,94,160
130,-30,40,47,47,94,120
10,0,-100,49,45,94,149
90,-30,-40,48,46,94,141
120,-30,50,46,48,94,148
150,-60,80,48,46,94,177
-10,40,-80,46,48,94,103
80,-30,-50,49,45,94,132
-160,70,60,51,43,94,135
-90,80,20,45,49,94,143
50,0,-130,46,48,94,125
140,-60,70,49,45,94,164
180,60,120,45,49,94,138
50,-30,-80,46,48,94,137
20,-60,-70,41,53,94,195
50,-70,-20,47,47,94,171
20,-50,-60,43,51,94,172
-180,60,120,45,49,94,138
30,-60,-40,41,54,95,178
-10,50,-90,49,46,95,139
110,-40,60,51,44,95,120
-160,80,100,43,52,95,140
130,0,80,45,50,95,134
120,40,110,46,49,95,160
40,-20,-100,46,49,95,150
80,70,160,50,45,95,146
-180,50,110,45,50,95,156
10,-10,-90,46,49,95,158
60,-60,-10,43,52,95,155
120,40,150,45,50,95,188
50,70,-110,48,47,95,120
90,40,-170,46,49,95,180
110,-30,20,52,43,95,132
30,80,-140,45,50,95,122
80,40,160,48,47,95,163
180,50,110,45,50,95,156
100,-80,20,47,49,96,161
30,-20,-90,41,55,96,152
160,-70,80,46,50,96,170
80,-80,0,45,51,96,166
120,-50,70,49,47,96,146
10,-40,-80,46,50,96,192
110,-80,30,46,50,96,161
-120,80,50,48,48,96,146
-30,70,-50,44,52,96,133
50,0,-110,47,49,96,155
140,50,100,46,50,96,132
80,-30,-40,47,49,96,135
70,-50,10,45,51,96,136
90,-80,10,46,50,96,162
100,-30,10,48,48,96,118
40,-70,-30,47,49,96,187
70,-80,-10,46,50,96,163
30,80,-90,47,49,96,130
-180,40,90,45,52,97,127
-180,80,70,48,49,97,123
30,0,-90,39,58,97,166
-180,50,100,50,47,97,158
150,-50,70,48,49,97,172
150,-50,80,51,46,97,165
180,40,90,45,52,97,127
180,50,100,50,47,97,158
170,50,130,49,48,97,139
130,60,170,45,52,97,114
30,-50,-40,46,51,97,190
180,0,110,49,48,97,164
-180,-70,90,48,49,97,187
140,-70,70,52,45,97,187
60,10,-140,51,46,97,162
110,-50,60,50,47,97,152
60,40,-140,46,51,97,151
-180,0,110,49,48,97,164
140,-60,40,42,55,97,127
70,-30,-40,47,50,97,136
180,80,70,48,49,97,123
-180,60,80,53,44,97,140
180,60,80,53,44,97,140
130,0,110,52,45,97,178
90,30,170,47,50,97,199
70,-50,20,50,47,97,149
180,-70,90,48,49,97,187
40,40,-100,49,48,97,109
-10,50,-70,49,48,97,123
0,-30,-90,50,48,98,200
40,-50,-30,46,52,98,174
120,-80,40,48,50,98,165
170,-30,110,49,49,98,170
90,-40,-30,43,55,98,139
90,30,180,45,53,98,196
70,40,170,49,49,98,167
50,-60,-20,47,51,98,163
90,30,-180,45,53,98,196
50,-50,-70,40,58,98,136
50,40,-150,50,48,98,155
30,70,-90,49,49,98,136
60,20,-140,50,48,98,162
140,-50,40,48,50,98,134
100,50,-170,45,53,98,159
-40,70,-50,48,50,98,135
160,-10,120,50,49,99,165
60,40,-160,49,50,99,174
30,20,-130,50,49,99,142
140,10,120,47,52,99,152
-180,40,110,46,53,99,162
130,70,110,51,48,99,155
-180,20,100,50,49,99,129
180,20,100,50,49,99,129
100,40,130,50,49,99,167
20,-70,-60,44,55,99,170
-150,70,60,53,46,99,136
-100,80,30,46,53,99,145
160,-30,110,51,48,99,162
0,30,-80,48,51,99,139
80,-30,-20,50,49,99,137
180,40,110,46,53,99,162
-20,60,-60,51,49,100,136
-110,80,40,48,52,100,141
80,-50,-30,38,62,100,154
-10,40,-90,50,50,100,141
160,60,90,51,49,100,138
170,20,120,48,52,100,144
30,-70,-40,46,54,100,201
90,-40,-20,42,58,100,148
-170,60,90,50,50,100,149
130,60,110,47,53,100,143
30,0,-120,49,51,100,163
40,-60,-70,45,55,100,162
60,-20,-80,50,50,100,164
170,-10,120,53,47,100,182
160,-60,90,53,47,100,192
160,30,130,48,52,100,157
120,30,110,46,55,101,181
110,50,120,46,55,101,159
180,30,100,49,52,101,125
50,-10,-90,49,52,101,187
160,-50,90,50,51,101,185
10,-10,-80,49,52,101,172
150,-50,50,45,56,101,150
-180,50,120,45,56,101,153
180,50,120,45,56,101,153
-180,30,100,49,52,101,125
-150,80,90,46,55,101,154
150,-50,90,49,52,101,173
60,-80,-20,46,56,102,173
170,-60,90,48,54,102,185
170,20,90,45,57,102,152
10,-40,-90,51,51,102,195
90,50,-160,54,48,102,170
80,30,180,46,56,102,177
40,-20,-90,46,56,102,169
110,-30,10,51,51,102,143
10,0,-90,51,51,102,146
150,0,80,51,51,102,135
120,-60,60,56,46,102,165
20,-60,-60,47,55,102,177
10,-60,-60,51,51,102,208
-30,60,-70,53,49,102,160
80,30,-180,46,56,102,177
120,-80,30,46,57,103,182
100,-30,20,52,51,103,136
180,-10,120,52,51,103,193
170,10,90,54,49,103,132
20,-30,-60,48,55,103,183
60,50,-130,52,51,103,150
130,-50,80,54,49,103,152
120,40,160,45,58,103,193
130,-60,70,54,49,103,171
-180,-10,120,52,51,103,193
20,70,-80,50,53,103,144
20,-60,-50,49,54,103,201
130,-80,50,50,54,104,178
100,-30,30,56,48,104,143
170,-50,100,56,48,104,194
-140,70,60,53,51,104,136
160,70,90,54,50,104,154
-160,70,100,45,59,104,159
20,80,-80,50,54,104,146
0,10,-90,55,49,104,168
50,-50,-20,47,57,104,184
50,-60,-60,44,60,104,151
30,-10,-80,47,57,104,178
20,-70,-50,51,53,104,208
110,-70,10,47,57,104,195
90,30,160,50,54,104,211
160,50,140,53,51,104,166
150,-70,80,57,47,104,207
100,-60,40,54,50,104,155
0,50,-70,50,54,104,157
60,-30,-40,51,53,104,161
0,-20,-80,53,51,104,202
40,60,-150,46,58,104,182
120,10,100,51,54,105,202
100,50,130,51,54,105,163
-170,-70,100,52,53,105,220
30,-30,-90,53,52,105,158
140,-60,80,57,48,105,187
30,70,-140,48,57,105,171
140,-80,60,49,56,105,189
0,-10,-90,53,52,105,165
170,-30,100,51,54,105,201
10,-50,-60,49,56,105,224
50,50,-160,46,59,105,183
10,-40,-70,49,56,105,202
10,-30,-70,49,56,105,208
-170,80,60,52,53,105,136
70,70,170,51,54,105,161
50,-20,-90,51,54,105,148
110,-80,20,45,60,105,191
20,-40,-90,48,57,105,216
170,-50,90,52,53,105,200
-170,60,110,48,57,105,163
60,0,-130,49,57,106,171
50,-80,-30,49,57,106,181
-180,10,110,53,53,106,174
170,-40,110,58,48,106,188
-180,10,100,51,55,106,149
110,-30,60,55,51,106,163
20,-10,-100,56,50,106,153
170,-40,90,49,57,106,199
-180,30,110,49,57,106,160
180,30,110,49,57,106,160
-160,80,50,56,50,106,142
150,-80,70,49,57,106,198
110,-60,50,58,48,106,157
160,-50,80,51,55,106,182
100,-80,10,44,62,106,200
20,-50,-50,50,56,106,209
50,10,-140,52,54,106,149
10,-50,-80,51,55,106,217
10,-50,-70,48,58,106,196
130,-40,30,55,51,106,137
180,10,100,51,55,106,149
180,10,110,53,53,106,174
180,20,110,49,58,107,174
20,80,-130,50,57,107,137
100,-70,0,50,57,107,192
160,50,90,46,61,107,161
120,-70,20,48,59,107,186
90,-30,-30,53,54,107,126
100,-40,50,50,57,107,157
-180,20,110,49,58,107,174
10,-70,-60,51,56,107,214
-140,80,80,50,58,108,172
170,30,90,53,55,108,161
-170,60,80,59,49,108,156
140,20,90,52,56,108,131
70,-30,-70,50,58,108,197
30,10,-90,49,59,108,189
40,-80,-40,49,59,108,182
60,60,-180,46,62,108,166
70,30,180,51,57,108,182
10,80,-70,52,56,108,163
0,-40,-90,55,53,108,213
160,-40,80,51,57,108,192
-140,70,70,53,55,108,162
90,60,140,56,52,108,139
60,60,180,46,62,108,166
120,60,180,49,59,108,142
60,-60,-50,50,58,108,169
70,30,-180,51,57,108,182
120,60,-180,49,59,108,142
10,-60,-70,50,58,108,203
10,-60,-80,50,58,108,223
60,-40,-10,47,61,108,176
160,-70,90,56,52,108,230
80,30,170,56,53,109,188
-50,70,-40,54,55,109,146
120,0,80,54,55,109,197
60,50,-180,49,60,109,168
-150,80,40,56,53,109,143
170,-60,80,48,61,109,166
150,-40,100,59,50,109,169
130,30,140,56,53,109,187
0,-70,-80,52,57,109,210
50,40,-110,53,56,109,140
10,-70,-70,51,58,109,194
0,-10,-80,56,53,109,194
60,50,180,49,60,109,168
90,50,140,50,59,109,157
-20,50,-70,57,53,110,133
80,30,-170,52,58,110,196
10,-50,-90,54,56,110,199
150,-80,60,49,61,110,187
170,-20,120,59,51,110,190
80,-60,20,57,53,110,166
150,-60,90,58,52,110,198
120,-10,70,54,56,110,185
60,0,-120,55,55,110,163
160,-80,80,51,59,110,214
170,-60,100,55,55,110,214
110,30,130,49,61,110,209
30,40,-90,52,58,110,151
40,0,-130,56,54,110,161
140,70,100,56,54,110,169
90,-70,-10,53,57,110,191
70,-30,10,57,53,110,102
90,-60,30,57,53,110,158
130,-30,90,50,60,110,171
140,-40,40,55,55,110,165
70,30,-170,53,57,110,186
50,60,-110,50,60,110,167
170,0,120,57,53,110,190
60,-40,0,50,60,110,174
60,-40,-70,53,58,111,164
60,20,-110,53,58,111,182
80,60,150,56,55,111,166
60,10,-110,56,55,111,154
-50,70,-50,55,56,111,151
90,40,140,54,57,111,181
70,50,-140,56,55,111,192
120,10,90,56,55,111,208
-180,-40,110,58,53,111,197
80,-30,-60,50,61,111,174
110,60,-170,52,59,111,171
50,-10,-80,50,61,111,152
80,-30,-30,47,64,111,162
20,-60,-40,53,58,111,249
0,-60,-70,55,56,111,217
180,-40,110,58,53,111,197
90,-80,0,45,66,111,204
160,30,90,57,55,112,170
50,50,-110,53,59,112,177
60,-20,-90,56,56,112,155
130,-30,50,55,57,112,192
-20,50,-80,60,52,112,170
60,30,-140,56,56,112,190
0,-50,-70,54,58,112,220
40,0,-90,46,66,112,228
80,-80,10,55,57,112,209
0,-50,-80,54,58,112,233
0,-50,-90,56,56,112,243
60,30,-130,54,58,112,188
-140,80,30,58,54,112,147
100,-30,0,55,57,112,145
40,-80,-30,54,58,112,217
-170,70,120,54,58,112,147
-130,70,50,55,57,112,147
160,-50,100,58,54,112,213
100,-80,30,54,58,112,211
60,40,-130,55,57,112,194
170,-70,90,55,57,112,197
90,-80,20,53,59,112,209
180,-80,90,53,60,113,217
50,-80,-20,55,58,113,213
-140,70,50,57,56,113,157
90,-30,-20,54,59,113,148
110,-80,40,55,58,113,217
180,-80,100,55,58,113,220
-180,0,100,58,55,113,164
170,40,130,54,59,113,150
150,-60,50,50,63,113,166
30,-60,-80,50,63,113,191
-180,-80,100,55,58,113,220
140,-50,90,63,50,113,179
-110,-80,170,56,57,113,230
-180,-80,90,53,60,113,217
130,-80,40,49,64,113,180
30,-80,-50,52,61,113,190
50,-10,-100,50,63,113,196
180,0,100,58,55,113,164
30,-80,-40,54,60,114,219
110,30,120,54,60,114,193
20,-70,-70,49,65,114,206
130,20,120,50,64,114,193
-180,-10,100,54,60,114,203
170,-80,80,53,61,114,205
20,70,-130,54,60,114,199
30,20,-90,56,58,114,161
40,-20,-60,44,70,114,173
-10,60,-60,55,59,114,170
140,30,140,50,64,114,168
140,-80,50,50,64,114,175
140,-70,40,47,67,114,175
180,-10,100,54,60,114,203
-40,70,-40,55,59,114,164
10,-40,-60,51,63,114,227
10,30,-80,55,59,114,198
60,40,-170,59,55,114,177
60,-80,-10,56,58,114,212
140,-20,70,60,54,114,167
130,-70,30,47,67,114,172
60,30,-120,60,55,115,183
170,-80,90,55,60,115,224
-180,-50,110,61,54,115,222
-30,60,-60,61,54,115,167
-180,-60,110,59,56,115,240
170,70,80,56,59,115,182
180,-60,110,59,56,115,240
180,-50,110,61,54,115,222
50,-30,-40,64,51,115,192
0,-40,-80,57,58,115,225
50,-20,-60,46,69,115,157
-10,-20,-90,57,58,115,198
70,-80,0,57,58,115,211
160,-80,70,52,63,115,198
10,80,-120,52,63,115,155
20,-80,-50,54,61,115,219
80,50,150,62,53,115,165
140,-30,100,54,61,115,169
50,-80,-40,52,63,115,222
20,0,-110,57,58,115,208
80,50,-150,60,56,116,187
0,-60,-80,53,63,116,225
70,40,-150,62,54,116,202
-130,80,20,58,58,116,145
-150,70,90,51,65,116,183
-130,80,70,55,61,116,186
120,-80,50,58,58,116,226
170,-10,90,58,58,116,164
80,-50,30,55,61,116,175
180,-30,110,56,60,116,209
-180,-30,110,56,60,116,209
170,-70,100,60,56,116,236
-120,80,60,54,62,116,190
-20,70,-50,53,63,116,172
60,-60,-60,46,70,116,186
10,-80,-60,55,61,116,231
20,-60,-80,55,61,116,206
20,10,-120,56,60,116,188
150,50,150,57,59,116,208
100,-50,50,61,55,116,167
20,-70,-40,57,59,116,273
130,40,150,57,59,116,235
10,-60,-50,54,62,116,248
80,40,-160,58,58,116,208
20,-80,-60,54,62,116,206
90,-50,40,59,57,116,177
50,10,-100,61,55,116,205
20,-50,-90,60,56,116,188
60,-20,-60,53,63,116,163
160,0,120,57,59,116,188
40,-70,-20,57,60,117,257
120,20,120,49,68,117,238
-180,-50,100,59,58,117,220
-120,80,10,61,56,117,152
0,-70,-70,56,61,117,226
70,-80,-20,49,68,117,210
90,-30,30,61,56,117,157
0,30,-100,55,62,117,155
-180,-60,100,59,58,117,214
30,10,-130,55,62,117,185
-180,-70,100,57,60,117,222
170,10,120,58,59,117,190
140,40,150,53,64,117,226
80,-80,-10,50,67,117,207
0,-30,-80,58,59,117,226
180,-70,100,57,60,117,222
180,-50,100,59,58,117,220
30,-70,-30,57,60,117,262
60,30,-150,56,61,117,198
-120,-80,160,58,59,117,245
100,60,130,61,56,117,160
130,-80,60,60,57,117,233
180,-60,100,59,58,117,214
160,-50,70,53,64,117,211
-60,-90,-140,54,64,118,218
90,-20,10,62,56,118,177
40,-90,-40,54,64,118,218
-140,-90,140,54,64,118,218
50,0,-100,54,64,118,238
-40,-90,-120,54,64,118,218
-180,-90,100,54,64,118,218
10,20,-80,58,60,118,205
180,-30,120,60,58,118,206
-130,-90,150,54,64,118,218
-80,-90,-160,54,64,118,218
20,-90,-60,54,64,118,218
160,-90,80,54,64,118,218
-170,-90,110,54,64,118,218
-160,-90,120,54,64,118,218
-100,-90,-180,54,64,118,218
80,-30,20,59,59,118,150
60,-90,-20,54,64,118,218
90,-90,10,54,64,118,218
70,-90,-10,54,64,118,218
0,-90,-80,54,64,118,218
140,-90,60,54,64,118,218
50,-90,-30,54,64,118,218
0,10,-100,57,61,118,174
170,-90,90,54,64,118,218
130,-90,50,54,64,118,218
10,-90,-70,54,64,118,218
150,-40,70,56,62,118,214
-50,-90,-130,54,64,118,218
100,-90,20,54,64,118,218
180,-90,100,54,64,118,218
-30,-90,-110,54,64,118,218
-120,-90,160,54,64,118,218
-10,-60,-80,60,58,118,234
30,-90,-50,54,64,118,218
-90,-90,-170,54,64,118,218
-70,-90,-150,54,64,118,218
-20,-90,-100,54,64,118,218
-10,-90,-90,54,64,118,218
110,-90,30,54,64,118,218
-100,-90,180,54,64,118,218
80,-90,0,54,64,118,218
60,-80,-30,52,66,118,220
80,-50,-50,46,72,118,174
-10,-40,-90,59,59,118,242
-150,-90,130,54,64,118,218
-180,-30,120,60,58,118,206
-10,-30,-90,59,59,118,221
-110,-90,170,54,64,118,218
150,-90,70,54,64,118,218
120,-90,40,54,64,118,218
0,40,-70,54,65,119,194
-120,70,40,57,62,119,159
80,-70,-20,57,62,119,197
160,-40,110,64,55,119,214
-170,-80,110,60,59,119,234
180,-20,120,60,59,119,201
70,-60,10,57,62,119,187
70,-30,-10,53,66,119,198
-140,70,80,52,67,119,208
0,20,-80,60,59,119,192
-90,-80,-170,59,60,119,253
120,30,140,56,63,119,246
-160,-70,110,60,59,119,234
30,-60,-30,59,60,119,240
100,30,170,54,65,119,233
-180,-20,120,60,59,119,201
40,-80,-50,52,67,119,225
-170,-10,110,65,54,119,210
-170,50,100,60,59,119,197
-10,40,-70,58,62,120,166
-160,-80,120,60,60,120,240
-170,50,90,63,57,120,188
80,-40,30,59,61,120,171
-150,-80,130,61,59,120,245
0,80,-110,54,66,120,167
10,0,-80,57,63,120,203
-130,70,60,59,61,120,172
70,-60,-40,54,66,120,198
-140,-80,140,61,59,120,250
20,-40,-50,56,64,120,229
-100,-80,180,60,60,120,244
80,40,150,62,58,120,194
-10,-50,-80,63,57,120,225
80,30,160,58,62,120,221
-10,-10,-90,60,60,120,209
50,-60,-70,51,69,120,197
30,-20,-60,55,65,120,197
170,60,80,61,59,120,172
-100,-80,-180,60,60,120,244
10,-20,-70,56,64,120,217
30,30,-90,56,64,120,192
60,-50,0,57,63,120,194
-170,-80,100,54,66,120,240
-110,80,50,54,66,120,203
180,70,130,61,60,121,155
-60,70,-30,61,60,121,154
-10,30,-80,57,64,121,140
120,20,110,52,69,121,233
-130,-80,150,61,60,121,245
-160,70,110,57,64,121,163
-170,-70,110,61,60,121,240
140,-80,70,61,60,121,245
-80,70,-10,60,61,121,171
0,80,-60,57,64,121,188
-180,70,130,61,60,121,155
180,40,120,54,67,121,177
100,30,160,53,68,121,244
160,40,140,60,61,121,167
-150,70,50,63,58,121,151
-180,40,120,54,67,121,177
160,-20,120,60,61,121,209
110,-20,30,63,58,121,190
40,-50,-80,57,64,121,196
70,-70,-30,58,64,122,185
50,-20,-100,57,65,122,173
-100,80,40,56,66,122,214
100,-30,-30,60,62,122,157
120,-30,20,61,61,122,168
-60,70,-40,63,59,122,170
40,20,-140,59,63,122,168
150,30,140,55,67,122,181
10,20,-110,62,60,122,179
-10,-50,-90,62,60,122,250
10,-80,-70,56,66,122,213
0,-40,-70,59,63,122,236
130,10,120,60,62,122,253
70,-30,-20,59,63,122,188
120,50,110,61,61,122,186
140,60,100,57,65,122,181
70,-70,10,57,65,122,251
100,60,-160,60,63,123,194
-170,0,110,66,57,123,241
90,60,-150,64,59,123,185
170,70,140,63,60,123,160
-10,-70,-80,59,64,123,245
180,70,70,61,62,123,195
30,-80,-60,52,71,123,235
-130,70,40,62,61,123,175
0,-50,-60,59,64,123,236
-10,80,-100,56,67,123,181
-180,70,70,61,62,123,195
10,-70,-50,60,63,123,270
10,70,-70,62,61,123,179
150,-40,60,56,67,123,250
-50,70,-30,60,63,123,176
0,60,-110,65,59,124,197
80,-70,20,59,65,124,239
-70,70,-20,59,65,124,166
180,50,80,62,62,124,182
40,50,-150,56,68,124,226
160,-60,60,54,70,124,199
50,-70,-10,60,64,124,255
0,-80,-70,59,65,124,243
50,-70,-50,57,67,124,202
-180,50,80,62,62,124,182
-170,-20,120,61,63,124,209
0,70,-60,58,66,124,206
-40,60,-60,63,61,124,196
100,-70,40,65,59,124,225
70,-50,-60,49,75,124,181
-170,60,120,64,60,124,162
90,-20,0,65,60,125,171
-120,70,30,59,66,125,197
0,-80,-80,57,68,125,226
60,70,-180,58,67,125,186
-170,50,110,57,68,125,189
170,-50,80,54,71,125,236
0,-60,-60,61,64,125,265
-10,-70,-90,61,64,125,233
60,70,180,58,67,125,186
110,-20,40,65,60,125,188
-170,50,80,67,58,125,187
60,60,-120,60,65,125,182
-10,-80,-80,61,64,125,242
150,0,120,62,63,125,171
110,-70,50,66,59,125,217
90,-40,40,58,67,125,166
10,-70,-80,57,69,126,232
60,-70,0,60,66,126,262
10,50,-70,56,70,126,188
150,20,130,59,67,126,197
10,60,-120,64,62,126,204
180,-20,100,63,63,126,242
-170,-40,120,68,58,126,235
150,-80,80,62,64,126,255
-10,-60,-90,63,63,126,248
-160,-70,120,65,61,126,263
-20,80,-90,59,67,126,187
-160,-80,110,58,68,126,246
30,60,-140,60,66,126,222
-170,-60,110,67,59,126,251
-10,30,-90,56,70,126,187
130,30,100,62,64,126,184
-180,-20,100,63,63,126,242
-80,70,0,62,65,127,186
-110,80,0,64,63,127,153
0,-60,-90,62,65,127,256
-10,80,-50,61,66,127,201
-110,70,30,62,65,127,165
0,-30,-70,62,65,127,237
10,-50,-50,61,66,127,262
120,-20,60,63,64,127,190
90,-70,30,63,64,127,230
60,-70,-40,62,65,127,205
120,20,130,54,73,127,236
-10,-40,-80,67,60,127,246
70,10,-130,67,60,127,208
70,-20,-70,61,66,127,214
120,10,110,60,67,127,284
-80,-90,-150,61,67,128,256
30,-90,-40,61,67,128,256
-110,-90,-180,61,67,128,256
70,-90,0,61,67,128,256
-180,-70,110,64,64,128,274
180,-60,90,59,69,128,209
-160,60,90,64,64,128,190
50,-90,-20,61,67,128,256
-170,60,70,72,56,128,198
-150,-90,140,61,67,128,256
-10,-90,-80,61,67,128,256
180,0,120,61,67,128,216
-30,-90,-100,61,67,128,256
90,-90,20,61,67,128,256
10,60,-70,63,65,128,187
-50,-90,-120,61,67,128,256
140,-90,70,61,67,128,256
-40,-90,-110,61,67,128,256
-100,-90,-170,61,67,128,256
150,-90,80,61,67,128,256
-70,-90,-140,61,67,128,256
10,-60,-90,60,68,128,262
-160,-90,130,61,67,128,256
180,-70,110,64,64,128,274
140,20,130,57,71,128,226
170,-90,100,61,67,128,256
-170,-90,120,61,67,128,256
30,-10,-70,60,68,128,196
80,60,-140,67,61,128,192
-150,-70,120,64,64,128,256
110,-90,40,61,67,128,256
-170,-30,120,68,60,128,221
-20,-50,-90,67,61,128,231
70,50,160,64,64,128,187
-180,0,120,61,67,128,216
-180,-90,110,61,67,128,256
20,-50,-40,59,69,128,263
-20,-90,-90,61,67,128,256
180,30,90,65,63,128,173
-120,-90,170,61,67,128,256
160,-90,90,61,67,128,256
60,-90,-10,61,67,128,256
40,-90,-30,61,67,128,256
100,-90,30,61,67,128,256
70,-60,-50,53,75,128,192
180,-90,110,61,67,128,256
-90,-90,-160,61,67,128,256
80,-90,10,61,67,128,256
-30,60,-50,62,66,128,186
-180,30,90,65,63,128,173
130,-90,60,61,67,128,256
-60,-90,-130,61,67,128,256
10,-90,-60,61,67,128,256
120,-90,50,61,67,128,256
-140,-90,150,61,67,128,256
-130,-90,160,61,67,128,256
20,-90,-50,61,67,128,256
-180,-60,90,59,69,128,209
0,-90,-70,61,67,128,256
-110,-90,180,61,67,128,256
50,20,-100,61,68,129,205
-10,-50,-70,62,67,129,238
160,-60,100,69,60,129,236
110,80,130,63,66,129,208
140,0,120,60,69,129,211
70,60,-130,65,64,129,194
-150,-70,130,67,62,129,286
50,-10,-120,65,64,129,179
-70,70,-30,64,65,129,182
-90,80,30,59,70,129,228
30,-50,-30,64,65,129,247
170,-80,100,61,68,129,261
-70,70,-10,60,69,129,178
-150,-80,120,61,68,129,253
-10,-50,-100,65,64,129,278
-170,-50,110,68,62,130,244
90,-30,-50,65,65,130,193
100,-30,-10,60,70,130,178
160,-50,60,64,66,130,202
150,-50,100,70,60,130,227
50,30,-150,66,64,130,196
120,80,120,64,66,130,213
60,40,-180,61,69,130,200
-20,70,-90,69,61,130,208
120,40,170,57,73,130,245
170,-50,110,71,59,130,228
-20,-80,-90,66,64,130,248
-120,70,50,64,66,130,197
-80,-80,-160,64,66,130,273
60,40,180,61,69,130,200
160,-80,90,64,66,130,253
-160,60,80,71,59,130,190
0,10,-80,67,63,130,215
70,30,170,61,69,130,211
20,-10,-70,64,66,130,242
40,-60,-20,61,69,130,257
40,-10,-70,57,73,130,201
-40,60,-50,67,64,131,200
0,0,-90,68,63,131,214
90,-80,30,63,68,131,294
60,-60,0,62,69,131,224
70,-30,-30,59,72,131,194
0,20,-100,64,67,131,189
-40,-80,-110,66,65,131,267
-30,70,-40,62,69,131,213
-170,-20,110,68,63,131,218
30,-30,-50,56,75,131,205
-130,-70,150,68,63,131,284
10,70,-120,64,67,131,220
0,0,-80,68,63,131,232
-70,-80,-150,63,68,131,277
20,-80,-70,57,74,131,258
70,10,-140,63,68,131,221
100,-30,50,63,68,131,187
120,-30,80,65,66,131,234
-20,-60,-90,68,63,131,251
-140,-70,140,69,62,131,286
70,-40,20,61,70,131,168
10,10,-80,68,63,131,228
-10,-40,-70,64,67,131,253
100,-20,10,66,66,132,193
-170,-50,120,70,62,132,258
-90,70,10,67,65,132,192
-10,-80,-90,60,72,132,248
130,20,130,57,75,132,227
60,30,-160,66,66,132,243
-120,-70,160,65,67,132,274
-50,-80,-130,62,70,132,269
180,10,120,66,66,132,228
-30,80,-80,60,72,132,202
110,-20,20,71,61,132,217
130,-10,70,61,71,132,198
-180,10,120,66,66,132,228
170,-60,70,59,73,132,215
100,80,140,62,70,132,203
60,-80,0,67,65,132,300
-70,-80,-140,68,64,132,276
50,-80,-10,64,68,132,301
70,-80,10,65,67,132,292
-80,80,20,60,72,132,230
-140,70,40,66,67,133,179
90,30,150,62,71,133,247
-10,20,-90,62,71,133,215
-30,80,-30,63,70,133,219
180,-40,100,65,68,133,222
90,-50,-20,57,76,133,215
80,-80,20,65,68,133,294
-60,70,-20,64,69,133,186
100,-20,20,70,63,133,216
40,-80,-20,64,69,133,298
-30,50,-70,67,66,133,215
-70,80,10,60,73,133,226
-150,70,100,62,71,133,195
160,70,150,62,71,133,198
-130,70,70,62,71,133,226
-20,-50,-80,70,63,133,257
-20,-80,-100,62,71,133,256
-60,80,0,59,74,133,229
120,-70,60,68,65,133,230
120,-20,30,71,62,133,185
40,-70,-60,59,74,133,229
-10,-60,-70,65,68,133,279
-180,-40,100,65,68,133,222
-30,-80,-100,67,66,133,261
100,-20,30,70,63,133,233
140,-30,60,59,75,134,261
-180,30,120,66,68,134,212
-170,-60,120,71,63,134,267
150,70,160,63,71,134,204
100,-40,-10,62,72,134,194
-110,70,40,67,67,134,195
-80,-80,-150,69,65,134,281
-20,50,-60,67,67,134,173
100,30,150,60,74,134,271
180,30,120,66,68,134,212
-10,-20,-80,73,61,134,239
10,-30,-60,60,74,134,263
-180,20,120,69,65,134,237
70,40,160,66,68,134,215
40,-10,-110,60,74,134,272
180,20,120,69,65,134,237
130,-70,70,69,65,134,238
-110,-70,170,67,67,134,296
-160,60,100,62,72,134,195
-10,70,-100,72,62,134,209
-20,40,-80,64,70,134,209
-10,60,-100,71,63,134,207
30,-80,-30,62,72,134,291
60,0,-140,65,70,135,208
130,40,160,59,76,135,277
-20,-70,-100,67,68,135,260
40,-10,-120,67,68,135,202
130,80,110,65,70,135,227
0,70,-110,64,71,135,208
50,40,-160,63,72,135,245
20,0,-80,59,76,135,242
-50,80,-10,58,77,135,229
-60,-80,-140,64,71,135,273
-60,-80,-130,70,65,135,276
-10,-50,-60,64,71,135,289
50,-60,-10,63,72,135,262
170,-20,90,67,68,135,227
0,-70,-60,65,70,135,295
-90,-80,-160,68,67,135,286
-170,-40,110,73,62,135,230
120,20,100,60,75,135,245
-50,-80,-120,72,64,136,273
-160,80,110,68,68,136,214
160,-30,80,78,58,136,252
110,30,140,61,75,136,276
-20,80,-40,64,72,136,224
-60,80,-50,59,77,136,194
50,-10,-70,62,74,136,225
70,-20,-60,68,68,136,195
180,-40,120,73,63,136,223
170,-30,120,69,67,136,227
-20,-40,-80,72,64,136,235
-160,60,70,71,65,136,220
150,-40,50,68,68,136,220
70,20,-130,67,69,136,245
-180,-40,120,73,63,136,223
-30,-80,-110,64,73,137,269
-170,80,120,68,69,137,210
80,-60,30,68,69,137,214
-20,-40,-90,74,63,137,248
-100,70,20,70,67,137,189
-100,80,-10,68,69,137,170
90,-50,-30,56,81,137,209
0,-50,-100,66,71,137,264
-40,70,-30,66,71,137,225
-40,80,-70,62,75,137,200
170,80,140,70,67,137,217
70,80,170,64,73,137,195
100,-20,0,68,70,138,182
90,80,150,67,71,138,204
100,30,130,65,73,138,277
140,-20,110,69,69,138,176
70,0,-130,67,71,138,224
130,-60,80,74,64,138,246
100,-30,-20,72,66,138,188
30,-20,-100,63,75,138,237
-50,80,-60,62,76,138,201
110,10,90,68,70,138,274
-10,-30,-80,68,70,138,256
-170,-10,120,69,69,138,243
150,70,90,70,68,138,206
60,20,-150,68,70,138,218
140,-70,80,70,68,138,260
150,80,160,67,71,138,228
-40,80,-20,65,73,138,231
120,-20,40,73,65,138,198
60,-30,-80,63,75,138,257
60,0,-110,72,66,138,219
-90,70,0,69,69,138,201
160,80,150,70,68,138,225
80,-20,0,72,66,138,181
-40,-80,-120,65,73,138,277
150,-30,70,66,73,139,270
-60,-90,-150,62,77,139,266
180,80,130,71,68,139,212
-10,-90,-100,62,77,139,266
180,-90,90,62,77,139,266
40,-90,-50,62,77,139,266
120,-60,70,79,60,139,232
150,-90,60,62,77,139,266
-110,-90,160,62,77,139,266
160,0,80,68,71,139,199
-180,-90,90,62,77,139,266
-30,-90,-120,62,77,139,266
-20,-50,-100,68,71,139,280
130,-90,40,62,77,139,266
-170,70,60,69,70,139,235
20,-80,-40,68,71,139,313
-20,-90,-110,62,77,139,266
100,-90,10,62,77,139,266
-120,-90,150,62,77,139,266
30,-90,-60,62,77,139,266
-20,-70,-90,70,69,139,277
110,-90,20,62,77,139,266
-180,80,130,71,68,139,212
170,-90,80,62,77,139,266
100,-80,40,66,73,139,300
120,-90,30,62,77,139,266
-130,-90,140,62,77,139,266
-150,-90,120,62,77,139,266
60,-90,-30,62,77,139,266
-100,-90,170,62,77,139,266
-170,-90,100,62,77,139,266
-80,-90,-170,62,77,139,266
50,-90,-40,62,77,139,266
70,-90,-20,62,77,139,266
-90,-90,180,62,77,139,266
160,-10,80,72,67,139,235
10,-90,-80,62,77,139,266
-100,-80,-170,71,68,139,297
40,-30,-90,66,73,139,271
-70,-90,-160,62,77,139,266
80,-90,-10,62,77,139,266
20,-90,-70,62,77,139,266
-40,-90,-130,62,77,139,266
140,-90,50,62,77,139,266
-140,-90,130,62,77,139,266
70,-60,20,63,76,139,224
90,-90,0,62,77,139,266
-50,-90,-140,62,77,139,266
0,-90,-90,62,77,139,266
160,-90,70,62,77,139,266
-160,-90,110,62,77,139,266
-90,-90,-180,62,77,139,266
110,-80,10,63,76,139,290
-30,70,-80,76,64,140,210
-180,-30,100,69,71,140,290
110,60,120,63,77,140,214
120,-10,100,63,77,140,256
30,-10,-110,69,71,140,259
-110,70,20,69,71,140,203
180,-80,110,66,74,140,283
-20,-60,-80,69,71,140,266
120,-80,20,63,77,140,289
180,-30,100,69,71,140,290
80,80,160,69,71,140,200
110,0,80,69,71,140,254
-20,-60,-100,73,67,140,270
-140,-80,130,67,73,140,269
-10,-10,-80,76,64,140,239
-130,70,30,66,74,140,192
-140,-70,130,70,70,140,298
-180,-80,110,66,74,140,283
150,-70,50,63,77,140,204
150,-30,110,69,71,140,232
-180,60,130,71,70,141,184
90,30,-170,67,74,141,246
-110,-80,180,71,70,141,300
30,-40,-40,68,73,141,232
20,40,-80,65,76,141,222
-90,80,-20,68,73,141,185
-160,-50,120,78,63,141,289
70,30,-150,67,74,141,273
-20,60,-50,63,78,141,216
110,0,90,65,76,141,265
150,40,150,64,77,141,242
180,60,130,71,70,141,184
-10,70,-50,64,77,141,253
110,-60,60,76,65,141,233
-80,80,-30,64,77,141,181
-110,-80,-180,71,70,141,300
170,-30,90,73,68,141,289
10,50,-120,71,70,141,222
0,-40,-60,66,75,141,264
150,40,90,72,69,141,188
-20,40,-70,65,76,141,171
-160,-60,120,75,67,142,281
100,30,140,65,77,142,284
-30,-50,-90,75,67,142,255
-180,50,130,70,72,142,194
110,30,150,62,80,142,321
10,-80,-50,69,73,142,313
110,30,160,63,79,142,293
180,-50,90,62,80,142,248
-180,-50,90,62,80,142,248
-100,70,30,73,69,142,213
40,10,-90,69,73,142,266
50,70,-170,67,75,142,197
-140,-60,140,75,67,142,321
70,30,-160,72,70,142,245
120,0,110,70,72,142,286
180,50,130,70,72,142,194
40,-50,-20,69,74,143,278
90,-60,40,72,71,143,225
-10,20,-80,71,72,143,209
80,40,-150,78,65,143,286
-30,50,-60,72,71,143,204
130,-10,110,64,79,143,248
170,50,140,73,70,143,218
130,50,100,73,70,143,232
170,-40,120,73,70,143,277
-170,-70,120,71,72,143,295
-150,-60,130,76,67,143,316
-10,-70,-70,73,70,143,308
110,-80,50,69,74,143,308
-160,-40,120,76,67,143,278
110,20,120,61,82,143,275
60,30,-170,74,69,143,231
100,-40,-20,64,79,143,254
-170,-80,120,68,75,143,298
70,20,-140,70,73,143,267
150,50,90,68,76,144,230
10,10,-110,69,75,144,233
130,-30,30,74,70,144,198
80,-60,-30,64,80,144,234
140,80,170,69,75,144,245
120,-80,60,71,73,144,313
140,-30,50,68,76,144,259
130,-20,100,70,74,144,214
-10,10,-90,72,72,144,248
-170,-60,100,67,77,144,263
140,-60,90,76,68,144,269
100,-40,-30,60,84,144,199
-10,-80,-70,71,73,144,322
140,50,160,63,81,144,243
130,-80,70,69,75,144,314
-100,70,10,76,68,144,206
-140,-80,150,70,74,144,311
-10,50,-100,74,70,144,234
100,-20,40,75,69,144,226
120,30,150,65,79,144,333
-20,60,-90,74,71,145,230
-70,80,-40,64,81,145,196
150,-70,90,72,73,145,275
70,0,-140,73,72,145,240
20,60,-130,70,75,145,232
160,-50,110,77,68,145,264
50,-40,-20,70,75,145,252
-40,70,-70,76,69,145,219
-120,70,20,73,72,145,211
0,-80,-60,71,74,145,321
110,-20,10,77,68,145,212
170,-60,110,78,67,145,280
-160,-70,130,74,71,145,314
-180,20,90,69,76,145,218
20,-60,-90,62,83,145,244
180,20,90,69,76,145,218
0,-20,-70,73,73,146,270
-150,-80,140,71,75,146,308
50,-40,-80,71,75,146,246
-80,-70,-150,76,70,146,301
-120,-80,170,73,73,146,303
-170,50,120,67,79,146,194
30,50,-140,70,76,146,245
90,40,-160,75,71,146,266
20,-20,-100,65,81,146,268
170,50,80,68,78,146,258
160,20,130,70,76,146,252
-160,60,110,72,74,146,199
80,30,150,72,74,146,282
-110,-70,180,77,69,146,315
-170,-30,110,76,70,146,276
60,30,-110,75,71,146,217
40,-60,-80,63,83,146,244
-170,0,100,80,66,146,261
-110,-70,-180,77,69,146,315
60,40,-120,75,71,146,239
160,10,130,70,76,146,232
-20,30,-80,67,79,146,234
-80,70,-20,72,74,146,206
30,-40,-90,67,80,147,295
-10,-60,-100,72,75,147,303
-20,-80,-80,72,75,147,326
-70,-70,-140,78,69,147,298
70,10,-120,72,75,147,229
30,-70,-70,64,83,147,256
90,40,130,73,74,147,250
40,0,-80,66,81,147,308
-110,70,10,71,76,147,217
130,20,90,72,75,147,243
70,40,-140,74,73,147,286
120,80,-170,75,72,147,248
0,-30,-100,71,76,147,274
-130,-80,160,72,75,147,309
-30,-70,-100,73,74,147,294
-90,70,20,78,69,147,226
-160,-80,130,70,77,147,305
-130,-80,140,69,78,147,289
-40,-70,-110,75,72,147,296
50,80,-170,72,75,147,224
10,-80,-80,66,81,147,277
-40,60,-40,69,78,147,217
-170,40,90,72,76,148,229
50,60,-170,68,80,148,219
-170,0,120,78,70,148,266
130,-80,30,65,83,148,284
-20,-40,-100,73,75,148,286
20,50,-130,67,81,148,250
170,-50,70,73,75,148,245
60,-30,-30,65,83,148,242
70,60,160,73,75,148,233
-120,-70,170,79,69,148,317
130,80,180,72,76,148,249
0,-70,-90,72,76,148,271
160,-40,70,70,78,148,297
140,-80,80,71,77,148,318
60,10,-150,73,75,148,232
130,80,-180,72,76,148,249
60,80,-180,71,77,148,219
60,80,180,71,77,148,219
150,-90,90,70,79,149,340
160,-90,100,70,79,149,340
-40,-90,-100,70,79,149,340
-100,-90,-160,70,79,149,340
100,-90,40,70,79,149,340
140,10,130,69,80,149,268
0,50,-110,71,78,149,219
-120,-90,180,70,79,149,340
90,-90,30,70,79,149,340
-80,-90,-140,70,79,149,340
-70,-90,-130,70,79,149,340
60,-90,0,70,79,149,340
50,-90,-10,70,79,149,340
-20,-20,-90,73,76,149,288
30,-90,-30,70,79,149,340
180,-90,120,70,79,149,340
100,-60,50,77,72,149,248
-90,-90,-150,70,79,149,340
-150,-90,150,70,79,149,340
60,-30,-90,68,81,149,268
-170,-90,130,70,79,149,340
-170,40,110,73,76,149,222
110,-20,60,73,76,149,252
80,-20,10,72,77,149,208
140,-90,80,70,79,149,340
-30,-90,-90,70,79,149,340
150,-10,120,74,75,149,219
80,20,-180,73,76,149,249
-30,-60,-90,77,72,149,282
10,-90,-50,70,79,149,340
130,-20,60,68,81,149,237
-110,-90,-170,70,79,149,340
170,-90,110,70,79,149,340
-50,-90,-110,70,79,149,340
110,-90,50,70,79,149,340
80,20,180,73,76,149,249
-180,-90,120,70,79,149,340
80,-90,20,70,79,149,340
-120,-90,-180,70,79,149,340
130,-90,70,70,79,149,340
120,-90,60,70,79,149,340
-20,-90,-80,70,79,149,340
110,10,100,74,75,149,305
170,60,140,73,76,149,240
40,-90,-20,70,79,149,340
-140,-90,160,70,79,149,340
20,-90,-40,70,79,149,340
0,-90,-60,70,79,149,340
-10,-90,-70,70,79,149,340
-130,-90,170,70,79,149,340
70,-90,10,70,79,149,340
0,-20,-100,67,82,149,230
-160,-90,140,70,79,149,340
-60,-90,-120,70,79,149,340
-100,-70,180,73,77,150,310
-120,70,60,73,77,150,245
-10,50,-60,69,81,150,216
50,50,-170,70,80,150,257
-170,10,110,78,72,150,264
-130,-70,160,79,71,150,335
50,0,-90,68,82,150,300
130,30,150,70,80,150,321
30,-50,-90,71,79,150,278
100,30,180,69,81,150,290
-10,-30,-70,79,71,150,268
180,0,90,75,75,150,218
60,30,180,74,76,150,237
-180,0,90,75,75,150,218
110,-10,70,76,74,150,242
40,-40,-30,76,74,150,256
100,30,-180,69,81,150,290
-170,40,100,76,74,150,255
60,30,-180,74,76,150,237
10,-10,-100,72,78,150,285
-100,-70,-180,73,77,150,310
-20,-30,-80,85,66,151,269
140,80,100,74,77,151,255
-10,-40,-100,77,74,151,268
-80,70,10,78,73,151,220
130,20,140,71,80,151,293
-30,-60,-100,81,70,151,270
-30,-80,-90,75,76,151,328
-50,70,-20,75,76,151,236
-50,-70,-120,77,74,151,295
-100,-70,-170,80,71,151,324
100,-80,0,69,83,152,303
170,30,130,74,78,152,251
80,20,170,72,80,152,259
110,20,110,67,85,152,314
-50,60,-50,78,74,152,235
70,30,-140,74,78,152,295
100,40,120,73,79,152,246
0,-80,-90,70,82,152,284
60,50,-120,75,77,152,258
110,40,180,74,78,152,269
110,30,170,72,80,152,302
110,40,-180,74,78,152,269
-160,-60,130,75,77,152,322
50,-50,-10,73,79,152,289
-20,-70,-80,78,74,152,313
-170,10,100,78,75,153,279
-130,-70,140,76,77,153,307
-90,-70,-160,82,71,153,304
-20,-10,-90,76,77,153,265
-160,-40,130,82,71,153,317
-150,-50,130,81,72,153,340
140,-80,40,66,87,153,282
-20,-50,-70,76,77,153,298
-10,30,-70,71,82,153,233
-150,80,100,73,80,153,236
120,-20,50,74,80,154,271
-40,-80,-100,78,76,154,336
-70,70,0,78,76,154,220
-160,0,110,81,73,154,294
60,-50,10,71,83,154,229
0,60,-60,76,78,154,243
40,80,-160,74,80,154,243
-160,-50,130,80,74,154,330
20,10,-80,73,81,154,292
150,10,130,74,80,154,221
-10,-60,-60,76,78,154,315
150,10,80,78,76,154,202
70,20,-180,77,77,154,253
150,-80,90,72,82,154,328
70,20,180,77,77,154,253
40,40,-150,77,77,154,282
50,20,-150,83,71,154,242
-30,-50,-100,86,68,154,268
30,0,-80,62,92,154,295
-150,-60,120,82,73,155,340
-160,-50,110,76,79,155,310
20,20,-80,78,77,155,268
-90,70,-10,75,80,155,216
50,-30,-90,66,89,155,302
-140,-70,150,79,76,155,350
180,-60,80,67,88,155,265
-10,10,-80,76,79,155,253
140,10,80,80,75,155,219
150,80,90,79,76,155,259
-170,-50,100,70,85,155,282
180,60,70,76,79,155,257
110,-30,0,75,80,155,250
20,-20,-60,81,74,155,270
70,0,-120,77,78,155,244
-140,-60,130,78,77,155,344
90,30,140,75,80,155,309
-180,60,70,76,79,155,257
-30,-60,-80,84,71,155,315
70,30,160,79,76,155,258
-180,-60,80,67,88,155,265
150,30,90,71,85,156,226
-170,30,100,74,82,156,251
80,-70,30,71,85,156,289
-60,70,-10,80,76,156,217
60,-40,10,81,75,156,216
40,20,-90,73,83,156,269
-60,-70,-130,80,76,156,299
60,-50,-70,67,89,156,240
30,0,-130,77,79,156,256
60,-10,-90,77,79,156,264
130,40,100,75,81,156,235
-120,-80,150,73,83,156,303
0,0,-100,77,79,156,274
90,-20,20,82,74,156,234
0,-60,-50,79,77,156,323
90,-40,-50,66,90,156,230
-20,-40,-70,81,75,156,292
-40,-60,-100,83,73,156,315
-30,-70,-110,81,75,156,293
140,70,170,73,84,157,222
90,-80,-10,74,83,157,304
-10,-20,-100,69,88,157,268
20,40,-130,75,82,157,233
60,-60,10,73,84,157,270
60,-10,-130,82,75,157,252
-70,-80,-130,80,77,157,350
150,-60,100,79,78,157,295
120,60,110,71,86,157,267
-150,-70,140,77,80,157,334
50,30,-100,79,78,157,237
-110,-80,-170,77,80,157,364
170,-50,120,79,78,157,302
170,-40,80,75,82,157,297
-10,-80,-100,75,82,157,295
110,-20,50,79,79,158,268
50,40,-100,77,81,158,234
-100,70,0,77,81,158,222
-160,-60,110,79,79,158,316
130,50,170,68,90,158,238
-160,-20,120,82,76,158,276
-20,-30,-90,84,74,158,281
150,60,90,79,79,158,238
-180,-50,120,84,74,158,279
180,-50,120,84,74,158,279
10,-40,-100,71,87,158,292
-50,-80,-110,80,78,158,346
70,20,-120,76,82,158,255
90,20,170,76,82,158,272
80,-40,-60,72,87,159,269
-30,-40,-90,83,76,159,266
70,30,-130,79,80,159,310
180,-30,130,79,80,159,278
-120,-80,180,78,81,159,367
70,-70,20,72,87,159,302
40,40,-90,76,83,159,272
-180,-30,130,79,80,159,278
-160,-10,120,82,77,159,293
-120,-80,-180,78,81,159,367
90,-50,-40,61,98,159,227
110,-30,70,80,79,159,290
160,-70,60,71,88,159,249
90,-70,40,74,85,159,278
-60,-80,-120,81,78,159,346
-160,-30,130,83,76,159,306
10,-10,-70,80,79,159,298
-20,-20,-80,85,74,159,271
-160,-30,120,85,74,159,311
60,-10,-120,82,77,159,254
-140,80,90,73,86,159,258
90,-20,-10,83,76,159,205
60,40,170,78,82,160,274
150,-80,50,69,91,160,294
120,-50,10,70,90,160,284
110,20,130,69,91,160,291
120,10,120,77,83,160,352
-170,10,120,79,81,160,282
50,0,-140,80,80,160,233
-140,70,90,74,86,160,244
-170,-10,100,85,75,160,316
0,-40,-100,80,80,160,272
10,-20,-100,74,86,160,248
80,20,160,76,84,160,298
-40,-50,-100,85,75,160,296
-150,60,70,91,69,160,249
-10,0,-90,81,79,160,304
-170,-30,130,82,78,160,272
180,40,80,73,88,161,242
-180,40,80,73,88,161,242
-140,-80,160,78,83,161,368
50,-10,-130,80,81,161,216
120,30,160,75,86,161,363
100,70,130,75,86,161,251
120,-20,20,79,82,161,236
-30,-70,-90,85,76,161,330
-160,70,50,81,80,161,258
-10,0,-80,83,78,161,268
110,80,-160,84,77,161,257
80,30,-160,79,82,161,303
-160,-10,110,83,78,161,278
-100,-80,170,76,86,162,318
-90,-70,-170,80,82,162,318
-150,-50,120,86,76,162,342
60,50,170,83,79,162,267
140,30,150,77,85,162,303
160,-70,100,81,81,162,299
-20,-10,-80,88,74,162,281
-180,-40,90,82,80,162,295
180,-40,90,82,80,162,295
100,-50,-10,83,79,162,279
-130,-80,170,79,83,162,364
-170,30,110,81,81,162,276
-20,-60,-70,83,79,162,300
120,-60,10,79,84,163,317
-170,-20,130,82,81,163,270
70,50,-130,84,79,163,304
0,30,-70,72,91,163,273
-150,-60,140,83,80,163,373
-100,-80,-160,80,83,163,367
110,0,100,77,86,163,319
50,-10,-110,74,89,163,308
70,20,-170,86,77,163,264
0,-60,-100,73,90,163,320
160,80,80,85,78,163,284
90,-30,40,82,81,163,250
-150,60,90,80,83,163,266
-30,-40,-100,84,79,163,297
20,30,-80,74,89,163,277
110,-20,70,82,81,163,305
90,70,140,83,80,163,269
-110,-80,160,76,87,163,311
-170,20,110,79,84,163,285
100,40,-170,77,86,163,302
160,-20,80,86,77,163,281
70,10,-150,75,88,163,295
90,-60,-20,77,87,164,286
160,-80,100,78,86,164,339
0,-50,-50,78,86,164,319
160,70,80,82,82,164,254
20,-10,-110,76,88,164,317
-80,-80,-140,82,82,164,358
80,-80,-20,81,83,164,307
-110,70,50,80,84,164,273
-150,60,80,82,82,164,259
80,50,-140,87,77,164,306
-10,0,-70,84,80,164,324
-10,-40,-60,77,87,164,320
180,10,90,80,84,164,250
-50,-70,-110,85,79,164,329
-180,10,90,80,84,164,250
-90,-80,-150,81,83,164,361
160,-80,60,72,92,164,292
130,70,180,78,87,165,266
60,20,-160,89,76,165,297
-40,-60,-90,88,77,165,332
70,20,-150,86,79,165,293
-10,20,-70,81,84,165,283
130,70,-180,78,87,165,266
170,-80,110,78,87,165,353
140,-10,70,79,86,165,259
40,50,-90,73,92,165,243
-40,-70,-100,85,80,165,337
60,-80,10,82,83,165,364
40,-30,-40,78,87,165,285
90,-20,30,85,80,165,283
100,20,120,74,91,165,378
110,10,110,79,86,165,384
-30,-50,-80,85,80,165,328
80,20,-170,84,82,166,287
-40,-70,-120,88,78,166,317
180,-80,120,79,87,166,363
60,-70,10,78,88,166,325
-40,50,-60,85,81,166,274
-30,60,-80,82,84,166,249
-180,-80,120,79,87,166,363
120,20,140,76,90,166,341
0,-70,-50,84,82,166,357
-10,40,-100,82,84,166,268
60,-30,-20,74,93,167,297
10,-30,-100,84,83,167,294
80,-60,-40,67,100,167,260
-130,-60,150,86,81,167,337
-160,-80,140,79,88,167,370
100,-10,30,82,85,167,303
0,20,-70,80,87,167,285
-20,50,-90,87,80,167,264
-130,80,80,76,91,167,276
80,30,140,83,84,167,354
-80,-70,-160,88,79,167,329
90,-80,40,79,88,167,347
-170,-80,130,79,88,167,368
-30,-40,-80,84,83,167,297
120,50,-180,75,92,167,290
120,50,180,75,92,167,290
-60,-70,-120,88,79,167,346
-30,-60,-110,90,78,168,306
70,-80,20,82,86,168,356
100,-30,-40,80,88,168,247
-20,20,-80,80,88,168,293
70,-80,-30,83,85,168,328
110,40,110,82,86,168,295
10,-70,-40,84,84,168,375
-150,-80,150,80,88,168,366
70,40,-130,81,87,168,341
-30,60,-40,73,95,168,275
170,-80,70,76,92,168,313
-160,90,110,84,85,169,292
-140,90,90,84,85,169,292
10,90,-60,84,85,169,292
-170,-40,100,86,83,169,314
-110,90,60,84,85,169,292
110,-40,0,83,86,169,276
40,90,-90,84,85,169,292
-50,90,0,84,85,169,292
-80,90,30,84,85,169,292
-20,90,-30,84,85,169,292
140,90,170,84,85,169,292
180,90,130,84,85,169,292
0,90,-50,84,85,169,292
20,90,-70,84,85,169,292
10,-60,-40,86,83,169,356
-130,90,80,84,85,169,292
-30,50,-50,79,90,169,242
120,90,-170,84,85,169,292
-170,-40,130,90,79,169,299
-90,-80,180,81,88,169,325
-180,90,130,84,85,169,292
60,90,-110,84,85,169,292
110,30,110,80,89,169,284
170,10,130,85,84,169,286
70,90,-120,84,85,169,292
-90,-80,-180,81,88,169,325
-30,40,-70,83,86,169,272
30,90,-80,84,85,169,292
90,50,-150,90,79,169,302
-10,90,-40,84,85,169,292
50,90,-100,84,85,169,292
150,90,160,84,85,169,292
160,90,150,84,85,169,292
100,-80,50,79,90,169,349
-170,90,120,84,85,169,292
10,-40,-50,79,90,169,314
-100,90,50,84,85,169,292
-20,70,-40,76,93,169,293
100,80,-150,88,81,169,264
-70,90,20,84,85,169,292
130,90,-180,84,85,169,292
80,90,-130,84,85,169,292
-120,90,70,84,85,169,292
70,-30,-80,81,88,169,322
100,90,-150,84,85,169,292
160,-30,120,81,88,169,308
-150,90,100,84,85,169,292
130,90,180,84,85,169,292
110,90,-160,84,85,169,292
-30,90,-20,84,85,169,292
120,-40,80,87,82,169,241
170,90,140,84,85,169,292
-40,90,-10,84,85,169,292
-60,90,10,84,85,169,292
-50,70,-60,86,83,169,250
-90,90,40,84,85,169,292
-120,80,70,78,91,169,287
90,90,-140,84,85,169,292
-130,-70,170,88,82,170,389
-20,30,-90,80,90,170,317
-150,-40,120,90,80,170,353
20,-70,-30,85,85,170,369
10,-60,-100,78,92,170,311
20,-70,-80,75,95,170,317
160,-40,60,81,89,170,282
-50,60,-40,85,85,170,255
60,20,-170,86,84,170,269
120,-20,90,82,88,170,299
80,-80,30,82,88,170,360
-50,-60,-110,90,80,170,321
160,90,80,80,91,171,280
-140,-50,140,83,88,171,380
150,90,90,80,91,171,280
50,-80,0,86,85,171,361
-10,90,-110,80,91,171,280
110,-80,60,81,90,171,342
-160,90,40,80,91,171,280
180,90,60,80,91,171,280
40,90,-160,80,91,171,280
-50,90,-70,80,91,171,280
60,90,180,80,91,171,280
-10,-70,-100,81,90,171,313
-170,20,100,86,85,171,298
180,-20,130,78,93,171,279
-140,90,20,80,91,171,280
0,-10,-70,86,85,171,338
-120,90,0,80,91,171,280
130,0,120,81,90,171,321
-100,70,40,82,89,171,291
130,90,110,80,91,171,280
-80,-70,-140,88,83,171,355
-150,90,30,80,91,171,280
140,90,100,80,91,171,280
30,90,-150,80,91,171,280
10,-50,-100,83,88,171,293
20,90,-140,80,91,171,280
-70,90,-50,80,91,171,280
-170,90,50,80,91,171,280
-100,90,-20,80,91,171,280
-150,-40,130,87,84,171,367
-80,90,-40,80,91,171,280
-10,-10,-70,87,84,171,351
60,90,-180,80,91,171,280
90,20,160,82,89,171,321
-30,90,-90,80,91,171,280
-60,90,-60,80,91,171,280
50,-20,-50,76,95,171,355
-40,90,-80,80,91,171,280
50,90,-170,80,91,171,280
120,90,120,80,91,171,280
-180,-20,130,78,93,171,279
100,90,140,80,91,171,280
-180,90,60,80,91,171,280
0,90,-120,80,91,171,280
30,50,-80,76,95,171,239
90,90,150,80,91,171,280
-130,90,10,80,91,171,280
80,90,160,80,91,171,280
-90,90,-30,80,91,171,280
110,90,130,80,91,171,280
-10,30,-100,82,89,171,310
10,90,-130,80,91,171,280
50,-70,0,81,90,171,348
170,90,70,80,91,171,280
-110,90,-10,80,91,171,280
50,-60,0,79,92,171,333
70,90,170,80,91,171,280
-20,90,-100,80,91,171,280
-20,0,-70,82,90,172,311
-120,-70,-180,89,83,172,376
-120,-60,160,87,85,172,349
-150,60,60,89,83,172,287
-20,-30,-100,80,92,172,334
170,-70,70,76,96,172,280
-150,70,40,89,83,172,274
-160,50,90,86,86,172,280
100,30,120,77,95,172,348
-10,-70,-60,88,84,172,365
-120,-70,180,89,83,172,376
170,-70,110,87,85,172,326
-20,-80,-110,83,89,172,339
80,70,150,88,85,173,308
-160,-20,130,86,87,173,301
-40,-60,-110,91,82,173,317
-90,-70,-150,92,81,173,365
110,70,120,85,88,173,273
-160,-40,110,89,84,173,314
130,-40,20,80,93,173,257
0,30,-110,85,88,173,284
100,-70,50,80,93,173,292
-30,-80,-120,81,92,173,348
140,20,140,74,99,173,309
-180,40,130,83,90,173,281
-70,-70,-150,91,82,173,349
30,-70,-20,84,89,173,370
0,-10,-100,81,92,173,329
-110,-70,-170,88,85,173,375
180,40,130,83,90,173,281
130,10,80,82,91,173,292
120,70,-170,82,91,173,273
20,-60,-30,82,91,173,369
-20,-30,-70,87,87,174,328
80,30,-150,84,90,174,358
130,-60,20,84,90,174,292
50,40,-170,87,87,174,283
-120,-70,150,78,96,174,336
50,30,-160,83,91,174,317
60,-80,-40,86,88,174,333
-140,-60,150,88,86,174,383
-20,20,-90,85,89,174,344
100,-10,10,89,85,174,276
-10,-20,-70,92,82,174,329
110,-50,0,84,90,174,319
110,50,-170,86,88,174,300
-170,-60,90,80,94,174,316
-10,-30,-100,84,90,174,323
170,80,70,85,89,174,300
160,-60,110,85,89,174,320
-20,-60,-110,83,91,174,353
-170,20,120,82,92,174,288
110,-10,80,81,93,174,312
-30,-50,-110,95,79,174,305
-70,-80,-160,84,91,175,361
30,-80,-20,91,84,175,379
-180,-50,80,79,96,175,313
-50,-70,-130,92,83,175,357
180,-50,80,79,96,175,313
170,-20,130,81,94,175,292
-110,-60,170,85,90,175,339
70,20,170,91,84,175,289
-40,-40,-100,95,80,175,310
80,40,140,86,89,175,302
-170,30,90,81,94,175,238
30,40,-140,78,98,176,306
-20,-70,-70,87,89,176,356
-70,-70,-130,93,83,176,354
0,50,-60,86,90,176,280
-20,10,-80,84,92,176,285
160,30,140,83,93,176,282
10,-80,-40,88,88,176,373
10,20,-120,89,87,176,278
10,40,-120,83,93,176,270
90,20,-180,83,94,177,281
-130,70,80,86,91,177,276
-10,10,-70,89,88,177,311
-50,-80,-140,88,89,177,369
100,-10,20,87,90,177,308
70,20,-160,93,84,177,319
180,-60,120,95,82,177,323
-100,-70,-160,93,84,177,366
90,80,-140,89,88,177,288
90,20,180,83,94,177,281
40,-70,-10,84,93,177,372
160,60,150,81,96,177,300
10,40,-70,85,92,177,324
0,40,-110,92,85,177,282
-20,40,-60,83,94,177,263
-180,-60,120,95,82,177,323
-130,-60,140,88,90,178,344
100,50,-160,89,89,178,320
-110,80,60,80,98,178,312
-90,70,30,86,92,178,304
20,-80,-30,93,85,178,367
-40,-50,-110,101,77,178,321
-160,50,100,77,101,178,277
100,-20,-10,87,91,178,245
70,-40,-70,82,96,178,329
-10,60,-50,83,95,178,308
-40,-80,-130,85,93,178,360
110,-70,60,85,93,178,307
-30,-30,-80,95,83,178,305
30,80,-150,86,92,178,278
-140,-50,130,89,89,178,350
-20,50,-50,86,92,178,299
-150,-40,140,91,88,179,414
-170,-50,130,90,89,179,332
-140,-70,160,90,89,179,415
-80,-80,-170,82,97,179,351
-20,-50,-110,88,91,179,363
40,-80,-10,90,89,179,376
0,-80,-50,90,89,179,387
-180,-70,80,78,101,179,310
170,20,130,92,87,179,302
180,-70,80,78,101,179,310
120,10,80,85,94,179,339
-160,50,80,94,85,179,277
130,-20,50,80,99,179,340
130,-50,20,90,89,179,259
-160,60,60,91,88,179,289
0,-30,-60,84,95,179,293
-50,-60,-100,93,86,179,340
110,-10,30,87,92,179,305
120,-70,70,89,91,180,316
-60,-80,-150,90,90,180,374
120,-30,10,89,91,180,284
80,20,-160,89,91,180,363
100,-50,-20,84,96,180,333
-160,10,110,94,86,180,354
-60,-70,-140,96,84,180,366
-20,30,-70,87,93,180,262
120,-40,10,88,92,180,276
-60,-60,-120,93,87,180,330
30,-60,-90,79,101,180,333
-20,0,-80,85,96,181,322
180,-80,80,85,96,181,348
-20,-10,-70,89,92,181,349
-50,60,-30,88,93,181,288
-180,-80,80,85,96,181,348
-40,60,-70,89,92,181,290
60,-10,-100,81,100,181,319
-160,50,110,87,94,181,279
110,-40,70,89,92,181,280
-10,40,-60,85,96,181,274
-20,-20,-100,85,97,182,338
-60,70,-50,91,91,182,277
110,50,110,96,86,182,331
80,80,-130,93,89,182,291
60,0,-100,86,96,182,326
40,70,-160,85,97,182,268
-140,60,80,89,93,182,327
60,-10,-80,90,92,182,294
80,20,150,90,92,182,371
180,-70,120,91,91,182,352
-180,-70,120,91,91,182,352
-140,-40,130,94,88,182,371
150,-20,120,89,94,183,278
-20,40,-90,93,90,183,308
40,-30,-100,82,101,183,330
60,0,-150,90,93,183,299
60,20,-180,96,87,183,290
150,-30,60,83,100,183,402
110,20,100,83,100,183,362
-140,-40,140,95,88,183,416
60,20,180,96,87,183,290
-130,-60,160,96,87,183,364
-170,40,120,88,95,183,285
40,50,-160,84,100,184,330
60,-20,-100,86,98,184,297
50,50,-100,87,97,184,291
120,-80,70,88,96,184,361
-150,-70,150,90,94,184,408
10,30,-120,94,90,184,289
130,-70,80,93,91,184,340
-170,50,70,84,100,184,319
-40,-40,-90,90,94,184,326
40,30,-90,88,96,184,316
50,-50,0,83,102,185,331
-110,-60,-180,101,84,185,347
-60,60,-30,99,86,185,301
-40,-70,-90,95,90,185,362
-170,-10,130,88,97,185,307
-150,-50,140,98,87,185,402
-30,-70,-80,92,93,185,356
-10,-50,-110,88,97,185,371
-160,10,120,93,92,185,354
-110,-60,180,101,84,185,347
60,-10,-140,89,96,185,307
60,30,170,87,98,185,319
50,10,-150,94,92,186,276
-20,-50,-60,99,87,186,357
-60,-60,-110,94,92,186,353
-150,60,100,93,93,186,301
50,-30,-100,83,103,186,303
90,30,-160,94,92,186,348
-40,-50,-90,93,93,186,333
10,0,-110,85,101,186,322
-60,60,-40,97,89,186,300
90,30,130,88,98,186,378
-120,-60,170,99,87,186,369
-170,40,80,89,97,186,299
100,50,120,91,95,186,315
30,10,-80,82,104,186,359
-140,70,30,101,85,186,287
80,-30,-70,90,97,187,356
-160,-70,140,90,97,187,383
100,-20,50,92,95,187,318
-30,-30,-90,95,92,187,313
-50,-70,-100,98,89,187,377
70,-20,-90,94,93,187,268
-170,30,120,87,100,187,308
140,-20,60,89,98,187,380
70,-10,-130,88,99,187,305
100,-30,60,96,91,187,342
-170,80,50,89,98,187,328
90,-90,40,95,93,188,404
110,-10,20,91,97,188,306
-80,-90,-130,95,93,188,404
70,-90,20,95,93,188,404
-30,70,-30,86,102,188,329
40,-90,-10,95,93,188,404
180,-90,130,95,93,188,404
-180,-90,130,95,93,188,404
-160,-90,150,95,93,188,404
140,-90,90,95,93,188,404
60,-90,10,95,93,188,404
120,-90,70,95,93,188,404
-50,-90,-100,95,93,188,404
-170,-90,140,95,93,188,404
170,-90,120,95,93,188,404
-80,70,20,90,98,188,318
-40,-90,-90,95,93,188,404
-90,-90,-140,95,93,188,404
-110,-90,-160,95,93,188,404
-10,-90,-60,95,93,188,404
0,10,-70,93,95,188,344
-30,-30,-100,92,96,188,376
-130,-90,-180,95,93,188,404
10,-90,-40,95,93,188,404
-160,0,120,95,93,188,336
-70,-90,-120,95,93,188,404
50,-90,0,95,93,188,404
80,-90,30,95,93,188,404
-150,-90,160,95,93,188,404
110,-90,60,95,93,188,404
-20,20,-70,92,96,188,320
100,-90,50,95,93,188,404
0,-90,-50,95,93,188,404
30,-90,-20,95,93,188,404
-20,-70,-110,91,97,188,362
-170,-70,130,95,93,188,367
-30,-90,-80,95,93,188,404
-120,-90,-170,95,93,188,404
-20,-90,-70,95,93,188,404
-60,-90,-110,95,93,188,404
-110,-70,160,90,98,188,366
-140,-90,170,95,93,188,404
-180,80,60,87,101,188,323
60,-20,-50,86,102,188,349
130,-90,80,95,93,188,404
20,-90,-30,95,93,188,404
-130,-90,180,95,93,188,404
180,80,60,87,101,188,323
160,-90,110,95,93,188,404
-100,-90,-150,95,93,188,404
130,10,130,83,105,188,366
-30,50,-80,97,91,188,305
150,-90,100,95,93,188,404
70,-20,-80,93,96,189,280
50,-70,-60,83,106,189,358
-30,-50,-70,97,92,189,373
60,60,170,93,96,189,304
140,-50,30,90,99,189,287
160,10,80,97,92,189,271
-90,-60,-160,95,94,189,332
70,30,150,90,99,189,348
30,-60,-20,91,98,189,393
-140,60,60,98,91,189,289
-10,-80,-60,97,92,189,395
40,10,-140,91,98,189,285
-100,-60,-170,99,90,189,343
-120,70,10,97,92,189,287
-100,80,50,85,105,190,331
70,20,160,93,97,190,349
140,40,160,83,107,190,361
40,-70,-70,85,105,190,347
-90,80,40,86,104,190,350
140,-70,90,97,93,190,355
120,70,110,95,95,190,295
20,-30,-50,82,108,190,342
170,40,140,88,102,190,313
130,-80,80,92,98,190,369
20,0,-120,98,93,191,287
110,-10,60,96,95,191,360
140,-60,30,92,99,191,333
10,-70,-90,87,104,191,364
-20,-20,-70,97,94,191,365
110,-60,0,91,100,191,371
-130,70,20,96,95,191,273
-30,40,-60,93,98,191,291
-10,20,-100,88,103,191,335
-50,50,-50,100,91,191,323
40,-20,-50,89,103,192,412
110,-20,0,95,97,192,285
-70,-60,-130,96,96,192,355
-100,-60,180,101,91,192,356
170,70,70,94,98,192,328
-160,0,100,100,92,192,338
50,-40,-10,87,105,192,353
40,60,-160,88,104,192,321
100,-40,-40,92,100,192,261
-100,-60,-180,101,91,192,356
-10,-10,-100,90,102,192,327
-160,-60,100,92,100,192,378
180,-10,90,98,95,193,373
-20,-80,-70,96,97,193,406
-110,-90,150,99,94,193,399
-20,-90,-120,99,94,193,399
-160,-90,100,99,94,193,399
-140,-90,120,99,94,193,399
-60,-70,-110,103,90,193,384
-30,-20,-80,102,91,193,319
-80,-90,180,99,94,193,399
-10,-90,-110,99,94,193,399
100,-90,0,99,94,193,399
10,-90,-90,99,94,193,399
140,-90,40,99,94,193,399
-170,-80,90,93,100,193,372
110,-90,10,99,94,193,399
-160,20,120,98,95,193,373
-80,-90,-180,99,94,193,399
60,-90,-40,99,94,193,399
130,-90,30,99,94,193,399
160,-90,60,99,94,193,399
20,80,-140,93,100,193,318
60,-70,-50,84,109,193,406
70,40,150,94,99,193,316
80,-90,-20,99,94,193,399
-170,-90,90,99,94,193,399
-180,-40,130,98,95,193,341
-100,-90,160,99,94,193,399
-140,60,70,96,97,193,313
-60,-90,-160,99,94,193,399
-150,-90,110,99,94,193,399
0,-90,-100,99,94,193,399
-40,-90,-140,99,94,193,399
50,-90,-50,99,94,193,399
-70,-90,-170,99,94,193,399
70,-90,-30,99,94,193,399
180,-40,130,98,95,193,341
-180,-90,80,99,94,193,399
110,70,-160,91,102,193,297
110,10,80,93,100,193,352
-30,-90,-130,99,94,193,399
20,-90,-80,99,94,193,399
30,-90,-70,99,94,193,399
-120,-90,140,99,94,193,399
140,-80,90,94,99,193,378
80,40,-140,91,102,193,403
90,-90,-10,99,94,193,399
-130,-90,130,99,94,193,399
180,-90,80,99,94,193,399
120,-90,20,99,94,193,399
-180,-10,90,98,95,193,373
-50,-90,-150,99,94,193,399
-90,-90,170,99,94,193,399
40,-90,-60,99,94,193,399
150,-90,50,99,94,193,399
170,-90,70,99,94,193,399
150,-20,70,97,97,194,356
50,-80,-50,95,99,194,355
170,-60,120,99,95,194,362
-150,-30,130,96,98,194,410
70,-10,-120,95,99,194,346
20,0,-70,94,100,194,402
60,10,-100,94,100,194,377
-40,-60,-80,98,96,194,378
150,-70,100,96,98,194,375
110,20,140,86,108,194,406
-70,-70,-120,105,89,194,384
-160,80,40,93,101,194,338
90,20,150,91,103,194,388
80,-70,-30,88,106,194,437
100,20,130,89,105,194,428
-40,70,-20,92,103,195,340
30,40,-80,89,106,195,350
-70,70,10,96,99,195,330
110,0,70,94,101,195,342
10,-20,-60,96,99,195,349
150,-80,100,96,99,195,393
40,-60,-10,95,100,195,381
-170,-70,90,85,110,195,350
110,-10,10,93,102,195,307
-160,-20,110,101,94,195,361
-170,-60,130,100,96,196,376
130,-40,90,99,97,196,297
-180,10,130,97,99,196,342
-30,-80,-80,98,98,196,402
180,10,130,97,99,196,342
130,30,160,89,107,196,429
-100,-80,-150,103,93,196,415
100,-60,-10,96,100,196,357
-10,10,-100,95,101,196,344
-60,70,0,93,103,196,340
110,-10,40,98,98,196,353
0,0,-70,94,102,196,361
-40,-50,-80,98,98,196,380
150,30,150,88,108,196,371
70,-20,-50,92,104,196,336
120,20,90,96,100,196,354
-170,-20,100,100,96,196,398
-170,-30,100,99,97,196,404
70,0,-150,94,102,196,324
-40,50,-50,92,104,196,288
150,60,160,89,108,197,321
160,60,80,98,99,197,327
110,-30,-10,100,97,197,332
-110,-80,-160,103,94,197,413
-120,-80,-170,102,95,197,407
-90,-80,-140,103,94,197,414
50,-50,-80,92,105,197,349
-30,-10,-80,102,95,197,334
40,-20,-110,87,110,197,381
30,-30,-100,87,110,197,406
-70,-60,-120,103,94,197,366
130,-20,40,104,93,197,260
70,-70,-40,86,111,197,424
-50,60,-60,97,100,197,332
140,-40,30,89,108,197,293
140,-30,40,95,102,197,284
-50,-50,-110,102,96,198,350
-20,10,-70,99,99,198,328
-50,-60,-120,106,92,198,367
120,-10,60,92,106,198,345
90,-10,10,101,97,198,340
60,-10,-110,94,104,198,353
-40,-40,-110,104,94,198,370
-180,-50,130,99,99,198,365
160,-80,110,95,103,198,391
120,30,100,92,106,198,322
180,-50,130,99,99,198,365
-160,-10,130,100,98,198,325
170,0,130,99,99,198,340
-40,50,-40,95,104,199,326
10,-50,-40,94,105,199,378
170,40,80,95,104,199,283
-130,-80,-180,102,97,199,395
170,-40,70,90,109,199,360
120,0,70,99,100,199,343
-130,-80,180,102,97,199,395
150,-50,40,89,110,199,311
60,10,-170,98,101,199,323
-160,50,70,97,102,199,329
-120,-60,150,101,98,199,375
100,20,170,89,110,199,372
70,10,-160,96,103,199,364
-30,20,-80,100,99,199,388
120,-50,80,100,99,199,331
90,-60,-30,90,110,200,360
70,80,-120,103,97,200,312
50,-10,-60,90,110,200,376
140,60,170,89,111,200,356
70,70,160,102,98,200,356
-30,-60,-70,101,99,200,379
20,50,-70,91,109,200,301
30,30,-140,94,106,200,320
50,30,-170,102,98,200,336
-160,-30,110,105,95,200,415
-130,-60,170,103,97,200,413
-80,80,30,91,109,200,374
-80,-80,-130,103,97,200,418
80,-60,-50,87,113,200,376
30,-20,-110,98,102,200,386
60,10,-160,101,100,201,352
70,-30,-90,93,108,201,284
-40,60,-30,89,112,201,326
160,-70,110,101,100,201,394
180,-10,130,103,98,201,339
-150,-60,150,105,96,201,423
-180,-10,130,103,98,201,339
-70,70,-40,97,104,201,305
30,-10,-120,96,105,201,360
100,-20,-20,97,104,201,283
60,20,-100,101,100,201,358
100,20,160,93,108,201,396
90,20,-170,93,108,201,336
-140,-60,160,102,100,202,433
-30,-60,-120,96,106,202,401
130,60,-180,88,114,202,349
-140,-80,170,103,99,202,407
130,-50,90,103,99,202,347
-20,60,-40,96,106,202,377
30,-70,-80,86,116,202,364
130,60,180,88,114,202,349
70,-60,-60,85,117,202,334
70,50,150,101,101,202,297
10,0,-70,101,101,202,404
-160,-40,140,101,101,202,380
-40,50,-70,102,100,202,348
-130,60,70,95,108,203,375
60,-10,-70,94,109,203,336
-130,-50,140,102,101,203,377
-130,-50,150,105,98,203,382
40,-80,-60,96,107,203,362
-160,-50,140,102,101,203,409
-160,-80,100,97,106,203,390
-170,-50,90,92,111,203,373
160,50,150,94,109,203,341
100,70,-150,100,103,203,327
-30,30,-70,98,105,203,346
100,20,110,91,112,203,411
-20,10,-90,104,100,204,341
80,-20,-60,101,103,204,316
-170,20,90,92,112,204,321
40,60,-90,99,105,204,342
-180,20,130,100,104,204,343
110,-40,-10,101,103,204,372
-170,10,130,103,101,204,366
-30,30,-80,103,101,204,364
180,20,130,100,104,204,343
70,10,-180,98,106,204,366
70,10,-170,96,108,204,385
-150,-20,130,102,102,204,415
170,-80,120,99,105,204,398
20,10,-130,102,102,204,325
-70,80,20,94,110,204,385
-20,-60,-60,106,98,204,371
110,-20,80,96,108,204,362
70,10,180,98,106,204,366
60,40,-110,99,105,204,326
30,0,-70,90,114,204,403
-80,-60,-140,101,103,204,383
-30,-40,-110,104,101,205,385
140,-40,100,102,103,205,338
90,-30,-60,103,102,205,331
50,80,-100,102,103,205,332
110,-50,70,105,100,205,314
-110,-60,-170,106,99,205,403
20,-40,-100,94,111,205,399
-70,-80,-120,107,98,205,422
120,-70,10,96,109,205,399
-160,10,100,98,107,205,390
-80,-70,-130,110,95,205,410
-140,-50,150,103,102,205,428
180,-80,130,100,105,205,413
-180,-80,130,100,105,205,413
90,50,130,96,110,206,333
110,-70,0,98,108,206,418
130,0,70,105,101,206,352
180,30,130,104,102,206,371
100,20,140,98,108,206,488
100,20,150,99,107,206,437
-180,30,130,104,102,206,371
80,20,140,99,107,206,436
120,10,130,94,112,206,431
60,30,160,104,102,206,387
-160,-60,140,107,99,206,415
-160,-70,100,92,114,206,383
60,-60,20,97,109,206,373
30,20,-80,99,107,206,391
-40,-50,-120,104,102,206,371
80,-20,-10,106,100,206,322
40,-10,-130,101,105,206,286
-50,70,-10,98,108,206,353
-80,-60,-150,106,100,206,355
20,-30,-100,98,108,206,389
40,-40,-90,97,109,206,415
-90,60,20,105,102,207,370
30,60,-80,95,112,207,349
-40,-60,-120,114,93,207,377
80,10,170,103,104,207,386
110,-10,90,97,110,207,368
-40,-80,-90,104,103,207,408
110,-30,-20,99,108,207,315
100,-40,60,101,106,207,333
140,-50,100,104,103,207,335
130,60,100,97,110,207,359
-20,-70,-60,107,100,207,396
70,-10,-140,98,109,207,328
50,-30,-30,97,110,207,344
-120,70,70,104,103,207,318
-10,-60,-110,101,107,208,386
120,20,150,91,117,208,466
90,70,-140,101,107,208,335
-120,60,40,102,106,208,355
-100,60,30,102,106,208,379
-60,-80,-110,109,99,208,421
-30,40,-80,109,99,208,370
170,-10,130,107,101,208,383
60,-40,-80,96,112,208,437
-150,-80,160,105,103,208,417
-170,60,60,102,106,208,368
-30,-70,-120,100,108,208,428
90,-70,-20,96,113,209,441
40,-10,-60,89,120,209,372
-180,0,130,108,101,209,358
-150,-80,110,97,112,209,406
180,0,130,108,101,209,358
130,-70,20,98,111,209,414
20,-50,-100,96,113,209,396
60,80,-110,107,102,209,328
150,-60,40,96,113,209,388
110,20,150,92,117,209,478
-30,-20,-90,102,107,209,380
-50,-80,-100,108,101,209,417
-90,-60,-150,108,101,209,369
-90,-60,-170,108,101,209,366
10,10,-120,95,114,209,368
130,20,150,94,115,209,450
-120,-60,180,109,101,210,409
-150,-60,110,101,109,210,415
10,30,-70,95,115,210,391
-60,60,-20,106,104,210,326
10,20,-70,101,109,210,397
170,-70,120,103,107,210,424
-160,-80,150,108,102,210,420
-90,70,-20,99,111,210,339
-130,60,50,107,103,210,344
-120,-60,-180,109,101,210,409
-100,-70,170,103,107,210,389
180,-30,90,107,103,210,408
100,-10,40,104,106,210,404
-20,-40,-110,97,113,210,417
0,20,-110,96,114,210,366
60,20,170,102,108,210,367
50,-70,-70,99,111,210,429
-50,-60,-90,107,103,210,388
-180,-30,90,107,103,210,408
60,-60,-70,90,121,211,376
50,20,-160,101,110,211,398
120,-10,40,109,102,211,350
-110,70,0,101,110,211,328
-50,-40,-110,106,105,211,387
-50,-50,-120,109,102,211,396
130,-60,90,105,106,211,388
90,-20,40,111,100,211,372
-70,60,-30,104,107,211,344
-30,-70,-70,109,103,212,403
-130,60,60,102,110,212,356
30,-80,-70,98,114,212,398
-20,0,-90,102,110,212,395
-140,60,50,109,103,212,363
-30,0,-70,102,110,212,357
0,-60,-110,97,115,212,394
50,60,-100,100,112,212,351
20,20,-130,98,114,212,330
-60,80,10,97,115,212,390
-30,0,-80,99,113,212,357
10,-10,-110,102,110,212,405
-70,60,-20,107,105,212,340
150,20,140,97,115,212,360
-50,-50,-100,108,104,212,361
100,-50,-30,92,121,213,373
90,40,-150,106,107,213,425
-100,70,-10,97,116,213,333
-110,-70,-160,114,99,213,419
-120,-70,-170,114,99,213,422
60,-30,-10,95,118,213,384
70,-70,30,104,109,213,398
90,-10,30,109,104,213,368
-60,-60,-130,113,100,213,380
-130,80,10,105,108,213,324
50,0,-80,97,116,213,379
-140,-80,120,99,114,213,432
0,-20,-60,100,113,213,383
-170,-80,140,107,106,213,430
-40,-70,-80,104,110,214,410
140,50,90,106,108,214,368
-90,-70,-140,116,98,214,427
-110,60,40,105,109,214,388
60,-70,-60,100,114,214,434
-150,-30,140,109,105,214,449
-140,-40,150,105,109,214,475
70,20,150,107,107,214,414
-150,60,50,109,105,214,371
-140,80,20,103,111,214,331
170,0,80,105,109,214,357
160,-30,70,105,109,214,464
100,-70,-10,100,114,214,433
70,30,-120,103,111,214,384
180,70,60,111,104,215,391
-150,80,30,101,114,215,333
-180,70,60,111,104,215,391
-40,-30,-90,115,100,215,359
-80,60,10,110,105,215,367
-110,-60,160,106,109,215,398
-80,-60,-130,110,105,215,393
40,-50,-10,103,112,215,409
-170,20,130,108,107,215,361
60,-30,0,107,108,215,280
0,-70,-100,97,118,215,442
60,40,160,106,109,215,381
-30,-30,-70,107,108,215,411
-100,-60,-160,108,107,215,397
-70,60,-10,108,107,215,342
-150,0,110,111,104,215,391
110,30,-180,100,116,216,431
120,30,170,99,117,216,444
110,10,120,98,118,216,442
-180,-70,130,105,111,216,445
110,30,180,100,116,216,431
-50,-40,-100,110,106,216,398
140,-70,30,105,111,216,409
-120,60,50,108,108,216,394
80,10,180,106,110,216,394
-10,-60,-50,113,103,216,406
-130,-40,140,112,104,216,404
100,30,-170,97,119,216,411
180,-70,130,105,111,216,445
80,30,130,107,109,216,445
120,-20,10,111,105,216,335
80,10,-180,106,110,216,394
-70,-60,-140,113,103,216,379
80,20,-150,106,110,216,431
130,-10,60,111,105,216,430
30,60,-150,99,117,216,404
-150,-10,120,108,109,217,394
-50,-70,-90,107,110,217,429
120,60,-170,98,119,217,389
-30,-10,-90,107,110,217,380
30,70,-150,102,115,217,365
50,10,-90,103,114,217,406
-150,-50,150,110,107,217,458
-160,-50,100,99,118,217,423
-130,-70,-180,110,107,217,438
50,-20,-110,102,115,217,447
60,-70,20,104,113,217,411
30,-10,-60,98,119,217,363
-40,40,-60,110,107,217,367
-100,-70,-150,119,98,217,432
-130,-70,180,110,107,217,438
10,80,-130,101,116,217,354
40,0,-70,97,120,217,377
-60,-60,-100,110,107,217,393
-120,80,0,107,110,217,323
150,-10,70,104,113,217,446
130,-30,20,99,119,218,340
-80,60,-10,108,110,218,372
-40,-30,-100,109,109,218,377
110,20,160,98,120,218,505
-170,10,90,102,116,218,354
-160,-30,140,111,107,218,415
40,80,-90,109,109,218,351
-50,-60,-130,112,106,218,430
20,-70,-90,95,123,218,425
0,10,-110,105,113,218,391
40,30,-150,113,105,218,391
-40,-80,-80,117,101,218,429
-110,60,30,106,112,218,356
40,40,-160,108,110,218,393
-30,-50,-120,109,109,218,436
-30,-40,-70,105,113,218,401
70,-70,-50,101,117,218,462
-130,-80,130,101,117,218,445
-170,0,130,113,105,218,366
20,-90,-20,111,108,219,441
-50,-90,-90,111,108,219,441
-20,-90,-60,111,108,219,441
0,-90,-40,111,108,219,441
170,-90,130,111,108,219,441
-180,-40,80,102,117,219,415
-90,-90,-130,111,108,219,441
-30,-20,-70,110,109,219,403
140,-10,120,100,119,219,359
100,-90,60,111,108,219,441
30,-90,-10,111,108,219,441
-100,-90,-140,111,108,219,441
-10,-90,-50,111,108,219,441
20,30,-130,101,118,219,367
-30,-90,-70,111,108,219,441
110,-90,70,111,108,219,441
-60,-90,-100,111,108,219,441
180,-90,140,111,108,219,441
-40,-40,-80,110,109,219,386
-110,-90,-150,111,108,219,441
-160,40,100,103,116,219,400
150,-50,110,109,110,219,370
-130,-90,-170,111,108,219,441
-140,-90,-180,111,108,219,441
-120,-90,-160,111,108,219,441
-180,-90,140,111,108,219,441
40,-90,0,111,108,219,441
-140,-90,180,111,108,219,441
10,-90,-30,111,108,219,441
60,-80,20,108,111,219,449
100,20,180,96,123,219,427
-30,50,-40,103,116,219,369
80,-90,40,111,108,219,441
-140,-60,120,99,120,219,436
130,-90,90,111,108,219,441
160,-90,120,111,108,219,441
140,-90,100,111,108,219,441
50,-90,10,111,108,219,441
-70,-90,-110,111,108,219,441
150,-90,110,111,108,219,441
-50,60,-20,106,113,219,340
100,20,-180,96,123,219,427
-30,40,-50,105,114,219,348
-160,30,110,105,114,219,401
80,-50,-60,100,119,219,383
-80,-90,-120,111,108,219,441
-40,-90,-80,111,108,219,441
0,-40,-50,109,110,219,399
60,-90,20,111,108,219,441
120,-90,80,111,108,219,441
90,-90,50,111,108,219,441
140,-60,100,110,109,219,406
-150,-90,170,111,108,219,441
70,-90,30,111,108,219,441
80,70,-130,109,110,219,343
-160,40,90,106,113,219,396
180,-40,80,102,117,219,415
70,10,-110,106,113,219,402
-160,-90,160,111,108,219,441
-80,70,-30,107,112,219,341
-170,-90,150,111,108,219,441
-110,70,60,107,113,220,355
30,80,-80,112,108,220,380
-150,-30,120,116,104,220,464
180,-60,130,107,113,220,427
10,10,-70,109,111,220,443
-10,-70,-50,113,107,220,408
80,30,-140,105,115,220,442
-10,-30,-60,106,114,220,398
-170,0,90,106,114,220,381
90,-20,-20,102,118,220,357
-180,-60,130,107,113,220,427
70,10,160,108,113,221,443
150,-70,40,109,112,221,448
160,40,150,104,117,221,367
60,50,-110,105,116,221,380
30,-50,-20,110,111,221,424
80,-20,-50,110,111,221,357
20,-40,-40,102,119,221,419
-150,-20,120,116,105,221,427
-50,-50,-90,111,110,221,386
20,-50,-30,109,112,221,410
150,-30,50,111,110,221,407
150,-40,110,107,114,221,392
-30,-10,-70,107,115,222,397
120,40,180,108,114,222,453
-30,10,-70,110,112,222,376
100,-60,60,118,104,222,394
70,-60,30,111,111,222,385
160,-60,50,102,120,222,420
100,10,100,109,113,222,431
160,50,80,99,123,222,404
30,-40,-30,116,106,222,411
-160,20,110,109,113,222,399
130,70,100,110,112,222,346
120,40,-180,108,114,222,453
-10,0,-100,114,108,222,424
-150,-70,110,98,124,222,404
20,-10,-60,112,111,223,408
150,0,130,109,114,223,393
40,-40,-20,112,111,223,417
70,10,170,109,114,223,405
-20,-40,-60,109,114,223,437
100,-10,0,114,109,223,321
100,40,-160,108,115,223,449
140,30,90,99,124,223,367
-80,-70,-170,114,109,223,452
-160,40,80,101,123,224,390
50,-70,10,109,115,224,423
-120,-80,140,103,121,224,450
-170,-70,140,112,112,224,445
90,20,140,110,114,224,496
170,-30,80,113,111,224,439
-60,-50,-110,109,115,224,373
-20,-30,-110,106,118,224,459
-30,-80,-70,118,106,224,440
120,-70,80,110,114,224,450
80,50,140,111,113,224,333
-100,60,20,106,119,225,376
50,-80,10,110,115,225,462
-70,60,0,115,110,225,369
-130,60,40,113,112,225,409
-20,30,-60,108,117,225,365
-100,70,50,108,117,225,373
20,-80,-80,104,121,225,431
90,20,130,109,116,225,505
0,-40,-110,108,117,225,436
-50,-80,-90,122,103,225,432
-30,10,-80,112,113,225,373
160,0,130,103,123,226,402
-80,60,0,113,113,226,358
-130,-40,150,121,105,226,415
-40,-70,-130,112,114,226,447
0,80,-120,104,122,226,402
-30,20,-90,111,115,226,443
-50,-40,-120,109,117,226,463
-60,-70,-100,112,114,226,440
180,-20,90,107,119,226,467
30,30,-80,108,118,226,422
-80,-60,-160,116,110,226,379
-160,40,110,112,114,226,384
60,20,160,113,113,226,446
-180,-20,90,107,119,226,467
110,-40,-20,103,123,226,392
-10,50,-50,112,115,227,402
-50,50,-40,109,118,227,363
110,-70,70,108,119,227,451
-140,-70,170,116,111,227,454
80,-80,40,112,115,227,449
20,80,-70,115,112,227,397
-140,60,90,109,118,227,390
-60,-50,-120,111,116,227,392
50,-20,-120,108,119,227,332
-150,-70,160,112,115,227,454
-140,-30,140,114,113,227,475
-160,-70,150,113,114,227,446
80,-30,-80,103,124,227,355
110,40,-170,109,118,227,466
90,-10,20,113,114,227,390
-20,-80,-60,121,106,227,446
70,30,140,116,112,228,418
90,-80,50,114,114,228,454
120,-60,80,115,113,228,395
20,60,-70,101,127,228,391
-120,60,60,110,118,228,442
80,-20,20,117,111,228,324
80,10,-160,112,116,228,460
40,-80,0,112,116,228,455
-50,80,0,102,126,228,415
50,-60,-80,95,133,228,495
70,20,-110,115,113,228,341
0,40,-60,113,115,228,410
-10,-40,-110,108,120,228,431
-20,10,-60,115,113,228,417
70,-80,30,111,117,228,450
-120,60,30,112,116,228,400
110,-10,50,104,124,228,452
60,60,-110,115,114,229,389
110,-60,70,120,109,229,410
120,0,120,113,116,229,495
-70,-80,-110,122,107,229,432
-90,-70,-180,112,117,229,441
100,-20,60,114,115,229,427
0,-70,-40,118,111,229,449
130,40,170,106,123,229,425
-170,70,130,105,124,229,378
100,-80,60,115,114,229,457
40,-70,-80,107,122,229,451
10,-80,-90,107,122,229,451
-90,-70,180,112,117,229,441
90,-50,-50,107,122,229,376
-100,80,-20,110,120,230,348
100,10,110,114,116,230,485
-150,-50,110,112,118,230,449
60,70,-110,110,120,230,370
70,70,-120,113,117,230,356
-150,50,70,116,114,230,408
80,10,-170,114,116,230,421
-10,-80,-50,120,110,230,456
-160,-20,140,116,114,230,411
-60,-80,-100,122,108,230,438
20,-20,-110,102,128,230,459
-150,-10,130,118,113,231,439
-110,60,20,114,117,231,399
110,0,110,110,121,231,453
20,70,-140,106,125,231,434
-30,-20,-100,112,119,231,460
110,-50,-10,114,117,231,434
30,50,-150,102,129,231,478
100,10,90,119,112,231,450
-90,-80,-130,121,110,231,449
140,-30,110,114,117,231,410
-90,60,0,114,117,231,395
-90,60,10,116,115,231,374
90,-70,50,112,119,231,419
120,-10,30,113,118,231,384
-130,-50,160,119,112,231,451
20,-60,-100,106,125,231,465
50,70,-100,110,121,231,385
-110,-80,150,106,125,231,461
70,0,-110,114,118,232,397
-160,30,100,105,127,232,415
60,70,170,116,116,232,399
100,-60,-20,110,122,232,446
130,-30,100,115,117,232,396
-110,80,-10,108,124,232,341
150,-80,110,112,120,232,467
-150,-40,150,113,119,232,486
160,-50,50,105,127,232,336
-140,60,40,121,111,232,422
-120,-50,160,118,114,232,456
-100,60,10,116,116,232,418
-70,-60,-110,120,112,232,412
-40,-30,-80,124,108,232,412
-170,-60,140,119,114,233,459
80,-30,30,105,128,233,342
100,30,110,113,120,233,468
80,-70,-40,109,124,233,474
50,20,-170,118,115,233,401
140,-80,100,112,121,233,463
-150,0,120,119,114,233,409
-150,50,90,111,122,233,432
0,-80,-40,117,116,233,464
170,-30,130,113,120,233,377
-40,40,-50,113,121,234,399
60,10,180,123,111,234,402
-60,-70,-150,119,115,234,476
-60,60,-50,121,113,234,398
-180,50,70,116,118,234,449
180,50,70,116,118,234,449
10,50,-60,112,122,234,395
-80,-80,-120,121,113,234,445
30,-70,-90,111,123,234,472
10,-80,-30,117,117,234,461
80,10,160,114,120,234,433
80,-70,40,115,119,234,428
60,10,-180,123,111,234,402
-150,50,80,117,118,235,423
-140,-70,120,106,129,235,421
-50,50,-30,114,121,235,405
-150,10,110,114,121,235,434
50,-60,10,112,123,235,430
30,-80,-10,115,120,235,462
140,20,150,109,126,235,499
-140,-50,160,119,116,235,490
-160,70,120,110,125,235,365
-130,-60,130,108,127,235,450
-90,80,-30,111,124,235,369
-50,-40,-90,118,117,235,432
-30,-30,-110,111,124,235,459
10,-70,-30,120,116,236,480
0,-50,-110,109,127,236,433
110,-30,-30,115,121,236,332
80,-60,40,120,116,236,409
90,20,-160,116,120,236,446
160,-70,50,113,123,236,509
170,10,80,114,122,236,393
-30,20,-70,109,127,236,403
-40,40,-70,124,112,236,438
-20,50,-40,115,121,236,445
140,-70,100,114,122,236,493
-10,-50,-50,122,114,236,435
-160,20,100,115,121,236,444
-100,-80,160,109,127,236,474
-80,60,20,118,118,236,439
90,20,120,107,129,236,473
-20,-10,-100,117,119,236,411
130,-70,90,114,123,237,480
-170,50,130,110,127,237,366
170,-10,80,114,123,237,481
-180,30,80,117,120,237,422
100,-70,60,114,123,237,435
-30,60,-30,110,127,237,445
120,-10,50,115,122,237,480
0,-60,-40,121,116,237,435
-50,50,-60,124,113,237,407
180,30,80,117,120,237,422
-10,-30,-110,116,121,237,423
120,-80,80,114,123,237,462
-130,60,30,125,112,237,433
130,-80,90,115,122,237,450
40,-50,-90,112,125,237,465
-110,60,50,116,121,237,478
-90,70,40,111,126,237,419
-170,-50,140,118,119,237,450
-160,-10,100,122,115,237,428
170,-60,60,111,127,238,429
-100,-80,-140,125,113,238,455
0,-80,-100,113,125,238,471
90,10,170,118,120,238,425
140,0,130,112,126,238,445
20,10,-70,115,123,238,515
90,-60,-40,105,133,238,465
60,30,-100,116,122,238,349
110,0,60,113,125,238,481
-60,50,-40,119,119,238,413
-90,-80,170,109,129,238,498
-140,-30,130,121,118,239,488
160,-80,120,114,125,239,485
130,-20,110,109,130,239,416
70,60,-120,117,122,239,434
-170,-20,140,121,118,239,391
20,-80,-20,120,119,239,465
10,-30,-50,107,132,239,435
90,-60,50,125,114,239,415
-160,60,120,114,125,239,353
70,-10,-110,114,125,239,436
-70,-50,-120,117,122,239,419
20,60,-140,111,128,239,483
120,-30,90,110,130,240,428
-140,-50,120,115,125,240,488
-20,40,-50,113,127,240,415
100,0,20,124,116,240,441
110,-80,70,120,120,240,471
-160,30,120,115,125,240,420
40,70,-90,114,126,240,412
-10,80,-110,111,129,240,435
60,-20,-120,123,117,240,366
-10,30,-60,114,126,240,430
-160,0,130,116,124,240,405
-160,-80,160,127,113,240,479
-40,30,-70,119,121,240,462
100,-30,-50,110,130,240,385
-170,60,130,110,130,240,387
-90,-60,-140,122,119,241,409
120,-10,20,116,125,241,380
-70,-70,-160,123,118,241,476
-120,-80,-160,125,116,241,470
150,50,160,107,134,241,444
-80,70,30,113,128,241,452
110,10,130,108,133,241,520
50,-40,-90,105,136,241,534
-90,60,30,120,121,241,477
80,-20,-20,113,128,241,412
20,40,-70,118,123,241,423
90,30,120,116,126,242,508
170,60,70,115,127,242,416
160,-10,130,117,125,242,423
90,-70,-30,115,127,242,506
-80,80,-40,118,124,242,393
-150,10,100,122,120,242,486
170,-80,130,118,124,242,473
-110,-80,-150,128,114,242,459
160,-40,50,99,143,242,428
-150,-20,140,120,122,242,509
110,-20,-10,123,120,243,375
80,60,140,119,124,243,378
60,10,170,116,127,243,507
10,-60,-30,124,119,243,483
-160,30,90,112,131,243,411
-150,-80,170,129,114,243,485
-170,70,50,121,122,243,453
-180,50,140,106,137,243,411
180,50,140,106,137,243,411
-30,80,-20,110,133,243,429
-70,70,20,114,129,243,472
-40,80,-10,110,133,243,428
-170,80,130,112,131,243,393
-120,-50,170,127,117,244,487
-60,-50,-100,123,121,244,418
-10,20,-60,115,129,244,465
40,-70,0,117,127,244,487
70,40,-120,117,127,244,460
-80,-80,180,114,130,244,517
-150,20,120,118,126,244,418
-140,-40,160,123,121,244,494
-120,60,20,118,126,244,429
140,60,90,108,136,244,449
-20,20,-60,118,126,244,424
100,10,120,119,125,244,511
10,80,-60,121,123,244,414
-80,-80,-180,114,130,244,517
10,70,-130,109,135,244,473
-50,-70,-140,119,125,244,487
-70,-70,-110,119,125,244,474
80,-40,-70,116,129,245,524
140,0,70,116,129,245,440
-100,60,40,120,125,245,460
-60,60,-10,125,120,245,371
120,40,100,117,128,245,443
180,-80,140,122,123,245,466
100,80,130,117,128,245,452
-170,-80,150,127,118,245,483
-180,-80,140,122,123,245,466
150,-60,110,125,120,245,454
90,-40,-60,116,130,246,491
-30,30,-60,116,130,246,420
-70,-50,-130,121,125,246,443
-130,-80,-170,130,116,246,485
-150,20,110,124,122,246,482
70,20,140,122,124,246,452
-160,-60,150,124,122,246,479
-10,80,-40,120,126,246,427
50,-40,0,122,125,247,395
-50,-50,-80,126,121,247,433
40,0,-140,119,128,247,385
50,60,180,121,126,247,412
-130,-50,170,127,120,247,500
-10,-80,-110,119,128,247,495
-40,-40,-120,122,125,247,490
90,10,180,122,125,247,427
170,-50,60,111,136,247,395
160,20,140,113,134,247,474
170,-70,60,113,134,247,492
150,-40,40,113,134,247,361
70,-50,-70,116,131,247,511
50,60,-180,121,126,247,412
90,10,-180,122,125,247,427
60,-20,-110,123,124,247,486
-170,-40,140,121,127,248,458
-140,-80,-180,131,117,248,486
-140,-80,180,131,117,248,486
-150,50,60,123,125,248,482
-180,70,140,111,137,248,414
120,50,100,127,121,248,434
-170,40,130,118,130,248,424
-20,0,-60,123,125,248,437
180,70,140,111,137,248,414
-110,-50,170,124,125,249,479
-20,80,-30,119,130,249,437
90,30,-150,122,127,249,483
-10,-20,-60,129,120,249,457
-80,60,-20,121,128,249,405
-40,-50,-70,129,120,249,426
60,-30,-100,122,127,249,410
10,-70,-100,111,138,249,490
0,80,-50,123,126,249,431
-10,10,-60,121,128,249,473
110,-10,0,128,121,249,433
110,80,120,122,127,249,457
60,0,-160,124,125,249,469
-160,10,130,122,127,249,420
20,-70,-20,120,130,250,496
110,-60,-10,116,134,250,481
30,-40,-100,122,128,250,572
110,60,-160,120,130,250,439
100,-50,60,123,127,250,384
60,-20,-40,120,130,250,463
-170,30,130,121,129,250,451
-140,-40,120,127,123,250,487
-130,60,80,117,133,250,445
80,20,130,118,132,250,528
90,80,140,121,129,250,462
-150,10,120,122,128,250,411
-100,-60,170,124,126,250,433
-70,-80,-170,118,132,250,516
-50,-50,-130,129,121,250,497
-20,20,-100,122,129,251,473
-130,-60,180,134,117,251,481
-80,-70,-120,129,122,251,485
-130,70,90,126,125,251,403
120,20,160,114,137,251,545
180,80,140,114,137,251,402
-150,70,110,123,128,251,373
-180,80,140,114,137,251,402
-160,80,120,119,132,251,400
100,-70,-20,113,138,251,523
-130,-60,-180,134,117,251,481
60,10,160,122,129,251,516
-100,-60,-150,119,133,252,457
-20,80,-100,117,135,252,443
-160,50,120,125,127,252,402
-30,10,-60,122,130,252,441
-60,-60,-140,129,123,252,466
140,40,90,125,127,252,436
10,60,-130,122,130,252,507
40,10,-80,122,130,252,472
-120,-60,-170,135,117,252,469
-40,50,-30,124,128,252,449
110,-50,-20,116,136,252,496
120,80,110,120,132,252,471
140,70,90,121,131,252,404
-150,80,110,122,130,252,401
0,-30,-110,122,130,252,491
-20,-50,-120,122,131,253,476
20,20,-70,127,126,253,535
140,30,160,118,135,253,495
50,50,180,129,124,253,400
160,-40,120,124,129,253,462
-170,-40,90,112,141,253,488
-60,-50,-130,126,127,253,475
50,50,-180,129,124,253,400
170,-20,80,126,127,253,550
-150,50,100,125,128,253,446
-10,-70,-110,115,139,254,507
90,-50,50,123,131,254,399
70,-40,-80,112,142,254,526
0,70,-120,117,137,254,491
10,-10,-60,129,125,254,474
-140,80,100,121,133,254,418
30,-70,-10,124,130,254,492
-170,-30,140,123,131,254,418
-70,80,-50,124,130,254,440
70,50,-120,129,125,254,449
100,10,80,132,122,254,464
130,-80,20,121,134,255,500
-40,-80,-140,126,129,255,498
-120,-70,-160,134,121,255,529
80,80,150,124,131,255,458
-110,-70,-150,136,119,255,515
-170,-10,90,118,137,255,503
-30,-80,-130,123,132,255,515
110,20,170,114,141,255,528
-20,-80,-120,120,135,255,501
-120,-50,150,122,134,256,505
-40,20,-70,126,130,256,468
-70,60,10,130,126,256,454
50,40,-180,128,128,256,403
50,40,180,128,128,256,403
100,0,30,128,128,256,452
-130,-30,140,131,125,256,463
40,-60,-90,110,146,256,604
110,-80,0,116,140,256,512
30,70,-80,119,137,256,429
60,50,160,127,129,256,418
-70,-60,-150,133,123,256,436
-110,60,10,118,138,256,453
60,0,-90,122,135,257,519
-50,60,-10,129,128,257,483
-60,-80,-160,122,135,257,512
-150,-60,160,128,129,257,502
160,-50,120,123,134,257,441
150,-70,110,126,131,257,529
-40,-60,-130,122,135,257,510
-110,-50,-180,129,128,257,470
-160,50,60,123,134,257,465
70,0,-160,128,129,257,433
110,20,90,117,140,257,455
-170,30,80,122,135,257,430
80,-20,-40,130,127,257,442
0,0,-110,125,132,257,540
-40,40,-40,125,132,257,471
-110,-50,180,129,128,257,470
-50,40,-50,131,127,258,477
-80,-50,-140,129,129,258,433
140,-20,50,124,134,258,490
-160,60,50,128,130,258,459
-130,-40,160,128,130,258,481
100,-10,60,126,132,258,479
-40,-50,-130,125,133,258,508
-150,-40,110,131,127,258,505
100,60,-150,128,130,258,468
100,-10,50,124,134,258,512
-50,80,-70,125,133,258,475
-50,-80,-150,129,129,258,508
90,-30,50,127,131,258,465
90,60,130,131,127,258,404
-160,20,130,131,128,259,455
-30,80,-90,121,138,259,455
-40,60,-20,121,138,259,478
80,60,-130,129,130,259,483
-150,60,110,135,124,259,386
-100,-50,-170,128,131,259,422
-90,-70,-130,138,121,259,509
90,40,120,130,129,259,496
-60,50,-30,120,139,259,416
-160,-50,150,124,135,259,494
-30,0,-60,126,133,259,461
130,10,140,122,138,260,547
-160,70,40,127,133,260,498
80,-20,-70,120,140,260,394
160,-30,60,127,133,260,526
-180,-50,70,112,148,260,446
-130,-70,130,116,144,260,479
180,-50,70,112,148,260,446
-60,-40,-120,129,131,260,493
90,20,110,125,135,260,510
70,-20,-120,122,139,261,473
-30,20,-60,123,138,261,464
-60,70,10,126,135,261,497
-140,-60,170,133,128,261,512
120,-80,10,120,141,261,493
20,-70,-100,126,135,261,527
-130,80,90,127,134,261,422
-40,30,-60,122,139,261,480
50,-10,-140,129,132,261,444
-140,-10,130,130,131,261,480
-140,70,100,131,130,261,395
80,10,150,133,128,261,508
130,80,100,124,137,261,479
130,-20,30,127,134,261,413
170,20,80,124,137,261,443
100,-80,-10,123,139,262,522
-130,-40,130,134,128,262,491
-180,-70,70,119,143,262,538
110,-20,-20,123,139,262,388
90,60,-140,131,131,262,485
-50,-40,-80,131,131,262,496
70,-20,0,127,135,262,371
180,-70,70,119,143,262,538
-10,70,-110,122,140,262,506
-30,-40,-120,122,140,262,523
-90,60,-10,125,137,262,437
70,-10,-150,128,134,262,412
170,70,150,113,149,262,457
10,-20,-110,117,145,262,586
130,50,-180,119,144,263,510
-160,10,90,127,136,263,491
30,-50,-100,121,142,263,562
-110,-60,-160,137,126,263,494
60,-50,-80,120,143,263,599
-40,80,-80,123,140,263,476
80,20,-140,124,139,263,494
130,50,180,119,144,263,510
30,-20,-50,124,139,263,505
-130,-70,-170,141,123,264,527
80,40,130,129,135,264,481
80,0,-130,123,141,264,428
-150,-10,110,129,135,264,473
100,20,100,123,141,264,500
-60,80,-60,128,136,264,472
-60,-50,-90,138,126,264,491
-180,-60,70,124,140,264,479
180,-60,70,124,140,264,479
-140,50,70,131,133,264,502
100,10,130,122,142,264,565
-100,60,0,128,136,264,475
60,-40,-90,117,148,265,521
-150,0,100,128,137,265,469
-10,0,-60,124,141,265,523
-20,70,-100,130,135,265,515
-100,-50,-180,135,130,265,456
-50,40,-40,123,142,265,493
-30,0,-90,136,129,265,469
-100,-50,180,135,130,265,456
90,-20,-30,130,135,265,458
70,-20,-40,129,137,266,459
-20,-60,-120,124,142,266,498
80,50,-130,136,130,266,550
-60,-40,-110,133,134,267,468
-150,-70,170,142,125,267,518
-150,0,130,135,132,267,475
160,20,80,126,141,267,444
90,-40,50,126,141,267,461
-160,40,120,134,133,267,477
40,30,-160,133,134,267,479
90,-10,0,132,135,267,428
-10,-10,-60,137,130,267,561
10,60,-60,119,148,267,455
20,70,-70,124,143,267,442
160,-60,120,135,132,267,510
170,30,140,124,143,267,482
140,10,140,119,149,268,545
140,-80,30,127,141,268,516
-100,-70,-140,144,124,268,526
80,-50,40,132,136,268,461
70,-30,20,130,138,268,382
-60,60,0,138,130,268,479
-70,60,-40,136,132,268,460
-180,60,60,132,137,269,514
180,60,60,132,137,269,514
-160,20,90,124,145,269,477
110,0,30,130,139,269,475
80,-80,-30,123,146,269,577
70,80,160,136,133,269,472
-150,-50,160,131,138,269,525
-160,-40,100,121,148,269,516
100,0,80,134,135,269,505
70,-20,-100,133,136,269,452
90,-80,-20,124,145,269,540
40,20,-150,134,135,269,456
60,20,150,136,133,269,513
110,10,70,132,137,269,527
50,70,-180,131,138,269,447
50,70,180,131,138,269,447
150,-80,40,136,133,269,533
50,10,-170,135,135,270,462
140,50,170,126,144,270,505
-20,-30,-60,136,134,270,521
0,-10,-60,132,138,270,525
70,0,-170,127,143,270,472
60,30,150,134,136,270,490
130,0,130,126,144,270,511
20,-10,-120,132,138,270,559
-120,-40,150,133,137,270,517
50,20,-90,136,134,270,477
70,-20,-110,139,132,271,472
100,60,120,134,137,271,460
-90,-50,-150,129,142,271,462
40,-20,-120,132,139,271,506
-50,-30,-100,147,124,271,457
-40,-30,-110,136,135,271,499
-70,50,-30,132,139,271,499
100,-20,-30,137,134,271,433
90,10,160,128,144,272,533
-70,-50,-110,141,131,272,495
160,-80,50,140,132,272,547
120,-10,110,129,143,272,530
-40,20,-80,136,136,272,499
70,-80,-40,122,150,272,586
180,60,140,122,150,272,505
60,-10,-60,122,150,272,471
90,-20,-40,133,139,272,438
-170,-50,80,118,154,272,492
-180,60,140,122,150,272,505
80,10,-130,128,144,272,463
-40,10,-70,139,133,272,468
20,-60,-20,133,139,272,568
-90,-60,-180,139,134,273,494
-120,-70,140,123,150,273,507
-50,-60,-80,136,137,273,488
170,-40,60,117,156,273,530
30,-30,-40,122,151,273,488
-140,50,80,133,140,273,523
-30,10,-90,134,139,273,517
160,40,80,137,136,273,439
-90,-60,180,139,134,273,494
60,-50,20,135,138,273,417
-80,-60,-120,140,133,273,508
-160,-10,140,136,138,274,433
-120,-60,140,127,147,274,519
-40,30,-50,137,137,274,504
70,-20,-130,134,140,274,460
150,40,160,124,150,274,528
120,-30,0,133,141,274,502
10,-50,-110,124,150,274,526
90,-10,40,138,136,274,500
-10,-60,-120,129,145,274,563
-120,-40,160,139,135,274,514
110,-70,-10,124,150,274,570
-130,-30,150,139,135,274,478
30,20,-140,134,140,274,532
-100,-50,-160,133,141,274,465
-50,50,-20,134,140,274,489
-140,60,100,144,131,275,467
-160,-70,160,142,133,275,532
170,-80,60,140,135,275,555
70,40,140,133,142,275,519
160,-70,120,133,142,275,561
70,60,150,129,146,275,466
10,-60,-110,126,149,275,587
-40,-20,-90,142,133,275,496
120,-20,100,127,148,275,547
80,10,-140,136,139,275,531
150,0,70,129,146,275,561
170,-40,130,133,142,275,553
-140,-70,-180,145,131,276,518
80,10,-150,134,142,276,513
140,80,90,134,142,276,495
-140,-70,180,145,131,276,518
150,-20,60,134,142,276,630
90,-20,-50,130,146,276,446
-170,-60,80,132,144,276,510
70,-50,30,132,144,276,441
100,0,70,138,138,276,475
-120,70,80,137,139,276,437
-120,80,80,139,137,276,445
-20,-10,-60,138,139,277,563
-140,-30,150,137,140,277,538
-140,50,60,134,143,277,506
-150,40,80,131,146,277,543
-140,-10,140,146,131,277,546
100,0,60,134,143,277,509
80,40,-130,142,135,277,566
-60,50,-50,148,129,277,479
120,-10,10,134,143,277,440
-20,-40,-120,129,148,277,554
-40,-20,-80,140,137,277,468
130,-10,120,129,148,277,564
-50,40,-60,140,137,277,524
-60,50,-20,131,146,277,459
100,-60,-30,131,146,277,545
180,-80,70,139,139,278,559
-180,-80,70,139,139,278,559
150,10,140,127,151,278,503
-150,70,30,136,142,278,478
60,0,-170,139,139,278,441
0,-10,-110,125,153,278,548
-40,-60,-70,143,135,278,505
-60,-60,-90,140,138,278,505
50,-30,-20,131,147,278,484
100,0,10,135,143,278,506
-150,40,70,135,143,278,560
-90,-50,-160,128,150,278,474
120,-40,0,135,144,279,524
50,30,-90,141,138,279,463
80,-70,-50,138,141,279,552
170,60,150,130,149,279,596
-30,40,-40,133,146,279,504
150,-30,120,139,140,279,499
-60,-40,-100,143,136,279,491
50,40,-90,134,145,279,460
70,10,150,138,141,279,551
-80,-50,-130,133,146,279,494
-150,20,100,132,147,279,568
170,80,150,128,152,280,432
-70,-50,-140,134,146,280,548
90,10,150,136,144,280,578
170,-70,130,134,146,280,558
50,10,-160,137,143,280,557
120,10,140,128,152,280,586
20,30,-70,131,149,280,584
-120,-50,-180,152,128,280,543
-120,-50,180,152,128,280,543
50,30,180,133,148,281,492
-30,30,-50,131,150,281,468
100,0,90,131,150,281,508
-130,-50,130,140,141,281,519
-120,60,70,135,146,281,499
10,-40,-110,130,151,281,550
-160,-60,90,136,145,281,539
180,0,80,138,143,281,498
-80,60,-30,147,134,281,469
-180,0,80,138,143,281,498
50,30,-180,133,148,281,492
-20,-70,-120,128,153,281,598
-150,40,90,137,144,281,573
0,20,-60,131,150,281,525
-40,-40,-70,137,145,282,513
80,20,120,136,146,282,553
110,0,20,137,145,282,486
160,70,160,127,155,282,507
180,20,80,134,148,282,452
60,-80,-50,127,155,282,621
0,60,-120,137,145,282,502
120,10,70,136,146,282,584
-170,-70,80,130,152,282,582
-150,30,90,135,147,282,593
-40,-10,-80,142,140,282,474
50,-80,-60,127,155,282,633
120,0,60,141,141,282,572
100,20,-170,134,148,282,517
-80,-50,-150,137,145,282,470
-180,20,80,134,148,282,452
-30,70,-90,143,140,283,518
-20,-20,-110,140,143,283,547
-30,50,-30,141,142,283,553
30,-20,-120,136,147,283,595
110,0,40,136,147,283,534
110,30,-170,131,153,284,585
-10,-20,-110,138,146,284,569
170,-60,130,145,139,284,552
-70,50,-20,138,146,284,501
-50,30,-60,138,146,284,527
-130,-40,170,147,137,284,528
-40,0,-80,140,144,284,493
70,-10,-100,132,152,284,530
90,10,-170,146,139,285,513
-110,-70,150,128,157,285,569
40,-60,0,132,153,285,548
150,-10,130,134,151,285,513
120,-60,0,135,150,285,564
140,-10,60,132,153,285,600
-170,-70,150,142,143,285,549
50,-50,-90,132,153,285,672
-140,-20,140,144,141,285,556
150,70,80,136,149,285,485
-140,-20,130,148,137,285,537
90,-30,-70,133,153,286,517
-170,-80,80,140,147,287,582
30,-60,-10,141,146,287,562
-30,-50,-60,147,140,287,476
-10,60,-110,139,148,287,491
110,-40,-30,133,154,287,517
-20,0,-100,138,149,287,527
80,-20,-30,140,148,288,503
-160,40,70,135,153,288,525
170,30,80,135,153,288,497
10,-70,-110,133,155,288,603
-20,10,-100,147,141,288,582
-150,60,40,143,145,288,524
100,-10,70,137,151,288,521
10,70,-60,135,153,288,490
-150,-10,140,155,133,288,530
-140,70,20,145,144,289,458
-90,-70,170,137,152,289,591
170,20,140,139,150,289,572
-40,20,-60,139,150,289,533
110,0,50,136,153,289,613
-150,-60,100,143,146,289,549
70,-70,-60,139,150,289,566
110,60,110,138,151,289,547
80,0,-140,143,146,289,493
-150,-30,150,140,150,290,573
150,80,80,143,147,290,528
-70,-60,-100,151,139,290,538
0,30,-60,131,159,290,545
-90,-50,-170,140,150,290,515
110,-10,100,131,159,290,533
-150,30,100,142,148,290,607
120,-50,0,140,150,290,531
50,0,-150,143,147,290,510
-40,-10,-70,151,140,291,506
-20,-20,-60,141,150,291,524
-90,60,40,143,148,291,574
100,30,-160,136,155,291,577
-100,-70,160,135,156,291,581
160,-20,70,142,149,291,632
0,10,-60,133,158,291,589
-110,-50,-170,149,142,291,527
60,80,170,144,147,291,478
150,20,80,139,152,291,492
10,40,-60,146,145,291,511
110,10,140,128,163,291,613
-50,-30,-110,153,139,292,513
-140,-50,170,148,144,292,552
-160,-20,100,137,155,292,574
110,-60,-20,142,150,292,548
120,50,-170,134,158,292,549
60,-70,-70,138,154,292,585
-140,60,30,152,140,292,541
-130,50,60,147,145,292,551
10,-40,-40,135,157,292,622
20,50,-140,137,156,293,580
-130,-30,160,150,143,293,533
130,-20,20,136,157,293,448
-170,50,60,141,152,293,558
-160,-80,90,139,154,293,593
-110,-50,160,143,150,293,558
40,70,-170,141,152,293,502
-40,0,-70,149,144,293,487
-40,10,-60,148,145,293,513
-50,-60,-140,142,151,293,618
-150,40,100,143,150,293,601
-50,70,0,139,154,293,559
-180,-70,140,146,148,294,572
-140,-30,120,154,140,294,596
-160,30,80,138,156,294,507
50,-30,-110,145,149,294,625
40,-40,-100,131,163,294,621
0,-70,-110,134,160,294,596
180,-70,140,146,148,294,572
100,0,40,149,145,294,546
-60,50,-10,146,148,294,516
-130,50,50,147,147,294,548
-160,0,90,148,146,294,524
-110,80,70,146,148,294,478
90,-70,-40,149,145,294,538
150,50,80,139,156,295,567
120,30,180,140,155,295,617
180,40,140,143,152,295,550
-50,-30,-90,158,137,295,527
-30,30,-90,145,150,295,546
-160,-40,150,146,149,295,557
0,0,-60,139,156,295,603
-100,50,20,156,139,295,612
-110,60,60,150,145,295,567
-150,30,110,149,146,295,534
120,30,-180,140,155,295,617
160,80,160,139,156,295,469
-20,30,-50,146,149,295,576
-80,60,30,148,147,295,560
110,-30,80,147,148,295,576
-180,40,140,143,152,295,550
70,-20,10,153,142,295,432
30,-60,-100,135,160,295,687
-50,-70,-80,149,147,296,539
60,-10,-150,147,149,296,516
-50,-40,-130,152,144,296,588
90,50,-140,151,145,296,628
80,30,-130,140,156,296,581
130,30,90,139,157,296,525
-10,40,-50,143,153,296,514
-110,70,70,142,154,296,484
-150,-20,110,149,147,296,598
110,50,-160,135,162,297,571
-180,0,140,145,152,297,564
30,-30,-110,135,162,297,636
-150,-80,100,138,159,297,623
130,20,160,141,156,297,640
50,-20,-40,136,161,297,574
-150,10,130,146,151,297,520
80,-10,-140,145,152,297,491
-60,-70,-90,149,148,297,547
80,0,170,144,153,297,618
70,-20,-140,148,149,297,506
180,0,140,145,152,297,564
-60,40,-40,148,149,297,559
-40,30,-80,148,150,298,541
40,20,-80,157,141,298,581
80,-40,40,143,155,298,490
-50,30,-50,147,151,298,549
160,-20,130,136,162,298,510
-90,-60,-130,149,149,298,569
-40,50,-20,148,150,298,581
-70,50,-10,149,150,299,524
70,0,170,139,160,299,595
60,40,150,150,149,299,533
-100,80,60,145,154,299,500
30,40,-150,143,156,299,626
-40,-70,-70,149,150,299,560
20,0,-130,147,152,299,544
50,-70,-80,140,159,299,630
-20,60,-100,144,155,299,516
-160,-70,90,141,158,299,611
-130,60,90,151,148,299,539
170,50,70,138,162,300,549
-170,-10,140,145,155,300,504
-100,60,50,149,151,300,578
70,-20,-30,148,152,300,545
40,-80,-70,134,166,300,662
160,70,70,148,152,300,524
-30,-70,-130,137,163,300,658
80,0,180,154,146,300,578
-10,-50,-120,144,156,300,622
70,-80,-50,138,162,300,641
80,0,-180,154,146,300,578
-120,-60,-160,155,145,300,596
0,-20,-110,137,163,300,634
100,-40,-50,140,160,300,501
30,10,-70,147,154,301,599
-80,-60,-170,151,150,301,555
100,-50,-40,135,166,301,555
-50,30,-40,152,149,301,550
-130,70,10,153,148,301,479
-40,70,-80,150,151,301,536
-40,40,-30,152,149,301,563
10,0,-60,145,156,301,627
-50,40,-30,144,157,301,528
100,10,140,140,161,301,680
140,20,80,144,157,301,525
-80,-50,-120,153,148,301,561
-70,-50,-100,156,145,301,557
-80,-70,-180,142,160,302,599
100,40,110,136,166,302,554
90,10,140,145,157,302,627
-140,50,50,147,155,302,614
50,80,-180,150,152,302,480
110,0,10,147,155,302,530
0,-50,-40,150,152,302,544
-150,50,110,154,148,302,531
-80,-70,180,142,160,302,599
50,80,180,150,152,302,480
60,-20,-130,147,155,302,491
40,-30,-110,144,158,302,588
-30,-10,-100,145,158,303,542
-120,50,50,152,151,303,559
-40,-30,-70,152,151,303,553
80,-10,-130,144,159,303,501
70,-10,-90,141,162,303,515
-160,-60,160,150,153,303,593
-70,-70,-100,150,153,303,558
-30,-20,-110,144,159,303,537
-70,-40,-120,147,156,303,513
80,-80,-40,137,166,303,640
60,-80,-60,139,164,303,630
-40,70,-10,147,157,304,576
110,10,150,145,159,304,707
90,-20,50,150,154,304,523
10,-30,-110,140,164,304,669
0,60,-50,140,164,304,541
-40,-70,-140,146,158,304,685
160,80,70,147,157,304,575
-120,-30,150,154,150,304,529
110,30,100,137,167,304,550
-150,-30,110,155,149,304,590
-160,-30,100,151,153,304,614
-10,20,-110,146,158,304,542
170,50,150,138,167,305,571
150,80,170,144,161,305,497
-40,-20,-100,158,147,305,548
-40,-20,-70,148,157,305,564
-160,-50,90,133,172,305,588
-140,50,90,140,165,305,580
-150,30,120,149,156,305,582
20,0,-60,151,154,305,624
100,10,150,149,156,305,678
80,-20,-80,150,155,305,463
100,-70,-30,151,154,305,577
180,-60,140,152,154,306,595
40,60,-170,153,153,306,543
-180,10,80,148,158,306,513
160,60,160,142,164,306,616
-180,-60,140,152,154,306,595
-70,60,20,152,154,306,551
180,10,80,148,158,306,513
30,-10,-130,149,157,306,601
-30,-10,-60,151,155,306,554
40,-70,-90,138,168,306,662
-120,-40,170,153,153,306,602
70,-20,-10,154,152,306,531
-130,-30,130,160,147,307,572
30,-80,-80,137,170,307,683
-60,-60,-150,156,151,307,626
-80,50,-10,152,155,307,572
-130,-60,-170,167,140,307,585
100,10,60,151,156,307,624
140,-30,30,139,168,307,486
50,20,180,158,150,308,564
40,-50,-100,144,164,308,706
90,-80,-30,136,172,308,652
-100,-50,170,154,154,308,531
-60,-50,-140,149,159,308,625
-130,50,70,153,155,308,597
-40,10,-80,149,159,308,528
-120,50,40,154,154,308,554
-150,-70,100,151,157,308,636
50,-80,-70,143,165,308,639
50,20,-180,158,150,308,564
20,-20,-120,147,161,308,613
110,0,120,145,164,309,642
100,-20,-40,148,161,309,519
-70,-40,-130,158,151,309,521
-60,-40,-130,149,160,309,590
50,0,-70,142,167,309,541
80,30,120,153,156,309,642
-90,-50,-140,149,160,309,528
-110,50,40,154,155,309,576
-140,-30,160,153,156,309,581
0,50,-50,147,162,309,550
0,70,-50,149,160,309,520
50,20,160,157,153,310,586
70,0,-180,151,159,310,576
50,30,170,152,158,310,572
-140,-60,180,164,146,310,589
-10,70,-40,148,162,310,562
-30,-60,-130,144,166,310,653
130,-10,50,150,160,310,594
150,20,150,145,165,310,612
100,10,160,142,168,310,661
70,30,-110,148,162,310,552
-60,40,-30,142,168,310,564
80,20,-130,148,162,310,560
-80,50,0,158,152,310,577
70,0,180,151,159,310,576
-140,-60,-180,164,146,310,589
90,10,120,148,162,310,643
-20,30,-100,152,159,311,534
-90,50,10,160,151,311,592
-70,50,0,156,155,311,575
80,10,-120,146,165,311,546
100,10,70,158,153,311,604
130,10,70,147,164,311,582
-130,50,40,155,157,312,613
160,30,150,145,167,312,589
40,80,-170,149,163,312,516
-170,-60,150,153,159,312,643
-80,50,10,161,151,312,579
-40,30,-40,154,158,312,565
-140,-80,110,147,165,312,650
40,-80,-80,144,168,312,650
-150,40,110,158,154,312,597
-90,50,20,159,153,312,619
-140,-10,120,157,155,312,551
-110,-60,-150,162,150,312,607
120,-70,0,141,171,312,624
-100,-60,-140,162,151,313,605
-150,50,50,152,161,313,611
50,-50,10,156,157,313,524
-30,-60,-60,162,151,313,547
100,10,170,146,167,313,598
90,10,130,146,167,313,659
-50,-30,-80,162,151,313,597
130,30,170,134,179,313,647
60,0,180,159,155,314,580
-160,30,130,162,152,314,562
-140,0,120,164,150,314,537
120,-40,-10,153,161,314,599
-40,-10,-90,159,155,314,591
20,-30,-110,138,176,314,699
60,0,-180,159,155,314,580
-140,-20,120,159,155,314,665
-170,40,70,147,168,315,558
-70,-60,-160,155,160,315,576
-20,70,-30,151,164,315,587
100,50,-150,147,168,315,664
70,-10,-80,149,166,315,597
-30,20,-50,150,165,315,568
-150,20,90,148,167,315,618
-130,-50,180,165,150,315,593
-130,-50,-180,165,150,315,593
-70,-70,-170,149,167,316,635
20,-40,-110,147,169,316,676
20,-50,-110,151,165,316,686
10,50,-130,153,163,316,614
90,40,-140,165,151,316,676
-80,-70,-110,157,159,316,597
-180,-20,140,153,163,316,520
-140,10,110,151,165,316,555
70,20,130,156,160,316,583
180,-20,140,153,163,316,520
-10,-40,-50,155,161,316,590
160,10,140,155,162,317,547
-40,-40,-130,155,162,317,640
30,0,-60,154,163,317,629
100,0,100,151,166,317,598
-130,60,20,156,161,317,561
20,-80,-90,143,174,317,711
10,0,-120,152,165,317,578
-60,-40,-90,167,150,317,563
-150,-50,100,144,173,317,626
180,-10,140,153,165,318,621
-170,60,50,161,157,318,611
100,20,90,152,166,318,580
100,-80,-20,143,175,318,689
-70,-50,-150,153,165,318,655
130,0,60,157,161,318,653
-30,60,-90,151,167,318,567
-180,-10,140,153,165,318,621
10,-10,-120,149,169,318,671
60,10,150,156,162,318,608
40,-30,-30,151,167,318,587
-110,60,0,156,162,318,590
-140,-40,170,167,152,319,568
10,10,-60,151,168,319,669
-150,30,80,154,165,319,592
-100,50,30,162,157,319,611
-100,70,60,152,167,319,543
-90,60,-20,158,161,319,542
-30,70,-20,151,168,319,600
-10,-10,-110,148,171,319,652
180,90,140,154,166,320,588
50,-60,-90,159,161,320,735
40,90,-80,154,166,320,588
-140,90,100,154,166,320,588
90,90,-130,154,166,320,588
-120,90,80,154,166,320,588
-60,90,20,154,166,320,588
70,90,-110,154,166,320,588
140,90,180,154,166,320,588
-90,-70,-120,163,157,320,631
150,90,170,154,166,320,588
-120,60,10,161,159,320,590
130,90,-170,154,166,320,588
80,90,-120,154,166,320,588
20,90,-60,154,166,320,588
-30,90,-10,154,166,320,588
-130,90,90,154,166,320,588
140,90,-180,154,166,320,588
-120,50,30,164,156,320,623
-180,-40,70,145,175,320,609
-180,90,140,154,166,320,588
-140,-60,110,162,158,320,601
-100,90,60,154,166,320,588
60,90,-100,154,166,320,588
-150,-60,170,166,154,320,588
-70,90,30,154,166,320,588
170,90,150,154,166,320,588
120,90,-160,154,166,320,588
-50,90,10,154,166,320,588
30,90,-70,154,166,320,588
-150,90,110,154,166,320,588
-50,-70,-150,152,168,320,688
160,90,160,154,166,320,588
50,90,-90,154,166,320,588
-40,90,0,154,166,320,588
-120,-50,-170,170,150,320,624
10,90,-50,154,166,320,588
-90,90,50,154,166,320,588
-110,90,70,154,166,320,588
110,90,-150,154,166,320,588
0,90,-40,154,166,320,588
-20,90,-20,154,166,320,588
0,20,-120,151,169,320,554
180,-40,70,145,175,320,609
100,90,-140,154,166,320,588
-80,90,40,154,166,320,588
-160,90,120,154,166,320,588
-170,90,130,154,166,320,588
-10,90,-30,154,166,320,588
120,-20,0,168,153,321,566
170,80,60,154,167,321,612
60,40,-100,152,169,321,550
-30,-40,-60,159,162,321,597
-50,50,-10,158,163,321,600
-100,50,10,158,163,321,635
170,-30,70,161,160,321,682
-60,40,-50,160,161,321,616
50,20,170,167,155,322,614
-110,50,30,165,157,322,571
-170,-20,90,148,174,322,652
170,-50,130,152,170,322,588
-40,20,-50,163,159,322,589
-30,10,-50,162,160,322,581
150,60,80,150,172,322,625
-70,-40,-110,167,155,322,577
-30,-70,-60,161,161,322,599
0,-30,-50,157,165,322,560
-50,70,-70,166,156,322,571
-80,-50,-160,157,166,323,570
-110,50,20,165,158,323,626
80,0,-120,153,170,323,528
-110,-60,150,153,170,323,586
120,60,100,156,167,323,619
-170,-30,90,164,159,323,621
170,70,60,159,164,323,590
-140,0,110,163,160,323,563
-10,-40,-120,147,176,323,612
80,0,-170,157,166,323,617
100,0,50,151,172,323,624
140,-20,120,155,168,323,583
30,-80,-90,151,172,323,670
-170,-90,80,149,175,324,641
-150,-90,100,149,175,324,641
130,-90,20,149,175,324,641
-160,-90,90,149,175,324,641
-80,-90,170,149,175,324,641
180,-90,70,149,175,324,641
140,80,-180,156,168,324,565
10,-90,-100,149,175,324,641
30,-90,-80,149,175,324,641
-140,-90,110,149,175,324,641
-90,-90,160,149,175,324,641
110,20,-180,149,175,324,649
80,-90,-30,149,175,324,641
140,10,70,159,165,324,629
-100,-90,150,149,175,324,641
-120,-90,130,149,175,324,641
90,20,-150,166,158,324,636
110,20,180,149,175,324,649
-110,-90,140,149,175,324,641
-70,-90,180,149,175,324,641
80,-40,-80,150,174,324,598
50,-90,-60,149,175,324,641
-180,-90,70,149,175,324,641
0,-90,-110,149,175,324,641
-50,-90,-160,149,175,324,641
160,-90,50,149,175,324,641
-60,-90,-170,149,175,324,641
20,-90,-90,149,175,324,641
-30,-90,-140,149,175,324,641
100,-90,-10,149,175,324,641
-10,-70,-120,153,171,324,682
110,-90,0,149,175,324,641
140,80,180,156,168,324,565
-10,-90,-120,149,175,324,641
120,-90,10,149,175,324,641
-20,-90,-130,149,175,324,641
-70,-90,-180,149,175,324,641
90,-90,-20,149,175,324,641
110,-30,-40,153,171,324,523
-130,-90,120,149,175,324,641
40,-90,-70,149,175,324,641
170,-90,60,149,175,324,641
150,-90,40,149,175,324,641
70,-90,-40,149,175,324,641
140,-90,30,149,175,324,641
60,-90,-50,149,175,324,641
-40,-90,-150,149,175,324,641
-50,20,-60,161,164,325,617
180,-30,140,162,163,325,561
-150,10,90,161,164,325,641
110,-70,-20,156,169,325,611
-180,-10,80,153,172,325,633
-80,-60,-110,166,159,325,582
60,-60,-80,150,175,325,737
-40,10,-50,165,160,325,559
180,-10,80,153,172,325,633
-50,40,-20,163,162,325,604
-180,-30,140,162,163,325,561
80,-30,-90,156,169,325,528
-20,-30,-120,156,169,325,627
120,10,150,145,180,325,738
90,70,130,161,165,326,538
70,-30,-100,161,165,326,627
60,0,170,165,161,326,627
-100,-50,-150,160,166,326,556
80,-20,30,159,167,326,535
70,0,-100,155,171,326,617
-60,30,-40,162,164,326,605
20,-20,-50,158,168,326,636
-150,-20,150,163,163,326,649
80,-50,-70,149,177,326,714
60,-30,10,160,166,326,499
-80,-50,-110,163,164,327,620
-120,-30,160,166,161,327,622
150,70,170,147,180,327,563
-30,-30,-120,157,170,327,626
-140,0,130,168,159,327,596
-50,-30,-120,174,153,327,606
60,-30,-110,160,167,327,661
-130,-20,140,160,167,327,584
-70,-80,-100,168,159,327,645
90,10,110,159,169,328,651
-110,-40,180,172,156,328,607
80,10,140,160,168,328,644
-110,-40,170,165,163,328,595
130,-60,10,155,173,328,703
70,-20,-20,153,175,328,556
-40,60,-80,160,168,328,603
-110,-40,-180,172,156,328,607
120,-30,-10,161,167,328,574
-60,60,10,167,161,328,600
150,-30,40,142,186,328,595
-100,60,-10,167,161,328,596
10,-80,-100,145,184,329,752
-110,-50,-160,160,169,329,602
-100,-70,-130,171,158,329,664
160,-10,70,143,186,329,677
-150,20,130,162,167,329,605
50,-40,-100,152,177,329,663
-120,50,60,166,163,329,645
-60,-70,-160,158,171,329,672
80,70,140,166,163,329,599
-150,-40,160,166,164,330,637
70,-60,-70,144,186,330,724
30,10,-140,162,168,330,607
70,-40,-90,158,172,330,609
70,30,130,154,176,330,615
0,-60,-120,148,182,330,666
-60,-80,-90,171,159,330,653
130,20,80,160,170,330,622
-180,30,140,151,179,330,628
-140,10,100,165,165,330,616
-140,-70,110,161,169,330,673
-40,0,-60,169,161,330,601
180,30,140,151,179,330,628
130,40,-180,155,176,331,638
-10,60,-40,161,170,331,592
-50,-80,-80,170,161,331,650
-50,-50,-140,160,171,331,649
-150,40,60,164,167,331,680
140,20,160,158,173,331,740
130,40,180,155,176,331,638
-130,-80,120,158,173,331,694
0,-70,-120,156,176,332,693
60,-10,-160,160,172,332,602
-90,80,50,155,177,332,537
130,80,-170,158,174,332,600
-150,-10,100,163,169,332,675
80,50,130,171,161,332,630
-20,40,-40,166,166,332,606
120,0,130,159,173,332,708
-80,-80,-110,175,157,332,643
-90,-60,-120,167,165,332,608
-80,50,-20,164,168,332,618
40,50,-170,166,166,332,606
140,-20,40,163,170,333,593
70,-50,-80,149,184,333,719
140,40,170,152,181,333,689
100,-20,70,164,169,333,618
80,-10,10,173,160,333,541
-140,20,100,159,174,333,657
60,-20,-140,166,167,333,543
-90,50,0,169,165,334,639
90,0,30,170,164,334,576
70,10,140,164,170,334,635
-30,-50,-130,153,181,334,684
-80,50,20,171,163,334,647
-10,30,-110,157,177,334,565
60,60,160,164,170,334,626
20,-80,-100,160,174,334,717
-120,70,0,160,174,334,527
170,40,150,155,180,335,644
50,10,160,167,168,335,627
-60,70,-60,174,161,335,623
80,0,-150,166,169,335,618
-180,10,140,165,170,335,632
180,10,140,165,170,335,632
60,-50,-90,160,175,335,712
30,-70,-100,157,178,335,701
70,50,140,168,167,335,579
-140,40,70,164,171,335,680
-110,70,-10,157,178,335,554
-140,10,120,160,176,336,588
-140,50,40,167,169,336,669
70,-10,-60,156,180,336,602
-170,20,80,161,175,336,569
-140,-50,110,155,181,336,660
0,50,-120,170,166,336,627
-40,-30,-120,164,172,336,655
-20,50,-100,160,176,336,632
-120,-40,140,167,169,336,619
-120,60,80,167,169,336,577
-60,50,0,168,169,337,610
170,0,140,160,177,337,649
50,50,-90,158,179,337,527
-90,70,50,163,174,337,580
160,0,70,149,188,337,702
-70,50,-40,170,167,337,604
100,70,120,168,169,337,549
-90,-80,-120,178,159,337,634
-30,-80,-60,177,160,337,656
70,-30,-110,168,169,337,581
50,-30,-120,159,178,337,620
-90,50,30,175,163,338,714
80,-10,-120,160,178,338,557
110,-20,-30,160,178,338,516
90,-40,-70,163,175,338,637
-60,-30,-100,186,152,338,614
130,50,90,168,170,338,602
-160,50,130,165,173,338,624
-50,-20,-100,182,156,338,658
-120,-50,140,161,177,338,667
180,40,70,155,183,338,638
-90,-50,-130,170,168,338,631
-140,40,80,171,167,338,721
-20,20,-50,163,175,338,670
-110,50,50,164,174,338,681
30,80,-160,169,169,338,570
-70,50,10,170,168,338,622
-180,40,70,155,183,338,638
-140,-20,150,171,168,339,649
40,10,-150,161,178,339,618
-140,20,110,168,171,339,578
130,10,150,158,181,339,688
100,-10,-10,176,163,339,566
70,-10,-160,168,171,339,585
-180,-30,80,163,176,339,667
160,30,80,147,192,339,643
-60,40,-20,157,182,339,614
180,-30,80,163,176,339,667
-110,-40,-170,167,172,339,677
-170,0,140,168,172,340,651
-10,10,-110,164,176,340,642
20,-60,-110,153,187,340,766
-120,-40,180,169,171,340,667
-70,40,-30,170,170,340,634
120,40,-170,162,178,340,651
-40,-80,-70,176,164,340,653
40,50,-80,154,186,340,531
-50,60,-70,172,168,340,610
110,-80,-10,154,186,340,722
-120,-40,-180,169,171,340,667
-160,40,130,166,174,340,593
-20,-80,-50,179,162,341,664
100,-30,-60,159,182,341,650
-80,-40,-130,172,169,341,591
-100,-80,-130,177,164,341,634
0,-80,-110,154,187,341,780
-100,50,40,176,165,341,706
70,0,160,164,177,341,660
170,10,140,166,175,341,632
-60,-30,-110,180,161,341,631
-20,-60,-130,161,180,341,728
50,40,170,170,172,342,588
-80,-40,-140,168,174,342,574
80,-60,-60,147,195,342,718
-110,-80,-140,175,167,342,646
40,40,-80,164,178,342,566
110,10,160,162,180,342,710
90,50,120,172,170,342,648
-140,20,120,163,179,342,612
-50,30,-30,174,168,342,634
150,30,160,158,184,342,675
-170,10,140,166,176,342,626
-10,0,-110,171,171,342,696
130,40,90,162,180,342,683
-120,-30,170,172,170,342,679
40,30,-80,163,180,343,631
60,20,140,176,167,343,625
-110,-70,-140,177,166,343,675
150,-60,30,176,167,343,718
-180,80,50,167,176,343,638
-20,60,-30,169,174,343,651
180,80,50,167,176,343,638
90,30,110,173,171,344,681
-100,-60,-130,174,170,344,650
150,60,170,155,189,344,684
110,70,110,175,169,344,593
30,-50,-110,156,189,345,764
-70,40,-20,168,177,345,673
-60,30,-30,177,168,345,630
110,10,60,160,185,345,726
-20,-60,-50,178,167,345,609
120,20,170,156,189,345,697
160,50,160,161,184,345,715
40,-20,-40,165,181,346,662
110,80,-150,166,180,346,646
50,10,180,176,170,346,657
120,-50,-10,168,178,346,638
90,20,100,176,170,346,664
-160,-10,90,164,182,346,658
-100,-40,-170,166,180,346,629
-180,20,140,180,166,346,651
0,-50,-120,157,189,346,724
180,-50,140,170,176,346,729
180,20,140,180,166,346,651
50,10,-180,176,170,346,657
0,30,-120,169,177,346,648
-180,-50,140,170,176,346,729
120,80,-160,170,176,346,625
20,40,-140,167,180,347,729
-140,40,60,167,180,347,723
-30,50,-90,162,185,347,647
-100,-40,-180,177,170,347,653
-60,-30,-120,175,172,347,628
-100,-40,180,177,170,347,653
-10,-80,-40,179,168,347,678
60,0,160,168,180,348,672
70,-10,-70,159,189,348,578
130,-70,10,162,186,348,737
90,10,-160,174,174,348,682
-130,50,30,174,174,348,678
110,-50,-30,157,191,348,722
-20,-70,-50,173,175,348,637
90,-50,-60,162,186,348,749
-60,-30,-90,193,155,348,674
-120,-80,130,167,182,349,719
50,10,170,176,173,349,636
-40,20,-40,171,178,349,656
-180,70,50,177,172,349,639
30,70,-160,170,179,349,626
-10,50,-110,177,172,349,638
-60,30,-50,177,172,349,631
180,70,50,177,172,349,639
-10,-80,-120,157,193,350,787
60,50,-100,168,182,350,571
80,10,120,173,177,350,684
-130,50,80,177,173,350,667
10,20,-130,176,174,350,647
-30,-20,-60,174,176,350,641
-30,40,-90,176,174,350,688
-20,-70,-130,164,186,350,756
-90,-50,180,176,175,351,651
120,70,100,177,174,351,608
-20,10,-50,176,175,351,685
-90,-50,-180,176,175,351,651
-20,-80,-130,157,194,351,796
110,-10,-10,177,174,351,615
40,-60,-100,166,185,351,800
140,70,-180,164,187,351,618
-30,-80,-140,158,193,351,816
40,20,-160,179,172,351,686
-110,-40,160,179,172,351,687
-30,30,-40,173,178,351,666
-50,20,-50,184,167,351,618
140,70,180,164,187,351,618
-80,80,40,166,186,352,585
-150,-40,100,169,183,352,736
110,-40,80,169,183,352,622
100,10,180,171,181,352,677
10,-80,-110,170,182,352,769
80,20,-120,173,179,352,627
90,0,20,175,177,352,635
130,-40,10,174,178,352,722
120,-60,-10,168,184,352,664
-40,-20,-110,179,173,352,634
-130,-30,170,178,174,352,603
60,0,-80,165,187,352,679
100,10,-180,171,181,352,677
80,10,130,168,184,352,745
-160,50,50,174,179,353,665
50,-20,-130,181,172,353,606
-30,-30,-60,178,175,353,689
-50,-20,-90,190,163,353,651
-130,-10,140,176,177,353,672
50,30,160,176,177,353,622
10,-50,-30,171,182,353,654
-40,0,-90,175,179,354,665
-110,-80,140,169,185,354,746
-130,-20,160,187,167,354,633
30,50,-70,165,189,354,552
-120,-80,-150,180,174,354,686
-100,-60,160,167,187,354,646
140,-60,20,173,182,355,757
-100,50,0,170,185,355,708
120,-10,0,183,172,355,658
40,40,-170,181,174,355,636
-50,30,-70,178,177,355,643
110,40,-160,161,194,355,736
130,-10,40,172,183,355,592
120,0,50,179,176,355,734
-160,-30,150,177,178,355,724
100,-30,70,173,183,356,613
-40,40,-80,184,172,356,692
-30,-40,-130,171,185,356,761
-150,40,120,175,181,356,673
-150,0,140,179,177,356,658
100,80,-140,177,179,356,672
140,-70,20,176,180,356,778
-50,20,-70,173,184,357,673
120,-40,90,174,183,357,671
0,-80,-30,180,177,357,705
-20,40,-100,175,182,357,651
-40,60,-10,175,182,357,671
80,0,-160,175,182,357,658
-140,50,100,174,183,357,652
-40,-10,-100,168,189,357,691
-140,40,90,184,173,357,731
20,80,-150,178,180,358,621
70,70,150,177,181,358,665
50,50,170,188,170,358,655
-130,-20,150,174,184,358,615
130,60,90,175,183,358,694
-90,-40,-160,172,186,358,645
50,20,150,183,175,358,662
-110,-30,170,179,179,358,724
-130,-70,120,174,185,359,693
20,-70,-110,176,183,359,726
60,-30,-120,178,181,359,611
-160,60,40,179,180,359,667
-140,30,110,169,190,359,688
100,0,110,176,183,359,764
120,-80,0,169,190,359,750
-70,-40,-100,194,165,359,637
-120,-30,140,185,174,359,613
160,-70,40,182,178,360,748
-100,-50,-140,180,180,360,682
-100,-40,-160,171,189,360,706
-50,60,0,182,178,360,665
70,40,-110,177,183,360,661
-10,-60,-130,168,192,360,742
-120,50,20,180,180,360,683
70,-40,30,175,185,360,666
-90,-50,-120,181,179,360,660
-160,0,140,172,189,361,659
110,-20,90,167,194,361,741
-70,-40,-140,177,184,361,618
120,-20,-10,185,176,361,652
-80,70,40,172,189,361,642
60,30,140,178,183,361,711
-40,-60,-140,171,190,361,781
-100,-80,150,172,189,361,750
-20,-50,-130,164,197,361,789
-40,-10,-60,179,182,361,631
-140,30,80,179,183,362,747
180,-40,140,176,186,362,675
-180,-40,140,176,186,362,675
130,70,90,180,182,362,651
160,60,70,176,186,362,720
100,10,50,178,184,362,716
180,-20,80,169,193,362,739
-180,-20,80,169,193,362,739
170,-70,50,183,179,362,753
-60,60,-60,181,181,362,654
10,20,-60,181,181,362,712
40,-50,0,176,187,363,648
-130,-60,120,178,185,363,680
0,40,-120,173,190,363,676
-10,50,-40,184,179,363,666
90,-10,-10,182,181,363,668
30,60,-160,177,186,363,721
-140,30,90,181,182,363,766
-50,-80,-160,172,191,363,809
-30,0,-100,172,191,363,673
-80,-40,-120,189,175,364,692
-50,-10,-80,191,173,364,695
80,-20,-120,173,191,364,646
50,-50,-100,168,196,364,734
-10,-30,-120,170,194,364,727
100,50,110,174,190,364,667
-90,50,-10,176,188,364,715
-170,-40,80,172,192,364,686
-140,0,140,179,185,364,687
-50,-20,-80,195,169,364,716
10,10,-130,176,188,364,724
120,20,80,174,190,364,724
80,-20,-90,184,181,365,610
40,-10,-50,178,187,365,756
60,10,-90,173,192,365,693
-50,20,-40,185,180,365,629
90,30,-140,179,186,365,731
10,30,-60,175,190,365,753
-40,20,-90,184,181,365,710
120,30,90,175,190,365,716
110,0,0,184,181,365,686
-60,40,-10,185,181,366,686
-160,40,60,184,182,366,767
-110,-50,150,176,190,366,754
130,-50,10,178,188,366,716
100,10,30,189,177,366,690
-70,80,30,171,195,366,617
90,80,-130,184,182,366,677
-90,-80,160,171,195,366,754
-170,0,80,182,184,366,626
140,0,60,172,194,366,778
-80,-80,170,171,196,367,771
-110,50,10,175,192,367,723
-170,80,40,180,187,367,701
-170,20,140,187,180,367,750
-40,-80,-150,170,197,367,822
-10,90,-120,184,184,368,655
140,90,90,184,184,368,655
-180,90,50,184,184,368,655
20,90,-150,184,184,368,655
160,90,70,184,184,368,655
40,90,-170,184,184,368,655
60,90,170,184,184,368,655
-120,90,-10,184,184,368,655
180,90,50,184,184,368,655
-60,-40,-80,191,177,368,683
80,90,150,184,184,368,655
-40,50,-80,168,200,368,677
-140,90,10,184,184,368,655
10,90,-140,184,184,368,655
30,90,-160,184,184,368,655
-110,-50,-150,189,179,368,696
50,90,180,184,184,368,655
-160,90,30,184,184,368,655
70,90,160,184,184,368,655
-10,40,-110,177,191,368,644
150,90,80,184,184,368,655
-40,90,-90,184,184,368,655
-60,90,-70,184,184,368,655
-90,-40,-150,177,191,368,669
-170,90,40,184,184,368,655
100,90,130,184,184,368,655
120,90,110,184,184,368,655
-130,90,0,184,184,368,655
-80,90,-50,184,184,368,655
-100,90,-30,184,184,368,655
-70,90,-60,184,184,368,655
0,-40,-120,170,198,368,781
-110,90,-20,184,184,368,655
110,90,120,184,184,368,655
170,90,60,184,184,368,655
-60,-80,-170,171,197,368,784
-150,90,20,184,184,368,655
-20,90,-110,184,184,368,655
-140,20,90,176,192,368,747
-90,90,-40,184,184,368,655
-50,90,-80,184,184,368,655
0,90,-130,184,184,368,655
130,90,100,184,184,368,655
-30,90,-100,184,184,368,655
150,40,80,179,189,368,684
100,40,-150,174,194,368,786
90,90,140,184,184,368,655
50,90,-180,184,184,368,655
-30,10,-100,180,189,369,774
-50,-40,-70,183,186,369,675
-30,60,-20,180,189,369,708
30,30,-150,178,191,369,799
20,-40,-30,173,196,369,728
150,50,170,160,209,369,753
-70,-60,-90,189,181,370,659
10,40,-130,173,197,370,739
50,10,-80,174,196,370,724
-70,40,-40,181,189,370,697
-90,-60,170,172,198,370,731
90,-20,-60,175,195,370,624
80,80,-120,183,187,370,681
40,-40,-10,178,192,370,682
-120,-70,-150,187,183,370,722
-20,-10,-110,179,191,370,724
40,-30,-120,175,196,371,731
-70,-80,180,173,198,371,788
80,0,160,185,186,371,735
30,20,-70,187,184,371,764
160,40,160,174,197,371,767
30,-40,-110,175,196,371,761
-150,50,120,186,185,371,724
-70,-80,-180,173,198,371,788
160,-30,50,174,197,371,729
160,-30,130,172,199,371,673
90,-10,50,173,198,371,669
20,-30,-40,174,197,371,781
-160,-20,150,177,194,371,668
-150,-80,-180,183,189,372,700
-150,-80,180,183,189,372,700
-130,-40,180,191,181,372,682
10,30,-130,187,185,372,763
150,10,70,176,196,372,736
-130,-40,-180,191,181,372,682
-130,-70,-160,190,182,372,748
-140,-40,110,175,197,372,759
-30,20,-100,186,187,373,703
140,-10,130,162,211,373,706
-70,40,-10,188,185,373,693
-70,70,-50,188,185,373,670
170,-10,140,184,189,373,685
-150,60,30,189,184,373,731
90,-60,-50,172,201,373,810
80,-30,40,183,190,373,661
160,-60,40,182,191,373,763
-110,50,60,185,188,373,789
-50,0,-70,191,183,374,667
0,-10,-120,176,198,374,796
-100,70,-20,178,196,374,628
130,-10,30,180,194,374,754
-140,30,100,183,191,374,757
-160,20,80,176,198,374,664
-60,-50,-80,190,185,375,675
10,80,-140,189,186,375,689
120,10,160,173,202,375,845
40,30,-170,185,190,375,685
120,-30,-20,178,197,375,670
-30,-70,-140,177,198,375,853
-30,0,-50,190,185,375,701
-160,-50,160,184,191,375,703
-10,-70,-40,192,183,375,715
-140,40,100,185,190,375,773
140,-50,20,188,187,375,769
50,-10,-50,184,191,375,746
130,70,-170,180,195,375,703
-120,-50,-160,191,184,375,728
-170,30,140,185,190,375,737
-160,-40,90,177,198,375,731
80,-20,-110,175,201,376,666
50,10,150,184,192,376,717
-170,-50,150,192,184,376,787
110,40,100,171,205,376,694
130,-30,10,186,190,376,738
60,-20,-30,186,190,376,650
10,-80,-20,181,195,376,738
30,0,-140,186,190,376,674
-70,-30,-120,199,177,376,694
130,-80,10,171,205,376,761
-60,80,20,186,190,376,670
-60,-60,-80,191,185,376,675
100,10,20,186,190,376,686
-70,40,0,189,188,377,710
0,-80,-120,182,195,377,817
-130,-80,-160,186,191,377,710
-120,50,70,182,195,377,755
-10,-70,-130,184,193,377,787
110,20,80,177,200,377,755
-110,-40,-160,187,190,377,749
-160,-80,170,187,190,377,706
120,10,60,177,201,378,809
-150,-10,150,180,198,378,736
140,60,-180,172,206,378,717
50,-30,-10,178,200,378,693
100,-40,-60,183,195,378,727
140,60,180,172,206,378,717
-60,30,-20,192,186,378,730
-180,50,60,188,190,378,720
-40,40,-20,193,185,378,723
40,-20,-130,190,188,378,707
10,-20,-50,178,200,378,783
180,50,60,188,190,378,720
-140,-70,-170,190,189,379,712
-60,-40,-140,180,199,379,750
-50,-10,-70,203,176,379,712
10,-70,-120,188,191,379,753
50,0,-170,191,189,380,644
-170,-80,160,187,193,380,730
90,0,-180,184,196,380,716
140,-40,110,174,206,380,822
-130,-20,130,196,184,380,733
-170,10,80,178,202,380,677
90,0,180,184,196,380,716
-50,40,-70,187,193,380,731
150,-70,30,186,194,380,756
-140,-80,-170,185,195,380,698
10,-40,-120,178,203,381,841
-100,50,50,194,187,381,789
20,-80,-10,181,200,381,739
-140,-10,110,187,194,381,725
150,-10,60,172,209,381,824
-140,0,100,201,181,382,662
-180,-70,60,189,193,382,765
-60,20,-40,195,187,382,710
100,10,-170,183,199,382,747
50,60,-90,173,209,382,709
-130,-40,120,184,198,382,733
180,-70,60,189,193,382,765
30,-80,0,186,196,382,753
-50,50,-70,182,201,383,749
-180,-80,150,190,193,383,745
130,-40,100,176,207,383,766
-170,40,140,181,202,383,727
-60,20,-50,193,190,383,726
120,-20,-20,174,209,383,643
180,-80,150,190,193,383,745
80,-10,0,201,182,383,690
-110,-60,-140,195,188,383,725
-30,40,-30,198,185,383,669
120,-70,-10,183,200,383,759
-110,-30,160,198,185,383,724
140,10,150,175,208,383,715
-150,30,70,183,201,384,715
-140,-50,180,194,190,384,690
40,60,-80,178,206,384,704
0,10,-120,186,198,384,705
-170,50,140,176,208,384,684
170,-10,70,178,206,384,854
70,50,-110,182,202,384,691
30,-20,-130,185,199,384,735
-140,-50,-180,194,190,384,690
60,-40,20,185,199,384,660
-60,-50,-150,196,188,384,789
-130,40,60,198,186,384,803
30,50,-160,181,203,384,763
20,70,-150,186,198,384,752
50,0,-160,182,202,384,756
-120,-70,130,182,202,384,720
60,-80,-70,189,196,385,767
160,0,140,175,210,385,764
-150,-50,170,190,195,385,725
-150,0,90,190,195,385,714
-130,40,50,196,189,385,781
-120,-20,150,194,191,385,666
-10,-80,-130,187,198,385,843
60,50,150,184,201,385,668
-50,10,-50,198,187,385,656
110,20,-170,172,213,385,820
50,-80,-80,190,195,385,787
70,-80,-60,187,198,385,770
-90,-40,-140,190,195,385,728
-40,30,-30,192,194,386,704
140,30,170,179,207,386,834
-50,10,-60,198,188,386,664
-80,-40,-150,190,196,386,669
-160,10,140,187,199,386,719
90,0,40,184,202,386,691
-50,-60,-150,187,199,386,822
160,-80,40,184,202,386,857
130,-90,100,189,198,387,745
180,-90,150,189,198,387,745
-110,-90,-140,189,198,387,745
80,20,110,184,203,387,712
-160,-90,170,189,198,387,745
-50,-90,-80,189,198,387,745
160,20,150,176,211,387,772
50,-90,20,189,198,387,745
-150,-90,180,189,198,387,745
0,-90,-30,189,198,387,745
-30,-90,-60,189,198,387,745
20,-90,-10,189,198,387,745
100,-90,70,189,198,387,745
-150,-90,-180,189,198,387,745
30,-90,0,189,198,387,745
-60,-90,-90,189,198,387,745
-90,-90,-120,189,198,387,745
-120,-90,-150,189,198,387,745
140,-90,110,189,198,387,745
170,-90,140,189,198,387,745
110,-90,80,189,198,387,745
90,-90,60,189,198,387,745
-10,-90,-40,189,198,387,745
150,-90,120,189,198,387,745
70,-90,40,189,198,387,745
-40,-90,-70,189,198,387,745
160,-90,130,189,198,387,745
60,-90,30,189,198,387,745
-130,-90,-160,189,198,387,745
-170,-90,160,189,198,387,745
80,-90,50,189,198,387,745
-70,-90,-100,189,198,387,745
-20,-90,-50,189,198,387,745
-10,30,-50,192,195,387,767
10,-90,-20,189,198,387,745
-180,-90,150,189,198,387,745
-100,-90,-130,189,198,387,745
40,-90,10,189,198,387,745
120,-90,90,189,198,387,745
-50,0,-60,204,183,387,701
-80,-90,-110,189,198,387,745
-110,60,70,187,200,387,673
-70,-30,-110,198,189,387,725
-140,-90,-170,189,198,387,745
-140,-30,170,202,186,388,743
10,-20,-120,177,211,388,761
-130,-10,150,193,195,388,727
150,30,80,178,210,388,749
100,30,100,180,208,388,779
30,-40,-20,187,201,388,722
100,20,-160,188,200,388,781
50,40,160,192,196,388,741
100,0,0,195,193,388,708
170,60,60,191,197,388,763
50,0,-180,197,191,388,749
50,0,180,197,191,388,749
-120,40,50,196,193,389,790
-70,30,-30,193,196,389,718
140,-80,20,179,210,389,824
40,-80,10,192,197,389,785
70,-20,-150,198,191,389,667
140,70,80,193,196,389,687
-140,10,130,187,202,389,722
170,0,70,189,200,389,845
-140,30,70,193,196,389,785
70,80,-110,189,200,389,702
40,10,-70,179,211,390,742
20,60,-150,189,201,390,809
-120,-20,160,202,188,390,703
-140,-10,150,199,191,390,743
90,10,100,185,205,390,706
80,-30,-110,199,191,390,641
100,-10,80,191,199,390,773
50,-10,-150,189,201,390,762
-100,60,60,195,195,390,711
150,-20,50,190,200,390,715
40,20,-170,187,203,390,717
100,20,80,195,195,390,788
-130,-10,130,206,184,390,697
-40,10,-90,189,201,390,796
50,-80,20,196,195,391,799
-130,40,70,196,195,391,825
-110,-70,140,185,206,391,773
-50,-10,-90,196,195,391,768
40,0,-60,182,209,391,744
120,0,40,190,201,391,727
-80,40,10,202,189,391,767
40,-10,-140,193,198,391,671
80,-20,-130,190,201,391,631
150,-50,30,192,199,391,762
120,0,30,186,205,391,748
70,-30,-120,207,185,392,720
-120,-40,-170,198,194,392,752
60,80,-100,190,202,392,710
90,0,10,193,199,392,752
-110,-30,180,197,195,392,766
90,60,120,188,204,392,728
150,-80,30,184,208,392,863
20,10,-60,188,204,392,788
-110,-30,-180,197,195,392,766
80,-80,-50,184,208,392,783
30,40,-160,187,205,392,771
-140,-20,160,198,195,393,779
100,10,40,196,197,393,718
-130,-50,-170,205,188,393,737
170,-80,50,184,209,393,834
-80,-60,180,188,205,393,759
-120,40,40,200,193,393,793
90,-30,-80,186,207,393,596
110,-80,80,183,210,393,803
-80,-60,-180,188,205,393,759
120,-10,120,175,218,393,802
10,-60,-120,182,212,394,831
40,-80,-90,192,202,394,804
0,-70,-30,202,192,394,778
0,80,-130,190,204,394,726
10,-50,-120,183,211,394,875
-70,70,30,187,207,394,700
-80,-60,-100,199,195,394,660
-90,-40,-170,188,206,394,732
-90,70,-30,194,201,395,734
20,30,-140,185,210,395,805
70,-10,-170,193,202,395,746
-60,-30,-130,200,195,395,714
-170,-10,80,190,205,395,805
-50,0,-80,194,201,395,709
-20,50,-30,204,191,395,717
-80,50,30,202,193,395,794
60,-60,-90,191,204,395,798
-40,0,-50,196,199,395,708
-20,-20,-120,192,204,396,815
-70,30,-20,205,191,396,774
80,60,130,189,207,396,724
120,-40,-20,186,210,396,741
-150,30,130,195,201,396,774
-180,-80,60,185,211,396,823
0,40,-50,208,188,396,707
180,-80,60,185,211,396,823
-130,0,120,204,193,397,689
60,-80,30,193,204,397,785
30,-80,-100,191,206,397,837
-140,30,120,193,204,397,749
60,-10,-170,191,206,397,651
0,-30,-120,186,211,397,852
-90,40,10,206,191,397,805
160,-20,60,199,198,397,874
90,-80,-40,191,206,397,812
100,-80,70,189,208,397,803
20,20,-140,195,202,397,845
20,-10,-130,193,204,397,801
-50,10,-70,195,202,397,706
0,0,-120,188,209,397,844
120,-80,90,188,209,397,814
-90,-40,-130,206,191,397,755
-50,80,10,193,205,398,747
140,-20,30,172,226,398,781
80,30,-120,186,212,398,737
80,-20,-100,196,202,398,761
-10,-60,-40,200,198,398,710
90,0,170,188,210,398,800
120,0,20,196,202,398,683
-10,-30,-50,201,197,398,819
170,-80,140,197,201,398,775
-110,40,30,207,191,398,810
-50,-20,-110,205,193,398,793
60,-10,-50,196,203,399,772
70,10,-100,184,215,399,695
80,-10,20,197,202,399,726
-80,70,-40,199,200,399,749
40,-50,-110,182,217,399,852
-20,-40,-130,196,203,399,815
120,-50,90,187,212,399,826
30,-10,-50,190,209,399,805
-170,-70,70,199,200,399,814
30,-60,-110,194,205,399,855
-40,-70,-150,192,207,399,868
-70,60,-50,196,204,400,747
-170,70,40,202,198,400,745
20,-50,-120,188,212,400,810
60,60,-100,187,213,400,745
-170,-80,70,190,210,400,816
-70,-40,-90,206,194,400,756
-160,80,30,199,201,400,749
-100,-40,-150,195,205,400,825
-70,30,-40,202,199,401,744
30,-50,-10,192,209,401,749
160,-80,130,196,205,401,788
-100,-40,170,203,198,401,771
-130,40,40,201,200,401,809
170,-20,70,190,211,401,845
150,70,70,200,201,401,749
-140,50,110,199,202,401,821
70,20,120,201,200,401,689
-100,-50,160,200,202,402,729
-120,-30,-180,199,203,402,788
-120,-30,180,199,203,402,788
50,80,-90,196,206,402,720
-80,50,-30,196,206,402,767
-30,-10,-110,205,197,402,852
-150,20,80,189,213,402,788
-90,40,20,214,189,403,815
80,40,-120,190,213,403,786
-120,-20,140,205,198,403,736
130,-80,100,192,211,403,802
-130,50,90,201,202,403,784
110,-40,-40,196,207,403,738
-50,-60,-70,200,203,403,731
-20,-50,-50,202,201,403,658
140,-40,20,202,201,403,813
60,-10,180,202,201,403,798
-70,-60,-170,203,200,403,796
90,10,90,205,198,403,752
-140,40,50,208,195,403,839
-130,-50,120,193,210,403,721
-80,40,0,209,194,403,787
130,-10,20,187,216,403,732
60,-10,-180,202,201,403,798
50,60,170,195,208,403,800
120,70,-160,194,209,403,768
-140,60,20,195,208,403,718
-90,50,40,212,192,404,831
90,-80,60,195,210,405,812
-80,-40,-110,209,196,405,738
10,70,-140,193,212,405,837
20,-50,-20,199,206,405,750
0,-70,-130,186,219,405,808
-40,-50,-140,187,218,405,848
-120,-20,170,201,204,405,804
110,10,170,194,212,406,846
-90,-70,160,192,214,406,862
-80,40,-20,200,206,406,781
140,50,180,184,222,406,806
110,70,-150,194,212,406,785
100,-80,-30,191,215,406,849
60,-40,-100,195,211,406,844
120,0,10,207,199,406,701
-70,-30,-130,208,198,406,782
100,0,120,194,212,406,892
-60,-60,-160,206,200,406,838
140,50,-180,184,222,406,806
70,40,130,198,208,406,789
-50,-50,-70,201,205,406,708
-50,30,-20,207,199,406,788
-110,-40,150,208,198,406,794
100,-20,-50,183,224,407,680
50,0,160,206,201,407,723
160,50,70,193,214,407,793
0,-20,-120,186,221,407,909
-20,-70,-140,202,205,407,893
110,10,10,196,211,407,781
-60,-20,-90,205,202,407,864
100,-60,-40,193,214,407,839
-70,-50,-90,202,205,407,724
-60,30,-60,201,207,408,778
150,-80,120,197,211,408,799
-110,-30,-170,203,205,408,843
-60,-70,-170,197,211,408,878
130,60,-170,197,211,408,815
-120,-60,-150,208,200,408,797
30,40,-70,195,213,408,751
-50,-70,-160,196,212,408,918
160,-10,140,190,218,408,792
-60,-30,-80,215,193,408,809
-140,40,110,202,206,408,794
-160,-80,80,194,215,409,833
70,-60,-80,199,210,409,857
150,-20,130,192,217,409,860
-80,40,-10,204,205,409,799
-50,20,-80,197,212,409,817
-80,-50,-170,188,221,409,764
-10,-50,-130,191,218,409,822
100,-40,70,201,208,409,773
-100,40,20,208,201,409,816
170,40,70,190,220,410,742
140,-80,110,195,215,410,806
170,-60,50,193,217,410,862
-50,-20,-70,212,198,410,824
-150,-80,90,197,213,410,850
-160,-10,150,199,211,410,740
130,-20,10,199,211,410,762
-50,20,-30,215,195,410,738
80,50,-120,198,213,411,787
-10,20,-50,202,209,411,829
100,60,110,196,215,411,722
-20,80,-20,211,200,411,766
-150,80,20,209,202,411,765
-150,10,140,202,209,411,834
-30,-20,-120,198,213,411,804
-130,-20,170,211,201,412,754
-10,80,-120,198,214,412,780
40,80,-80,201,211,412,732
-40,80,0,209,203,412,769
-100,-70,150,191,221,412,803
-30,80,-10,214,198,412,778
80,-70,-60,194,218,412,948
110,-90,-10,188,225,413,919
60,-90,-60,188,225,413,919
-160,-90,80,188,225,413,919
-180,-90,60,188,225,413,919
20,-30,-120,198,215,413,916
-150,50,40,200,213,413,785
170,-90,50,188,225,413,919
180,-90,60,188,225,413,919
120,-90,0,188,225,413,919
0,-90,-120,188,225,413,919
30,30,-70,190,223,413,860
80,-10,-110,185,228,413,787
-50,10,-40,211,202,413,746
-110,-90,130,188,225,413,919
130,-60,0,199,214,413,853
-90,-90,150,188,225,413,919
100,-90,-20,188,225,413,919
140,-90,20,188,225,413,919
-150,-90,90,188,225,413,919
-60,-90,-180,188,225,413,919
-10,-90,-130,188,225,413,919
150,0,140,195,218,413,862
-150,-70,180,210,203,413,765
130,-90,10,188,225,413,919
150,-90,30,188,225,413,919
-30,-90,-150,188,225,413,919
-90,60,50,208,205,413,784
30,-90,-90,188,225,413,919
-60,-90,180,188,225,413,919
20,-90,-100,188,225,413,919
-150,-70,-180,210,203,413,765
70,-90,-50,188,225,413,919
50,-90,-70,188,225,413,919
-100,-90,140,188,225,413,919
-80,-90,160,188,225,413,919
-120,-90,120,188,225,413,919
80,-90,-40,188,225,413,919
-130,-90,110,188,225,413,919
90,-90,-30,188,225,413,919
-20,-90,-140,188,225,413,919
-70,-90,170,188,225,413,919
-50,40,-10,207,206,413,838
-140,-90,100,188,225,413,919
-170,-90,70,188,225,413,919
-50,-90,-170,188,225,413,919
10,-90,-110,188,225,413,919
-40,-90,-160,188,225,413,919
40,-90,-80,188,225,413,919
160,-90,40,188,225,413,919
-20,0,-50,210,204,414,805
-130,0,130,210,204,414,727
-120,40,30,205,209,414,874
120,30,-170,186,228,414,855
-80,-70,170,198,216,414,871
-140,10,90,204,210,414,778
70,-80,40,195,219,414,800
-70,-50,-160,203,212,415,862
-10,80,-30,210,205,415,766
110,50,100,204,211,415,785
50,-60,-100,195,220,415,830
-30,20,-40,208,207,415,836
150,40,170,192,223,415,846
110,10,50,207,208,415,866
80,-80,50,197,218,415,808
60,10,140,211,204,415,829
-90,40,0,213,203,416,850
-110,40,40,216,200,416,842
-70,-70,-180,204,212,416,880
-70,-70,180,204,212,416,880
100,70,-140,200,216,416,814
110,-30,-50,204,212,416,751
-20,0,-110,200,216,416,870
80,-30,-100,210,206,416,787
-100,40,30,210,206,416,840
-100,-50,-130,201,215,416,763
110,30,-160,194,222,416,913
20,40,-150,195,222,417,834
-120,-60,130,195,222,417,796
30,80,-70,202,215,417,748
90,10,80,201,216,417,867
0,80,-40,202,215,417,770
150,-40,120,188,229,417,931
110,-10,110,194,223,417,888
-140,20,130,207,210,417,783
-110,-30,150,215,202,417,804
-90,-60,-110,211,206,417,734
-20,80,-110,204,213,417,817
20,80,-60,202,216,418,748
160,10,70,201,217,418,850
70,-70,-70,196,222,418,955
170,30,150,193,225,418,865
80,-20,-140,193,225,418,656
-160,60,130,201,217,418,813
80,-10,-150,210,208,418,763
110,10,30,212,207,419,764
90,20,90,205,214,419,819
30,30,-160,210,209,419,822
-30,-60,-140,196,223,419,918
10,80,-50,201,218,419,764
-110,-50,-140,211,208,419,812
60,70,160,204,215,419,797
10,-70,-20,212,207,419,839
-10,-20,-120,199,220,419,907
-20,-80,-140,199,220,419,890
40,-40,-110,202,217,419,934
90,10,-150,199,221,420,906
-160,-70,170,212,208,420,799
10,-30,-120,200,220,420,931
100,-10,90,196,224,420,861
-130,40,80,209,211,420,886
130,-40,0,204,216,420,877
110,0,130,194,226,420,921
-170,-70,160,213,207,420,803
150,20,160,203,217,420,809
20,50,-150,194,226,420,818
30,-50,-120,199,221,420,942
50,-70,20,199,221,420,818
30,-30,-120,198,222,420,842
100,30,-150,206,215,421,905
180,60,50,216,205,421,747
140,60,80,200,221,421,813
-70,-30,-100,210,211,421,784
-180,60,50,216,205,421,747
-60,50,-60,209,212,421,814
140,0,140,201,220,421,906
120,60,-160,203,218,421,890
20,-40,-120,201,220,421,910
130,-50,100,197,224,421,860
-30,50,-20,215,207,422,780
120,20,180,197,225,422,934
-10,10,-50,212,210,422,851
-120,40,60,222,200,422,876
50,30,150,209,213,422,785
-80,-50,-100,219,203,422,780
120,20,-180,197,225,422,934
80,-50,-80,200,223,423,847
140,-10,50,212,211,423,816
90,0,-170,209,214,423,877
-80,40,-30,221,202,423,813
100,-70,70,207,216,423,879
130,10,160,196,227,423,971
-160,-70,80,210,213,423,839
-70,50,20,216,207,423,807
160,-70,30,202,221,423,811
-170,70,140,181,243,424,822
-140,80,10,215,209,424,806
-130,-30,180,216,208,424,832
-120,50,10,212,212,424,796
10,60,-140,198,226,424,827
-130,-30,-180,216,208,424,832
-40,10,-40,210,214,424,826
90,20,-140,207,217,424,842
-150,-30,160,216,208,424,809
0,-60,-130,196,228,424,852
130,10,60,206,219,425,900
90,70,-130,205,220,425,810
-140,-30,110,205,220,425,866
10,50,-140,204,221,425,799
-140,-80,100,204,221,425,880
180,-50,60,194,232,426,840
80,30,110,204,222,426,838
140,50,80,206,220,426,802
130,-50,0,199,227,426,846
110,10,20,217,209,426,796
90,0,160,207,219,426,880
-180,-50,60,194,232,426,840
-30,80,-100,206,220,426,841
80,40,120,202,224,426,855
-170,60,140,195,232,427,876
110,-20,-40,201,226,427,732
-50,-30,-70,217,210,427,819
-60,-20,-100,225,202,427,872
70,0,150,213,214,427,842
-100,40,10,211,216,427,851
110,-80,-20,201,226,427,869
-90,50,-20,217,210,427,863
70,70,-110,201,226,427,812
20,-20,-130,205,222,427,823
0,70,-130,199,228,427,885
-90,-50,-110,221,207,428,821
20,-80,-110,205,223,428,885
130,-70,0,202,226,428,912
-80,60,40,216,212,428,790
150,10,150,188,240,428,872
40,-70,10,207,221,428,808
-130,0,140,214,214,428,760
110,-70,80,206,222,428,882
150,-70,20,204,224,428,813
50,0,170,216,212,428,779
140,-60,110,202,226,428,829
100,-50,-50,196,232,428,900
-40,-30,-130,210,218,428,855
120,-30,-30,206,222,428,801
-60,30,-10,222,207,429,870
-160,70,130,196,234,430,794
160,70,60,222,208,430,806
120,-50,-20,199,231,430,814
170,-30,60,209,221,430,879
-70,40,10,221,209,430,805
140,-60,10,206,225,431,898
-110,50,0,214,217,431,838
-50,-10,-100,212,219,431,860
-130,-30,120,217,214,431,833
-50,-30,-130,219,212,431,763
130,20,170,199,232,431,925
-130,-80,110,209,222,431,891
100,20,70,212,219,431,849
60,-70,-80,198,233,431,952
80,70,-120,206,225,431,819
-70,30,-10,220,211,431,809
20,50,-60,198,234,432,717
50,-30,0,207,225,432,757
60,-70,30,202,230,432,858
60,-20,-150,209,223,432,808
150,0,60,194,238,432,905
160,-50,40,197,235,432,938
130,-10,130,195,237,432,896
80,-60,-70,206,226,432,945
-170,40,60,208,224,432,832
90,-70,-50,199,233,432,919
-60,70,20,210,222,432,814
-80,-40,-160,209,223,432,807
100,60,-140,214,218,432,912
70,60,-110,197,236,433,805
-130,30,80,219,214,433,946
-30,-30,-130,207,226,433,885
130,0,50,217,216,433,918
130,0,140,197,236,433,916
60,0,150,220,213,433,845
110,-60,-30,200,233,433,863
70,60,140,220,213,433,801
0,-50,-130,208,226,434,1001
-180,-70,150,215,219,434,805
110,10,40,213,221,434,830
180,-70,150,215,219,434,805
-160,30,70,213,221,434,789
-10,-70,-140,207,227,434,890
130,30,180,193,241,434,908
110,-50,80,213,221,434,783
130,30,-180,193,241,434,908
150,-60,20,207,227,434,829
90,-50,-70,200,235,435,845
-60,-20,-110,223,212,435,969
30,-70,0,217,218,435,871
-20,-60,-140,200,235,435,900
40,-30,-20,218,217,435,761
170,-50,50,202,233,435,851
0,-60,-30,215,220,435,825
90,-70,60,196,240,436,904
10,-80,-120,211,225,436,927
-60,20,-30,224,212,436,778
0,-40,-40,205,231,436,888
180,-60,60,204,232,436,903
20,10,-140,207,229,436,917
170,20,150,206,230,436,882
-110,40,20,219,217,436,861
-130,80,0,217,219,436,832
140,30,80,201,235,436,848
-180,-60,60,204,232,436,903
60,70,-100,210,227,437,840
110,60,100,215,222,437,800
90,-40,-80,208,229,437,814
-130,-60,-160,223,214,437,835
-130,20,100,222,215,437,855
120,40,90,205,233,438,908
140,-50,110,206,232,438,883
-130,50,20,220,218,438,859
110,20,70,211,227,438,940
-170,-50,70,189,249,438,891
70,30,120,215,223,438,849
-50,0,-50,231,207,438,809
-150,40,50,212,227,439,918
-50,-40,-140,212,227,439,859
180,70,150,188,251,439,858
-160,20,140,212,227,439,858
110,60,-150,213,226,439,908
110,80,110,215,224,439,830
-130,20,90,218,221,439,939
60,-20,-20,208,231,439,823
100,80,120,218,221,439,822
150,-60,120,204,235,439,867
180,60,150,203,236,439,864
50,-40,10,225,214,439,765
-60,20,-60,215,224,439,828
-70,-30,-90,224,215,439,862
-180,70,150,188,251,439,858
-180,60,150,203,236,439,864
40,10,-160,216,223,439,894
30,60,-70,205,234,439,793
-60,50,10,221,218,439,813
-130,30,70,225,215,440,1003
-90,-40,180,210,230,440,878
170,-40,50,191,249,440,812
-120,-80,120,211,229,440,903
-90,-40,-180,210,230,440,878
110,30,90,203,237,440,892
120,-30,100,201,239,440,858
120,-80,-10,206,234,440,929
90,40,110,211,230,441,878
-100,-40,-140,217,224,441,865
120,80,100,221,220,441,849
-50,10,-80,211,230,441,845
0,60,-130,211,230,441,819
-40,50,-10,220,221,441,841
20,-10,-50,203,238,441,879
90,80,130,215,226,441,861
-20,10,-110,215,226,441,926
-40,80,-90,218,223,441,876
-130,0,110,223,218,441,776
-80,-30,-130,233,209,442,888
-100,-30,180,216,226,442,912
-100,-30,-180,216,226,442,912
-140,50,30,214,228,442,871
-130,70,100,216,226,442,781
120,-70,90,208,234,442,890
-70,-40,-150,226,216,442,837
-170,50,50,218,224,442,905
-130,40,90,212,230,442,931
-40,30,-90,218,225,443,866
30,-30,-30,215,228,443,915
140,-70,10,206,237,443,874
50,-70,-90,209,234,443,966
170,-70,140,213,230,443,847
80,-70,50,196,247,443,883
70,-50,-90,211,232,443,896
70,-20,20,218,225,443,765
-120,50,80,215,228,443,862
130,-60,100,214,229,443,837
-110,40,50,230,214,444,913
50,-20,-30,210,234,444,856
-90,40,-10,224,220,444,911
160,-40,40,197,247,444,869
-70,20,-40,223,221,444,835
-80,-30,-120,230,214,444,869
-60,40,-60,220,224,444,838
70,10,130,226,218,444,822
80,0,150,212,233,445,928
-60,-10,-90,226,219,445,933
50,50,160,225,220,445,868
40,0,-150,211,234,445,880
-120,-50,130,211,234,445,887
170,-20,140,200,246,446,851
-30,-70,-150,221,225,446,1016
130,-70,100,214,232,446,882
90,50,-130,215,231,446,970
-30,-50,-140,203,243,446,965
-150,-20,100,211,236,447,913
-110,-20,160,227,220,447,903
150,-40,30,209,238,447,940
-60,40,0,227,220,447,880
-10,70,-120,206,241,447,874
-170,-40,150,213,234,447,882
80,-40,-90,216,231,447,865
-50,80,-80,218,229,447,891
80,60,-120,209,238,447,882
80,-20,40,219,229,448,903
-120,40,70,232,216,448,983
-130,10,120,232,216,448,809
0,-20,-50,223,225,448,946
-150,-70,90,217,231,448,901
20,-70,-10,222,226,448,893
10,0,-130,216,232,448,865
-120,-40,-160,229,219,448,932
30,20,-150,207,241,448,906
-90,40,30,236,212,448,935
150,60,70,208,240,448,908
30,-20,-40,215,234,449,826
-110,-80,130,220,229,449,957
-40,0,-100,226,223,449,945
-120,80,-10,219,230,449,858
120,50,-160,216,233,449,942
-130,10,110,225,224,449,833
150,-70,120,207,242,449,897
-170,60,40,232,217,449,831
-40,-20,-60,219,230,449,894
100,20,60,222,227,449,979
-160,-20,90,207,242,449,922
-20,30,-40,228,221,449,907
-150,70,120,209,240,449,806
-80,30,-20,225,224,449,872
100,0,130,219,230,449,937
-20,70,-110,213,237,450,856
170,-80,40,224,226,450,902
160,30,160,215,235,450,922
180,-40,60,197,253,450,828
-140,60,110,230,220,450,805
-180,-40,60,197,253,450,828
-110,-20,170,224,226,450,900
-120,-40,130,207,243,450,881
120,-10,-10,223,227,450,844
-10,60,-120,214,236,450,838
140,40,80,211,239,450,865
80,80,140,221,229,450,901
-40,-20,-120,221,229,450,857
160,-70,130,210,241,451,855
130,80,90,228,223,451,865
90,0,50,218,233,451,834
70,-10,-180,219,232,451,887
-130,50,100,225,226,451,904
-110,70,80,221,230,451,796
-160,10,80,224,227,451,889
-100,40,40,234,217,451,948
60,40,140,223,228,451,822
70,-10,180,219,232,451,887
-150,60,120,229,222,451,780
-120,70,90,221,231,452,778
-170,30,70,218,234,452,897
-170,-60,70,210,242,452,931
-130,60,100,232,220,452,848
-30,-80,-150,212,240,452,927
-40,-60,-150,218,235,453,1004
40,-70,-100,217,236,453,985
160,-80,30,226,227,453,904
-130,-10,120,234,219,453,903
-180,50,150,199,254,453,877
180,50,150,199,254,453,877
70,-70,40,213,240,453,891
-90,-30,-150,226,227,453,940
60,20,130,227,226,453,846
-100,-60,-120,226,227,453,862
-60,-20,-80,233,220,453,927
-160,30,140,223,231,454,939
70,-80,-70,206,248,454,976
-140,-60,-170,236,218,454,839
-120,-50,-150,227,227,454,925
-40,-10,-110,224,230,454,905
-90,-40,-120,231,223,454,878
60,-20,-10,228,226,454,891
60,-80,-80,203,251,454,954
120,0,140,206,248,454,962
-100,80,-30,218,237,455,885
-60,80,-70,223,232,455,886
-110,-60,140,217,238,455,901
-50,70,10,222,233,455,915
-120,-10,150,224,231,455,850
10,-10,-50,216,239,455,919
120,0,0,230,226,456,892
-100,50,-10,229,227,456,911
40,-60,-110,215,241,456,925
100,-70,-40,207,249,456,915
-70,-70,-90,226,230,456,836
-130,10,100,229,227,456,883
-90,-30,-140,237,219,456,918
130,50,-170,218,238,456,899
180,-80,50,225,231,456,906
-180,-80,50,225,231,456,906
140,-70,110,216,241,457,900
-50,0,-90,220,237,457,883
-140,70,110,216,241,457,792
160,-60,130,209,248,457,896
-130,30,90,228,229,457,963
130,-30,110,212,245,457,864
-50,50,0,228,229,457,865
50,70,-90,215,242,457,866
10,-20,-130,208,250,458,1009
-170,-80,60,224,234,458,940
120,20,70,231,227,458,1006
-150,40,130,221,237,458,897
-80,40,20,234,224,458,892
80,-80,-60,211,247,458,978
-170,-20,150,215,243,458,850
130,-80,0,222,236,458,968
-120,-30,130,229,230,459,843
-30,30,-100,229,230,459,896
-140,-40,180,228,231,459,862
70,-10,170,216,243,459,901
-140,-40,-180,228,231,459,862
-90,80,-40,223,236,459,875
60,60,150,229,231,460,854
-10,40,-40,229,231,460,867
-10,-40,-130,216,244,460,996
-130,20,110,220,240,460,841
130,-30,0,221,239,460,974
-140,-20,110,232,228,460,882
-160,70,30,229,231,460,873
50,0,-60,212,248,460,868
50,70,170,223,237,460,945
80,0,-110,219,241,460,847
50,-80,-90,210,250,460,943
-100,-80,140,227,234,461,987
140,80,80,236,225,461,913
10,-30,-40,222,239,461,971
-70,60,30,233,228,461,837
-60,10,-40,240,221,461,906
70,0,-90,215,246,461,903
-140,40,120,230,231,461,889
-130,-20,120,232,229,461,919
170,60,160,206,255,461,883
-60,10,-50,235,226,461,861
40,10,-170,234,228,462,859
-100,-30,-170,222,240,462,998
-100,-30,-160,219,243,462,990
0,-80,-130,225,237,462,986
-120,-30,-170,235,227,462,952
-60,-80,-180,220,242,462,1014
-100,-50,-120,231,231,462,864
90,-80,-50,215,247,462,994
-60,-80,180,220,242,462,1014
150,-30,30,207,255,462,952
-110,50,70,233,229,462,957
-20,-10,-50,226,237,463,932
170,-70,40,221,242,463,884
50,-40,-110,228,235,463,1087
70,50,130,231,232,463,881
-100,40,0,230,233,463,959
90,-20,-70,222,241,463,779
-70,50,-50,226,237,463,868
-110,-40,-150,232,231,463,907
-80,-30,-110,240,224,464,829
80,-60,50,219,245,464,965
-130,60,10,230,234,464,826
-70,80,-60,227,237,464,900
-20,20,-110,226,238,464,897
-40,-60,-60,226,238,464,846
-80,80,-50,224,240,464,880
0,50,-130,225,239,464,903
-20,-40,-50,233,231,464,880
-40,-30,-60,229,235,464,911
30,-40,-120,224,241,465,1045
-50,-10,-60,242,223,465,913
10,-40,-130,224,241,465,1030
-60,-10,-80,238,227,465,947
-100,-30,-150,224,241,465,986
20,-60,-120,225,240,465,949
-10,-10,-120,215,250,465,968
-180,40,150,212,253,465,881
-90,-50,170,214,251,465,885
-10,0,-50,214,251,465,944
10,-50,-130,228,237,465,992
-20,60,-110,219,246,465,859
80,-10,30,222,243,465,883
40,70,-80,219,246,465,866
180,40,150,212,253,465,881
90,40,-130,222,244,466,979
100,-40,-70,227,239,466,879
30,-80,-110,217,249,466,921
-110,-20,150,245,221,466,879
20,20,-60,225,241,466,978
140,-30,20,222,245,467,947
140,10,160,213,254,467,1039
-80,60,-40,236,231,467,860
-80,-40,-100,237,230,467,900
70,80,150,228,239,467,944
120,-60,-20,220,247,467,897
-10,0,-120,230,237,467,1004
40,-80,-100,215,252,467,942
40,-40,0,227,240,467,827
60,-10,170,231,236,467,880
-110,80,-20,223,244,467,899
40,-30,-130,218,250,468,910
-130,-10,160,230,238,468,822
-160,-60,80,227,241,468,928
20,40,-60,230,238,468,890
-170,-30,150,225,244,469,917
-120,60,90,234,235,469,869
90,-60,60,229,240,469,906
-140,40,40,226,243,469,938
-40,-80,-160,223,246,469,974
20,30,-150,225,244,469,1016
60,20,-90,222,247,469,928
-50,-80,-170,226,243,469,1005
150,-80,20,230,239,469,950
-150,-60,-180,239,231,470,845
-20,-50,-140,220,250,470,880
-130,10,130,234,236,470,900
-130,-40,-170,238,232,470,925
90,10,70,227,243,470,970
90,0,150,228,242,470,1039
90,60,-130,224,246,470,909
-150,-60,180,239,231,470,845
10,-60,-20,242,228,470,931
-130,30,60,238,232,470,979
10,40,-140,227,243,470,985
110,-40,-50,227,243,470,871
140,10,60,222,249,471,985
-80,-70,-100,226,245,471,889
90,-30,60,232,239,471,879
-80,30,-10,237,234,471,937
-50,-50,-150,229,242,471,1007
-160,-50,80,207,264,471,941
-60,10,-60,240,231,471,904
110,-70,-30,221,250,471,948
-180,-60,150,221,250,471,971
50,-20,-140,230,241,471,862
-30,70,-100,224,247,471,889
-70,-80,170,221,250,471,1009
180,-60,150,221,250,471,971
140,-90,10,232,240,472,1052
100,-90,-30,232,240,472,1052
-40,-90,-170,232,240,472,1052
10,-90,-120,232,240,472,1052
-50,-90,-180,232,240,472,1052
-140,-90,90,232,240,472,1052
30,-90,-100,232,240,472,1052
110,-90,-20,232,240,472,1052
-160,-90,70,232,240,472,1052
90,30,100,225,247,472,1016
-180,-90,50,232,240,472,1052
60,-90,-70,232,240,472,1052
-130,-90,100,232,240,472,1052
-150,-90,80,232,240,472,1052
170,-90,40,232,240,472,1052
-120,-90,110,232,240,472,1052
50,-90,-80,232,240,472,1052
110,50,-150,228,244,472,1052
120,-90,-10,232,240,472,1052
-20,-90,-150,232,240,472,1052
160,-90,30,232,240,472,1052
-150,-40,170,231,241,472,918
180,-90,50,232,240,472,1052
-110,-90,120,232,240,472,1052
-50,-90,180,232,240,472,1052
-170,-90,60,232,240,472,1052
-30,-90,-160,232,240,472,1052
70,-90,-60,232,240,472,1052
-80,-30,-140,234,238,472,963
80,-90,-50,232,240,472,1052
120,-20,110,197,275,472,950
-60,-90,170,232,240,472,1052
-10,-90,-140,232,240,472,1052
-90,-90,140,232,240,472,1052
0,-90,-130,232,240,472,1052
40,-90,-90,232,240,472,1052
20,-90,-110,232,240,472,1052
150,-90,20,232,240,472,1052
-80,-90,150,232,240,472,1052
130,-90,0,232,240,472,1052
-100,-90,130,232,240,472,1052
90,-90,-40,232,240,472,1052
-70,-90,160,232,240,472,1052
-140,10,140,240,233,473,961
140,-80,10,230,243,473,977
-150,-30,100,229,244,473,909
-100,-40,160,239,234,473,941
100,-20,80,224,249,473,897
0,-40,-130,236,237,473,991
-160,-60,170,232,241,473,859
170,-60,140,213,260,473,944
-10,-80,-140,232,241,473,1014
-40,-50,-60,236,237,473,858
110,10,180,218,256,474,1017
70,-10,-50,230,244,474,898
110,10,-180,218,256,474,1017
-130,40,30,237,237,474,973
-60,-70,-80,238,236,474,858
30,20,-160,238,236,474,994
-140,20,80,233,241,474,912
-80,-80,160,232,242,474,999
150,-50,120,230,245,475,981
-110,-20,180,237,238,475,979
-30,-10,-50,235,240,475,915
160,10,150,224,251,475,936
160,-60,30,228,247,475,934
10,-10,-130,226,249,475,872
160,-40,130,224,251,475,1001
100,-50,70,229,246,475,913
50,-60,20,233,242,475,880
-110,-20,-180,237,238,475,979
0,-10,-50,223,253,476,933
140,40,-180,213,263,476,947
120,-60,90,233,243,476,873
-10,-60,-140,225,251,476,939
-170,-30,80,238,238,476,985
140,40,180,213,263,476,947
-90,-80,150,236,240,476,979
20,0,-140,234,242,476,954
110,70,100,232,245,477,894
170,70,50,247,230,477,930
20,-40,-130,225,252,477,1071
-100,50,60,238,239,477,956
40,60,180,230,247,477,976
-70,30,0,244,233,477,944
-60,-20,-120,238,239,477,1014
40,60,-180,230,247,477,976
70,-20,-160,238,239,477,844
160,40,70,224,253,477,932
-140,30,60,236,241,477,936
60,-60,30,229,248,477,923
180,20,150,226,251,477,968
-180,20,150,226,251,477,968
-100,-30,170,240,237,477,950
30,-10,-140,228,249,477,892
-150,-60,90,233,245,478,943
120,70,90,231,247,478,891
30,-70,-110,225,253,478,995
60,-20,-160,236,242,478,859
-170,-60,160,230,248,478,916
90,70,120,233,245,478,861
-10,10,-120,223,255,478,955
70,-60,40,224,254,478,1001
-130,30,100,238,241,479,932
-110,-50,140,226,253,479,1026
100,0,150,230,249,479,1070
10,30,-140,234,245,479,1011
150,-20,40,232,247,479,991
-40,-40,-140,230,249,479,1000
-140,0,150,229,250,479,895
-100,70,70,233,246,479,882
90,10,60,229,250,479,867
120,60,90,239,240,479,950
-180,-30,70,237,243,480,980
60,0,-70,228,252,480,908
20,-30,-130,229,251,480,1032
180,-30,70,237,243,480,980
60,-50,-100,225,255,480,1016
150,30,170,239,241,480,956
150,80,70,249,231,480,983
-10,-10,-50,235,245,480,962
-130,20,120,242,238,480,893
-50,30,-80,243,237,480,921
80,-50,50,233,247,480,972
-40,70,0,233,248,481,913
30,-60,0,240,241,481,958
0,10,-130,225,256,481,996
-70,-30,-80,242,239,481,980
90,-20,60,238,243,481,902
-70,-30,-140,243,238,481,958
-100,-40,-130,244,238,482,918
-120,-10,160,246,236,482,906
160,60,60,236,246,482,937
-100,40,50,250,232,482,1048
120,40,-160,224,258,482,1022
-70,-20,-100,247,235,482,983
80,70,130,241,241,482,884
90,0,80,240,242,482,974
-150,0,150,244,238,482,931
-120,-20,180,241,241,482,978
-120,-20,-180,241,241,482,978
-110,-30,-160,239,243,482,991
100,-80,-40,228,255,483,1023
-160,-80,70,237,246,483,959
-120,40,80,240,243,483,1062
-170,-40,70,215,268,483,955
0,10,-50,224,259,483,985
-140,-10,100,227,256,483,973
-160,-30,90,235,248,483,958
-170,-20,80,229,254,483,1002
-100,-60,150,229,255,484,931
-150,-10,90,227,257,484,1000
50,-10,-160,239,245,484,962
100,-60,70,237,247,484,918
100,70,110,233,251,484,886
-130,40,100,236,248,484,955
-30,0,-110,230,255,485,1050
-30,60,-100,231,254,485,853
50,40,150,238,247,485,983
-120,40,20,239,246,485,969
170,50,160,219,266,485,998
160,-10,60,226,259,485,1058
170,60,50,233,252,485,920
130,-50,-10,234,252,486,1006
170,10,70,232,254,486,994
-20,-80,-150,243,243,486,1067
60,80,160,234,252,486,1012
150,-50,20,239,247,486,999
-60,20,-20,248,238,486,900
170,-30,140,225,261,486,931
100,10,10,249,237,486,867
80,-10,-10,242,244,486,969
160,20,70,227,259,486,1037
90,10,40,242,244,486,892
-90,-70,-110,239,247,486,959
-80,30,-30,245,241,486,959
180,30,150,227,260,487,992
110,0,140,225,262,487,1018
70,-40,-100,239,248,487,1084
140,20,70,227,260,487,1071
0,30,-50,240,247,487,999
140,-50,10,232,255,487,960
-180,30,150,227,260,487,992
-60,0,-70,249,238,487,946
-140,-70,100,227,260,487,971
120,50,90,237,251,488,942
70,10,120,239,249,488,913
90,-50,60,232,256,488,947
80,50,120,241,247,488,935
150,20,70,226,262,488,1045
-120,-10,140,253,235,488,908
30,-30,-130,223,265,488,1042
-120,60,0,241,248,489,889
170,-70,30,231,258,489,962
90,-60,-60,236,253,489,1083
100,0,160,232,257,489,1060
-90,-30,-160,248,241,489,949
10,-30,-130,235,254,489,1093
130,-10,10,240,249,489,911
130,-20,120,215,274,489,1025
-60,-10,-100,251,239,490,1086
-150,-50,90,215,275,490,976
-40,-40,-60,243,247,490,864
30,70,-70,228,262,490,941
-130,30,110,229,261,490,894
-40,20,-30,244,246,490,987
-30,-60,-150,247,243,490,1073
90,-10,60,232,258,490,1005
-110,40,10,236,254,490,962
50,-30,-130,242,248,490,958
140,70,70,240,250,490,923
90,10,30,245,245,490,903
-10,-50,-40,241,250,491,916
90,-40,60,230,261,491,944
30,10,-60,225,266,491,1001
0,0,-50,229,262,491,1056
-90,40,-20,248,243,491,972
20,-50,-130,243,248,491,1043
60,-20,0,240,251,491,908
-40,70,-90,240,252,492,947
70,20,-100,239,253,492,885
0,-30,-130,242,250,492,1072
90,20,80,245,247,492,999
20,-80,-120,235,257,492,946
-90,-30,-130,253,239,492,1032
-20,-70,-150,241,251,492,1015
-150,-80,80,245,247,492,1003
20,60,-60,224,268,492,901
180,0,70,240,253,493,1026
170,50,60,238,255,493,1061
-70,40,-50,239,254,493,969
40,70,180,236,257,493,1026
130,30,80,223,270,493,972
-40,-70,-160,240,253,493,1040
-120,30,70,252,241,493,1111
40,70,-180,236,257,493,1026
-180,0,70,240,253,493,1026
-160,50,40,244,249,493,924
-110,40,60,254,239,493,1070
-70,-20,-110,252,241,493,1043
-160,-40,80,222,272,494,1006
-60,20,-70,243,251,494,999
170,70,160,217,277,494,947
110,-50,-40,228,266,494,1069
50,-10,-180,241,253,494,952
110,-60,80,245,249,494,947
80,10,-110,235,259,494,931
130,-60,-10,237,257,494,1056
120,10,50,243,251,494,1076
160,-30,40,216,278,494,947
50,-10,180,241,253,494,952
-50,-20,-120,242,252,494,984
100,-30,-70,233,261,494,846
130,70,80,236,258,494,912
80,-10,-100,230,264,494,962
170,-30,50,226,268,494,955
100,0,140,243,252,495,1127
110,-20,100,216,279,495,1012
100,20,-150,241,254,495,1092
-10,20,-120,240,255,495,1020
0,40,-130,236,259,495,987
160,0,60,228,267,495,1086
-180,-10,70,227,268,495,1070
180,-10,70,227,268,495,1070
50,80,170,242,254,496,1075
-20,-30,-130,237,259,496,1001
100,40,-140,241,255,496,1105
70,-30,-140,244,252,496,826
150,-60,10,228,269,497,1040
0,20,-50,251,246,497,1020
-30,-80,-160,253,244,497,1114
110,20,60,243,254,497,1051
20,-70,-120,232,265,497,1035
130,20,70,238,259,497,1057
90,0,120,234,263,497,995
-10,-30,-130,237,260,497,1094
-90,50,50,258,240,498,1052
-30,-40,-140,234,264,498,1005
80,10,110,242,256,498,936
-30,10,-40,251,247,498,1029
-70,-20,-90,254,244,498,1040
-150,70,20,240,258,498,937
-70,20,-50,246,253,499,978
-40,-80,-170,253,246,499,1132
-120,-70,120,234,265,499,1016
130,-20,0,246,253,499,1048
40,-60,10,242,257,499,940
120,-70,-20,237,262,499,1048
150,70,60,253,246,499,969
70,-30,-130,241,259,500,906
120,-20,-30,234,266,500,854
110,-30,90,239,261,500,993
180,30,70,239,261,500,1018
60,50,140,256,244,500,1030
-60,-40,-150,249,251,500,1003
80,-60,-80,236,264,500,1005
100,-10,-20,253,247,500,949
-180,30,70,239,261,500,1018
130,40,-170,246,254,500,1026
-70,20,-30,257,243,500,911
-60,0,-60,263,238,501,915
-80,-30,-100,261,240,501,922
-160,0,80,246,255,501,965
-120,30,40,253,248,501,1058
-20,30,-110,255,246,501,976
-110,-40,-140,252,249,501,1026
-120,-20,130,254,247,501,953
110,-80,-30,234,267,501,1096
-30,10,-110,242,260,502,1098
180,40,60,248,254,502,1003
50,-10,-170,256,246,502,912
20,-60,-10,253,249,502,964
-180,40,60,248,254,502,1003
-70,30,-50,246,256,502,959
100,40,100,232,270,502,1033
-120,30,60,256,246,502,1068
140,-60,0,244,259,503,1056
-140,-80,90,247,256,503,1023
-80,-60,170,249,254,503,1001
40,50,-180,244,259,503,961
-160,-40,160,246,257,503,1078
160,-60,20,240,263,503,964
-160,0,150,245,258,503,1059
0,20,-130,248,255,503,1079
100,50,-140,235,268,503,1038
40,50,180,244,259,503,961
160,50,170,234,270,504,1001
10,0,-50,230,274,504,1090
140,-10,40,249,255,504,1049
90,20,70,250,254,504,993
-100,-30,-140,257,247,504,1056
80,-10,-180,248,256,504,1057
140,-30,120,237,267,504,914
-60,-20,-70,260,244,504,1082
80,-10,180,248,256,504,1057
-80,50,-40,250,254,504,984
90,10,-140,247,257,504,978
-100,-70,-120,242,262,504,1021
-70,-20,-120,258,247,505,996
-90,60,-30,261,244,505,976
140,-40,10,244,261,505,1079
-100,-80,130,246,259,505,1035
-110,-30,140,255,250,505,989
-50,-70,-70,261,244,505,933
110,40,-150,244,261,505,1102
-170,-10,150,246,259,505,991
90,0,140,255,250,505,1173
-90,-80,140,245,261,506,1037
-50,-60,-160,244,262,506,1097
-10,50,-120,254,252,506,980
90,0,-160,248,258,506,1139
30,10,-150,242,264,506,1057
30,-60,-120,243,263,506,1062
120,-40,-30,235,271,506,1041
160,80,60,257,250,507,1028
-60,-10,-70,262,245,507,997
160,-50,30,248,259,507,1045
160,40,170,242,265,507,1066
-90,40,40,260,247,507,1086
-110,60,-10,252,255,507,950
-80,30,0,254,253,507,978
40,40,-180,253,254,507,1016
40,40,180,253,254,507,1016
140,-50,0,248,259,507,1051
50,60,160,251,256,507,1017
140,20,170,234,273,507,1044
-140,50,120,248,259,507,1045
-130,-70,110,241,267,508,1011
150,-10,50,245,263,508,1077
150,-70,10,239,269,508,1124
20,70,-60,235,273,508,982
-120,50,90,254,254,508,1042
20,30,-60,248,260,508,1037
70,-60,-90,234,274,508,1007
-150,80,120,231,277,508,970
-90,-60,160,242,266,508,994
-20,40,-30,250,259,509,1005
80,-10,170,247,262,509,969
70,70,140,258,251,509,950
-80,-30,-150,264,245,509,1024
-60,10,-70,254,255,509,1035
110,-10,-20,249,260,509,896
40,30,-180,256,254,510,1041
-130,-50,-160,260,250,510,1002
-130,0,150,248,262,510,900
-80,-80,150,250,260,510,1070
-60,-50,-160,260,250,510,1124
40,30,180,256,254,510,1041
-150,-40,90,233,277,510,1010
80,-10,-160,250,261,511,1029
-130,-80,100,248,263,511,1043
-10,-20,-50,243,268,511,1089
-120,30,50,261,250,511,1107
150,-10,140,229,282,511,1033
80,20,100,247,264,511,973
-150,20,140,247,264,511,1029
110,0,150,240,271,511,1159
120,10,170,245,266,511,1125
10,-80,-130,247,264,511,973
60,30,130,244,267,511,1008
-140,-60,100,249,262,511,1009
170,40,160,231,281,512,1021
-180,-70,50,242,270,512,987
160,-70,20,234,278,512,1032
180,-70,50,242,270,512,987
150,-50,10,243,270,513,983
-160,40,140,241,272,513,1038
-90,-70,150,242,271,513,1092
-140,-50,100,236,277,513,999
-30,30,-30,262,251,513,990
110,-10,120,228,285,513,1038
-60,30,0,264,249,513,1077
50,20,-80,255,258,513,1007
100,10,-160,249,264,513,1150
-160,40,50,255,258,513,1069
-50,70,-80,252,261,513,996
160,-50,20,240,273,513,928
-110,60,80,258,255,513,956
50,0,150,254,260,514,986
100,20,50,253,261,514,1033
80,-30,-120,249,265,514,923
40,-50,-120,244,270,514,1134
100,-50,-60,237,277,514,1031
60,-40,-110,252,262,514,1114
-40,40,-90,252,262,514,1073
90,50,110,259,255,514,1046
0,-10,-130,244,270,514,1143
-20,40,-110,244,270,514,1043
-120,-10,130,260,254,514,1024
-110,-80,120,252,263,515,1052
-150,50,130,250,265,515,1005
-60,0,-50,264,251,515,1011
-80,-40,-170,247,268,515,989
-140,0,90,254,261,515,946
50,-50,-110,248,267,515,1116
90,20,60,241,274,515,1002
160,-50,130,246,269,515,1075
90,0,70,249,266,515,952
40,80,180,242,274,516,1109
-140,80,110,237,279,516,952
40,80,-180,242,274,516,1109
10,-70,-130,240,276,516,1063
-70,-80,160,256,260,516,1092
-170,80,140,236,280,516,1029
-50,-80,180,259,257,516,1124
-100,-30,160,263,253,516,1049
-80,40,30,260,256,516,1101
-70,-50,-170,252,264,516,1115
-50,-80,-180,259,257,516,1124
70,-40,-110,250,266,516,1006
-110,30,30,264,253,517,1134
-20,-30,-50,248,269,517,1039
-50,-70,-170,249,268,517,1112
-160,80,130,238,279,517,999
80,-20,-150,249,268,517,895
0,0,-130,256,261,517,988
170,-60,40,249,268,517,1093
-80,30,10,269,248,517,1035
160,60,170,231,287,518,1016
-150,30,60,251,267,518,1041
170,80,50,260,258,518,1074
-130,0,100,261,257,518,950
-120,0,140,253,265,518,939
-30,70,-10,250,268,518,963
-40,60,-90,244,274,518,902
10,70,-50,238,280,518,1001
-20,50,-110,263,255,518,1055
130,-70,-10,251,267,518,1155
30,70,-170,246,272,518,1083
-110,-40,140,251,268,519,992
-40,-50,-150,251,268,519,1151
-30,40,-100,252,267,519,1102
-150,50,30,259,260,519,988
70,-30,30,258,261,519,972
-130,30,50,261,258,519,1121
-60,10,-30,267,252,519,994
-110,-20,140,276,243,519,1018
-60,-80,170,260,260,520,1117
30,-40,-130,242,278,520,1118
-90,-30,-170,255,265,520,1041
90,10,-130,243,277,520,959
-20,-40,-140,240,280,520,1085
110,20,-160,240,280,520,1143
-120,-80,110,252,268,520,1041
40,-40,-120,250,270,520,1154
80,-40,-110,252,269,521,965
-20,-10,-120,251,270,521,1109
20,20,-150,246,275,521,1077
-80,-70,160,249,272,521,1089
80,60,120,260,261,521,1024
-40,10,-100,251,270,521,1068
-90,30,10,267,254,521,1027
60,-60,-100,244,277,521,1098
20,0,-50,250,271,521,1056
0,-70,-140,248,274,522,1060
180,50,50,258,264,522,1080
-180,50,50,258,264,522,1080
-50,30,-10,269,253,522,1016
-130,40,110,255,267,522,1022
160,-40,30,239,283,522,978
-60,-30,-140,258,264,522,1000
-130,10,90,253,269,522,1014
130,-40,-10,245,277,522,1033
-150,-20,160,255,267,522,1058
-90,30,0,264,259,523,1091
-130,20,80,262,261,523,1081
90,-20,-80,271,252,523,931
-60,-60,-170,250,273,523,1100
-20,20,-40,258,265,523,1135
100,30,90,242,281,523,1065
-10,30,-120,263,260,523,1091
90,30,-130,253,270,523,1030
80,-10,-60,252,271,523,933
60,70,150,262,261,523,1083
-70,-10,-90,263,260,523,1091
-100,60,-20,264,259,523,1032
50,20,140,263,260,523,981
-90,-40,-110,270,253,523,1048
-150,10,80,263,260,523,1099
-20,-60,-150,247,276,523,1111
-30,-60,-50,264,259,523,1003
-60,-70,-180,258,265,523,1115
-60,-70,180,258,265,523,1115
-100,-70,140,249,275,524,1085
0,-20,-130,247,277,524,1158
170,30,70,245,279,524,1088
-60,60,20,266,258,524,986
-80,50,40,281,243,524,1071
-110,-70,130,247,277,524,1088
-140,-40,100,245,280,525,1034
-70,-60,180,255,270,525,1018
-40,30,-20,266,259,525,1054
130,60,80,261,264,525,1092
-90,70,60,260,265,525,975
-70,-60,-180,255,270,525,1018
90,-10,-20,263,262,525,1029
-130,80,100,245,280,525,968
160,-20,50,257,268,525,1116
90,0,60,242,284,526,976
150,-40,20,254,272,526,1135
170,10,150,254,272,526,1044
-50,10,-90,260,266,526,1113
130,0,20,251,275,526,977
150,50,70,251,275,526,1092
-10,40,-120,243,283,526,1044
-120,-10,170,259,267,526,1059
-120,40,90,260,266,526,1138
140,-40,0,248,278,526,1076
180,20,70,243,284,527,1049
60,-30,-130,261,266,527,1099
140,-70,0,251,276,527,1150
-80,-50,-180,238,289,527,1053
-180,20,70,243,284,527,1049
100,0,180,247,280,527,1046
90,0,130,261,266,527,1150
-10,70,-30,255,272,527,1041
-80,-50,180,238,289,527,1053
140,-20,20,243,284,527,1032
100,0,-180,247,280,527,1046
-140,-10,160,262,265,527,998
-170,-80,50,251,276,527,1073
170,20,70,241,286,527,1048
-40,20,-100,263,265,528,1103
80,-10,-90,255,273,528,1034
50,-10,170,260,268,528,1004
-50,-10,-110,266,262,528,1053
40,-10,-150,246,282,528,1111
-110,-50,-130,261,267,528,971
-130,10,140,270,259,529,976
90,0,-130,242,287,529,1008
-40,-70,-60,274,255,529,1022
-70,20,-20,277,252,529,985
-90,30,-10,265,265,530,1071
180,-80,40,245,285,530,1085
0,-80,-140,257,273,530,1057
50,-20,-150,254,276,530,1016
120,30,80,249,281,530,1120
-180,-80,40,245,285,530,1085
160,20,160,255,275,530,1109
-110,-30,-150,264,266,530,1074
-10,-50,-140,253,277,530,1088
0,30,-130,244,286,530,1070
0,70,-40,248,283,531,1047
100,0,170,265,266,531,1076
-70,-20,-80,275,256,531,1122
-170,30,150,258,273,531,1085
80,-10,-80,266,265,531,1040
-30,-50,-150,257,274,531,1098
170,-50,40,241,290,531,1031
130,-80,-10,253,279,532,1199
170,-60,30,260,272,532,1020
-70,-70,170,262,270,532,1090
60,-40,-120,251,281,532,1005
-60,-20,-130,261,271,532,1129
-80,-30,-90,276,256,532,1020
10,60,-50,252,280,532,1054
-80,-20,-120,269,263,532,1071
-140,-50,-170,271,261,532,1015
-110,40,70,273,259,532,1114
-140,70,10,258,274,532,971
40,0,-160,262,271,533,1139
10,50,-50,239,294,533,907
-100,30,30,279,254,533,1147
60,-10,160,261,272,533,970
160,30,70,247,286,533,1127
150,10,60,250,283,533,1162
120,20,60,263,270,533,1155
-50,40,-80,261,272,533,1093
-160,-10,80,254,279,533,1085
60,-20,-170,266,268,534,987
-150,-50,-180,264,270,534,1024
-180,-20,70,257,277,534,1158
180,-70,40,262,272,534,1043
90,0,-140,249,285,534,998
180,70,40,273,261,534,1057
-120,-30,-160,272,262,534,1134
-150,-50,180,264,270,534,1024
-180,70,40,273,261,534,1057
180,-20,70,257,277,534,1158
180,80,150,242,292,534,1105
-180,80,150,242,292,534,1105
-180,-70,40,262,272,534,1043
-90,-40,170,256,279,535,1094
-20,-20,-50,262,273,535,1078
120,20,-170,246,289,535,1151
-100,60,70,272,263,535,1026
70,-50,40,247,288,535,1098
-20,70,-20,258,277,535,1022
50,-60,-110,259,276,535,1164
-50,20,-20,275,260,535,1061
-120,30,80,267,268,535,1182
-110,-60,-130,269,266,535,1012
-60,0,-80,274,261,535,1068
-70,-40,-80,264,271,535,985
140,0,50,271,265,536,1110
120,-80,-20,255,281,536,1195
-50,20,-90,268,268,536,1054
30,60,-170,250,286,536,1109
140,-10,30,237,299,536,1071
160,-80,20,252,284,536,1161
170,80,160,247,289,536,1139
-140,30,50,278,258,536,1103
130,-30,-10,251,285,536,1098
50,-10,160,277,259,536,994
-60,30,-70,261,275,536,1083
-70,-40,-160,261,275,536,1104
-170,-70,60,245,291,536,1101
-110,30,40,276,261,537,1104
-160,60,30,276,261,537,1019
10,20,-140,253,284,537,1167
-80,-40,-90,266,271,537,1094
90,-30,-90,268,269,537,1006
-30,50,-100,266,271,537,1101
110,10,0,276,261,537,1002
120,10,10,271,266,537,1048
110,40,90,249,288,537,1176
-130,-10,110,269,268,537,1106
80,-10,-170,265,272,537,1135
-160,-80,60,261,277,538,1083
-120,0,130,268,270,538,968
130,40,80,256,282,538,1161
150,-80,10,256,282,538,1181
80,-40,50,257,282,539,1044
30,-50,-130,256,283,539,1191
170,-20,60,250,289,539,1183
100,-60,-50,259,280,539,1226
-120,80,90,256,283,539,987
140,-80,0,257,282,539,1195
100,-10,100,246,293,539,1115
110,0,160,252,287,539,1169
-170,-70,50,267,273,540,1128
120,0,150,249,291,540,1151
30,80,-170,253,287,540,1114
110,0,-10,261,279,540,1053
-110,-20,-170,276,264,540,1146
-170,20,70,262,278,540,1083
-130,-20,-180,260,281,541,1007
-180,80,40,262,279,541,1122
-70,-20,-130,272,269,541,1002
-80,-20,-110,280,261,541,1079
170,-80,30,252,289,541,1108
-30,20,-110,261,280,541,1176
180,80,40,262,279,541,1122
-130,-20,180,260,281,541,1007
-140,30,130,259,283,542,1016
120,-10,130,247,295,542,1173
160,-40,20,256,286,542,1014
-90,-30,-120,275,267,542,1106
-60,-30,-70,281,261,542,1121
-150,-80,70,269,273,542,1101
90,10,50,252,290,542,1060
150,-20,30,244,298,542,1114
-70,40,20,277,265,542,1045
-100,40,60,279,263,542,1187
-50,60,10,270,272,542,1074
-30,-70,-160,259,284,543,1124
-180,-40,50,249,294,543,1097
-100,30,10,271,272,543,1178
-80,40,-40,266,277,543,1044
-110,50,80,272,271,543,1168
60,20,120,275,268,543,988
180,-40,50,249,294,543,1097
80,-10,-70,268,275,543,990
-90,30,20,279,264,543,1131
-60,70,-70,267,277,544,1091
-40,-10,-50,277,267,544,1022
-20,10,-120,257,287,544,1144
-100,-50,150,272,272,544,1070
-120,0,150,259,285,544,1005
120,-30,-40,260,284,544,1020
80,0,140,276,269,545,1158
70,60,130,276,269,545,1108
-120,-40,-150,274,271,545,1067
-110,-70,-130,267,278,545,1137
150,-30,20,255,290,545,1055
90,20,-130,266,279,545,973
180,60,40,262,283,545,1015
-110,30,60,277,268,545,1182
-180,60,40,262,283,545,1015
-10,-20,-130,267,279,546,1215
90,60,110,272,274,546,1072
-70,-10,-80,278,268,546,1105
-110,80,80,259,287,546,1011
-30,40,-20,279,267,546,1038
-130,20,130,262,284,546,1074
160,70,170,245,301,546,1084
110,10,-170,261,285,546,1142
150,-30,130,257,289,546,1043
60,-20,-180,275,271,546,1120
60,-20,180,275,271,546,1120
90,0,110,257,290,547,1140
10,-60,-130,269,278,547,1144
90,0,-150,279,268,547,1133
-40,40,-10,279,268,547,1074
70,-10,160,268,279,547,1038
-40,-60,-160,269,278,547,1209
70,20,110,276,272,548,1040
-40,-90,-180,264,284,548,1219
-20,-90,-160,264,284,548,1219
100,-90,-40,264,284,548,1219
30,-90,-110,264,284,548,1219
-60,-90,160,264,284,548,1219
-140,-90,80,264,284,548,1219
-140,-20,170,266,282,548,1036
50,-90,-90,264,284,548,1219
0,-90,-140,264,284,548,1219
90,-90,-50,264,284,548,1219
170,-90,30,264,284,548,1219
-70,-90,150,264,284,548,1219
80,20,-110,259,289,548,1082
130,0,40,270,278,548,1086
20,-90,-120,264,284,548,1219
180,-90,40,264,284,548,1219
-160,-90,60,264,284,548,1219
-40,-90,180,264,284,548,1219
-80,-90,140,264,284,548,1219
-100,-90,120,264,284,548,1219
150,40,70,254,294,548,1210
-150,-90,70,264,284,548,1219
-120,-90,100,264,284,548,1219
140,-90,0,264,284,548,1219
120,-90,-20,264,284,548,1219
-10,-80,-150,265,283,548,1122
80,-90,-60,264,284,548,1219
-50,-90,170,264,284,548,1219
70,-90,-70,264,284,548,1219
-10,-90,-150,264,284,548,1219
-130,-90,90,264,284,548,1219
150,-90,10,264,284,548,1219
-30,-90,-170,264,284,548,1219
130,-90,-10,264,284,548,1219
60,-90,-80,264,284,548,1219
10,-90,-130,264,284,548,1219
-180,-90,40,264,284,548,1219
-110,-90,110,264,284,548,1219
-110,-10,170,272,276,548,1086
160,-90,20,264,284,548,1219
-90,-90,130,264,284,548,1219
40,-90,-100,264,284,548,1219
110,-90,-30,264,284,548,1219
-170,-90,50,264,284,548,1219
140,70,-170,266,283,549,1190
-130,30,120,259,290,549,964
-110,-10,160,277,272,549,1113
-50,60,-80,267,282,549,976
-100,30,20,281,268,549,1154
180,10,70,255,295,550,1153
-100,80,70,263,287,550,1053
-180,10,70,255,295,550,1153
-50,-20,-60,283,267,550,1180
-70,-80,-90,266,284,550,1164
70,-70,-80,275,275,550,1208
90,-60,-70,264,286,550,1136
150,60,-180,253,297,550,1189
60,-70,-90,274,276,550,1232
-60,-10,-110,270,280,550,1234
160,-20,40,264,286,550,1134
150,60,180,253,297,550,1189
70,0,-80,266,284,550,1106
40,20,-70,265,285,550,1164
100,20,30,280,270,550,1031
50,10,140,274,276,550,1084
90,-10,-140,262,288,550,1001
150,70,180,255,296,551,1201
50,-40,-120,251,300,551,1174
90,-70,-60,256,295,551,1201
40,-60,-120,264,287,551,1211
150,70,-180,255,296,551,1201
-170,50,40,276,275,551,1089
-110,30,50,271,280,551,1129
150,-40,10,258,293,551,1111
50,70,160,270,281,551,1230
30,0,-50,256,295,551,1086
-90,30,-20,279,273,552,1116
100,30,-140,264,288,552,1239
-130,30,40,277,275,552,1167
50,-10,-40,266,286,552,1116
-100,-20,-180,279,273,552,1124
-100,-20,180,279,273,552,1124
-120,30,90,283,269,552,1171
-130,-30,-170,281,271,552,1096
140,60,70,275,277,552,1129
-140,-80,80,274,278,552,1125
-50,-40,-150,260,292,552,1190
-100,-40,-120,290,263,553,1102
40,20,-180,277,276,553,1150
10,10,-140,273,280,553,1103
40,20,180,277,276,553,1150
-110,40,0,277,276,553,1119
160,80,170,255,298,553,1204
130,0,150,256,297,553,1140
170,-10,60,269,284,553,1254
130,50,80,265,288,553,1138
30,10,-160,264,290,554,1185
100,-80,-50,267,287,554,1089
120,-50,-30,254,300,554,1230
-90,30,30,278,276,554,1148
60,10,-80,256,298,554,1132
-100,-20,170,283,272,555,1083
90,80,120,278,277,555,1205
-50,0,-40,277,278,555,1037
10,80,-150,269,286,555,1124
180,10,150,268,287,555,1250
120,80,-150,262,293,555,1100
130,80,-160,264,291,555,1119
-180,10,150,268,287,555,1250
100,-70,-50,255,300,555,1166
170,-50,30,267,288,555,1023
-160,-70,70,254,301,555,1203
90,0,90,261,294,555,1143
70,-30,-150,280,275,555,1033
-130,40,20,275,280,555,1130
80,-70,-70,269,286,555,1211
150,30,70,258,298,556,1198
120,30,-160,268,288,556,1085
160,-20,140,259,297,556,1197
90,-80,-60,270,286,556,1101
130,10,170,257,299,556,1292
60,10,130,285,271,556,1083
50,10,-70,267,289,556,1101
20,-10,-140,266,290,556,1119
-170,0,150,262,294,556,1097
-40,50,-90,276,280,556,1132
160,70,50,280,276,556,1034
130,20,180,261,295,556,1148
20,80,-160,264,292,556,1126
100,60,100,276,280,556,1125
130,20,-180,261,295,556,1148
170,-50,140,260,297,557,1167
150,80,-180,252,305,557,1187
150,80,180,252,305,557,1187
-80,-80,-100,268,289,557,1176
-120,30,30,279,278,557,1183
10,-40,-30,270,287,557,1119
100,50,100,274,283,557,1124
110,30,80,258,299,557,1219
70,30,-100,274,284,558,1084
-30,-20,-130,274,284,558,1143
90,10,20,271,287,558,1041
-130,-40,110,260,298,558,1089
-80,-20,-90,286,272,558,1093
-80,-20,-100,292,266,558,1095
140,0,150,265,294,559,1233
-40,-20,-130,276,283,559,1129
80,-80,-70,263,296,559,1108
-130,70,0,269,290,559,1103
0,40,-140,266,293,559,1165
20,-20,-40,263,296,559,1085
-120,0,120,288,271,559,970
140,-10,140,260,299,559,1223
-30,-10,-120,275,284,559,1196
-60,-80,-80,274,285,559,1184
-50,0,-100,264,295,559,1141
-20,20,-120,263,297,560,1204
-100,-30,-130,286,274,560,1136
40,-20,-140,275,285,560,1142
130,70,-160,267,293,560,1135
20,70,-160,272,288,560,1152
80,-40,-100,290,270,560,1191
50,-70,-100,285,275,560,1259
-70,20,-10,300,261,561,1070
-90,-30,180,287,274,561,1121
-60,10,-80,283,278,561,1222
-100,40,-10,284,277,561,1172
40,-20,-30,269,292,561,1115
-70,30,10,289,272,561,1136
-60,40,10,292,269,561,1127
-80,-30,-160,278,283,561,1078
60,30,-90,269,292,561,1032
90,0,0,272,289,561,992
130,0,30,268,293,561,1135
-130,-60,110,271,290,561,1077
-90,-30,-180,287,274,561,1121
-70,10,-40,284,278,562,1099
170,-40,40,268,294,562,1213
0,-40,-140,285,277,562,1196
0,80,-140,274,288,562,1157
180,-60,50,262,300,562,1114
40,10,160,283,279,562,1090
90,0,100,271,291,562,1190
120,10,20,286,276,562,1108
-180,-60,50,262,300,562,1114
50,50,150,277,286,563,1108
-10,-70,-150,258,305,563,1117
60,-10,-40,264,299,563,1092
60,-30,20,261,302,563,1012
110,30,-150,266,297,563,1226
-20,0,-120,272,291,563,1208
-130,-80,90,280,283,563,1153
-70,-10,-100,285,278,563,1190
10,-40,-140,273,290,563,1207
70,0,140,271,292,563,1182
-80,30,20,288,276,564,1164
-80,-50,-90,277,287,564,1146
170,-40,140,270,294,564,1041
70,30,110,265,299,564,1085
140,80,-170,260,304,564,1152
0,-50,-30,275,289,564,1114
-80,20,-30,290,274,564,1174
80,80,130,279,285,564,1231
-100,30,40,286,279,565,1171
10,40,-50,283,282,565,1095
-90,-30,-110,283,283,566,1170
-60,-10,-60,290,276,566,1121
160,50,60,286,280,566,1254
-90,-80,-110,272,294,566,1216
80,-10,40,269,297,566,1087
-160,20,70,264,302,566,1151
-170,-40,60,260,306,566,1082
-70,-30,-150,276,290,566,1213
-120,10,130,272,294,566,1070
50,30,-80,269,298,567,1134
-120,-80,100,280,287,567,1153
-10,-40,-140,284,283,567,1225
110,-60,-40,266,301,567,1257
30,40,-170,274,293,567,1220
-110,30,20,284,283,567,1213
120,10,30,272,296,568,1156
-180,-50,50,272,296,568,1214
-120,10,120,281,287,568,1102
180,-50,50,272,296,568,1214
100,20,40,296,272,568,1074
40,10,150,277,291,568,1061
80,-10,-50,277,292,569,1048
-70,10,-50,284,285,569,1121
140,60,-170,270,299,569,1231
110,-80,-40,278,291,569,1123
-50,10,-30,289,280,569,1037
20,-60,-130,282,287,569,1205
-30,-70,-50,290,279,569,1130
-90,80,60,270,299,569,1123
-100,-20,-170,282,288,570,1213
140,30,180,267,303,570,1135
70,-80,-80,266,304,570,1117
20,-40,-140,266,304,570,1151
110,80,100,281,289,570,1214
140,30,-180,267,303,570,1135
0,-50,-140,291,279,570,1218
-150,30,140,271,299,570,1159
-40,60,0,276,294,570,1151
-120,40,100,281,289,570,1197
20,50,-160,277,294,571,1221
-170,80,30,272,299,571,1185
-100,-20,160,293,278,571,1134
130,10,50,289,282,571,1241
130,60,-160,274,297,571,1191
10,0,-140,272,299,571,1191
170,30,160,272,299,571,1177
-80,-20,-130,293,278,571,1176
-50,-30,-140,273,299,572,1150
-120,20,90,285,287,572,1185
-20,-20,-130,273,299,572,1222
120,-10,-20,282,290,572,975
110,80,-140,274,298,572,1137
140,-20,130,269,303,572,1240
-110,-10,150,284,288,572,1086
40,-70,-110,286,286,572,1281
-160,-70,60,282,290,572,1237
100,80,110,281,291,572,1211
-110,-80,110,278,294,572,1163
-170,90,140,269,304,573,1133
-140,90,110,269,304,573,1133
-150,90,120,269,304,573,1133
80,90,-110,269,304,573,1133
-60,90,30,269,304,573,1133
30,90,-60,269,304,573,1133
80,-30,-130,282,291,573,1010
0,90,-30,269,304,573,1133
90,90,-120,269,304,573,1133
-100,90,70,269,304,573,1133
50,90,-80,269,304,573,1133
40,90,-70,269,304,573,1133
-110,90,80,269,304,573,1133
130,90,-160,269,304,573,1133
-70,90,40,269,304,573,1133
-120,90,90,269,304,573,1133
150,90,-180,269,304,573,1133
140,90,-170,269,304,573,1133
60,90,-90,269,304,573,1133
170,90,160,269,304,573,1133
160,60,50,284,289,573,1154
-160,90,130,269,304,573,1133
160,90,170,269,304,573,1133
-110,40,80,285,288,573,1213
-20,90,-10,269,304,573,1133
-30,90,0,269,304,573,1133
-90,90,60,269,304,573,1133
-40,90,10,269,304,573,1133
150,-40,0,288,285,573,1184
70,90,-100,269,304,573,1133
-130,90,100,269,304,573,1133
100,90,-130,269,304,573,1133
110,90,-140,269,304,573,1133
-10,90,-20,269,304,573,1133
-50,90,20,269,304,573,1133
-180,90,150,269,304,573,1133
20,90,-50,269,304,573,1133
120,90,-150,269,304,573,1133
180,90,150,269,304,573,1133
-80,90,50,269,304,573,1133
10,90,-40,269,304,573,1133
150,90,180,269,304,573,1133
160,0,150,276,298,574,1152
-90,50,-30,292,282,574,1173
-70,70,-60,278,296,574,1174
70,-10,10,279,295,574,984
140,-30,10,270,304,574,1257
-160,-50,170,286,288,574,1145
-70,-50,-80,281,293,574,1115
-160,50,140,265,309,574,1075
-90,40,50,295,279,574,1247
-40,-70,-170,284,290,574,1253
-100,50,70,287,287,574,1215
-20,-80,-160,279,295,574,1209
120,80,90,284,291,575,1219
150,60,60,289,286,575,1133
-170,-60,60,266,309,575,1138
120,10,0,288,287,575,1159
-60,-50,-70,280,295,575,1115
40,20,160,289,286,575,1123
30,50,-170,275,300,575,1160
-120,-20,-170,285,290,575,1208
110,90,110,270,306,576,1210
90,90,130,270,306,576,1210
-80,90,-60,270,306,576,1210
90,70,110,284,292,576,1120
-40,90,-100,270,306,576,1210
30,90,-170,270,306,576,1210
40,90,-180,270,306,576,1210
-150,0,80,285,291,576,1232
160,10,60,265,311,576,1309
50,90,170,270,306,576,1210
-70,90,-70,270,306,576,1210
40,90,180,270,306,576,1210
60,90,160,270,306,576,1210
-70,50,30,296,280,576,1122
10,90,-150,270,306,576,1210
-150,90,10,270,306,576,1210
100,90,120,270,306,576,1210
170,90,50,270,306,576,1210
-170,90,30,270,306,576,1210
160,90,60,270,306,576,1210
-160,90,20,270,306,576,1210
-50,40,0,284,292,576,1176
10,-30,-140,278,298,576,1127
120,-80,-30,274,302,576,1161
-50,90,-90,270,306,576,1210
150,90,70,270,306,576,1210
120,-40,-40,274,302,576,1217
-60,90,-80,270,306,576,1210
-180,90,40,270,306,576,1210
130,90,90,270,306,576,1210
-100,90,-40,270,306,576,1210
-30,90,-110,270,306,576,1210
-20,90,-120,270,306,576,1210
180,90,40,270,306,576,1210
80,90,140,270,306,576,1210
130,30,-170,269,307,576,1177
0,90,-140,270,306,576,1210
150,20,170,283,293,576,1233
-110,90,-30,270,306,576,1210
120,90,100,270,306,576,1210
-120,90,-20,270,306,576,1210
80,-30,50,282,294,576,1144
-100,30,0,290,286,576,1216
-140,90,0,270,306,576,1210
-130,90,-10,270,306,576,1210
-10,90,-130,270,306,576,1210
-130,50,110,287,289,576,1149
20,90,-160,270,306,576,1210
-90,90,-50,270,306,576,1210
70,90,150,270,306,576,1210
90,-30,-100,301,275,576,1101
140,90,80,270,306,576,1210
170,-60,20,290,287,577,1120
-180,-30,60,274,303,577,1216
-50,-80,-70,286,291,577,1208
-30,-50,-50,280,297,577,1084
110,-20,-50,268,309,577,1073
60,-20,10,267,310,577,953
-10,10,-130,273,304,577,1133
80,-50,-90,270,307,577,1269
180,-30,60,274,303,577,1216
160,-50,10,278,299,577,1116
-180,-60,40,290,288,578,1133
160,-30,30,278,300,578,1187
0,30,-140,281,297,578,1219
0,-30,-40,280,298,578,1127
180,-60,40,290,288,578,1133
-60,60,-70,279,299,578,1085
-100,-40,150,285,293,578,1240
-60,0,-40,295,283,578,1135
-130,-50,110,264,314,578,1135
-110,70,-20,279,299,578,1172
-90,60,60,286,292,578,1099
-160,30,60,277,301,578,1189
-120,20,100,285,293,578,1191
70,-20,-170,284,294,578,1109
60,40,130,280,298,578,1155
80,30,100,273,306,579,1224
180,0,150,280,299,579,1136
150,50,-180,272,307,579,1161
90,-50,-80,264,315,579,1196
130,50,-160,278,301,579,1185
120,0,160,264,315,579,1293
10,10,-50,265,314,579,1133
70,-40,-120,276,303,579,1151
-180,0,150,280,299,579,1136
110,-40,-60,286,293,579,1091
110,-30,-60,268,311,579,1082
70,80,140,287,292,579,1250
150,50,180,272,307,579,1161
110,-50,-50,282,298,580,1232
100,0,-170,271,309,580,1297
170,0,150,270,310,580,1220
10,30,-150,281,299,580,1175
130,-10,0,284,296,580,1192
-170,40,150,275,305,580,1242
40,0,-50,269,312,581,1144
110,-70,-40,266,315,581,1171
-60,20,-10,304,277,581,1099
-10,80,-130,288,293,581,1168
140,-30,0,276,305,581,1212
-30,-60,-160,280,301,581,1231
-100,-80,-120,284,297,581,1244
-160,-30,160,274,307,581,1165
40,60,170,285,296,581,1301
-70,80,40,275,306,581,1202
-100,-80,120,280,301,581,1174
40,0,-170,298,283,581,1077
120,70,-150,281,301,582,1175
-110,-30,-140,289,293,582,1152
60,-30,-140,278,304,582,1120
140,30,70,269,313,582,1286
30,-20,-140,285,297,582,1217
-80,80,50,273,309,582,1175
-70,-70,160,288,294,582,1159
40,30,160,292,290,582,1171
-120,40,10,288,294,582,1131
110,20,20,294,288,582,1159
150,0,150,276,306,582,1252
-40,0,-40,288,295,583,1105
50,-80,-100,270,313,583,1149
40,-40,-130,266,317,583,1313
80,-30,-140,286,297,583,996
50,30,140,292,291,583,1102
70,40,120,284,299,583,1228
-140,20,140,293,290,583,1164
-170,-50,60,284,299,583,1250
130,80,80,288,296,584,1273
-60,20,-80,283,301,584,1197
-60,-70,170,285,299,584,1212
30,0,-150,273,311,584,1252
120,-70,-30,280,304,584,1197
-140,20,70,295,290,585,1196
100,70,100,289,296,585,1106
60,-30,-150,284,301,585,1149
100,80,-130,285,300,585,1201
-40,-30,-140,288,297,585,1215
-80,20,-20,302,283,585,1143
130,20,60,286,299,585,1279
60,-80,-90,275,311,586,1140
-130,-10,170,298,288,586,1051
130,-80,-20,286,300,586,1187
-80,20,-10,302,284,586,1190
170,40,60,280,306,586,1192
-80,70,50,284,302,586,1117
130,-70,-20,282,304,586,1236
150,-50,0,284,302,586,1211
-50,50,-80,289,297,586,1185
150,-30,10,274,313,587,1196
-80,70,-50,285,302,587,1190
40,10,180,285,302,587,1235
-120,-60,120,276,311,587,1192
150,0,50,288,299,587,1306
-140,50,20,295,292,587,1132
40,10,-180,285,302,587,1235
80,40,110,278,309,587,1245
-140,40,30,286,301,587,1166
140,50,70,276,312,588,1284
-130,50,10,293,295,588,1090
-120,30,100,293,295,588,1155
60,60,140,292,296,588,1178
-130,20,70,292,296,588,1232
-50,-20,-130,292,296,588,1252
-110,30,70,294,295,589,1306
150,10,160,273,316,589,1190
-180,-10,150,278,311,589,1244
-90,-20,-150,295,294,589,1218
140,80,70,291,298,589,1282
20,60,-160,275,314,589,1218
-40,0,-110,288,301,589,1196
-80,-70,150,291,298,589,1199
180,-10,150,278,311,589,1244
-60,0,-90,277,312,589,1202
-80,30,-40,286,303,589,1208
90,-30,-110,292,298,590,1077
20,-30,-140,277,313,590,1214
-70,0,-60,296,294,590,1152
-150,20,70,277,313,590,1168
-10,20,-130,296,294,590,1247
-10,-10,-130,286,304,590,1355
80,30,-110,276,314,590,1142
-90,-80,130,282,308,590,1187
-170,10,70,280,310,590,1301
-90,30,40,297,293,590,1253
-60,-40,-70,288,302,590,1116
20,-40,-20,277,313,590,1149
-170,20,150,285,305,590,1179
10,-50,-140,292,299,591,1271
150,20,60,282,309,591,1262
-80,-20,-140,295,296,591,1289
60,80,150,289,302,591,1260
40,-80,-110,275,316,591,1175
-90,70,-40,283,308,591,1184
10,20,-50,296,295,591,1192
-120,70,-10,284,308,592,1171
-90,-50,160,279,313,592,1211
-50,-70,-180,288,304,592,1235
160,-60,10,289,303,592,1141
40,30,-70,284,308,592,1218
40,40,170,288,304,592,1270
-180,-70,30,290,302,592,1195
180,-70,30,290,302,592,1195
-50,-70,180,288,304,592,1235
20,-50,-10,292,300,592,1208
-120,20,110,295,297,592,1163
-140,-30,180,285,308,593,1083
-40,-40,-150,284,309,593,1257
-20,80,-120,289,304,593,1226
-80,-80,140,282,311,593,1225
10,-20,-140,289,304,593,1222
-140,-30,-180,285,308,593,1083
-70,10,-60,289,304,593,1209
-60,50,-70,298,295,593,1167
-50,-50,-160,291,302,593,1309
-80,30,30,300,294,594,1276
-50,80,20,292,302,594,1237
-160,80,20,286,308,594,1236
100,-60,-60,291,303,594,1294
-70,60,-60,289,305,594,1153
110,70,90,297,297,594,1154
-80,-10,-90,302,292,594,1272
-110,-40,-130,300,295,595,1159
140,-80,-10,289,306,595,1226
-160,-50,70,274,321,595,1251
40,30,170,293,302,595,1262
10,70,-150,286,309,595,1235
-140,10,80,298,297,595,1246
-10,50,-130,293,303,596,1252
140,-70,-10,293,303,596,1218
-120,-10,-180,293,303,596,1169
50,-20,-160,295,301,596,1213
40,50,170,295,301,596,1262
100,20,20,299,297,596,1139
-120,-10,180,293,303,596,1169
80,70,120,294,302,596,1184
0,-30,-140,274,323,597,1296
0,-60,-140,301,296,597,1280
-20,-50,-150,281,316,597,1259
-150,-30,170,291,306,597,1252
-70,10,-30,299,298,597,1199
160,-70,10,283,314,597,1207
-100,70,-30,287,310,597,1166
-110,-80,-130,294,303,597,1289
-110,-10,140,304,294,598,1178
-110,-20,-160,302,296,598,1323
0,60,-40,278,320,598,1197
-120,-70,-140,294,304,598,1266
-70,20,-60,290,308,598,1206
170,-70,20,287,311,598,1173
110,60,90,289,309,598,1195
50,-40,-130,288,310,598,1289
-30,-20,-50,297,301,598,1160
-60,80,30,293,305,598,1253
-150,-70,80,270,329,599,1259
-170,60,150,276,323,599,1194
-60,40,-70,288,311,599,1223
-170,70,30,294,305,599,1237
-40,-80,-180,288,311,599,1284
-20,10,-40,306,293,599,1238
-100,30,50,296,303,599,1282
-70,0,-70,298,301,599,1184
-100,-20,-160,297,302,599,1266
60,30,120,301,298,599,1188
170,0,60,280,319,599,1295
130,-20,-10,287,312,599,1201
-120,10,110,302,297,599,1132
-40,-80,180,288,311,599,1284
-30,-80,-170,290,310,600,1255
-70,-10,-70,300,300,600,1225
-120,20,80,297,303,600,1299
70,-10,0,301,299,600,1141
-40,-80,-60,301,299,600,1229
60,-50,30,282,318,600,1166
70,10,-90,283,317,600,1207
110,20,10,298,302,600,1114
150,-80,0,292,309,601,1210
180,-50,150,274,327,601,1223
-180,-50,150,274,327,601,1223
120,10,-180,292,309,601,1264
150,-20,20,276,325,601,1176
-70,0,-50,306,295,601,1271
140,-10,20,275,326,601,1157
120,10,180,292,309,601,1264
90,-10,-130,284,317,601,1134
130,-30,-20,287,314,601,1239
30,-50,0,287,314,601,1061
-30,-30,-140,284,318,602,1257
0,-20,-140,297,305,602,1245
10,60,-150,294,308,602,1276
-150,80,10,289,313,602,1302
-80,-40,180,274,328,602,1266
-80,-40,-180,274,328,602,1266
140,40,70,282,320,602,1323
50,-50,-120,288,314,602,1310
120,0,-10,300,302,602,1198
30,-60,-130,293,309,602,1334
30,-80,-120,275,327,602,1208
-170,-50,160,282,321,603,1232
90,80,-120,285,318,603,1238
120,-60,-30,268,335,603,1265
20,10,-150,287,316,603,1297
140,20,60,282,321,603,1328
10,-10,-140,289,314,603,1328
70,-10,-40,293,310,603,1103
-40,80,10,296,307,603,1214
180,-50,40,291,312,603,1162
-50,-60,-170,296,307,603,1294
50,-20,-20,293,310,603,1198
-180,-50,40,291,312,603,1162
130,-20,-20,287,316,603,1189
170,70,40,297,306,603,1170
40,20,170,298,305,603,1283
-70,50,-60,298,306,604,1165
-40,-10,-120,291,313,604,1248
-160,-60,70,281,323,604,1218
20,0,-150,291,313,604,1288
-100,-20,150,311,293,604,1230
140,0,40,296,308,604,1356
170,-30,40,277,327,604,1237
150,80,60,301,304,605,1297
-70,-80,150,291,314,605,1263
-180,-20,150,285,320,605,1250
180,-20,150,285,320,605,1250
20,-30,-30,294,311,605,1332
-110,-10,-180,306,299,605,1236
150,-70,0,284,321,605,1231
0,50,-40,283,322,605,1104
-30,80,-110,292,313,605,1234
-50,-80,170,297,308,605,1301
100,0,-10,289,316,605,1224
-110,-10,180,306,299,605,1236
120,10,40,299,306,605,1250
160,20,60,287,318,605,1276
170,-40,30,301,304,605,1118
80,-10,160,297,309,606,1227
-110,30,10,300,306,606,1272
90,30,90,280,326,606,1232
30,30,-170,296,310,606,1200
-90,-20,-140,301,305,606,1287
-90,-40,-100,305,301,606,1233
-10,-30,-140,300,306,606,1297
-20,-70,-40,309,298,607,1239
-170,0,70,291,316,607,1378
160,-30,20,289,318,607,1108
20,-50,-140,296,311,607,1337
160,-80,10,289,318,607,1231
50,-50,20,290,317,607,1100
-60,-80,160,293,314,607,1294
120,70,80,303,304,607,1168
-90,-70,140,298,309,607,1256
-140,40,130,296,311,607,1224
-170,-30,70,286,322,608,1303
10,40,-150,295,313,608,1356
170,10,60,283,325,608,1335
-170,10,150,284,324,608,1278
20,-80,-130,287,321,608,1228
-170,60,30,295,313,608,1168
100,-50,-70,287,321,608,1226
-90,-20,-120,313,295,608,1278
20,-20,-140,290,318,608,1362
60,40,-90,277,331,608,1242
-120,-80,-140,302,307,609,1305
50,80,160,296,313,609,1300
60,0,140,300,309,609,1227
150,-10,30,281,328,609,1257
70,40,-100,282,327,609,1159
-30,0,-40,305,304,609,1280
-30,-80,-50,301,308,609,1239
100,-10,-30,297,312,609,1197
0,60,-140,297,312,609,1324
160,-10,50,292,317,609,1380
-130,-80,-150,302,307,609,1247
100,-20,-60,287,323,610,1174
170,-80,20,288,322,610,1260
150,-60,0,294,316,610,1215
60,0,-60,288,322,610,1117
30,-70,-120,302,308,610,1298
70,-40,40,290,320,610,1248
150,-10,40,292,318,610,1302
-40,-50,-160,304,306,610,1284
150,-30,0,287,323,610,1238
140,10,170,282,328,610,1290
-150,-50,80,283,328,611,1295
120,40,80,291,320,611,1373
90,-40,-90,304,307,611,1313
-80,40,40,313,298,611,1352
-150,-10,160,288,323,611,1251
-70,-60,-80,301,310,611,1090
40,-10,-160,307,304,611,1324
-120,-50,-140,309,302,611,1210
100,-10,110,293,318,611,1267
120,60,-150,297,314,611,1259
-20,-70,-160,289,322,611,1228
-100,-60,140,286,325,611,1244
20,30,-160,303,308,611,1329
100,30,80,283,328,611,1303
-110,-60,130,283,328,611,1249
170,50,50,308,303,611,1250
-150,40,40,295,317,612,1230
-140,10,150,302,310,612,1202
-120,-60,-140,308,304,612,1225
-160,60,140,293,319,612,1287
-10,30,-40,313,299,612,1258
110,70,-140,300,312,612,1247
20,40,-160,304,309,613,1278
100,-20,90,284,329,613,1264
90,-10,-180,294,319,613,1315
-120,0,160,317,296,613,1144
90,-10,180,294,319,613,1315
-90,-20,-130,315,298,613,1290
0,50,-140,302,311,613,1359
40,70,170,291,322,613,1333
-20,-30,-140,305,308,613,1349
-130,0,160,307,306,613,1170
-160,-40,70,289,325,614,1166
50,50,-80,291,323,614,1145
-10,-60,-150,295,319,614,1304
110,50,90,290,324,614,1263
150,50,60,297,317,614,1275
-60,-50,-170,293,321,614,1355
90,40,100,294,320,614,1351
140,50,-170,301,313,614,1290
140,0,30,290,324,614,1311
0,20,-140,300,315,615,1294
40,-10,-40,291,324,615,1250
120,50,80,290,325,615,1348
160,-40,10,305,310,615,1169
50,40,140,308,307,615,1262
-170,-60,50,293,322,615,1225
-40,20,-110,302,313,615,1289
170,20,160,287,328,615,1257
0,10,-140,303,312,615,1279
-10,40,-130,299,317,616,1300
150,40,180,292,324,616,1229
60,-50,-110,292,324,616,1331
30,-40,-10,297,319,616,1214
-70,-10,-110,307,309,616,1353
130,70,70,304,312,616,1204
-100,-30,150,314,302,616,1274
-150,60,20,301,315,616,1231
70,50,120,299,317,616,1205
150,40,-180,292,324,616,1229
80,0,20,303,314,617,1203
-80,-60,160,299,318,617,1316
110,-10,-30,310,307,617,1199
10,-50,-20,301,316,617,1254
-60,-40,-160,294,323,617,1321
140,-20,10,299,318,617,1387
70,-50,-100,296,321,617,1319
140,-40,-10,303,314,617,1332
80,-10,-20,311,307,618,1280
160,80,50,305,313,618,1355
-110,50,-10,309,309,618,1256
-120,20,70,304,314,618,1318
120,50,-150,308,310,618,1223
-130,-40,-160,315,303,618,1204
-150,-60,80,295,324,619,1256
50,40,-80,292,327,619,1225
-90,40,-30,299,320,619,1226
100,10,-150,308,311,619,1368
60,50,130,302,317,619,1197
0,-10,-140,301,318,619,1353
-10,0,-130,300,319,619,1337
0,70,-140,294,325,619,1310
-170,-70,40,311,308,619,1255
-80,20,-40,306,313,619,1259
-140,80,0,295,324,619,1325
-90,-20,-110,327,293,620,1337
-50,-10,-50,320,300,620,1273
130,-60,-20,297,323,620,1354
-50,-30,-60,300,320,620,1261
40,-50,-130,285,335,620,1294
40,10,170,308,312,620,1310
-120,10,140,302,318,620,1153
-100,-20,-150,313,307,620,1211
-90,-50,-100,313,307,620,1252
-40,80,-100,294,327,621,1257
-90,-60,150,302,319,621,1277
-150,-70,70,309,312,621,1369
60,50,-90,290,331,621,1182
90,-10,-150,305,316,621,1279
110,20,30,320,301,621,1266
110,-60,-50,303,318,621,1413
-140,-20,100,311,311,622,1293
30,0,-160,303,319,622,1356
130,-40,110,285,337,622,1268
-30,80,0,309,313,622,1234
-20,-60,-40,317,305,622,1190
-90,-20,-160,301,321,622,1292
130,30,70,293,329,622,1355
10,30,-50,305,317,622,1245
-130,-70,-150,306,316,622,1330
40,0,160,324,299,623,1160
-10,60,-130,303,320,623,1365
90,20,50,310,313,623,1170
60,-60,-110,287,336,623,1427
-20,50,-120,299,324,623,1325
80,-10,-40,304,319,623,1145
130,-30,-30,297,326,623,1314
130,40,-160,294,329,623,1243
40,40,160,295,329,624,1224
-80,-60,-90,310,314,624,1124
-70,10,-70,315,309,624,1320
80,0,130,307,317,624,1373
-80,-20,-80,317,307,624,1244
140,-60,-10,311,313,624,1321
90,20,40,311,314,625,1153
130,0,160,287,338,625,1357
40,-30,-10,309,316,625,1246
-10,-40,-40,308,317,625,1303
10,20,-150,306,319,625,1222
-170,-10,70,293,332,625,1397
-110,30,80,310,315,625,1341
-120,50,100,311,314,625,1271
140,10,50,296,330,626,1396
90,-20,-90,308,318,626,1245
20,20,-160,302,324,626,1303
-120,10,100,311,315,626,1205
-130,40,120,309,317,626,1241
50,-30,10,294,332,626,1070
10,50,-150,303,323,626,1383
-70,-20,-70,319,307,626,1319
-180,-60,30,318,309,627,1270
-60,50,20,315,312,627,1274
-150,-20,90,298,329,627,1280
-180,60,160,276,351,627,1180
180,60,160,276,351,627,1180
-170,40,50,304,323,627,1338
20,-70,-130,308,319,627,1296
180,-60,30,318,309,627,1270
-160,10,150,309,318,627,1255
-70,-20,-140,311,317,628,1292
-70,20,0,321,307,628,1233
130,-40,-20,294,334,628,1337
70,70,130,307,321,628,1240
-30,20,-30,310,318,628,1321
70,-60,-100,283,345,628,1421
-160,50,30,302,326,628,1179
30,-10,-150,297,331,628,1329
50,-20,180,314,315,629,1208
-170,30,60,306,323,629,1291
110,20,50,312,317,629,1366
-150,40,140,303,326,629,1376
50,60,150,310,319,629,1247
-30,-40,-50,300,329,629,1257
50,-20,-180,314,315,629,1208
120,-40,100,286,343,629,1334
-130,-30,110,302,327,629,1248
40,20,150,313,316,629,1171
-160,-30,80,308,322,630,1340
90,-40,-100,318,312,630,1196
-90,50,60,320,310,630,1295
180,-30,50,300,330,630,1264
-90,-30,-100,325,305,630,1271
-180,-30,50,300,330,630,1264
-80,20,0,336,294,630,1236
-60,0,-100,305,325,630,1341
-140,-30,100,312,318,630,1336
-120,-10,120,314,316,630,1289
170,-90,150,310,321,631,1235
70,-90,50,310,321,631,1235
-10,60,-30,298,333,631,1295
-20,60,-20,304,327,631,1331
-60,-90,-80,310,321,631,1235
20,-90,0,310,321,631,1235
80,-90,60,310,321,631,1235
0,-90,-20,310,321,631,1235
-150,-90,-170,310,321,631,1235
-20,60,-120,303,328,631,1328
180,-90,160,310,321,631,1235
-120,-90,-140,310,321,631,1235
40,10,-60,290,341,631,1298
100,-90,80,310,321,631,1235
-30,-90,-50,310,321,631,1235
-10,-90,-30,310,321,631,1235
-170,-90,170,310,321,631,1235
-50,-90,-70,310,321,631,1235
30,-90,10,310,321,631,1235
150,-90,130,310,321,631,1235
-90,-90,-110,310,321,631,1235
110,-90,90,310,321,631,1235
90,-90,70,310,321,631,1235
110,0,170,316,315,631,1387
140,-90,120,310,321,631,1235
-100,-90,-120,310,321,631,1235
-160,-90,-180,310,321,631,1235
-110,-90,-130,310,321,631,1235
130,-90,110,310,321,631,1235
-160,-90,180,310,321,631,1235
-180,-90,160,310,321,631,1235
50,-90,30,310,321,631,1235
160,30,170,314,317,631,1313
40,-90,20,310,321,631,1235
60,-90,40,310,321,631,1235
-30,60,-10,310,321,631,1273
-40,-90,-60,310,321,631,1235
-140,-90,-160,310,321,631,1235
120,-90,100,310,321,631,1235
-130,-90,-150,310,321,631,1235
160,-90,140,310,321,631,1235
-80,-90,-100,310,321,631,1235
10,-90,-10,310,321,631,1235
-20,-90,-40,310,321,631,1235
90,-10,-30,304,327,631,1303
-70,-90,-90,310,321,631,1235
70,-70,-90,308,324,632,1347
-150,60,130,308,324,632,1311
-100,40,70,318,314,632,1326
140,-50,-10,307,325,632,1346
-150,10,150,310,322,632,1290
90,-10,70,299,333,632,1216
170,60,40,308,324,632,1217
40,-30,-140,301,331,632,1396
50,-60,-120,293,340,633,1457
-120,-40,120,294,339,633,1249
-140,-70,90,288,345,633,1333
-120,50,0,306,327,633,1257
-130,80,-10,306,327,633,1309
30,-40,-140,290,343,633,1305
-30,20,-120,310,323,633,1291
10,-60,-140,309,325,634,1403
150,30,60,309,325,634,1422
180,-80,30,311,323,634,1241
-180,-80,30,311,323,634,1241
120,30,70,300,334,634,1370
-70,-60,170,307,327,634,1308
80,0,10,316,318,634,1151
-70,30,20,324,310,634,1351
-50,-10,-120,312,322,634,1314
80,80,-110,301,334,635,1324
-110,40,90,319,316,635,1244
40,-20,-150,301,334,635,1318
-180,-30,150,302,333,635,1290
-160,70,20,311,324,635,1333
180,-30,150,302,333,635,1290
30,20,-60,305,330,635,1361
-10,30,-130,315,321,636,1343
140,70,60,311,325,636,1241
100,-40,-80,306,330,636,1315
-120,0,110,325,311,636,1123
-10,-20,-140,305,331,636,1369
10,-20,-40,299,338,637,1311
-140,-10,90,303,334,637,1280
-20,-80,-40,314,323,637,1295
-60,-60,-70,312,325,637,1169
160,40,60,298,339,637,1337
-170,50,150,293,344,637,1277
-170,-80,40,311,326,637,1218
-40,10,-30,317,320,637,1326
-160,-20,80,307,330,637,1421
-120,20,120,316,321,637,1286
-30,-40,-150,303,334,637,1322
70,50,-100,293,345,638,1283
110,-10,130,298,340,638,1398
-120,80,-20,306,332,638,1332
-120,20,60,317,321,638,1326
140,-20,0,292,346,638,1286
-50,30,-90,317,321,638,1320
0,0,-140,309,330,639,1299
60,-70,-100,318,321,639,1343
110,0,180,308,331,639,1392
110,0,-180,308,331,639,1392
40,-50,10,314,325,639,1184
-100,30,60,320,320,640,1363
-140,-80,-160,318,322,640,1264
130,0,10,316,324,640,1214
70,60,120,311,329,640,1201
100,-30,-80,326,314,640,1238
-140,60,120,323,317,640,1350
80,40,-110,295,345,640,1286
150,-20,0,306,334,640,1307
130,-10,140,295,345,640,1423
-50,80,-90,304,336,640,1256
-10,-70,-30,320,320,640,1307
130,-50,-20,299,341,640,1372
-30,-30,-50,305,335,640,1278
-100,-70,130,313,328,641,1283
90,-10,170,310,331,641,1272
180,30,60,305,336,641,1359
170,-50,20,314,327,641,1243
-100,-20,-140,325,316,641,1309
80,0,120,302,339,641,1282
-40,30,-100,314,327,641,1398
-180,30,60,305,336,641,1359
40,80,170,307,334,641,1357
-30,50,-110,309,332,641,1416
150,-20,10,307,334,641,1300
-70,-40,-170,302,339,641,1315
30,-30,-140,309,333,642,1436
-130,-20,110,329,313,642,1348
20,-10,-150,300,343,643,1355
-80,60,50,324,319,643,1228
-110,20,60,326,317,643,1376
-20,-10,-130,307,336,643,1476
10,-80,-140,306,337,643,1285
-120,-50,120,292,351,643,1302
80,60,110,317,326,643,1255
120,40,-150,317,326,643,1323
170,-20,50,309,334,643,1443
-160,40,40,311,333,644,1389
-180,50,40,317,327,644,1305
80,-70,-80,307,337,644,1388
180,50,40,317,327,644,1305
80,10,100,315,329,644,1351
-100,-30,-120,335,309,644,1417
-50,-50,-60,306,338,644,1232
-10,70,-130,305,339,644,1355
80,-60,-90,293,352,645,1452
10,-70,-140,308,337,645,1356
-150,30,50,321,324,645,1336
80,50,-110,298,347,645,1252
40,50,-70,305,340,645,1238
120,-50,-40,309,336,645,1378
170,80,40,319,326,645,1406
-130,30,30,315,330,645,1424
180,70,30,323,322,645,1332
70,60,-100,306,339,645,1177
30,-30,-20,315,330,645,1260
80,-20,50,310,335,645,1229
-60,-10,-120,325,320,645,1399
-180,70,30,323,322,645,1332
-160,30,150,305,341,646,1294
-20,80,-10,319,327,646,1278
150,70,50,317,329,646,1271
-120,30,110,318,328,646,1166
40,-10,-170,334,312,646,1275
-60,-60,-180,310,336,646,1350
-60,-60,180,310,336,646,1350
-110,80,-30,311,336,647,1332
-30,-70,-170,314,333,647,1390
-20,40,-120,308,339,647,1309
140,-40,120,303,344,647,1380
50,20,130,327,320,647,1325
20,10,-50,306,341,647,1358
170,-10,150,299,348,647,1357
-160,-60,60,303,344,647,1306
-120,-30,120,309,338,647,1284
120,-20,120,301,346,647,1316
-10,-80,-30,316,331,647,1314
180,30,160,314,334,648,1364
30,20,-170,319,329,648,1299
-70,70,40,313,335,648,1275
-180,30,160,314,334,648,1364
-80,-30,-80,322,326,648,1250
-90,-20,-170,321,327,648,1332
-30,40,-110,311,337,648,1369
80,50,110,327,321,648,1293
80,-20,-160,321,327,648,1392
-20,30,-120,317,331,648,1460
-110,-20,-150,327,321,648,1394
180,60,30,319,330,649,1294
-120,20,50,332,317,649,1339
-90,-60,-100,329,320,649,1193
150,10,50,310,339,649,1465
-150,-80,-170,321,328,649,1298
-180,60,30,319,330,649,1294
-180,-40,150,305,344,649,1262
-150,-30,90,318,331,649,1330
-10,-50,-150,323,326,649,1411
180,-40,150,305,344,649,1262
-60,-30,-150,322,327,649,1313
80,0,-100,299,350,649,1285
70,80,-100,308,342,650,1320
160,0,50,318,332,650,1421
-70,80,-70,311,339,650,1269
70,-10,-10,314,336,650,1288
-10,80,-20,310,340,650,1296
60,80,-90,307,343,650,1316
150,-70,-10,322,328,650,1261
50,80,-80,308,342,650,1349
-140,-70,-160,314,336,650,1335
130,-40,-30,301,349,650,1418
130,-10,-10,314,336,650,1291
-70,10,-20,323,327,650,1318
-10,-10,-140,319,331,650,1421
-110,20,40,332,319,651,1374
50,50,140,322,329,651,1315
0,-80,-20,316,335,651,1344
-140,-40,-170,331,320,651,1224
-120,30,20,307,344,651,1333
100,70,-130,313,338,651,1347
-130,-70,100,294,357,651,1394
-100,80,-40,306,345,651,1324
10,-30,-150,309,342,651,1376
160,-60,0,321,330,651,1222
40,0,170,325,326,651,1400
160,30,60,306,345,651,1383
-20,-60,-160,305,347,652,1328
-70,0,-80,321,331,652,1324
-120,10,90,312,340,652,1351
-110,-70,120,309,343,652,1371
-90,20,-10,341,311,652,1260
60,70,140,319,333,652,1311
120,-10,140,313,339,652,1382
40,80,-70,311,342,653,1347
30,70,-180,313,340,653,1390
-70,-50,-180,312,341,653,1358
-70,-50,180,312,341,653,1358
-100,50,-20,323,330,653,1381
120,60,80,313,340,653,1304
30,70,180,313,340,653,1390
-90,30,50,329,324,653,1395
-90,80,-50,311,342,653,1283
-30,60,-110,316,338,654,1379
110,20,-150,307,347,654,1433
160,-70,0,318,336,654,1222
-150,-40,180,323,331,654,1256
10,0,-150,313,341,654,1371
-150,-40,-180,323,331,654,1256
90,-10,80,302,352,654,1327
160,-30,10,326,328,654,1278
-120,-70,110,306,348,654,1422
-160,-80,50,317,338,655,1251
-120,-30,-150,326,329,655,1336
-160,-80,-180,321,334,655,1281
-70,30,-60,323,332,655,1381
-60,80,-80,310,345,655,1277
10,10,-150,310,345,655,1378
-130,60,110,328,327,655,1356
-30,-50,-160,313,342,655,1328
-160,-80,180,321,334,655,1281
100,-30,80,301,354,655,1377
30,-50,-140,309,346,655,1327
-80,-50,170,310,345,655,1347
90,50,-120,313,343,656,1301
-130,0,90,326,330,656,1266
180,-20,60,305,351,656,1426
-20,-40,-150,324,332,656,1435
-180,-20,60,305,351,656,1426
140,-30,-10,314,342,656,1416
80,-10,-30,328,328,656,1315
160,-50,0,321,335,656,1258
40,0,-180,320,336,656,1382
110,60,-140,320,336,656,1369
40,0,180,320,336,656,1382
-50,50,10,318,339,657,1363
-80,80,-60,315,342,657,1284
50,-20,-170,321,336,657,1248
50,-70,-110,325,332,657,1340
-20,70,-120,314,343,657,1388
-160,70,140,311,346,657,1313
100,30,70,326,331,657,1471
150,40,60,310,348,658,1372
-90,-30,170,331,327,658,1327
170,50,170,305,353,658,1243
-20,30,-30,334,324,658,1320
40,30,150,333,325,658,1307
140,30,60,322,336,658,1418
-10,0,-140,332,326,658,1355
40,40,-70,313,345,658,1244
110,20,40,341,317,658,1417
40,50,160,314,344,658,1328
30,80,-60,311,347,658,1345
-140,-70,80,330,328,658,1472
-90,20,-20,330,328,658,1358
-90,-20,-100,339,320,659,1376
-20,20,-130,326,333,659,1340
-30,10,-120,314,345,659,1432
-100,30,-10,330,329,659,1376
40,60,160,322,337,659,1343
-50,20,-100,327,332,659,1394
-130,-10,100,321,338,659,1373
-80,50,-50,332,327,659,1295
-30,30,-110,320,339,659,1445
-140,-50,90,312,347,659,1367
110,30,70,318,342,660,1404
90,70,-120,310,350,660,1404
-10,10,-140,332,328,660,1374
100,40,90,306,354,660,1464
-40,50,-100,324,336,660,1444
-120,20,40,322,338,660,1351
-80,60,-50,326,334,660,1306
90,-60,-80,302,358,660,1465
-160,-70,50,327,333,660,1340
-80,10,-40,331,329,660,1375
-130,-60,-150,327,333,660,1347
0,-70,-20,324,336,660,1330
30,80,-180,314,347,661,1397
30,80,180,314,347,661,1397
-100,-10,170,343,318,661,1317
10,-80,-10,321,340,661,1395
-170,-50,50,309,352,661,1330
160,-80,140,317,344,661,1384
160,10,160,308,353,661,1378
-170,-80,170,322,339,661,1314
-40,-60,-170,322,339,661,1433
60,60,130,334,327,661,1253
-160,-20,160,307,355,662,1382
30,60,-180,311,351,662,1415
-50,-40,-60,318,344,662,1315
160,-20,30,307,355,662,1345
30,60,180,311,351,662,1415
20,80,-50,313,349,662,1343
-10,-60,-30,335,327,662,1314
-110,20,50,343,319,662,1347
170,-80,150,318,344,662,1349
100,20,-140,319,344,663,1424
-80,20,10,343,320,663,1306
-100,-10,160,343,320,663,1330
0,-20,-150,328,335,663,1462
20,-80,0,325,338,663,1366
-80,-30,-170,327,336,663,1352
50,60,-80,314,350,664,1203
30,-80,10,320,344,664,1344
-110,50,90,339,325,664,1320
10,80,-40,314,350,664,1346
110,10,-160,310,354,664,1462
-40,40,-100,326,339,665,1413
60,60,-90,315,350,665,1192
-110,20,80,327,338,665,1500
80,60,-110,307,358,665,1275
120,-20,-40,330,335,665,1202
-40,10,-110,319,346,665,1380
-10,-80,-160,318,347,665,1375
-140,-80,70,319,346,665,1258
-30,0,-120,313,352,665,1473
80,20,90,325,340,665,1289
40,-60,-130,314,351,665,1478
-140,-60,90,318,348,666,1295
-80,-10,-80,334,332,666,1371
0,0,-150,325,341,666,1407
-180,50,160,311,355,666,1330
50,10,130,318,348,666,1367
30,-10,-40,309,357,666,1427
0,-80,-150,320,346,666,1362
50,-10,150,320,346,666,1387
180,50,160,311,355,666,1330
0,80,-30,318,348,666,1323
30,50,-180,325,342,667,1438
170,-60,10,330,337,667,1260
180,-80,160,324,343,667,1306
-180,-80,160,324,343,667,1306
90,-70,-70,315,352,667,1421
20,10,-160,323,344,667,1325
120,20,50,329,338,667,1447
40,0,150,321,346,667,1230
30,50,180,325,342,667,1438
40,60,-70,307,360,667,1230
-150,-40,80,316,352,668,1267
-30,-90,-180,323,345,668,1255
-80,-90,130,323,345,668,1255
-40,-90,170,323,345,668,1255
60,-90,-90,323,345,668,1255
140,-90,-10,323,345,668,1255
30,-90,-120,323,345,668,1255
-60,30,-80,340,328,668,1360
-120,60,100,335,333,668,1445
-170,-90,40,323,345,668,1255
-20,-90,-170,323,345,668,1255
0,-90,-150,323,345,668,1255
170,20,60,317,351,668,1399
-80,-10,-100,337,331,668,1368
-130,-80,80,323,345,668,1283
180,-90,30,323,345,668,1255
150,-90,0,323,345,668,1255
-140,-90,70,323,345,668,1255
-100,-40,-110,334,334,668,1458
130,-90,-20,323,345,668,1255
90,-90,-60,323,345,668,1255
10,-90,-140,323,345,668,1255
80,-90,-70,323,345,668,1255
-70,-90,140,323,345,668,1255
-30,-90,180,323,345,668,1255
-160,-90,50,323,345,668,1255
110,-90,-40,323,345,668,1255
150,-80,130,321,347,668,1416
-90,-90,120,323,345,668,1255
120,-90,-30,323,345,668,1255
-70,40,-60,331,337,668,1333
-100,-90,110,323,345,668,1255
-120,-90,90,323,345,668,1255
-180,-90,30,323,345,668,1255
-110,-90,100,323,345,668,1255
-50,-90,160,323,345,668,1255
-150,-90,60,323,345,668,1255
20,-90,-130,323,345,668,1255
-180,20,160,313,355,668,1346
-10,-90,-160,323,345,668,1255
50,-90,-100,323,345,668,1255
40,-90,-110,323,345,668,1255
170,-90,20,323,345,668,1255
-60,-90,150,323,345,668,1255
100,-90,-50,323,345,668,1255
70,-90,-80,323,345,668,1255
160,-90,10,323,345,668,1255
-130,-90,80,323,345,668,1255
180,20,160,313,355,668,1346
-150,70,130,318,351,669,1337
-120,-80,90,327,342,669,1304
160,-10,150,307,362,669,1377
-60,70,30,325,344,669,1410
100,-70,-60,322,347,669,1383
160,50,50,334,336,670,1416
60,-30,-160,321,349,670,1327
120,20,-160,326,344,670,1346
-160,10,70,314,356,670,1440
-90,30,-30,336,334,670,1308
140,-70,-20,328,342,670,1321
110,-50,-60,321,350,671,1443
-40,20,-20,339,332,671,1395
130,0,0,331,340,671,1416
180,-10,60,314,357,671,1465
-70,40,30,341,330,671,1405
-180,-10,60,314,357,671,1465
160,-30,140,308,364,672,1372
-150,-70,-170,320,352,672,1283
-180,-40,40,319,353,672,1364
90,-20,-110,318,354,672,1383
-30,30,-120,340,332,672,1426
110,50,-140,329,343,672,1427
110,-70,-50,315,357,672,1362
80,-30,-150,323,349,672,1251
180,-40,40,319,353,672,1364
-150,-80,60,323,349,672,1277
-110,-30,-130,337,336,673,1381
-80,-70,140,321,352,673,1353
50,70,150,333,340,673,1378
20,-40,-150,325,348,673,1333
-90,20,0,342,331,673,1375
80,0,30,333,340,673,1295
-120,-40,-140,347,326,673,1326
-10,20,-40,333,341,674,1404
-50,10,-100,332,342,674,1420
-120,20,130,337,337,674,1297
-80,-10,-120,354,320,674,1399
130,60,70,330,344,674,1385
-70,-30,-160,321,353,674,1507
80,0,40,334,340,674,1255
40,-70,-120,337,337,674,1364
-130,-20,-170,339,335,674,1349
-60,30,10,342,332,674,1449
70,-20,-180,340,334,674,1451
20,-60,-140,331,343,674,1485
50,-80,30,321,353,674,1291
70,-20,180,340,334,674,1451
70,-20,30,334,340,674,1286
-70,0,-40,335,339,674,1402
90,-10,-160,337,337,674,1493
50,-20,-10,322,353,675,1377
160,-20,20,332,343,675,1319
-110,-20,130,342,333,675,1296
80,-10,150,334,341,675,1468
-70,20,-70,328,347,675,1398
-70,-70,150,317,358,675,1320
-130,10,80,335,341,676,1388
-110,0,160,339,337,676,1453
-150,-60,70,320,356,676,1324
-20,-80,-170,326,350,676,1407
180,80,30,334,342,676,1449
-180,80,30,334,342,676,1449
-110,20,70,333,343,676,1444
-120,-20,120,330,346,676,1320
-30,70,-110,329,347,676,1410
-180,-70,160,328,348,676,1356
0,-30,-150,323,353,676,1451
180,-70,160,328,348,676,1356
-10,10,-40,332,344,676,1447
-110,-80,100,330,346,676,1312
-100,20,20,353,324,677,1457
-110,0,150,342,335,677,1366
100,60,-130,319,358,677,1482
120,0,170,319,358,677,1571
-20,10,-130,336,341,677,1455
130,50,70,317,360,677,1360
-100,20,40,340,337,677,1400
170,-70,10,326,351,677,1258
-170,-70,170,333,344,677,1295
150,-10,20,327,350,677,1411
170,30,60,313,364,677,1473
-90,-70,130,329,348,677,1405
-70,-10,-120,343,334,677,1478
20,80,-170,327,350,677,1468
60,-80,40,325,352,677,1323
-80,-10,-110,351,326,677,1419
-110,30,90,339,338,677,1365
-70,-10,-60,338,340,678,1388
-180,0,60,323,355,678,1516
-80,-20,-150,339,339,678,1434
-120,40,110,328,350,678,1386
-170,50,30,328,350,678,1438
-50,0,-110,327,351,678,1443
-140,60,10,324,354,678,1314
-110,-50,130,318,360,678,1411
180,0,60,323,355,678,1516
130,40,70,325,354,679,1446
80,70,-110,315,364,679,1450
-90,20,30,350,329,679,1393
90,-20,-140,320,359,679,1309
-60,-20,-60,339,340,679,1487
120,-30,-50,322,357,679,1293
-140,30,40,334,345,679,1381
-30,30,-20,333,346,679,1376
140,40,-170,318,361,679,1389
-130,-70,90,337,342,679,1519
40,-80,20,326,353,679,1314
90,60,-120,316,364,680,1439
90,-10,-170,335,345,680,1523
180,40,50,326,354,680,1451
0,40,-40,327,353,680,1360
140,-80,120,325,355,680,1417
90,-10,160,333,347,680,1496
130,30,-160,334,346,680,1402
-180,40,50,326,354,680,1451
110,-40,90,311,369,680,1402
-130,10,150,345,335,680,1297
-90,40,60,340,340,680,1424
80,80,120,338,343,681,1449
50,0,-50,319,362,681,1338
-180,40,160,320,361,681,1452
30,10,-170,335,346,681,1447
90,0,-120,321,360,681,1373
50,30,130,344,337,681,1446
180,40,160,320,361,681,1452
90,20,-120,304,377,681,1282
60,-20,170,337,344,681,1312
50,-30,-140,332,349,681,1419
120,-60,-40,320,361,681,1465
120,-70,-40,327,354,681,1380
130,10,40,330,351,681,1544
-140,-40,90,320,362,682,1330
-40,-50,-170,338,344,682,1486
-40,60,-100,332,350,682,1424
-140,70,120,328,354,682,1377
130,-70,-30,338,344,682,1322
70,-80,50,332,350,682,1380
-20,0,-40,328,355,683,1456
70,-30,-160,345,338,683,1242
140,0,160,318,365,683,1467
140,0,20,316,367,683,1354
-50,20,-10,341,342,683,1402
130,-20,130,308,375,683,1416
-10,20,-140,337,346,683,1463
-130,30,130,322,361,683,1348
100,50,-130,329,354,683,1498
-20,0,-130,344,339,683,1582
90,80,110,340,343,683,1405
80,-50,-100,337,346,683,1539
60,-10,150,344,339,683,1405
-110,0,140,338,345,683,1343
-100,-10,150,346,338,684,1371
70,10,110,333,351,684,1294
-50,40,-90,341,343,684,1463
-60,10,-90,336,348,684,1485
170,-40,20,329,355,684,1309
10,-10,-150,327,357,684,1441
-70,0,-90,339,345,684,1407
110,40,80,326,358,684,1503
-100,50,80,359,325,684,1419
20,-30,-150,313,371,684,1436
110,80,90,342,342,684,1356
30,30,-60,325,359,684,1394
-10,-40,-150,338,346,684,1520
-110,-10,-170,350,334,684,1430
70,0,-70,335,349,684,1321
-140,0,160,332,353,685,1317
30,-20,-30,331,354,685,1434
-40,30,-10,341,344,685,1336
-150,70,10,339,346,685,1454
-20,30,-130,344,341,685,1476
100,-10,120,312,373,685,1368
120,-40,-50,327,358,685,1365
-20,-20,-140,331,354,685,1456
30,40,180,337,348,685,1520
150,-20,140,317,368,685,1477
30,40,-180,337,348,685,1520
-60,-20,-140,332,353,685,1493
-160,20,150,329,356,685,1506
10,-70,-10,331,354,685,1412
110,-20,110,313,373,686,1459
-170,-20,70,327,359,686,1527
-70,-30,-70,333,353,686,1413
170,40,50,337,349,686,1413
-100,30,70,339,347,686,1480
100,10,0,350,336,686,1343
0,-40,-150,328,358,686,1551
70,80,130,342,345,687,1459
160,70,40,337,350,687,1342
-110,20,30,344,343,687,1470
-90,20,20,351,336,687,1387
90,-10,-40,336,351,687,1332
-150,40,30,337,350,687,1325
150,-60,-10,343,344,687,1296
150,30,180,324,363,687,1382
-50,70,20,322,365,687,1392
150,30,-180,324,363,687,1382
-90,-40,160,326,361,687,1445
60,-60,-120,331,356,687,1436
-50,-50,-170,331,357,688,1447
140,20,180,332,356,688,1507
140,20,-180,332,356,688,1507
-40,-70,-180,328,360,688,1444
-40,-70,180,328,360,688,1444
170,60,170,326,362,688,1325
90,10,-120,319,369,688,1376
-130,20,60,347,341,688,1453
-100,20,30,351,337,688,1461
10,-40,-150,334,354,688,1424
-10,-30,-150,345,343,688,1523
150,-80,-10,331,357,688,1351
120,80,80,346,342,688,1377
170,-30,30,323,365,688,1357
-100,-80,110,334,354,688,1328
-100,-50,-110,347,342,689,1293
-160,-70,-180,334,355,689,1285
-160,-70,180,334,355,689,1285
100,40,-130,333,356,689,1413
160,-10,40,324,365,689,1488
-40,70,-100,338,351,689,1429
-120,-20,-160,350,339,689,1457
90,30,-120,318,371,689,1372
130,-80,110,330,359,689,1436
-90,-30,-90,350,340,690,1451
-110,20,90,343,347,690,1497
-20,0,-140,344,346,690,1531
-100,-20,-130,347,343,690,1516
100,80,100,342,348,690,1385
90,-10,-120,324,367,691,1374
-170,70,150,311,380,691,1364
-80,30,40,348,343,691,1442
-160,60,20,337,354,691,1444
-100,20,50,349,342,691,1430
90,60,100,335,356,691,1398
30,-20,-150,326,365,691,1412
90,30,80,329,362,691,1449
-170,-30,60,340,351,691,1445
-50,50,-90,340,352,692,1520
50,-20,170,350,342,692,1396
170,-70,150,332,360,692,1430
90,-20,-100,337,355,692,1380
160,10,50,326,367,693,1488
-100,40,80,353,340,693,1386
140,-80,-20,341,352,693,1386
-40,30,-110,340,353,693,1449
-180,10,60,329,364,693,1464
180,10,60,329,364,693,1464
120,-80,100,332,361,693,1461
0,10,-150,338,355,693,1543
130,80,70,349,344,693,1397
-100,-10,180,352,342,694,1430
40,-40,-140,334,360,694,1503
-60,10,-20,355,339,694,1315
0,-70,-150,331,363,694,1389
150,0,40,328,366,694,1579
30,-10,-160,336,358,694,1477
-100,-10,-180,352,342,694,1430
70,-10,150,349,345,694,1387
-80,10,-30,357,337,694,1420
-160,-50,60,331,363,694,1432
-130,-60,100,330,364,694,1406
-100,-50,140,326,369,695,1433
130,10,-180,335,360,695,1540
-130,70,110,337,358,695,1427
60,80,140,348,347,695,1455
120,10,-170,340,355,695,1509
90,-80,70,326,369,695,1460
70,70,-100,321,374,695,1441
130,10,30,332,363,695,1399
-100,-10,-170,352,343,695,1489
60,-40,-130,334,361,695,1451
20,-10,-160,340,355,695,1523
-60,-10,-50,344,351,695,1442
160,-40,0,345,350,695,1320
130,10,180,335,360,695,1540
20,60,-170,342,354,696,1508
0,-10,-150,349,347,696,1391
50,0,140,344,352,696,1399
-170,80,20,339,357,696,1495
50,-70,-120,337,360,697,1573
100,-60,-70,324,373,697,1560
-50,-40,-160,335,362,697,1510
90,50,100,340,357,697,1478
-170,-60,40,354,343,697,1383
110,-10,140,330,367,697,1532
-10,50,-30,328,369,697,1357
80,-80,60,328,370,698,1434
50,-50,-130,325,373,698,1436
160,-70,140,330,368,698,1460
70,0,130,340,358,698,1453
0,-60,-150,344,354,698,1481
90,-10,-50,338,360,698,1318
70,-50,-110,338,360,698,1536
160,20,170,337,362,699,1569
60,-70,-110,332,367,699,1562
30,-70,-130,342,357,699,1421
-160,0,70,341,358,699,1529
80,0,-90,327,372,699,1333
-180,20,60,338,362,700,1525
-30,-80,180,338,362,700,1432
80,-40,-120,344,356,700,1448
70,70,120,359,341,700,1443
140,60,60,340,360,700,1464
130,10,20,331,369,700,1342
130,-60,-30,337,363,700,1467
-90,-80,120,339,361,700,1352
-30,-80,-180,338,362,700,1432
120,-30,110,327,373,700,1505
180,20,60,338,362,700,1525
140,-10,10,325,375,700,1481
-60,-70,160,326,375,701,1402
30,60,170,351,350,701,1412
100,0,-160,348,353,701,1545
100,-10,130,337,364,701,1537
-50,-60,-60,345,356,701,1324
160,-20,10,341,360,701,1383
-20,-50,-40,330,371,701,1371
-110,-30,130,337,364,701,1408
90,-50,-90,345,356,701,1504
50,60,140,348,354,702,1430
-50,-60,-180,349,353,702,1526
90,-20,-120,342,360,702,1376
50,-30,-150,335,367,702,1420
140,-60,-20,342,360,702,1433
70,-60,-110,330,372,702,1440
40,40,150,349,353,702,1470
-50,-60,180,349,353,702,1526
20,-70,0,342,360,702,1500
10,-20,-150,326,376,702,1479
90,30,70,342,361,703,1427
110,-80,90,337,366,703,1492
-80,-10,-130,354,349,703,1393
140,80,60,357,346,703,1435
20,-20,-150,334,369,703,1509
-90,20,10,372,331,703,1420
150,-10,150,336,367,703,1350
-80,20,20,366,337,703,1442
100,90,110,332,372,704,1490
-40,90,-110,332,372,704,1490
-110,90,-40,332,372,704,1490
-70,90,-80,332,372,704,1490
90,40,-120,324,380,704,1435
180,90,30,332,372,704,1490
20,0,-160,341,363,704,1483
0,90,-150,332,372,704,1490
-60,90,-90,332,372,704,1490
70,90,140,332,372,704,1490
150,90,60,332,372,704,1490
-10,90,-140,332,372,704,1490
50,90,160,332,372,704,1490
-160,90,10,332,372,704,1490
140,90,70,332,372,704,1490
30,90,-180,332,372,704,1490
170,90,40,332,372,704,1490
60,90,150,332,372,704,1490
-170,90,20,332,372,704,1490
-130,90,-20,332,372,704,1490
-30,90,-120,332,372,704,1490
-50,90,-100,332,372,704,1490
-120,90,-30,332,372,704,1490
90,90,120,332,372,704,1490
160,90,50,332,372,704,1490
-10,-20,-150,341,363,704,1536
160,30,50,337,367,704,1578
40,90,170,332,372,704,1490
110,90,100,332,372,704,1490
80,90,130,332,372,704,1490
20,90,-170,332,372,704,1490
10,90,-160,332,372,704,1490
-140,90,-10,332,372,704,1490
-150,90,0,332,372,704,1490
-180,90,30,332,372,704,1490
-20,90,-130,332,372,704,1490
-90,90,-60,332,372,704,1490
-100,90,-50,332,372,704,1490
40,-70,-130,348,356,704,1577
130,90,80,332,372,704,1490
-60,20,0,359,345,704,1459
30,90,180,332,372,704,1490
-80,90,-70,332,372,704,1490
120,90,90,332,372,704,1490
10,80,-160,338,366,704,1464
-40,-40,-160,351,354,705,1534
-150,-10,80,337,368,705,1477
130,-50,-30,319,386,705,1522
140,10,40,345,360,705,1575
90,10,10,356,349,705,1360
140,50,60,340,365,705,1423
-90,-20,-90,362,343,705,1426
-120,-70,100,348,358,706,1578
170,-50,10,356,350,706,1330
40,70,160,347,359,706,1457
140,40,60,344,362,706,1492
-110,-10,130,358,348,706,1364
-70,0,-100,351,355,706,1444
80,70,110,351,355,706,1443
160,-80,0,341,365,706,1357
-70,60,40,355,351,706,1360
-100,-10,-160,350,356,706,1453
40,-20,-160,347,359,706,1490
-30,-60,-170,335,372,707,1493
0,-20,-40,350,357,707,1543
-50,-70,170,330,377,707,1464
-30,-10,-130,342,365,707,1545
-70,20,10,377,330,707,1479
-60,-60,170,334,373,707,1477
150,20,50,327,380,707,1527
-140,-10,170,355,352,707,1360
-110,-40,130,332,375,707,1421
100,-80,80,337,370,707,1475
50,80,150,355,353,708,1461
130,20,-170,354,354,708,1499
90,-10,150,347,361,708,1637
100,-10,140,343,365,708,1623
110,40,-140,342,366,708,1526
70,-10,-30,348,360,708,1451
120,40,70,339,370,709,1578
-50,70,-90,343,366,709,1445
-130,-40,100,331,378,709,1400
-130,20,50,343,366,709,1426
60,-50,-120,338,371,709,1503
130,-80,-30,347,362,709,1437
180,-70,20,347,362,709,1274
-40,-80,170,336,373,709,1472
-180,-70,20,347,362,709,1274
100,-40,80,324,386,710,1388
-10,-30,-40,351,359,710,1373
-150,-70,60,350,360,710,1425
-90,-10,-120,362,348,710,1483
-120,70,100,338,372,710,1435
160,20,50,341,369,710,1496
-130,60,0,346,364,710,1411
130,-20,-30,331,379,710,1371
150,-30,-10,339,372,711,1420
80,-60,-100,328,383,711,1506
-50,-80,160,343,368,711,1474
-50,60,-90,347,364,711,1490
-40,70,10,331,380,711,1439
-10,40,-140,348,363,711,1447
0,-60,-20,361,350,711,1378
-20,-30,-150,350,361,711,1545
-130,20,140,363,348,711,1388
140,20,50,328,383,711,1598
-110,0,130,354,358,712,1427
-30,-20,-140,350,362,712,1546
30,60,-60,328,384,712,1374
40,-50,-140,341,371,712,1412
-40,-20,-50,349,363,712,1407
-10,30,-140,353,359,712,1478
70,-70,-100,336,376,712,1556
-90,-10,-130,352,360,712,1529
-90,50,-40,358,355,713,1509
50,-60,-130,338,375,713,1476
60,-40,30,342,371,713,1479
20,50,-170,351,362,713,1520
-170,-40,160,340,373,713,1566
-180,-60,20,357,356,713,1371
180,-60,20,357,356,713,1371
-10,0,-150,366,347,713,1449
-100,-70,120,343,370,713,1548
90,-20,70,333,381,714,1533
80,-10,50,335,379,714,1420
120,20,20,355,359,714,1511
-50,-30,-150,350,364,714,1477
180,-50,30,353,361,714,1375
-180,-50,30,353,361,714,1375
20,70,-170,336,379,715,1474
-140,70,0,349,366,715,1573
-90,-20,-180,349,367,716,1444
60,0,130,352,364,716,1539
170,-10,50,331,385,716,1512
-20,10,-140,362,354,716,1453
150,0,30,337,379,716,1567
-90,-20,180,349,367,716,1444
-30,50,-10,350,366,716,1564
60,70,130,357,359,716,1434
30,-50,-150,352,365,717,1549
-20,40,-130,350,367,717,1456
160,40,50,340,377,717,1412
-110,60,90,364,353,717,1465
80,10,80,355,362,717,1446
150,80,50,365,352,717,1465
30,50,-60,341,376,717,1360
10,-50,-150,349,368,717,1643
140,-50,-20,341,377,718,1558
-170,40,40,357,361,718,1525
-90,60,-40,356,362,718,1511
70,40,110,346,372,718,1550
120,-80,-40,342,376,718,1441
160,50,-180,341,377,718,1454
100,-50,-80,343,375,718,1479
40,20,140,362,356,718,1450
170,-20,40,345,373,718,1510
160,50,180,341,377,718,1454
70,-20,170,341,377,718,1462
150,-10,10,331,388,719,1393
60,70,-90,323,396,719,1440
170,50,40,349,370,719,1506
-30,40,-120,356,363,719,1502
150,-50,-10,351,368,719,1409
-40,50,0,352,367,719,1494
0,20,-150,351,368,719,1545
0,-50,-150,351,368,719,1593
90,70,100,354,365,719,1484
50,70,-80,319,400,719,1454
150,-40,-10,344,375,719,1360
-170,-70,30,361,359,720,1316
-80,50,50,361,359,720,1470
-150,10,70,343,377,720,1507
40,70,-70,327,393,720,1445
-160,-10,160,340,380,720,1508
80,20,80,354,366,720,1538
110,0,-170,351,369,720,1619
-60,-80,150,347,373,720,1446
110,-60,-60,343,377,720,1563
150,-40,130,344,376,720,1552
-10,-10,-150,371,350,721,1533
-80,-80,130,348,373,721,1407
-10,0,-40,332,389,721,1573
120,-70,100,347,374,721,1536
170,-80,10,349,372,721,1361
20,-10,-40,335,386,721,1572
90,20,30,359,362,721,1376
-70,-20,-150,348,373,721,1587
-70,-60,160,341,381,722,1493
-170,70,20,359,363,722,1587
90,-40,-110,351,371,722,1298
100,-10,-180,341,381,722,1577
100,-10,180,341,381,722,1577
130,20,50,341,381,722,1592
30,50,170,348,374,722,1433
-140,-60,80,340,382,722,1426
130,-30,120,328,394,722,1505
150,-70,130,342,381,723,1522
120,30,-150,355,368,723,1457
120,-50,100,331,392,723,1444
-130,-10,180,358,365,723,1377
-20,50,-20,348,375,723,1524
110,-30,100,333,390,723,1544
30,40,170,350,373,723,1575
-130,-10,-180,358,365,723,1377
20,-70,-140,345,378,723,1469
-140,30,140,343,380,723,1556
-80,-20,-160,361,363,724,1587
100,-10,-40,352,372,724,1423
-120,-60,110,343,381,724,1495
-160,30,50,348,376,724,1563
0,80,-150,342,382,724,1510
-20,-10,-140,361,363,724,1598
80,-70,-90,341,383,724,1572
60,10,120,356,368,724,1441
140,-20,-10,333,392,725,1606
-90,20,40,372,353,725,1475
100,10,-140,348,377,725,1605
120,-50,-50,339,386,725,1592
110,-10,150,358,367,725,1594
140,60,-160,344,381,725,1591
-100,20,10,367,358,725,1531
30,-30,-150,344,381,725,1645
-80,0,-50,364,361,725,1515
-10,10,-150,364,362,726,1503
30,40,-60,341,385,726,1395
110,80,80,352,374,726,1578
30,-60,-140,348,378,726,1579
-160,80,10,354,372,726,1564
-120,60,-10,356,370,726,1518
100,50,90,344,382,726,1555
-110,30,0,347,379,726,1541
100,-80,-60,340,386,726,1487
-90,-50,150,350,377,727,1513
-60,-50,180,348,379,727,1561
-150,50,20,347,380,727,1469
-60,70,-80,356,371,727,1481
-140,-20,-180,355,372,727,1384
-140,-20,180,355,372,727,1384
-60,-50,-180,348,379,727,1561
60,40,120,354,373,727,1559
-150,-50,70,350,378,728,1472
90,-60,-90,338,390,728,1580
120,80,70,359,369,728,1566
170,40,170,368,360,728,1552
170,10,160,345,383,728,1475
40,80,160,371,357,728,1477
-60,-40,-170,345,383,728,1536
-140,20,60,360,368,728,1557
110,-80,-50,341,387,728,1464
70,-10,20,357,371,728,1331
90,0,-10,344,384,728,1436
30,70,170,362,366,728,1448
-60,0,-110,356,372,728,1517
-170,-40,50,347,381,728,1471
150,10,170,346,383,729,1585
140,-10,0,347,382,729,1553
90,80,100,354,375,729,1557
100,80,90,356,373,729,1576
120,-60,-50,349,380,729,1552
130,80,60,360,369,729,1587
-70,-80,140,346,383,729,1459
80,80,110,358,371,729,1534
150,-10,0,342,387,729,1507
-80,20,30,377,352,729,1480
-120,0,100,359,370,729,1366
90,-30,70,340,390,730,1449
20,-50,-150,357,373,730,1561
170,70,30,368,362,730,1457
-80,-60,150,341,389,730,1506
50,-30,-160,353,377,730,1508
10,-20,-160,354,376,730,1532
-180,-80,20,356,374,730,1357
-130,-50,100,343,387,730,1553
160,-30,0,358,372,730,1452
30,-40,-150,347,383,730,1541
180,-80,20,356,374,730,1357
140,-70,120,344,386,730,1523
-120,30,120,358,372,730,1433
-40,0,-120,359,371,730,1617
-100,-60,-110,372,359,731,1373
-80,10,-20,383,348,731,1497
-70,-50,170,345,386,731,1627
-70,30,30,377,354,731,1539
100,20,10,349,382,731,1368
-170,30,160,349,382,731,1502
-130,-50,-150,370,361,731,1536
-50,30,0,362,369,731,1583
90,-80,-70,343,389,732,1518
50,-40,20,353,379,732,1386
-130,30,20,362,370,732,1547
80,40,100,351,381,732,1608
30,30,-180,359,373,732,1635
130,60,-150,357,375,732,1534
30,30,180,359,373,732,1635
-140,-70,70,357,375,732,1520
-140,-60,-160,356,376,732,1470
170,30,50,354,378,732,1497
-110,-20,-140,367,366,733,1463
120,20,10,363,370,733,1471
80,10,-100,343,390,733,1532
-140,-20,90,359,374,733,1619
-80,0,-60,376,357,733,1521
-10,80,-140,346,387,733,1569
-110,0,170,370,364,734,1480
30,70,-60,337,397,734,1515
50,40,130,362,372,734,1442
-30,-40,-160,361,373,734,1618
180,70,160,340,394,734,1460
-50,-20,-140,361,373,734,1615
-180,70,160,340,394,734,1460
60,-10,-30,355,379,734,1482
100,-10,150,351,383,734,1678
-60,40,-80,372,362,734,1519
-130,70,-10,356,379,735,1573
30,-70,10,356,379,735,1500
-110,20,20,371,364,735,1527
-80,40,-50,347,388,735,1443
-100,-20,-110,385,350,735,1615
-160,40,30,357,378,735,1504
-100,-20,-120,373,362,735,1615
-30,-30,-150,362,373,735,1627
-10,-70,-160,354,381,735,1453
40,10,140,362,373,735,1359
-160,40,150,355,380,735,1633
-150,0,160,351,384,735,1473
-60,50,-80,369,367,736,1546
-110,-70,110,358,378,736,1593
0,30,-150,357,379,736,1489
-80,10,-60,370,366,736,1562
60,-70,40,350,386,736,1526
100,30,60,362,374,736,1581
130,-50,110,344,392,736,1504
-100,20,60,363,373,736,1546
100,-10,170,360,376,736,1664
100,60,90,357,379,736,1560
-80,10,-50,361,376,737,1547
-80,-40,-80,359,378,737,1488
140,80,-160,341,396,737,1606
170,0,50,351,386,737,1592
-160,-40,170,348,389,737,1547
170,70,170,344,393,737,1615
-110,-10,-160,377,360,737,1617
110,-70,90,347,390,737,1546
30,-70,-140,368,369,737,1609
-110,10,130,361,376,737,1408
-140,0,80,371,366,737,1508
-110,10,120,369,368,737,1476
90,40,90,350,387,737,1659
-90,-10,-110,386,352,738,1543
80,30,90,355,383,738,1533
-180,40,40,363,375,738,1560
0,30,-40,371,367,738,1591
20,60,-180,367,371,738,1561
180,40,40,363,375,738,1560
-70,10,-80,373,365,738,1533
40,50,150,361,377,738,1600
20,60,180,367,371,738,1561
-40,-10,-130,369,369,738,1567
-170,-80,30,361,378,739,1338
20,-20,-160,358,381,739,1576
40,-60,-140,356,383,739,1553
70,80,120,371,368,739,1542
90,-70,-80,350,389,739,1576
170,10,50,352,387,739,1564
-40,-30,-150,362,377,739,1567
-80,-10,-70,370,369,739,1525
150,60,50,362,378,740,1535
-30,70,0,346,394,740,1466
30,80,170,371,369,740,1495
50,70,140,360,380,740,1499
20,70,-50,344,396,740,1550
40,-30,0,367,373,740,1428
140,10,30,351,389,740,1532
-70,30,-70,372,368,740,1593
130,-70,110,346,394,740,1534
10,-10,-160,355,386,741,1578
-140,40,20,353,388,741,1470
-160,-40,60,361,380,741,1519
-70,70,-70,361,381,742,1487
-170,30,50,362,380,742,1642
-120,10,150,365,377,742,1392
140,70,-160,346,396,742,1560
90,-10,140,357,385,742,1655
80,20,70,359,383,742,1430
-140,50,130,361,381,742,1513
120,-10,150,366,376,742,1611
-110,40,100,368,374,742,1512
-20,-50,-160,361,382,743,1549
90,-20,-130,345,398,743,1416
-120,-10,-170,365,378,743,1542
100,-20,-70,379,364,743,1429
-40,-20,-140,365,378,743,1526
60,80,130,369,374,743,1538
150,30,50,353,390,743,1553
30,0,-170,365,378,743,1603
50,-40,-140,363,380,743,1678
40,-10,160,379,364,743,1426
-170,20,60,353,390,743,1598
140,-10,150,352,391,743,1565
-100,20,0,369,374,743,1510
160,80,40,379,365,744,1540
-80,30,-50,361,383,744,1562
-160,-60,50,369,375,744,1546
-80,20,-50,377,367,744,1532
80,10,90,362,382,744,1485
130,70,-150,361,383,744,1547
-20,70,-10,360,384,744,1533
-90,-10,-140,378,367,745,1589
-50,30,-100,367,378,745,1586
-20,80,-130,352,393,745,1594
150,80,-170,348,397,745,1627
0,-30,-160,372,373,745,1669
140,80,50,365,380,745,1619
-110,20,100,367,379,746,1589
90,-10,90,359,387,746,1588
-110,60,-20,359,387,746,1516
130,-10,150,365,381,746,1629
160,60,-180,359,387,746,1568
-150,-60,-170,360,386,746,1448
160,60,180,359,387,746,1568
10,-10,-40,338,408,746,1670
-80,0,-70,373,373,746,1549
40,-30,-150,356,390,746,1633
-90,-30,160,371,375,746,1639
10,70,-160,350,397,747,1576
-130,-30,-160,376,371,747,1474
100,70,90,365,382,747,1548
-140,30,30,373,374,747,1515
-10,40,-30,366,381,747,1477
-80,-50,160,357,391,748,1605
140,-50,120,353,395,748,1567
-100,40,-20,364,384,748,1537
0,0,-40,328,420,748,1578
70,-10,-20,374,374,748,1679
140,-20,140,347,401,748,1546
-10,-60,-160,361,388,749,1551
70,-80,-90,351,398,749,1538
80,-70,60,358,391,749,1620
40,-80,-120,348,401,749,1550
0,0,-160,371,378,749,1635
130,30,60,352,398,750,1588
-30,20,-130,381,369,750,1547
-80,-30,180,363,387,750,1584
-160,-80,40,365,385,750,1347
40,70,150,367,383,750,1539
70,-40,-130,367,383,750,1612
-70,-10,-130,369,381,750,1613
170,-20,150,361,389,750,1579
-60,-10,-130,370,380,750,1695
-80,-30,-180,363,387,750,1584
40,-40,10,359,392,751,1385
-180,50,30,369,382,751,1549
-30,50,-120,372,379,751,1571
170,-30,20,370,381,751,1501
60,-80,-100,347,404,751,1557
170,20,50,360,391,751,1642
-60,60,-80,367,384,751,1578
-180,-30,40,362,389,751,1532
-100,60,-30,363,388,751,1572
-40,40,-110,370,381,751,1544
10,70,-40,358,393,751,1594
-150,20,60,366,385,751,1692
180,50,30,369,382,751,1549
-100,-30,-110,388,363,751,1578
90,-70,70,362,389,751,1610
10,0,-160,360,391,751,1619
180,-30,40,362,389,751,1532
110,50,80,362,389,751,1584
110,70,80,364,387,751,1607
-120,0,170,373,379,752,1476
-60,20,-90,374,378,752,1588
70,-70,50,357,395,752,1641
80,-50,-110,369,383,752,1624
10,-30,-160,362,390,752,1627
10,-60,-150,367,385,752,1647
0,-10,-160,378,374,752,1693
-110,70,90,360,393,753,1506
50,80,140,372,381,753,1563
0,-10,-40,343,410,753,1593
130,-60,110,361,392,753,1584
100,-10,160,379,375,754,1748
-130,50,120,369,385,754,1559
70,-30,40,364,390,754,1487
170,60,30,372,382,754,1597
-170,10,60,363,391,754,1610
100,-60,-80,355,399,754,1646
-180,60,20,368,386,754,1603
-150,-20,170,366,388,754,1571
80,-80,-80,354,400,754,1545
-160,-70,40,374,380,754,1447
-80,-10,-140,371,383,754,1547
180,60,20,368,386,754,1603
-120,70,-20,366,388,754,1544
-110,30,100,381,374,755,1480
-90,30,60,373,382,755,1547
110,30,20,365,390,755,1583
110,30,60,360,395,755,1605
-80,-40,170,356,399,755,1624
-180,-40,30,372,383,755,1507
40,-70,20,373,382,755,1486
-100,-10,-150,378,377,755,1544
180,-40,30,372,383,755,1507
60,20,-80,365,391,756,1530
160,70,180,356,400,756,1684
-20,20,-140,383,373,756,1552
-40,50,-110,376,380,756,1600
50,-80,-110,347,409,756,1561
160,70,-180,356,400,756,1684
-160,20,60,359,397,756,1708
-120,-10,110,384,372,756,1564
-10,-10,-40,350,406,756,1613
110,-40,-70,359,397,756,1485
170,30,170,363,393,756,1694
160,-10,30,357,399,756,1681
70,-50,-120,363,393,756,1655
-90,-10,-100,391,365,756,1602
-70,20,20,390,366,756,1545
-50,30,-110,377,379,756,1550
130,0,170,355,401,756,1590
100,90,100,378,379,757,1569
80,0,110,357,400,757,1558
-60,-30,-160,360,397,757,1616
-160,90,0,378,379,757,1569
20,90,-180,378,379,757,1569
170,80,30,387,370,757,1542
100,0,-150,369,388,757,1668
30,90,170,378,379,757,1569
-20,90,-140,378,379,757,1569
-10,90,-150,378,379,757,1569
160,90,40,378,379,757,1569
-160,-30,70,359,398,757,1590
-150,30,40,380,377,757,1625
-90,90,-70,378,379,757,1569
-130,90,-30,378,379,757,1569
0,90,-160,378,379,757,1569
150,90,50,378,379,757,1569
80,90,120,378,379,757,1569
-150,-80,50,373,384,757,1372
-50,90,-110,378,379,757,1569
60,90,140,378,379,757,1569
170,90,30,378,379,757,1569
-180,90,20,378,379,757,1569
130,90,70,378,379,757,1569
-140,90,-20,378,379,757,1569
120,90,80,378,379,757,1569
-40,90,-120,378,379,757,1569
110,90,90,378,379,757,1569
10,90,-170,378,379,757,1569
50,90,150,378,379,757,1569
-120,90,-40,378,379,757,1569
-70,90,-90,378,379,757,1569
140,90,60,378,379,757,1569
90,90,110,378,379,757,1569
40,90,160,378,379,757,1569
20,90,180,378,379,757,1569
-110,90,-50,378,379,757,1569
180,90,20,378,379,757,1569
-150,90,-10,378,379,757,1569
-170,90,10,378,379,757,1569
-80,90,-80,378,379,757,1569
-100,90,-60,378,379,757,1569
160,-20,0,369,388,757,1545
70,90,130,378,379,757,1569
-30,90,-130,378,379,757,1569
-40,20,-120,372,385,757,1549
-60,90,-100,378,379,757,1569
160,40,180,365,393,758,1432
90,30,60,371,387,758,1589
-140,-80,60,382,376,758,1403
0,-40,-30,364,394,758,1496
-60,40,20,384,374,758,1592
10,60,-160,360,398,758,1643
120,30,60,362,396,758,1649
160,40,-180,365,393,758,1432
120,20,40,366,392,758,1691
-20,-10,-40,348,410,758,1576
-20,50,-130,374,384,758,1635
140,-40,-20,363,395,758,1581
10,-40,-160,374,385,759,1602
30,-80,-130,356,403,759,1561
-30,-10,-40,375,384,759,1533
80,-80,-90,365,394,759,1572
-50,-50,-180,374,385,759,1608
120,20,30,375,384,759,1581
-80,10,-10,391,368,759,1599
30,-20,-160,364,395,759,1678
110,-50,-70,354,405,759,1634
-50,-50,180,374,385,759,1608
20,60,-50,349,410,759,1497
-110,10,110,390,370,760,1606
20,70,-180,377,383,760,1521
20,70,180,377,383,760,1521
140,-60,120,360,400,760,1600
90,-10,130,358,402,760,1721
-150,80,0,361,399,760,1619
110,-50,90,360,400,760,1408
-30,10,-130,380,381,761,1632
-130,-30,100,377,384,761,1494
150,70,-170,364,397,761,1648
-80,70,-60,367,394,761,1544
150,0,160,374,387,761,1573
-100,-20,140,374,387,761,1526
20,80,180,376,385,761,1521
40,-10,170,387,374,761,1598
20,80,-180,376,385,761,1521
-10,-30,-160,382,379,761,1715
-110,-60,-120,385,376,761,1480
20,-30,-160,370,391,761,1653
-10,70,-20,363,399,762,1616
-110,-50,-120,380,382,762,1383
50,50,130,376,386,762,1481
90,-20,-150,365,397,762,1505
-120,30,10,388,375,763,1550
110,30,-140,374,389,763,1611
160,-10,20,374,389,763,1611
-10,50,-140,374,389,763,1739
-80,0,-90,391,372,763,1601
-140,-30,90,368,395,763,1616
-130,-20,100,378,385,763,1744
120,-10,-30,369,394,763,1453
40,-10,150,370,393,763,1490
90,-40,70,363,400,763,1514
140,30,-170,374,389,763,1519
-130,-80,70,381,382,763,1438
100,-70,80,368,395,763,1632
40,60,150,383,381,764,1596
20,50,-180,375,389,764,1659
10,10,-160,371,393,764,1623
180,30,50,376,388,764,1560
20,50,180,375,389,764,1659
-170,0,60,365,399,764,1578
130,0,-10,373,391,764,1620
10,80,-170,380,384,764,1538
-180,30,50,376,388,764,1560
-70,10,-10,387,377,764,1546
140,-30,-20,360,404,764,1598
100,30,50,382,382,764,1695
-110,-60,120,364,401,765,1602
100,40,80,356,409,765,1644
-30,0,-130,379,386,765,1748
-70,-40,-180,365,400,765,1618
30,20,-180,368,397,765,1688
-100,70,-40,361,404,765,1552
-70,-40,180,365,400,765,1618
-120,20,30,369,396,765,1581
0,40,-150,371,394,765,1686
60,-30,-170,385,380,765,1515
30,20,180,368,397,765,1688
0,70,-150,358,408,766,1664
-90,20,-30,380,386,766,1603
40,30,140,389,377,766,1584
120,20,0,379,387,766,1545
-40,-50,-50,370,396,766,1495
30,70,160,379,387,766,1577
-70,-70,-80,390,377,767,1426
10,-70,-150,367,400,767,1497
40,-20,-170,374,393,767,1527
150,40,50,358,409,767,1581
120,60,-140,373,394,767,1629
-120,-80,80,389,378,767,1502
-50,10,-20,394,373,767,1570
-50,-10,-130,369,398,767,1643
-120,-30,110,370,397,767,1583
30,60,160,391,376,767,1626
100,-70,-70,360,407,767,1587
-90,20,50,390,377,767,1564
150,80,40,382,385,767,1675
130,80,-150,361,407,768,1652
-20,-20,-150,377,391,768,1724
-170,-50,40,365,403,768,1526
40,80,150,378,390,768,1566
-90,40,-40,383,385,768,1489
-100,30,80,387,381,768,1562
0,70,-30,360,408,768,1609
70,-80,-100,375,394,769,1617
-150,-30,80,357,412,769,1634
-70,40,-70,386,383,769,1652
-100,-40,140,366,403,769,1630
-30,80,-120,366,403,769,1609
100,30,40,391,378,769,1670
-20,-70,-170,368,401,769,1604
-60,-70,-70,384,385,769,1430
60,50,120,372,397,769,1599
-130,-70,80,372,398,770,1590
20,-80,-140,359,411,770,1598
-120,-30,-140,388,382,770,1597
20,-40,-160,374,396,770,1667
-130,40,10,372,398,770,1437
-100,60,80,380,390,770,1535
80,0,0,388,382,770,1506
0,-20,-160,386,384,770,1650
-80,-20,-70,378,392,770,1580
-140,-50,80,374,397,771,1506
140,-30,130,347,424,771,1648
10,50,-160,363,408,771,1732
-120,10,80,377,394,771,1558
60,-80,-110,374,397,771,1607
20,-60,0,372,399,771,1584
-50,40,-100,378,393,771,1618
0,50,-150,366,405,771,1790
150,-50,130,362,409,771,1639
-160,-60,-180,375,397,772,1563
-160,-10,70,368,404,772,1706
20,40,-170,375,397,772,1592
160,80,180,368,404,772,1676
160,80,-180,368,404,772,1676
-180,70,20,387,385,772,1597
-110,-40,-120,391,381,772,1546
-160,-60,180,375,397,772,1563
-10,70,-140,359,413,772,1720
180,70,20,387,385,772,1597
-180,-20,50,371,402,773,1679
40,-10,-180,378,395,773,1577
-170,60,20,383,390,773,1547
-140,10,70,383,390,773,1561
-30,-20,-150,373,400,773,1709
40,-10,180,378,395,773,1577
180,-20,50,371,402,773,1679
80,-10,140,373,400,773,1762
-90,70,-50,369,404,773,1548
160,60,40,376,397,773,1578
-150,-40,70,380,393,773,1569
90,-50,-100,378,396,774,1682
110,60,80,372,402,774,1644
60,-50,-130,372,402,774,1667
120,-60,100,371,403,774,1640
180,80,20,388,387,775,1606
10,0,-40,355,420,775,1646
130,50,-150,379,396,775,1619
90,-80,-80,381,394,775,1582
10,-60,-10,364,411,775,1521
-20,-10,-150,375,400,775,1757
110,-70,-60,362,413,775,1524
-130,-60,90,360,415,775,1592
-180,80,20,388,387,775,1606
-110,40,-10,384,391,775,1610
0,80,-160,393,382,775,1602
150,0,20,369,406,775,1663
-40,-90,160,375,401,776,1582
-10,-20,-160,390,386,776,1746
170,-90,10,375,401,776,1582
-90,-90,110,375,401,776,1582
140,-90,-20,375,401,776,1582
0,-90,-160,375,401,776,1582
150,-90,-10,375,401,776,1582
-60,0,-30,394,382,776,1584
-160,0,160,369,407,776,1613
-10,-90,-170,375,401,776,1582
100,-90,-60,375,401,776,1582
-30,-90,170,375,401,776,1582
80,-90,-80,375,401,776,1582
-100,-90,100,375,401,776,1582
20,-90,-140,375,401,776,1582
-80,-90,120,375,401,776,1582
-150,-90,50,375,401,776,1582
150,-20,-10,368,408,776,1607
-60,-90,140,375,401,776,1582
50,-90,-110,375,401,776,1582
-70,-90,130,375,401,776,1582
160,-90,0,375,401,776,1582
40,-90,-120,375,401,776,1582
-140,-90,60,375,401,776,1582
-20,-90,-180,375,401,776,1582
60,-90,-100,375,401,776,1582
130,-90,-30,375,401,776,1582
-150,20,150,386,390,776,1725
-120,-90,80,375,401,776,1582
-20,-90,180,375,401,776,1582
-80,0,-80,385,391,776,1639
-80,0,-100,399,377,776,1607
-130,-90,70,375,401,776,1582
90,-90,-70,375,401,776,1582
-110,-90,90,375,401,776,1582
10,-90,-150,375,401,776,1582
120,-90,-40,375,401,776,1582
180,-90,20,375,401,776,1582
70,-90,-90,375,401,776,1582
-180,-90,20,375,401,776,1582
-160,-90,40,375,401,776,1582
-170,-90,30,375,401,776,1582
30,-90,-130,375,401,776,1582
110,-90,-50,375,401,776,1582
50,-80,-120,379,397,776,1631
-50,-90,150,375,401,776,1582
120,80,-140,373,404,777,1668
40,40,140,385,392,777,1541
50,-10,-30,381,396,777,1616
-10,-20,-40,377,400,777,1771
-120,50,110,383,394,777,1616
-10,-50,-30,375,402,777,1592
150,10,40,364,413,777,1746
90,-30,-120,376,401,777,1533
0,10,-40,377,401,778,1664
-110,20,110,386,392,778,1681
-120,-70,90,375,403,778,1583
50,-20,160,393,385,778,1542
100,-60,80,369,409,778,1674
110,-80,-60,385,393,778,1623
150,-60,130,371,407,778,1620
110,80,-130,379,400,779,1691
-60,-30,-60,383,396,779,1629
90,-10,-110,377,402,779,1650
90,-60,-100,380,399,779,1609
130,20,30,375,404,779,1639
10,-80,-150,365,414,779,1653
-10,20,-150,390,390,780,1759
-140,-30,-170,395,385,780,1463
160,0,40,363,417,780,1799
-40,-60,-180,380,400,780,1601
-170,-60,170,379,401,780,1569
-50,-40,-170,360,420,780,1665
-70,0,-110,393,387,780,1622
-40,-60,180,380,400,780,1601
170,-20,30,372,408,780,1633
10,70,-170,387,393,780,1630
10,-30,-30,368,413,781,1712
130,-10,-20,374,407,781,1549
-90,-10,-150,383,398,781,1702
90,-10,-80,378,403,781,1589
0,-70,-160,379,402,781,1615
130,20,40,372,409,781,1732
-80,40,50,392,390,782,1628
-170,-20,160,369,413,782,1672
-70,-60,150,368,414,782,1659
140,30,50,375,407,782,1718
130,-40,-40,365,417,782,1682
-90,40,70,405,377,782,1569
160,20,40,371,411,782,1693
30,50,160,392,390,782,1688
-40,80,-110,370,412,782,1630
30,-10,-170,383,399,782,1619
170,-40,10,374,409,783,1528
100,30,-130,373,410,783,1619
10,30,-160,376,407,783,1788
30,-60,-150,387,396,783,1627
110,40,70,373,410,783,1726
-110,-80,90,397,386,783,1535
50,-70,30,378,405,783,1514
130,10,0,387,396,783,1681
-160,50,20,384,399,783,1589
-100,20,70,382,401,783,1685
-80,0,-40,389,395,784,1666
-50,-70,-60,390,394,784,1468
-70,-10,-50,390,394,784,1607
130,40,60,378,406,784,1633
-80,-70,130,370,414,784,1642
120,70,-140,387,397,784,1649
100,-80,-70,388,396,784,1627
-180,-60,160,381,403,784,1602
120,70,70,382,402,784,1671
180,-60,160,381,403,784,1602
-90,-10,-160,387,397,784,1629
-10,80,-150,392,392,784,1652
-90,-10,-90,397,387,784,1537
80,0,-80,383,402,785,1559
130,10,10,373,412,785,1607
-40,30,-120,401,384,785,1617
-110,70,-30,382,403,785,1539
-140,80,-10,362,423,785,1616
50,20,-70,381,404,785,1630
90,-10,-60,373,412,785,1538
80,-20,-170,395,390,785,1853
20,20,-50,367,418,785,1674
60,-20,160,382,403,785,1580
100,-30,-90,398,387,785,1579
-70,-40,-70,395,391,786,1611
-30,10,-30,389,397,786,1639
130,-50,-40,369,417,786,1660
-150,30,30,389,397,786,1602
150,50,50,377,409,786,1626
60,-40,-150,386,400,786,1669
50,-20,0,375,411,786,1501
-10,-40,-160,387,399,786,1823
-60,-50,170,382,404,786,1693
0,60,-150,366,421,787,1759
20,70,170,385,402,787,1660
40,50,140,393,394,787,1569
30,-80,-140,378,409,787,1699
-30,0,-140,395,392,787,1725
-90,-60,140,375,412,787,1657
110,-60,-70,380,407,787,1719
-70,50,40,394,393,787,1594
120,50,-140,380,407,787,1679
120,-20,130,361,426,787,1634
-20,0,-150,385,402,787,1677
-100,-60,130,381,407,788,1670
-90,-20,170,388,400,788,1650
130,-60,-40,378,410,788,1624
-140,20,50,397,391,788,1642
-170,-30,160,366,422,788,1679
-110,0,-180,395,393,788,1633
-120,-40,110,371,417,788,1631
110,-10,160,384,404,788,1839
-100,-10,-110,399,389,788,1720
-110,0,180,395,393,788,1633
-100,-30,140,389,399,788,1670
-130,20,40,389,399,788,1661
-30,10,-140,385,403,788,1670
140,0,10,363,426,789,1641
160,0,160,384,405,789,1654
-80,-20,-170,385,404,789,1688
-50,50,-100,390,399,789,1691
-50,80,-100,370,419,789,1670
40,-30,-160,381,408,789,1688
-110,0,120,407,382,789,1547
-150,60,10,392,397,789,1706
-50,20,-110,380,410,790,1666
0,-40,-160,395,395,790,1730
0,20,-40,388,402,790,1649
120,0,-180,388,402,790,1735
30,40,160,377,413,790,1727
170,80,170,377,413,790,1730
150,50,-170,397,393,790,1658
150,60,-170,388,402,790,1636
40,-80,-130,385,405,790,1678
120,0,180,388,402,790,1735
-150,-60,60,392,398,790,1647
170,-60,150,385,405,790,1618
160,10,40,371,419,790,1740
-110,20,120,383,407,790,1632
160,-50,-10,403,387,790,1472
70,-60,50,375,416,791,1667
-60,10,-100,390,401,791,1782
110,0,-20,380,411,791,1524
80,-60,-110,383,408,791,1616
-20,20,-30,393,398,791,1732
0,70,-160,390,401,791,1739
160,80,30,398,393,791,1727
50,-30,-170,386,405,791,1569
40,-20,-20,394,397,791,1700
30,20,160,384,408,792,1649
-150,-20,80,380,412,792,1754
60,10,-70,386,406,792,1561
110,30,30,386,406,792,1703
140,50,-160,380,412,792,1673
140,20,40,372,420,792,1771
-170,80,10,398,394,792,1628
-100,30,-20,386,406,792,1607
-60,60,30,387,405,792,1595
-50,-60,170,374,418,792,1640
-170,40,30,396,396,792,1672
-50,60,20,382,411,793,1611
90,-60,70,378,415,793,1660
160,-40,140,365,428,793,1674
-40,-40,-170,377,416,793,1642
70,-10,140,391,402,793,1733
-30,-10,-140,383,410,793,1773
130,-30,-40,384,409,793,1602
50,-30,-180,412,381,793,1587
100,30,30,394,399,793,1603
0,-80,-160,375,418,793,1693
80,-20,170,387,406,793,1631
-150,0,70,389,404,793,1792
50,-30,180,412,381,793,1587
30,-40,0,378,416,794,1534
-100,20,-10,399,395,794,1558
-180,80,160,379,415,794,1783
30,10,160,403,391,794,1698
-30,-70,-180,384,410,794,1698
100,80,-120,390,404,794,1711
-30,-70,180,384,410,794,1698
20,-70,-150,395,399,794,1674
120,-80,-50,389,405,794,1626
-80,10,-70,403,391,794,1746
160,-60,-10,395,399,794,1508
180,80,160,379,415,794,1783
50,60,130,394,400,794,1582
30,30,170,380,414,794,1711
-50,-20,-50,397,397,794,1678
20,-50,-160,386,409,795,1676
170,10,40,385,410,795,1794
50,-50,-140,378,417,795,1734
-130,80,-20,369,426,795,1628
-40,-60,-50,394,401,795,1537
-70,-70,140,375,420,795,1659
130,-70,-40,382,413,795,1618
10,60,-170,393,402,795,1718
110,-30,-70,394,401,795,1547
100,-20,-80,396,399,795,1493
-80,-70,-90,398,397,795,1499
40,70,140,401,395,796,1595
30,10,-50,367,429,796,1648
-110,10,140,386,410,796,1531
100,-50,80,375,421,796,1597
150,20,180,389,407,796,1729
170,40,40,383,413,796,1644
30,80,160,394,402,796,1641
160,-10,10,387,409,796,1648
30,30,160,381,415,796,1682
150,20,-180,389,407,796,1729
-100,20,80,391,405,796,1693
-80,20,40,400,396,796,1635
20,40,170,387,409,796,1671
120,10,-10,390,406,796,1534
120,-70,-50,380,417,797,1590
-110,-30,120,380,417,797,1707
-140,50,10,389,408,797,1691
180,10,160,390,407,797,1642
100,-60,-90,386,411,797,1689
-70,0,-30,390,407,797,1629
90,-10,-70,387,410,797,1650
-60,-40,180,376,421,797,1685
-60,-40,-180,376,421,797,1685
30,-30,-160,397,400,797,1754
-170,-60,30,407,390,797,1591
-30,-50,-170,384,413,797,1648
60,0,-50,383,414,797,1563
-90,50,70,423,374,797,1627
-180,10,160,390,407,797,1642
140,10,20,373,424,797,1640
30,60,150,396,401,797,1602
-30,30,-130,407,391,798,1628
-100,80,-50,379,419,798,1680
90,80,-110,390,408,798,1744
-100,-10,140,409,389,798,1562
70,-30,-170,397,401,798,1681
-70,50,-70,397,401,798,1635
20,-80,-150,388,410,798,1717
-130,-10,90,386,412,798,1671
-10,-10,-160,408,390,798,1744
-150,30,150,373,425,798,1736
40,-40,-150,384,414,798,1822
-160,-50,50,381,417,798,1742
-20,70,-130,368,430,798,1804
-30,20,-140,397,401,798,1690
20,50,170,396,402,798,1651
90,-10,-90,382,417,799,1550
-60,30,-90,393,406,799,1675
100,-40,-90,414,385,799,1745
60,-30,-180,408,391,799,1659
60,-30,180,408,391,799,1659
-70,-30,-170,374,425,799,1701
10,40,-160,384,415,799,1805
50,70,130,403,396,799,1611
30,20,170,393,406,799,1778
-110,50,100,394,406,800,1714
60,-40,-140,380,420,800,1747
70,30,100,392,408,800,1581
-180,20,50,389,411,800,1701
-120,-50,110,374,426,800,1743
-100,-10,-120,416,384,800,1675
-100,-80,100,408,392,800,1568
180,30,40,398,402,800,1620
180,20,50,389,411,800,1701
-180,30,40,398,402,800,1620
80,-70,-100,382,418,800,1723
70,-70,-110,382,418,800,1730
-120,40,0,394,407,801,1630
130,-80,-40,392,409,801,1625
160,-60,140,391,410,801,1620
-20,-40,-160,390,411,801,1812
-20,30,-140,399,402,801,1721
-120,80,-30,371,430,801,1658
70,20,-90,370,431,801,1669
-50,10,-110,396,406,802,1820
-160,10,60,389,413,802,1715
70,0,-60,390,412,802,1609
40,60,140,408,394,802,1610
20,-20,-30,378,424,802,1690
10,20,-160,377,425,802,1628
20,60,170,399,403,802,1702
140,-10,-10,372,430,802,1771
-80,-10,-60,392,411,803,1640
-170,-20,60,372,431,803,1764
-10,-50,-160,389,414,803,1777
110,70,-130,396,407,803,1706
-60,-60,160,379,424,803,1655
-110,-70,100,386,417,803,1592
-170,80,150,383,420,803,1796
-100,-10,-130,398,406,804,1776
70,-40,-140,386,418,804,1557
-110,80,-40,377,427,804,1682
-60,80,-90,377,427,804,1705
100,-20,100,386,418,804,1756
170,30,40,386,418,804,1678
150,20,40,375,429,804,1756
80,-20,180,393,411,804,1826
80,-20,-180,393,411,804,1826
-120,-60,100,379,425,804,1720
-110,-10,-150,404,400,804,1671
-100,-20,-100,403,401,804,1712
20,0,-40,366,439,805,1719
-70,60,-70,389,416,805,1703
110,30,10,390,415,805,1489
60,60,120,401,404,805,1608
170,-10,40,378,427,805,1840
70,-60,-120,373,432,805,1619
70,20,100,400,406,806,1575
120,10,-160,387,419,806,1749
-60,-20,-150,393,413,806,1794
130,20,-160,397,409,806,1755
60,-70,-120,390,416,806,1705
-90,80,-60,383,423,806,1678
-110,10,100,399,407,806,1681
150,-60,-20,399,407,806,1637
170,20,170,372,434,806,1598
-170,30,40,401,406,807,1672
-160,70,10,401,406,807,1737
-160,80,0,402,405,807,1677
150,-50,-20,401,406,807,1642
140,-70,-30,394,413,807,1645
-40,-10,-40,397,410,807,1619
-170,-10,60,371,436,807,1731
20,-60,-150,384,424,808,1755
140,0,170,384,424,808,1770
120,-10,160,382,426,808,1792
60,-60,-130,383,425,808,1644
-10,60,-140,374,434,808,1809
-50,40,10,404,404,808,1721
-160,-20,70,379,429,808,1830
-50,0,-120,403,405,808,1736
80,-60,60,381,427,808,1656
-90,-10,-170,398,410,808,1695
100,-50,-90,407,401,808,1730
130,70,60,396,413,809,1727
120,50,70,379,430,809,1667
80,0,50,378,431,809,1558
10,-40,-20,393,416,809,1647
-40,10,-120,397,413,810,1800
-170,40,160,383,427,810,1772
160,-40,-10,402,408,810,1537
80,80,-100,390,420,810,1767
140,10,-180,389,421,810,1802
-110,-30,-120,406,404,810,1744
140,10,180,389,421,810,1802
-90,-40,-90,408,402,810,1606
-20,10,-150,411,399,810,1741
-20,40,-20,389,421,810,1629
-90,-70,120,383,428,811,1614
-170,-30,50,383,428,811,1727
-150,50,140,389,422,811,1702
90,-50,70,388,423,811,1636
-80,20,-60,411,400,811,1740
-80,30,50,409,402,811,1684
10,60,-40,381,430,811,1659
110,-60,90,385,426,811,1685
90,-70,-90,391,420,811,1757
60,90,-80,391,421,812,1715
-10,90,-10,391,421,812,1715
10,90,-30,391,421,812,1715
90,90,-110,391,421,812,1715
-20,90,0,391,421,812,1715
-30,90,10,391,421,812,1715
70,90,-90,391,421,812,1715
80,90,-100,391,421,812,1715
0,-60,-160,385,427,812,1704
-40,90,20,391,421,812,1715
0,90,-20,391,421,812,1715
-80,0,-110,407,405,812,1707
-180,90,160,391,421,812,1715
140,90,-160,391,421,812,1715
160,90,-180,391,421,812,1715
-150,90,130,391,421,812,1715
170,-20,20,401,411,812,1670
-100,90,80,391,421,812,1715
50,90,-70,391,421,812,1715
-50,90,30,391,421,812,1715
170,90,170,391,421,812,1715
-130,90,110,391,421,812,1715
-90,90,70,391,421,812,1715
-110,20,10,411,401,812,1717
40,90,-60,391,421,812,1715
-80,90,60,391,421,812,1715
-130,10,70,389,423,812,1639
-160,30,40,396,416,812,1753
100,90,-120,391,421,812,1715
130,90,-150,391,421,812,1715
110,90,-130,391,421,812,1715
-70,90,50,391,421,812,1715
-60,40,-90,392,420,812,1675
30,90,-50,391,421,812,1715
-60,90,40,391,421,812,1715
150,90,-170,391,421,812,1715
180,90,160,391,421,812,1715
-170,20,160,388,424,812,1673
-170,90,150,391,421,812,1715
-120,90,100,391,421,812,1715
120,90,-140,391,421,812,1715
160,90,180,391,421,812,1715
-140,90,120,391,421,812,1715
-160,90,140,391,421,812,1715
20,90,-40,391,421,812,1715
-110,90,90,391,421,812,1715
140,-60,-30,396,417,813,1659
-40,-50,180,402,411,813,1762
20,80,170,397,416,813,1670
20,20,-170,384,429,813,1846
-40,-50,-180,402,411,813,1762
110,10,-150,388,425,813,1738
170,80,20,417,396,813,1749
70,10,-80,382,431,813,1592
20,30,-50,393,420,813,1760
110,-10,-40,393,420,813,1567
-70,-10,-140,392,421,813,1795
-40,40,-120,401,412,813,1764
-100,10,50,399,415,814,1705
-10,-80,-170,392,422,814,1732
70,50,110,389,425,814,1672
-70,80,-80,385,429,814,1719
-40,-70,170,391,423,814,1734
-90,10,-20,414,400,814,1726
140,-80,-30,400,414,814,1649
-100,-10,-140,413,401,814,1709
30,10,180,393,422,815,1840
10,50,-180,410,405,815,1784
30,10,-180,393,422,815,1840
-80,80,-70,388,427,815,1689
30,70,150,401,414,815,1607
120,60,70,398,417,815,1717
170,0,160,396,419,815,1709
50,-60,-140,400,415,815,1706
-90,60,70,396,419,815,1663
50,-70,-130,391,424,815,1713
10,50,180,410,405,815,1784
10,-50,-160,403,412,815,1709
70,0,120,390,425,815,1748
160,-50,140,383,432,815,1663
110,-20,120,384,432,816,1716
20,40,180,401,415,816,1829
30,-60,10,395,421,816,1590
100,-30,90,394,422,816,1725
-120,20,140,409,407,816,1573
20,50,-50,387,429,816,1555
80,50,100,387,429,816,1771
20,40,-180,401,415,816,1829
-120,-20,-150,415,401,816,1742
130,-20,140,391,425,816,1554
0,-50,-160,391,425,816,1819
-150,-30,-180,394,422,816,1676
-170,20,50,392,424,816,1779
-150,-30,180,394,422,816,1676
90,50,90,383,434,817,1793
-20,80,-140,404,413,817,1738
-160,80,140,388,429,817,1816
160,10,170,382,435,817,1650
-100,-70,110,393,424,817,1584
-130,-40,-150,413,405,818,1682
-40,-70,-50,401,417,818,1599
-90,-70,-100,407,411,818,1579
-100,30,90,405,413,818,1745
-20,60,-130,391,427,818,1840
160,30,-180,416,402,818,1787
-180,0,50,392,426,818,1749
-80,10,0,430,388,818,1674
160,30,180,416,402,818,1787
-150,80,-10,404,414,818,1712
180,0,50,392,426,818,1749
-130,-50,90,391,428,819,1655
160,30,40,398,421,819,1825
-20,-40,-40,400,419,819,1628
130,50,60,384,436,820,1692
-20,-10,-160,407,413,820,1839
170,0,40,387,433,820,1781
-90,-80,110,411,409,820,1628
-30,70,-120,379,441,820,1837
-10,70,-150,408,412,820,1801
10,60,-180,410,410,820,1755
80,10,70,384,436,820,1672
70,-20,160,385,435,820,1636
20,60,160,411,409,820,1646
10,60,180,410,410,820,1755
150,30,40,393,428,821,1816
170,-60,0,405,416,821,1599
-100,-30,-100,425,396,821,1776
-120,-50,-130,417,404,821,1627
-100,70,80,397,424,821,1592
20,30,-170,393,428,821,1783
180,-10,50,383,439,822,1772
130,30,50,383,439,822,1916
170,-50,0,408,414,822,1606
-60,-70,150,383,439,822,1669
-180,-10,50,383,439,822,1772
140,70,50,405,417,822,1733
-100,50,-30,403,419,822,1778
180,10,50,385,438,823,1724
-140,-50,-160,397,426,823,1631
160,-10,0,405,418,823,1589
-180,10,50,385,438,823,1724
-10,0,-160,411,412,823,1778
160,70,30,401,422,823,1803
-20,-20,-160,401,422,823,1843
-80,-80,120,408,415,823,1665
130,10,-170,423,400,823,1808
-30,40,-130,410,413,823,1793
-100,40,90,413,410,823,1689
-60,20,-100,399,424,823,1792
10,-70,-160,402,421,823,1805
120,0,-170,402,421,823,1750
50,80,130,406,418,824,1685
-80,-40,160,401,423,824,1787
100,-70,-80,393,431,824,1800
-50,-10,-40,400,424,824,1710
-130,0,170,424,400,824,1632
-60,30,-100,404,420,824,1696
-150,-70,50,397,427,824,1618
-70,-80,130,407,417,824,1708
140,0,0,396,428,824,1811
-70,20,-80,394,430,824,1754
-170,70,10,411,413,824,1686
110,30,50,389,436,825,1813
-100,0,160,417,408,825,1711
170,70,20,405,420,825,1825
-40,-30,-50,392,433,825,1705
120,0,-20,404,421,825,1616
-50,-40,-180,399,426,825,1746
100,70,-120,394,431,825,1790
-40,-40,-50,406,419,825,1614
-50,-40,180,399,426,825,1746
-20,-60,-170,393,432,825,1708
10,70,180,402,424,826,1746
110,-70,-70,394,432,826,1824
-100,0,150,419,407,826,1821
-40,60,-110,403,423,826,1823
-30,60,-120,395,431,826,1876
50,20,120,418,408,826,1620
40,-50,-150,409,417,826,1779
160,0,30,395,431,826,1915
-70,0,-120,412,414,826,1843
20,50,160,424,402,826,1696
10,70,-180,402,424,826,1746
20,40,-50,386,440,826,1704
-30,80,-130,404,422,826,1759
-80,-60,140,394,432,826,1782
140,20,30,392,435,827,1794
-50,-70,160,403,424,827,1743
150,70,40,398,429,827,1742
120,20,-150,403,424,827,1711
60,30,110,394,433,827,1599
0,10,-160,410,417,827,1804
140,-50,-30,407,420,827,1759
-140,-10,80,401,427,828,1734
-110,10,90,404,424,828,1695
-50,40,-110,415,413,828,1834
160,-60,-20,413,415,828,1636
-70,-50,160,384,444,828,1721
40,-60,20,406,422,828,1644
120,-60,-60,401,427,828,1822
60,70,120,416,412,828,1698
170,-30,10,390,438,828,1705
140,-40,-30,392,437,829,1738
-110,30,110,409,420,829,1650
150,10,30,392,437,829,1844
-50,0,-30,401,428,829,1681
120,30,50,382,447,829,1926
150,40,-170,411,418,829,1692
70,-70,-120,400,429,829,1699
-30,-30,-160,407,422,829,1837
80,80,100,406,423,829,1709
80,-70,-110,389,440,829,1721
130,-10,160,408,421,829,1810
70,80,-90,400,429,829,1774
-90,-20,160,410,420,830,1805
130,40,-150,414,416,830,1742
-60,-80,140,410,420,830,1736
-140,-40,80,390,440,830,1700
160,50,40,402,428,830,1829
100,0,-140,399,431,830,1796
-100,0,170,413,418,831,1710
90,80,90,410,421,831,1758
70,60,110,405,426,831,1763
-70,-40,170,394,437,831,1812
50,10,-60,401,430,831,1702
-110,-20,-130,422,409,831,1724
-110,-20,120,399,432,831,1660
160,40,40,403,428,831,1771
70,80,110,406,426,832,1666
30,50,150,414,418,832,1644
20,-40,-10,416,416,832,1743
-170,-10,160,398,434,832,1801
-180,-50,20,416,416,832,1645
170,-30,150,382,450,832,1834
-20,-80,-180,407,425,832,1730
110,20,-140,406,426,832,1742
-110,0,110,420,412,832,1639
-20,-80,180,407,425,832,1730
60,80,120,406,426,832,1693
180,-50,20,416,416,832,1645
60,-10,140,411,421,832,1823
-150,40,20,401,431,832,1682
-100,10,40,423,409,832,1750
90,30,50,419,413,832,1670
100,-10,-170,405,428,833,1873
150,-80,-20,404,429,833,1684
-60,0,-120,399,434,833,1765
170,20,40,401,433,834,1866
-40,0,-130,411,423,834,1868
150,-60,-30,398,436,834,1639
-40,20,-130,399,435,834,1760
-80,-10,-150,409,425,834,1791
-170,50,20,416,418,834,1759
-90,-40,150,394,440,834,1819
110,-10,170,410,425,835,1937
-90,-20,-80,420,415,835,1693
10,80,180,411,424,835,1766
150,0,10,391,444,835,1680
90,40,80,403,432,835,1843
110,20,0,426,409,835,1652
90,-20,80,389,446,835,1757
-120,40,120,393,442,835,1653
120,-50,-60,391,444,835,1887
10,80,-180,411,424,835,1766
100,0,-20,407,429,836,1688
-60,-50,160,402,434,836,1815
130,-60,-50,404,432,836,1791
-70,10,-90,407,429,836,1895
150,-70,-20,411,425,836,1661
110,60,-130,404,432,836,1750
-10,-70,-170,406,430,836,1741
-90,30,70,419,417,836,1677
-90,20,60,416,420,836,1777
150,-40,-20,402,434,836,1743
90,20,20,412,424,836,1568
-140,20,150,406,431,837,1736
-120,-60,-130,412,425,837,1703
100,-10,-50,408,429,837,1620
80,-40,-130,405,432,837,1644
0,60,-160,407,430,837,1784
10,50,-170,414,423,837,1786
-100,-70,-110,405,432,837,1639
-90,10,-10,427,410,837,1768
-40,40,0,412,425,837,1864
80,10,40,414,424,838,1647
60,-60,40,401,437,838,1770
130,20,20,395,443,838,1726
170,-50,150,396,442,838,1681
80,-30,-160,406,432,838,1696
120,30,20,405,433,838,1799
-180,0,40,398,440,838,1885
-40,30,-130,417,421,838,1803
180,0,40,398,440,838,1885
140,50,50,410,429,839,1781
-10,30,-150,409,430,839,1894
80,30,80,412,427,839,1771
140,-20,-20,402,437,839,1755
50,80,-70,397,442,839,1794
-20,20,-150,425,414,839,1802
-90,-10,-80,420,419,839,1683
30,0,-40,388,451,839,1695
-30,0,-150,420,420,840,1865
110,30,40,401,439,840,1889
60,80,-80,400,440,840,1806
-40,70,-110,386,454,840,1888
100,80,80,416,424,840,1776
120,40,60,397,443,840,1839
-60,-30,-170,387,454,841,1756
180,-20,40,389,452,841,1901
-150,80,130,400,441,841,1862
-180,-20,40,389,452,841,1901
-110,-60,110,409,432,841,1799
110,-10,180,405,437,842,1807
-140,80,120,400,442,842,1893
110,-10,-180,405,437,842,1807
30,-40,-160,406,436,842,1829
-140,-60,70,407,435,842,1832
140,40,50,397,445,842,1831
-30,10,-150,413,429,842,1864
110,0,-160,405,438,843,1837
-40,-30,-160,421,422,843,1863
80,-50,60,391,452,843,1775
-110,20,130,410,433,843,1654
-80,50,-60,428,415,843,1781
100,50,80,396,448,844,1877
-60,10,-10,426,418,844,1648
80,40,90,401,443,844,1819
10,-80,-160,412,432,844,1815
-120,0,90,414,430,844,1709
-80,40,-60,423,421,844,1862
130,-70,-50,412,432,844,1792
90,-20,-160,405,439,844,1925
70,70,110,421,423,844,1770
-70,-20,-160,403,441,844,1787
-120,-20,110,403,441,844,1767
-160,0,60,409,435,844,1773
60,20,110,410,434,844,1575
100,30,20,432,413,845,1618
-50,-50,170,408,437,845,1742
140,30,40,397,448,845,1842
180,-30,30,396,449,845,1788
140,40,-160,416,429,845,1738
110,-20,-60,406,439,845,1802
-180,-30,30,396,449,845,1788
-140,80,-20,422,423,845,1757
-130,40,130,397,448,845,1740
30,30,150,420,425,845,1789
120,-70,-60,403,443,846,1831
30,10,170,418,428,846,1887
170,-40,0,420,426,846,1739
110,80,70,418,428,846,1813
40,-70,-140,412,434,846,1797
-60,50,-90,415,431,846,1857
-160,20,50,410,436,846,1959
-110,-10,120,434,412,846,1787
10,-60,-160,407,439,846,1927
0,80,-170,422,424,846,1805
-170,-50,170,416,430,846,1763
170,-40,150,397,449,846,1817
-160,50,150,407,440,847,1830
-110,10,40,423,424,847,1771
-120,20,20,419,428,847,1771
180,20,40,413,434,847,1807
-30,-80,170,416,431,847,1736
-60,30,20,420,427,847,1850
90,-10,-100,398,449,847,1807
-180,20,40,413,434,847,1807
-110,10,50,426,421,847,1750
40,80,-60,398,449,847,1784
-160,30,30,417,430,847,1746
80,30,70,408,440,848,1727
50,0,130,422,426,848,1792
-20,-30,-40,413,435,848,1676
-140,40,140,408,440,848,1711
-150,70,0,404,444,848,1774
-40,60,10,413,435,848,1770
90,-10,100,412,436,848,1792
40,0,140,416,433,849,1756
-60,20,10,433,416,849,1839
-80,-50,-80,422,427,849,1677
-70,-50,-70,415,434,849,1633
60,-30,30,406,443,849,1697
90,0,-110,410,439,849,1763
-180,-60,10,407,442,849,1639
160,-70,-10,412,437,849,1657
-90,-60,130,411,438,849,1868
180,-60,10,407,442,849,1639
140,-70,-40,423,426,849,1798
-30,-10,-150,418,431,849,1860
-90,10,0,446,403,849,1749
-170,-40,40,406,444,850,1844
-180,50,170,418,432,850,1805
180,50,170,418,432,850,1805
90,-70,-100,399,451,850,1752
-90,10,30,424,427,851,1794
180,10,40,416,435,851,1910
120,30,30,410,441,851,1845
-180,10,40,416,435,851,1910
40,80,140,422,429,851,1757
-120,10,70,419,432,851,1656
-20,70,-140,417,434,851,1867
-160,-30,60,406,445,851,1800
-100,50,90,425,426,851,1822
100,40,70,408,443,851,1857
-120,-10,-160,428,423,851,1810
50,30,120,423,428,851,1781
-20,-30,-160,411,440,851,1916
80,0,60,404,447,851,1705
-40,-20,-150,416,435,851,1841
-50,-80,150,421,431,852,1762
-180,-10,40,398,454,852,1965
-10,30,-30,434,418,852,1809
150,10,20,399,453,852,1805
160,0,20,404,448,852,1816
180,-10,40,398,454,852,1965
60,-70,-130,412,440,852,1774
140,20,-170,419,434,853,1799
-60,40,-100,432,421,853,1839
-140,20,40,426,427,853,1892
-160,-30,170,416,437,853,1839
-130,80,110,401,452,853,1913
60,-20,20,398,455,853,1647
70,-50,50,392,461,853,1767
-120,50,-10,411,442,853,1838
70,-40,-150,407,446,853,1718
40,20,-60,412,441,853,1856
50,-40,-150,405,448,853,1850
-80,0,-30,427,426,853,1814
-130,50,0,409,445,854,1769
160,-20,150,397,457,854,1917
130,60,60,405,449,854,1924
30,20,150,425,429,854,1758
80,40,-100,385,469,854,1712
20,30,170,410,445,855,1782
-100,10,30,432,423,855,1818
-100,-20,130,417,438,855,1858
30,40,150,419,436,855,1803
-30,40,-10,416,439,855,1822
-110,10,80,427,428,855,1779
110,-60,-80,421,434,855,1800
140,-10,160,415,441,856,1916
40,-20,160,435,421,856,1833
-140,60,0,410,446,856,1868
110,10,-10,405,451,856,1689
160,-30,-10,417,439,856,1687
-80,-30,170,411,445,856,1847
-10,-60,-170,409,447,856,1843
120,80,60,426,430,856,1852
70,-10,30,417,439,856,1707
40,0,-40,401,456,857,1784
-30,20,-20,435,422,857,1774
-40,-80,160,432,425,857,1764
-150,-50,60,415,442,857,1792
50,-60,30,408,449,857,1810
-120,80,100,407,450,857,1908
20,10,-170,408,449,857,1844
90,-10,120,414,444,858,1793
-120,0,180,426,432,858,1680
20,-10,-170,429,429,858,1799
-100,20,90,432,426,858,1864
-50,70,-100,399,459,858,1917
-100,-60,120,418,440,858,1884
-40,80,-120,413,445,858,1826
-120,0,-180,426,432,858,1680
-40,-10,-140,419,440,859,1854
120,-40,-60,408,451,859,1805
160,-80,-10,419,440,859,1743
-110,80,90,403,456,859,1935
-110,-70,-120,411,448,859,1778
70,50,-90,398,461,859,1617
-60,-60,150,414,445,859,1873
-70,40,-80,428,432,860,1775
180,-50,160,409,451,860,1737
120,40,-140,418,442,860,1816
80,-20,160,422,438,860,1751
0,50,-160,410,450,860,1875
90,-50,-110,400,460,860,1819
-170,50,160,425,435,860,1897
-180,-50,160,409,451,860,1737
-110,-40,120,411,449,860,1856
-90,70,70,428,432,860,1729
150,-10,-10,405,456,861,1830
160,10,30,405,456,861,1917
140,-60,-40,426,435,861,1736
-70,-20,-60,420,441,861,1858
-70,10,0,444,417,861,1762
70,40,100,415,446,861,1860
150,0,0,423,438,861,1688
80,-50,-120,406,455,861,1764
150,90,40,432,430,862,1789
50,90,140,432,430,862,1789
-120,90,-50,432,430,862,1789
-90,90,-80,432,430,862,1789
-100,-50,130,390,472,862,1726
100,90,90,432,430,862,1789
90,90,100,432,430,862,1789
30,90,160,432,430,862,1789
-170,90,0,432,430,862,1789
120,-20,-50,408,454,862,1685
-50,90,-120,432,430,862,1789
80,90,110,432,430,862,1789
10,90,180,432,430,862,1789
-150,90,-20,432,430,862,1789
10,90,-180,432,430,862,1789
140,90,50,432,430,862,1789
180,90,10,432,430,862,1789
40,90,150,432,430,862,1789
80,10,60,405,457,862,1707
-170,10,50,419,443,862,1859
-130,90,-40,432,430,862,1789
70,90,120,432,430,862,1789
-80,90,-90,432,430,862,1789
-20,90,-150,432,430,862,1789
170,90,20,432,430,862,1789
-110,90,-60,432,430,862,1789
-160,90,-10,432,430,862,1789
170,-10,30,402,460,862,1928
-30,90,-140,432,430,862,1789
30,80,-50,404,458,862,1834
-100,90,-70,432,430,862,1789
110,90,80,432,430,862,1789
-50,30,-120,416,446,862,1811
20,90,170,432,430,862,1789
120,90,70,432,430,862,1789
-40,90,-130,432,430,862,1789
60,90,130,432,430,862,1789
160,90,30,432,430,862,1789
-160,30,160,401,461,862,1853
180,70,10,428,434,862,1848
-180,70,10,428,434,862,1848
-60,90,-110,432,430,862,1789
130,90,60,432,430,862,1789
-10,90,-160,432,430,862,1789
-70,90,-100,432,430,862,1789
-140,90,-30,432,430,862,1789
0,90,-170,432,430,862,1789
-180,90,10,432,430,862,1789
-120,10,160,425,438,863,1624
60,-10,-20,424,439,863,1858
60,-10,-10,429,434,863,1814
-50,-30,-160,421,442,863,1786
-60,-10,-140,420,443,863,1976
80,-10,60,398,465,863,1696
-150,20,50,418,445,863,1914
-80,-30,-70,430,433,863,1809
-130,0,80,426,437,863,1831
-80,30,-60,424,439,863,1835
0,70,-170,432,431,863,1809
150,-70,-30,436,427,863,1772
60,-50,-140,402,462,864,1880
-170,0,160,420,444,864,1912
20,0,-170,419,445,864,1866
140,-30,-30,412,452,864,1697
90,-30,-130,413,451,864,1710
130,0,-180,410,454,864,1968
-10,10,-160,439,425,864,1821
130,0,180,410,454,864,1968
60,60,-80,400,464,864,1779
-160,-60,40,420,445,865,1775
90,30,40,429,436,865,1799
170,10,30,411,454,865,1948
-10,80,-10,406,459,865,1844
30,-20,-170,413,452,865,1839
-120,-10,100,414,451,865,1870
-130,-20,90,422,443,865,1863
160,-10,160,414,451,865,1749
-90,30,-40,412,453,865,1775
-120,80,-40,430,436,866,1799
10,80,-30,408,458,866,1817
-130,60,120,431,435,866,1894
100,-40,-100,427,439,866,1596
100,50,-120,415,451,866,1798
-60,80,40,423,443,866,1831
50,-10,140,417,449,866,1860
-40,10,-140,427,439,866,1883
0,-50,-20,424,443,867,1815
-100,0,180,436,431,867,1849
160,20,30,406,461,867,1883
-130,20,30,420,447,867,1786
-100,0,-180,436,431,867,1849
150,-30,140,402,465,867,1834
-80,-50,150,413,455,868,1902
-110,50,-20,433,435,868,1862
40,20,130,436,432,868,1910
100,-10,-150,424,444,868,1898
80,-10,130,417,451,868,1886
40,-30,-170,432,436,868,1882
-60,70,-90,407,461,868,1967
-50,-20,-150,418,450,868,2049
180,80,10,442,426,868,1842
-20,40,-140,423,445,868,1862
-180,80,10,442,426,868,1842
-90,-50,-90,430,438,868,1773
40,-60,-150,416,453,869,1822
10,40,-180,420,449,869,1909
-10,-40,-170,420,449,869,1928
110,50,70,404,465,869,1876
30,0,160,436,433,869,1849
20,-60,-160,427,442,869,1767
20,-30,-20,423,446,869,1815
-110,10,150,422,447,869,1714
40,30,130,426,443,869,1757
10,40,180,420,449,869,1909
160,-70,-20,442,427,869,1766
-90,10,40,437,432,869,1860
-120,30,130,442,428,870,1733
80,20,60,419,451,870,1788
80,-40,-140,418,452,870,1681
-60,-10,-40,432,438,870,1776
30,-30,-10,429,441,870,1786
180,30,170,416,454,870,1837
-30,-70,-40,437,433,870,1725
-180,30,170,416,454,870,1837
170,-70,0,419,451,870,1711
-40,0,-30,432,438,870,1832
-170,20,40,440,430,870,1811
-170,60,10,424,446,870,1745
-130,30,140,423,447,870,1841
100,20,-130,421,450,871,1862
20,70,160,426,445,871,1801
-80,60,-60,422,449,871,1789
-90,10,10,448,423,871,1844
-100,40,-30,424,447,871,1873
30,0,170,440,431,871,1954
-120,-50,100,412,459,871,1860
150,-10,160,425,446,871,1724
-160,60,10,434,438,872,1914
-70,20,30,445,427,872,1810
60,-10,0,420,452,872,1760
40,-10,-30,408,464,872,1872
80,0,80,408,464,872,1800
110,-50,-80,431,441,872,1830
100,-10,-160,428,444,872,1890
20,40,160,457,415,872,1810
-30,-40,-170,412,461,873,1885
20,30,180,426,447,873,1907
30,10,150,431,442,873,1776
-130,80,-30,439,434,873,1764
130,80,50,430,443,873,1878
90,70,-110,400,473,873,1818
20,80,-40,415,458,873,1841
-20,0,-160,440,433,873,1911
20,30,-180,426,447,873,1907
150,-30,-20,421,452,873,1808
80,-20,60,399,474,873,1771
-150,20,40,425,448,873,1858
120,30,10,423,450,873,1849
150,-20,150,419,454,873,1845
-180,-50,10,428,446,874,1779
180,-50,10,428,446,874,1779
-90,10,-30,435,439,874,1853
-130,60,-10,411,463,874,1836
100,-70,-90,412,462,874,1832
160,20,180,432,442,874,1832
160,20,-180,432,442,874,1832
0,80,-20,411,463,874,1844
90,-10,110,411,463,874,1907
0,60,-30,417,457,874,1867
-180,40,30,429,445,874,1854
180,40,30,429,445,874,1854
-50,50,-110,437,438,875,1890
-150,-10,70,417,458,875,1891
-70,80,50,424,451,875,1876
-150,-30,70,418,457,875,1870
-40,0,-140,441,434,875,1923
0,30,-160,426,449,875,1957
-110,-50,120,390,485,875,1729
-60,-30,-180,411,464,875,1890
-60,-30,180,411,464,875,1890
-140,-70,60,424,451,875,1739
-90,80,70,419,456,875,1932
130,30,40,412,463,875,1929
-140,70,-10,424,451,875,1748
-140,60,130,435,441,876,1890
-30,30,-140,447,429,876,1892
30,0,-180,426,450,876,2042
-20,-20,-40,404,472,876,1891
120,50,60,422,454,876,1902
110,50,-130,427,449,876,1841
30,0,180,426,450,876,2042
-50,80,-110,418,458,876,1872
-10,80,-160,440,436,876,1847
150,20,30,411,466,877,1973
80,60,100,419,458,877,1896
130,40,50,416,461,877,1869
-40,10,-130,422,455,877,1975
-40,20,-140,430,447,877,1898
-20,80,0,417,460,877,1855
40,-20,170,445,432,877,1805
-30,-60,-40,438,439,877,1801
80,70,100,427,450,877,1862
40,-20,180,427,450,877,1865
40,-20,-180,427,450,877,1865
180,50,20,433,445,878,1836
30,-50,-160,428,450,878,1881
-170,60,160,418,460,878,1795
-110,80,-50,430,448,878,1836
-10,60,-150,409,469,878,1891
170,-60,-10,437,441,878,1722
-130,-40,90,417,461,878,1768
50,-40,-160,424,454,878,1799
-100,-40,-100,434,444,878,1796
90,-20,180,429,449,878,2046
-180,50,20,433,445,878,1836
170,50,30,424,454,878,1939
-60,-40,170,420,458,878,1839
90,-20,-180,429,449,878,2046
80,50,-100,426,453,879,1740
-150,-40,60,418,461,879,1940
60,70,-80,395,484,879,1768
-80,80,60,424,455,879,1914
130,-50,-50,418,461,879,1976
0,20,-160,429,450,879,1968
80,20,-100,409,470,879,1837
150,10,-180,430,450,880,1852
-160,-50,-180,439,441,880,1853
80,0,90,431,449,880,1861
-170,-20,50,409,471,880,1948
-30,70,-130,428,452,880,1919
0,-70,-170,420,460,880,1926
-100,80,80,415,465,880,1921
90,60,-110,410,470,880,1789
-130,70,-20,430,450,880,1840
-160,-50,180,439,441,880,1853
-100,20,-20,439,441,880,1807
80,-30,60,417,463,880,1753
-60,50,30,443,437,880,1797
160,-50,-20,423,457,880,1667
150,10,180,430,450,880,1852
-70,40,40,445,435,880,1845
-130,20,150,429,451,880,1806
60,50,-80,419,462,881,1693
170,-20,10,417,464,881,1877
0,60,-170,432,449,881,1924
-50,60,-100,429,452,881,1907
70,-20,40,420,461,881,1750
-10,40,-150,434,447,881,2012
50,-30,170,449,432,881,1901
150,40,40,426,455,881,1859
-50,80,30,427,454,881,1818
30,80,150,432,449,881,1818
170,20,30,427,454,881,2012
100,60,-120,419,463,882,1832
-160,40,20,431,451,882,1806
-20,-30,-170,431,451,882,1961
-160,60,150,420,462,882,1840
-90,0,-130,447,435,882,1819
80,-40,60,417,465,882,1777
-160,-40,50,422,461,883,1921
100,10,-130,409,474,883,1886
-160,20,40,446,437,883,1852
80,-80,-100,425,458,883,1772
120,30,40,417,466,883,1988
20,30,160,440,443,883,1948
20,-20,-170,435,448,883,1899
-30,80,10,426,457,883,1826
-30,60,0,421,463,884,1926
-60,-40,160,427,457,884,1915
100,50,70,423,461,884,1947
-50,-10,-140,420,464,884,1965
70,60,-90,411,473,884,1779
160,0,10,434,450,884,1932
170,0,30,416,468,884,2022
150,0,170,436,448,884,1954
-50,-30,-170,428,456,884,1823
-20,-70,180,435,450,885,1903
70,-10,130,427,458,885,1986
140,0,-10,423,462,885,1907
10,40,-170,429,456,885,1912
-130,-60,80,419,466,885,1952
80,10,50,428,457,885,1741
-180,0,160,422,463,885,1868
-140,30,20,421,464,885,1897
180,0,160,422,463,885,1868
-20,-70,-180,435,450,885,1903
-50,-60,160,432,453,885,1891
70,-80,-110,431,455,886,1805
10,-20,-170,437,449,886,1898
-80,0,-120,451,435,886,1894
110,-80,-70,437,449,886,1827
140,-20,150,422,464,886,1768
70,70,-90,400,487,887,1761
-100,0,-170,447,440,887,1921
80,0,100,430,457,887,1821
-140,-20,80,431,456,887,1918
120,-10,170,438,449,887,1991
-30,50,-130,438,449,887,1983
-170,10,160,425,462,887,1944
-90,10,20,455,432,887,1854
170,-10,20,423,464,887,1949
-140,10,160,425,463,888,1773
-160,70,0,444,444,888,1859
-110,-10,-140,448,440,888,1878
140,40,40,434,454,888,1884
130,20,10,423,465,888,1910
-50,-40,170,443,445,888,1824
90,50,-110,438,450,888,1856
-150,10,60,427,461,888,1895
160,30,30,439,449,888,1995
140,80,40,436,453,889,1930
-170,30,30,446,443,889,1886
110,40,-130,429,460,889,1770
90,-80,-90,428,461,889,1817
-90,50,-50,437,452,889,1917
-10,-30,-170,447,442,889,1950
10,50,-40,426,463,889,1831
100,-20,110,419,471,890,1849
-90,20,-40,442,448,890,1846
120,-60,-70,438,452,890,1930
-130,-30,90,430,460,890,1878
0,-80,-170,432,458,890,1896
170,-80,0,431,459,890,1852
110,-70,-80,426,465,891,1895
100,-80,-80,437,454,891,1821
-70,-30,-180,426,465,891,1935
-40,80,20,432,459,891,1826
-130,10,160,435,456,891,1713
-100,80,-60,434,457,891,1873
-70,-30,180,426,465,891,1935
-170,-10,50,421,470,891,1916
-10,-50,-170,425,466,891,1978
180,40,170,447,444,891,1999
-180,40,170,447,444,891,1999
-170,-90,20,437,455,892,1880
-80,-90,110,437,455,892,1880
-180,-40,20,427,465,892,1835
180,-40,20,427,465,892,1835
130,-20,150,430,462,892,1883
0,-90,-170,437,455,892,1880
30,-90,-140,437,455,892,1880
50,-90,-120,437,455,892,1880
-90,-90,100,437,455,892,1880
120,-90,-50,437,455,892,1880
-130,-90,60,437,455,892,1880
-40,-90,150,437,455,892,1880
130,-90,-40,437,455,892,1880
90,-20,170,429,463,892,1936
80,-90,-90,437,455,892,1880
180,-90,10,437,455,892,1880
-10,-90,180,437,455,892,1880
10,-90,-160,437,455,892,1880
140,10,10,414,478,892,1969
-60,-90,130,437,455,892,1880
80,70,-100,411,481,892,1790
100,-90,-70,437,455,892,1880
70,-90,-100,437,455,892,1880
-110,-90,80,437,455,892,1880
-100,-90,90,437,455,892,1880
-10,-90,-180,437,455,892,1880
-160,-90,30,437,455,892,1880
-120,-90,70,437,455,892,1880
20,-90,-150,437,455,892,1880
150,-90,-20,437,455,892,1880
-140,-90,50,437,455,892,1880
160,-90,-10,437,455,892,1880
-30,-90,160,437,455,892,1880
-70,70,-80,424,468,892,1997
60,-90,-110,437,455,892,1880
80,60,-100,420,472,892,1797
40,-90,-130,437,455,892,1880
170,-90,0,437,455,892,1880
110,40,60,425,467,892,2022
-150,-90,40,437,455,892,1880
-180,-90,10,437,455,892,1880
-20,-90,170,437,455,892,1880
90,-90,-80,437,455,892,1880
110,-90,-60,437,455,892,1880
-50,-90,140,437,455,892,1880
-130,-70,70,427,465,892,1808
140,-90,-30,437,455,892,1880
-70,-90,120,437,455,892,1880
-90,-50,140,427,466,893,1931
-80,60,60,443,450,893,1817
30,0,150,443,450,893,1850
-60,-20,-50,451,442,893,1901
-90,0,-120,449,444,893,1908
120,-80,-60,438,455,893,1861
90,60,90,422,471,893,1936
-140,-50,70,419,474,893,1884
-140,-30,80,422,471,893,1978
70,-50,-130,418,475,893,1930
-170,0,50,428,465,893,1948
-150,-30,60,434,460,894,2029
-150,60,140,441,453,894,1866
60,-40,-160,425,469,894,1841
-60,80,-100,430,464,894,1914
-30,-20,-160,433,461,894,1948
100,-30,-100,441,454,895,1746
-60,-40,-60,442,453,895,1862
-50,0,-130,428,467,895,2005
10,30,-180,439,456,895,2024
10,30,180,439,456,895,2024
50,70,-70,404,491,895,1780
150,-50,-30,439,456,895,1812
90,50,80,427,468,895,1946
-40,50,-120,444,451,895,1931
20,20,160,451,444,895,1998
-20,-50,-170,425,470,895,1912
140,60,50,438,458,896,2025
10,10,-40,416,480,896,1878
-100,-20,-90,451,445,896,1889
140,-50,-40,432,464,896,1850
160,0,0,433,463,896,1829
120,-20,150,428,468,896,1838
10,60,170,458,439,897,1965
-180,-70,10,437,460,897,1783
-170,-50,30,438,459,897,1876
40,40,130,441,456,897,1849
-100,10,20,449,448,897,1968
180,-70,10,437,460,897,1783
80,30,-100,422,475,897,1949
-80,70,60,439,458,897,1866
-120,-40,-130,456,441,897,1760
-110,10,160,450,448,898,1954
150,10,10,447,451,898,1955
-40,-80,-50,427,471,898,1932
-160,-10,60,433,465,898,1938
110,-20,150,434,464,898,1896
70,10,100,438,460,898,1868
170,60,20,435,463,898,1946
60,-80,-120,440,458,898,1817
-10,50,-150,429,470,899,1964
80,10,30,439,460,899,1781
40,-40,-160,437,462,899,1991
50,-20,150,424,475,899,1977
20,20,-180,438,461,899,1994
60,40,110,438,461,899,1929
20,20,180,438,461,899,1994
-70,-60,140,440,459,899,1884
-170,-30,40,419,480,899,2005
170,-10,160,433,466,899,1963
90,70,90,438,461,899,1986
50,-70,-140,430,469,899,1890
-110,10,60,440,460,900,1835
90,-30,-140,435,465,900,1802
-30,-60,180,435,465,900,1925
-150,-50,-170,440,460,900,1813
-30,-60,-180,435,465,900,1925
-150,20,30,445,455,900,1870
10,-10,-170,445,455,900,1984
-120,60,110,456,444,900,2006
-80,40,-70,445,456,901,1890
-110,10,70,455,446,901,1809
-100,20,100,436,465,901,1967
110,-20,140,449,452,901,1873
-110,10,30,457,444,901,1965
140,20,20,429,472,901,1889
-120,-40,100,427,474,901,1933
-70,40,-90,462,439,901,1880
-90,-10,180,450,452,902,1887
-20,60,-140,433,469,902,1880
-80,10,10,474,428,902,1841
-10,60,-20,430,472,902,1904
-90,-10,-180,450,452,902,1887
-100,-10,-100,470,432,902,1887
-70,30,-80,450,452,902,1946
-40,-30,-170,444,458,902,1897
-170,80,0,454,448,902,1914
30,-70,-150,439,464,903,1842
170,50,-180,443,460,903,1806
-100,0,-130,452,451,903,1956
-90,80,-70,436,467,903,1916
-40,-60,170,445,458,903,1961
-20,30,-150,454,449,903,1917
170,50,180,443,460,903,1806
-110,0,100,457,446,903,1828
-90,-10,160,454,449,903,1902
50,60,-70,427,476,903,1863
-20,-40,-170,442,461,903,1977
50,40,120,444,460,904,1896
70,-40,50,428,476,904,1910
-50,-80,-60,423,481,904,1942
130,-80,-50,447,457,904,1877
-90,-30,150,436,468,904,1953
10,-30,-170,433,471,904,1869
-160,-30,50,427,477,904,2011
-160,-20,60,433,471,904,1987
10,-50,-10,444,460,904,1917
-20,60,-10,428,476,904,1978
-10,70,-160,452,453,905,1924
-120,-60,90,439,466,905,1983
-90,-10,170,452,453,905,1983
-40,20,-10,449,456,905,1805
-20,80,-150,459,446,905,1942
-180,60,170,425,480,905,1880
180,60,170,425,480,905,1880
-100,0,140,451,454,905,1951
0,40,-160,427,478,905,1972
-150,40,150,431,474,905,1863
130,30,30,443,463,906,1955
-80,10,-80,450,456,906,2060
-120,10,50,454,452,906,1771
180,0,30,440,466,906,1994
120,40,50,429,477,906,2066
170,-50,-10,455,451,906,1701
-50,40,-120,450,456,906,1936
-50,20,-120,435,471,906,1967
150,50,40,448,458,906,1892
-130,-10,-170,442,464,906,1823
90,30,-110,412,494,906,1874
-180,0,30,440,466,906,1994
-80,-10,-160,441,466,907,1975
10,30,-170,443,464,907,2052
-20,50,-140,439,469,908,2004
-80,20,50,465,443,908,1897
130,10,-10,452,456,908,1798
-80,-60,130,445,463,908,1901
-90,0,-60,449,459,908,1854
40,-50,20,448,460,908,1719
-30,20,-150,452,456,908,1968
-90,-10,-70,447,462,909,1856
120,-20,140,430,479,909,1892
-70,-50,150,430,479,909,1920
-50,20,0,445,464,909,1902
-90,0,-90,463,446,909,1903
90,-20,-170,455,454,909,2130
40,10,130,427,482,909,1869
-100,-10,130,442,467,909,1833
-30,-80,-40,430,479,909,1946
80,0,-10,442,468,910,1869
40,10,-50,440,470,910,1892
-120,60,-20,441,469,910,1879
-170,-60,20,432,478,910,1829
100,60,80,433,477,910,1981
-130,30,10,446,464,910,1937
-100,10,0,452,459,911,1913
10,30,170,456,455,911,1968
-150,50,10,452,459,911,1986
-70,50,-80,451,460,911,2009
50,30,-70,430,481,911,1953
-40,10,-20,464,447,911,1928
-40,-10,-150,443,468,911,2064
10,50,170,460,451,911,1954
30,-50,10,432,479,911,1752
-30,-70,170,452,459,911,1977
120,-30,120,426,485,911,1938
-120,-20,100,446,466,912,1915
-180,60,10,447,465,912,1980
-170,-70,20,445,467,912,1837
-50,10,-120,447,465,912,2075
150,80,30,449,463,912,1974
110,70,70,440,472,912,2072
180,60,10,447,465,912,1980
-120,-70,-130,443,470,913,1920
-120,70,-30,439,474,913,1944
20,-50,0,431,482,913,1818
100,-20,140,450,463,913,1919
-90,40,80,452,461,913,1917
-120,10,60,457,456,913,1909
-140,0,70,438,475,913,1912
-100,10,10,461,452,913,1965
130,-10,170,448,466,914,2004
-20,-70,-30,458,456,914,1829
-60,50,-100,453,461,914,1939
-110,40,110,448,466,914,1843
130,20,0,447,467,914,1957
10,40,170,454,460,914,1936
180,-80,10,443,471,914,1903
70,30,-90,429,485,914,1927
50,-80,-130,445,469,914,1855
-180,-80,10,443,471,914,1903
80,10,20,445,469,914,1821
-90,20,70,460,455,915,2000
-160,10,50,443,472,915,1950
180,10,30,446,469,915,1985
-80,80,-80,441,474,915,1937
130,-40,-50,441,474,915,2060
-180,10,30,446,469,915,1985
-170,10,40,439,476,915,1964
-50,50,20,447,468,915,1913
-160,-70,30,444,472,916,1903
-40,70,-120,442,474,916,1985
100,0,-130,436,480,916,2006
-150,10,160,426,490,916,1919
-80,50,60,457,459,916,1931
-60,-50,-60,447,469,916,1821
-50,20,-130,451,465,916,2012
100,-10,-140,442,474,916,1892
-90,60,-50,435,482,917,1929
140,-80,-40,454,463,917,1915
-80,-20,180,441,476,917,1942
-180,30,30,458,459,917,1955
-80,40,60,461,456,917,1922
-60,30,-110,440,477,917,1952
-80,-20,-180,441,476,917,1942
180,30,30,458,459,917,1955
-60,10,-110,452,465,917,2099
50,50,-70,443,474,917,1809
90,40,70,439,478,917,2011
90,40,-110,443,474,917,1952
-80,-10,-50,468,450,918,1832
-10,-20,-170,458,460,918,1979
110,-10,-170,433,485,918,2097
70,-60,-130,435,483,918,1982
50,-50,-150,441,477,918,1992
70,40,-90,433,485,918,1990
160,-20,-10,446,472,918,1835
-40,-40,180,459,459,918,2013
-40,-40,-180,459,459,918,2013
-40,-70,160,461,457,918,1952
-50,30,-130,453,465,918,1995
-70,80,-90,440,478,918,1940
-110,-30,110,440,478,918,1899
-70,30,-90,445,474,919,1971
-80,70,-70,439,480,919,2062
-90,-80,-100,432,487,919,1943
-90,0,-100,457,462,919,1939
-90,0,-110,466,453,919,1927
180,-20,30,453,466,919,1982
160,40,30,456,463,919,2003
-180,-20,30,453,466,919,1982
20,80,160,448,471,919,1948
-160,20,30,456,463,919,1931
100,70,80,444,475,919,2040
-140,20,30,451,468,919,1889
10,20,-40,441,479,920,2045
-60,60,-90,446,474,920,2038
-150,10,40,460,460,920,1925
110,50,60,432,488,920,2039
-120,-30,100,439,481,920,1911
-90,-60,120,441,479,920,1917
-60,-80,-70,434,486,920,1964
30,-30,-170,450,470,920,2019
30,-60,-160,449,471,920,1976
-150,-10,170,444,476,920,1973
150,30,30,435,486,921,1899
-90,0,-70,459,462,921,1812
-60,0,-130,430,491,921,2068
170,-30,0,446,475,921,1832
-100,0,-160,466,455,921,1897
0,-40,-170,446,475,921,2016
-70,10,-100,444,477,921,2071
-110,-60,100,443,478,921,1976
100,40,-120,443,479,922,1957
120,-70,-70,455,467,922,1944
10,20,-170,446,476,922,2100
-80,10,20,470,452,922,1905
-100,-60,110,440,482,922,1942
90,-40,-120,451,471,922,1910
40,70,-60,413,509,922,1858
-80,0,-130,462,460,922,1981
-170,-10,40,441,481,922,2056
60,-10,10,449,473,922,1838
50,-50,30,429,494,923,1862
170,30,30,449,474,923,1992
0,50,-170,446,477,923,2092
160,10,20,441,482,923,2007
-40,40,-130,465,458,923,2028
-170,20,30,454,469,923,1961
-170,40,20,454,469,923,1938
-80,10,30,473,450,923,1904
80,10,-90,434,489,923,1867
-70,10,10,471,453,924,2010
130,0,-170,449,475,924,1984
100,40,60,434,490,924,2117
-170,0,40,450,474,924,2052
-100,-40,130,434,490,924,2070
130,50,50,451,473,924,1954
-60,-20,-160,437,487,924,2027
-60,-30,170,433,491,924,2032
-120,-70,80,456,468,924,1861
180,20,30,458,467,925,2012
80,50,90,440,485,925,1985
-40,30,-140,462,463,925,1988
-150,-20,70,443,482,925,2060
90,20,-110,422,503,925,1979
-90,0,-80,466,459,925,1897
-110,60,100,464,461,925,2066
-80,-80,-90,436,489,925,1953
120,-30,-60,445,480,925,1907
10,20,170,466,459,925,2073
40,50,130,465,460,925,1946
-180,20,30,458,467,925,2012
20,20,170,452,473,925,2047
50,0,-40,434,492,926,1902
-90,-30,-80,472,454,926,1884
150,20,20,436,490,926,2010
60,30,-80,441,485,926,1958
90,0,-20,441,485,926,1966
-30,-30,-170,450,476,926,1994
100,-20,150,452,474,926,1992
-60,40,-110,458,468,926,1949
-170,50,10,461,466,927,1960
-70,20,-90,436,491,927,2046
-100,0,-150,467,460,927,1933
10,0,-170,454,473,927,2157
-160,10,160,460,467,927,2091
-70,-80,-80,436,491,927,1966
-150,60,0,461,467,928,1962
-30,-10,-160,469,459,928,2066
0,40,-170,449,479,928,2074
-110,-70,90,463,465,928,1896
-30,60,-130,450,478,928,1977
-150,30,20,456,472,928,1867
-130,-50,80,438,490,928,1998
0,-30,-170,455,473,928,1983
10,-20,-30,445,483,928,1989
-160,-20,50,444,484,928,2027
120,70,60,445,483,928,2044
-30,-50,-40,442,486,928,1863
-170,-20,40,441,487,928,2075
-90,10,50,458,471,929,1984
-50,-30,180,455,474,929,1996
-70,70,50,456,473,929,2006
-40,-20,-160,456,473,929,2012
-50,-30,-180,455,474,929,1996
-90,40,-50,451,478,929,2007
-110,30,120,469,460,929,1855
130,-30,130,443,486,929,2040
110,40,30,444,485,929,1898
50,-20,10,441,489,930,1804
40,-10,140,439,491,930,1949
-100,30,-30,467,463,930,1922
-70,-10,-150,446,484,930,2008
140,10,0,454,476,930,2004
70,0,-50,443,487,930,1898
60,-20,150,440,490,930,1933
20,-30,-170,440,490,930,2022
-10,-80,-180,459,472,931,2001
130,40,40,445,486,931,1998
-10,-80,180,459,472,931,2001
100,-20,-90,444,487,931,1864
10,70,170,466,465,931,2021
-80,0,-20,476,455,931,1918
-100,10,110,470,462,932,1991
80,0,-70,449,483,932,1883
-100,-30,130,447,485,932,2021
-110,20,0,459,473,932,1951
-110,-50,110,436,496,932,1977
-170,-80,20,458,474,932,1962
150,-80,-30,468,464,932,1924
-50,70,-110,454,478,932,2004
110,-40,100,439,493,932,2046
-140,-30,70,445,487,932,2145
80,-60,-120,443,489,932,2006
-110,30,-10,464,468,932,1989
-70,50,-90,467,466,933,2075
-130,10,60,452,481,933,2037
-110,70,-40,450,483,933,2001
50,-30,20,457,476,933,1906
-20,-60,-180,450,483,933,2030
-20,-60,180,450,483,933,2030
-130,-60,-140,449,484,933,2041
-140,70,130,446,487,933,1960
60,-60,-140,450,483,933,2063
10,-40,-170,462,471,933,2000
-60,70,40,454,479,933,2000
70,-20,150,452,481,933,1954
-140,-40,70,429,504,933,2039
-160,10,40,460,474,934,2003
-90,10,-40,464,470,934,1973
-100,60,-40,439,495,934,1972
120,-40,110,441,493,934,2050
-130,-20,-160,468,466,934,1852
110,30,-130,436,498,934,1970
-20,10,-30,453,482,935,2027
-160,30,20,464,471,935,2036
150,60,40,446,489,935,2058
0,-60,-170,442,493,935,2050
150,70,30,454,481,935,2073
110,60,70,447,488,935,2066
-50,10,-130,466,470,936,2140
-160,20,160,447,489,936,2127
-90,30,80,470,466,936,1975
-60,-70,140,456,480,936,1997
30,30,140,459,477,936,1904
-30,80,-140,472,464,936,2023
140,-40,130,445,491,936,2072
-20,30,-20,454,482,936,1952
-90,-40,140,431,505,936,1983
70,-30,-180,480,456,936,2119
30,40,140,469,467,936,1927
50,50,120,454,482,936,2076
-100,10,100,476,460,936,2067
-80,20,-70,456,480,936,2042
70,-30,180,480,456,936,2119
160,60,30,450,487,937,2057
-110,0,-170,468,469,937,2031
50,-40,-170,453,484,937,1987
150,-20,-20,454,483,937,1935
-20,-20,-170,472,465,937,1979
-100,0,-140,465,472,937,2060
90,10,0,461,476,937,1953
-140,10,60,443,495,938,2019
140,70,40,449,489,938,2090
-110,-20,-120,473,465,938,1938
130,30,20,456,482,938,1995
40,-80,-140,458,480,938,1920
30,70,-50,424,514,938,1889
-40,0,-150,459,480,939,2063
120,50,50,448,491,939,2032
0,-50,-170,453,486,939,2027
0,-20,-170,467,472,939,1982
-70,0,-130,453,486,939,2112
130,70,50,445,494,939,2094
-110,60,-30,441,498,939,1980
180,-10,160,440,499,939,1950
-50,-50,160,454,485,939,2027
150,0,-10,455,484,939,1980
180,-10,30,450,489,939,2132
10,20,180,463,476,939,2179
-100,-70,100,459,480,939,1981
-180,-10,160,440,499,939,1950
-30,0,-160,482,457,939,1998
-180,-10,30,450,489,939,2132
10,20,-180,463,476,939,2179
-80,40,-80,470,470,940,1932
170,-70,-10,470,470,940,1920
110,-40,-80,485,455,940,1954
130,-40,120,453,487,940,2061
-100,10,60,460,480,940,1928
10,70,-30,446,494,940,1898
-100,0,-120,476,464,940,2057
-100,20,110,472,468,940,2031
-90,0,-140,465,475,940,1971
-90,-50,130,446,494,940,2093
50,10,120,451,489,940,1963
-100,-30,-90,475,466,941,1979
110,-20,130,452,489,941,1958
10,80,170,449,492,941,2020
90,-60,-110,448,493,941,2007
90,-20,150,468,473,941,2132
-160,-80,30,469,473,942,1991
-10,20,-30,461,481,942,2093
70,50,100,446,496,942,2046
-50,-20,-160,453,489,942,2147
160,80,20,457,485,942,2014
-50,-70,150,460,482,942,1995
180,20,170,459,483,942,1929
-180,20,170,459,483,942,1929
-160,50,10,469,473,942,2065
-70,-20,-170,442,500,942,2048
-70,-40,160,438,504,942,1961
170,60,-180,459,484,943,1980
-10,60,-160,454,489,943,2048
-150,-60,50,460,483,943,1936
-40,60,-120,462,481,943,1968
170,40,30,454,489,943,2051
90,-20,160,458,485,943,2064
170,60,180,459,484,943,1980
-90,-20,150,459,484,943,2044
-130,-80,-140,466,478,944,1896
-110,-40,110,440,504,944,2050
-20,-80,-30,443,501,944,1981
100,-20,160,473,471,944,2242
-100,-50,-100,465,479,944,1965
60,40,-80,450,494,944,2010
-100,-80,-110,439,505,944,1944
-70,30,40,490,455,945,1953
-120,30,0,468,477,945,2027
-30,-20,-40,456,489,945,1994
-90,70,-60,453,492,945,2098
150,30,-170,450,495,945,2009
-100,30,100,475,470,945,2009
120,30,-140,458,487,945,2013
-150,70,-10,470,475,945,1967
-140,40,10,463,482,945,2046
170,10,170,457,488,945,1948
60,50,110,447,498,945,2063
-130,10,50,463,482,945,2002
10,-50,-170,455,490,945,2048
-100,70,-50,455,490,945,2026
20,70,-40,436,510,946,1898
20,40,150,471,475,946,2007
-90,0,-50,474,472,946,1970
130,30,-150,473,473,946,1963
-110,-10,-130,476,470,946,2025
30,70,140,464,482,946,2025
-10,20,-160,473,473,946,1978
100,-20,170,464,482,946,2073
80,-10,120,447,500,947,2138
110,40,50,437,510,947,2140
-130,70,120,463,484,947,2001
110,10,-140,452,495,947,2019
80,0,70,450,498,948,1873
-20,10,-160,473,475,948,2052
-170,70,0,471,477,948,2031
-50,70,30,462,486,948,1976
-80,30,60,476,472,948,1924
160,70,20,461,487,948,2068
-160,80,-10,477,471,948,2016
-110,-80,-120,450,498,948,1951
20,10,170,477,472,949,2176
-70,-70,130,460,489,949,2047
-70,-10,-40,484,465,949,1957
-10,-70,-20,470,479,949,1959
20,-70,-160,460,489,949,1955
-80,-40,150,448,501,949,2144
40,70,130,465,484,949,1994
40,-20,150,463,487,950,2033
60,0,120,453,497,950,2037
-140,0,170,466,484,950,1938
140,10,-170,469,481,950,2059
-120,20,10,474,476,950,2070
-130,-40,80,441,509,950,2085
160,50,30,456,494,950,2082
40,-30,10,451,500,951,1868
0,70,-20,455,496,951,1874
-80,-50,140,452,499,951,2101
30,-10,180,459,492,951,2247
-140,10,40,476,475,951,2013
-70,60,-80,452,499,951,2130
130,-60,-60,476,475,951,1987
30,-10,-180,459,492,951,2247
-30,40,-140,469,482,951,2079
-150,10,50,458,493,951,2147
160,-80,-20,479,472,951,2013
70,-40,-160,460,492,952,1865
90,-20,90,451,501,952,1910
-150,-80,40,468,484,952,1987
-60,-20,-170,445,507,952,2090
-110,10,20,478,474,952,2081
-150,-20,60,455,497,952,2130
-100,10,-10,477,475,952,2053
110,-30,-80,474,478,952,1838
130,-20,160,451,502,953,2003
-80,50,-80,481,472,953,2149
170,-20,0,450,503,953,1958
-80,-30,160,449,504,953,2057
120,-50,-70,463,490,953,2014
90,-20,140,454,499,953,2098
90,10,-110,447,506,953,1944
60,-50,40,443,510,953,1975
30,50,140,480,474,954,1987
140,50,40,463,491,954,2098
180,-40,10,472,482,954,1931
-180,-40,10,472,482,954,1931
20,10,180,474,480,954,2180
10,10,-170,459,495,954,2125
20,10,-180,474,480,954,2180
100,-20,130,475,480,955,2096
-130,-70,-140,473,482,955,2016
180,50,10,479,476,955,2052
-180,50,10,479,476,955,2052
-100,-30,120,459,496,955,2070
-130,-10,80,473,483,956,2074
-160,60,0,473,483,956,2078
170,-40,-10,483,473,956,1815
-120,-80,-130,466,490,956,1924
160,-40,-20,471,486,957,1909
-90,0,-160,476,481,957,2065
-80,-70,120,463,494,957,2028
-100,10,70,470,487,957,2004
20,10,160,474,483,957,2100
140,20,10,456,502,958,2160
110,0,-150,459,499,958,2026
-150,0,60,462,496,958,1920
10,40,160,484,474,958,1930
140,30,30,454,505,959,2075
0,50,-30,455,504,959,2067
-80,30,-70,471,488,959,2032
30,-10,-30,456,503,959,2106
100,40,40,459,500,959,2103
-40,80,-130,478,481,959,2062
80,-30,-170,472,487,959,2160
-60,30,-120,464,495,959,2068
170,40,-180,474,486,960,2008
-140,30,150,471,489,960,2142
-30,-50,180,459,501,960,2125
-30,-50,-180,459,501,960,2125
170,40,180,474,486,960,2008
-80,50,-70,468,492,960,2138
-120,-30,-130,478,482,960,1901
0,-70,-10,469,492,961,2026
-130,-30,-150,484,477,961,2024
140,30,-160,476,485,961,2004
-50,30,10,477,484,961,2078
-90,-70,110,469,492,961,2040
170,10,20,463,498,961,2100
-60,70,-100,471,490,961,2053
-140,-20,-170,490,471,961,1873
140,0,-180,465,497,962,2147
150,40,30,466,496,962,2114
110,40,40,462,500,962,2136
40,-70,-150,455,507,962,2008
120,-20,160,461,501,962,2025
-10,-70,180,453,509,962,2104
-10,-70,-180,453,509,962,2104
20,50,150,480,482,962,2014
-110,-10,110,472,490,962,2126
-100,10,120,484,478,962,2005
-50,10,-10,485,477,962,1962
140,0,180,465,497,962,2147
-40,70,20,460,502,962,1995
-50,60,-110,480,482,962,2052
-40,-50,170,460,503,963,2078
-20,70,-150,468,495,963,2057
-20,-60,-30,476,487,963,1982
-10,70,-10,458,505,963,1951
-140,60,-10,477,486,963,1947
-60,10,0,484,479,963,2032
0,-30,-30,457,507,964,2108
110,-30,110,461,503,964,2113
-120,-50,90,459,505,964,2089
170,0,20,451,513,964,2102
30,20,-50,463,501,964,2130
-60,40,30,491,474,965,2077
-70,0,-20,469,496,965,1953
-20,-50,-180,462,503,965,2124
80,-20,150,468,497,965,2104
-20,-50,180,462,503,965,2124
-110,0,-160,478,487,965,2060
170,-10,10,464,501,965,2098
100,50,60,464,501,965,2173
30,20,140,481,484,965,2017
40,-20,-10,468,497,965,1863
-90,0,-150,483,482,965,2184
-150,70,140,453,512,965,1956
20,60,150,475,491,966,1968
-20,70,0,454,512,966,2014
120,0,-160,471,495,966,2086
-180,40,20,478,488,966,2121
180,40,20,478,488,966,2121
-70,40,-100,482,484,966,2043
-160,-50,40,467,499,966,2035
150,20,-170,469,498,967,2151
-160,10,30,471,496,967,2038
-100,-50,120,444,523,967,2102
-120,10,40,485,483,968,2019
-160,0,50,468,500,968,2147
-140,10,50,479,489,968,2231
-180,-30,20,470,498,968,1991
30,-10,170,485,483,968,2051
180,-30,20,470,498,968,1991
120,70,-130,466,502,968,2016
0,-10,-170,491,477,968,1973
-20,-80,170,468,500,968,2108
30,-10,160,481,488,969,2158
-160,40,160,477,492,969,2097
-170,-50,20,470,499,969,2012
50,40,-70,456,513,969,2006
170,50,20,476,493,969,2028
120,40,20,477,492,969,2087
110,40,20,458,511,969,1980
-160,-60,30,467,503,970,1977
40,30,-60,464,506,970,2133
-90,20,80,494,476,970,2127
180,-60,0,481,489,970,1938
-60,60,-100,490,480,970,2124
-150,10,30,489,481,970,2040
10,30,-40,479,491,970,2121
-150,-70,40,469,501,970,1982
-40,20,-150,475,495,970,2132
-180,-60,0,481,489,970,1938
-40,10,-150,481,489,970,2058
10,40,-40,463,507,970,2089
-180,-30,160,463,507,970,2092
180,-30,160,463,507,970,2092
60,-10,130,471,500,971,2157
180,-40,160,456,515,971,1998
-180,-20,160,454,517,971,2103
-100,0,130,492,479,971,1960
180,-20,160,454,517,971,2103
-180,-40,160,456,515,971,1998
170,70,10,477,494,971,2067
-140,-80,50,473,499,972,2013
-140,50,0,472,500,972,2127
-120,0,80,472,500,972,2069
-70,30,-100,470,502,972,2110
80,40,80,467,505,972,2074
90,-30,-150,473,499,972,1981
-60,-50,150,475,497,972,2076
-10,-40,-30,477,495,972,1958
-140,-80,-150,480,492,972,1981
-30,0,-30,479,493,972,2063
-30,70,10,467,506,973,2016
70,-30,50,473,500,973,2005
-100,50,-40,467,506,973,2056
90,40,60,463,510,973,2091
160,-10,-10,467,506,973,2023
-110,-20,110,474,499,973,1948
140,-10,-20,473,500,973,2071
-70,-30,170,465,509,974,2136
-120,-10,90,480,494,974,2210
-140,-40,-160,474,500,974,1953
20,30,150,475,499,974,2052
40,60,130,488,487,975,2096
-170,0,30,473,502,975,2124
-10,50,-160,467,508,975,2086
-30,-60,170,478,497,975,2170
150,10,0,471,504,975,2030
-60,20,-110,464,511,975,2161
60,-30,170,480,495,975,2144
-100,-10,-90,490,486,976,2007
140,-10,170,476,500,976,2145
140,-20,-30,482,494,976,1990
-90,10,-60,477,499,976,2124
100,-60,-100,467,509,976,2076
120,60,60,465,511,976,2099
60,10,110,469,507,976,2058
-90,-10,150,478,499,977,2013
160,10,-180,468,509,977,2024
-90,0,-20,500,477,977,2152
-10,-80,-20,467,510,977,1971
-50,-20,-170,463,514,977,2161
160,10,180,468,509,977,2024
140,-40,-40,466,511,977,2145
40,-50,-160,468,509,977,2170
30,60,140,487,490,977,1980
120,40,30,480,497,977,2094
-80,10,-90,476,502,978,2200
80,30,60,471,507,978,1990
140,-60,-50,479,499,978,2080
-90,50,80,489,489,978,2074
-100,60,90,481,497,978,2175
30,-80,-150,476,502,978,1988
-120,-20,-140,488,490,978,1978
-90,30,-50,478,500,978,2178
-120,40,-10,475,504,979,2136
110,70,-120,475,504,979,2020
120,40,40,473,506,979,2129
-170,-40,30,476,503,979,2018
90,-70,-110,483,496,979,2107
90,0,-100,477,502,979,2091
-90,10,-50,498,481,979,2118
130,60,50,472,507,979,2092
10,30,160,492,487,979,1998
-110,40,-20,479,501,980,2125
-70,-50,140,473,507,980,2094
50,-60,-150,471,509,980,2157
-60,10,-120,485,495,980,2252
-50,-30,-50,477,503,980,2079
-170,10,30,468,512,980,2044
140,60,40,478,502,980,2083
-90,10,60,488,492,980,2045
-30,10,-160,482,499,981,2090
70,0,10,479,502,981,1993
-180,-50,0,482,499,981,1936
-140,-10,70,480,501,981,2017
10,50,160,489,492,981,1998
180,-50,0,482,499,981,1936
130,-10,-30,472,509,981,2002
-140,-30,60,464,517,981,2148
130,-70,-60,482,499,981,2006
100,-50,-100,467,514,981,2069
-150,80,-20,497,484,981,2080
120,-10,-180,484,498,982,2180
40,60,-60,469,513,982,2036
-160,-40,-180,477,505,982,2036
150,60,30,474,508,982,2156
-160,-40,180,477,505,982,2036
150,50,30,485,497,982,2096
10,60,160,484,498,982,2048
170,30,180,475,507,982,2106
120,-10,180,484,498,982,2180
-70,60,50,477,505,982,2029
170,30,-180,475,507,982,2106
-130,20,20,484,498,982,2046
-170,40,10,493,490,983,2114
140,30,20,468,515,983,2118
-130,60,-20,491,492,983,2191
110,0,-30,474,509,983,2056
-50,10,-140,484,499,983,2140
-130,0,70,480,503,983,2041
-100,10,130,479,505,984,2026
90,60,80,479,505,984,2112
90,-20,130,470,514,984,2208
-100,-50,110,471,513,984,2187
-120,70,110,472,512,984,2079
100,40,50,461,523,984,2150
-100,-20,120,484,500,984,2042
-70,-30,-60,484,500,984,1994
130,-20,-40,484,501,985,1944
-50,-10,-150,474,511,985,2305
-180,70,170,479,506,985,2221
60,-40,-170,485,500,985,1999
50,70,120,485,500,985,2050
180,70,170,479,506,985,2221
100,60,70,471,514,985,2128
140,40,30,476,509,985,2149
-100,10,90,483,502,985,2109
20,70,150,479,506,985,2101
-110,20,140,490,495,985,1982
-160,70,150,470,515,985,2049
40,-40,-170,496,489,985,2138
-60,-30,160,459,526,985,2132
-80,-10,-170,474,512,986,2078
-50,0,-140,473,513,986,2207
60,-50,-150,485,501,986,2101
-30,-20,-170,483,503,986,2144
0,80,-180,473,513,986,2106
80,20,50,488,498,986,1992
0,80,180,473,513,986,2106
0,30,-170,474,512,986,2205
10,-60,-170,476,510,986,2050
-140,-40,60,476,510,986,2138
-170,30,20,485,501,986,2168
-170,30,10,485,502,987,2167
-150,-30,50,471,516,987,2144
-70,-60,-70,496,491,987,2043
-150,-40,50,483,504,987,2162
-90,40,-70,486,501,987,2079
80,-20,140,486,501,987,2187
-70,70,-90,483,504,987,2125
130,90,50,483,505,988,2083
0,90,180,483,505,988,2083
140,90,40,483,505,988,2083
110,90,70,483,505,988,2083
20,90,160,483,505,988,2083
-10,-60,-180,474,514,988,2202
80,90,100,483,505,988,2083
-110,90,-70,483,505,988,2083
-90,90,-90,483,505,988,2083
-30,90,-150,483,505,988,2083
-100,90,-80,483,505,988,2083
120,90,60,483,505,988,2083
-140,90,-40,483,505,988,2083
-60,90,-120,483,505,988,2083
170,90,10,483,505,988,2083
-130,90,-50,483,505,988,2083
-20,90,-160,483,505,988,2083
10,90,170,483,505,988,2083
150,90,30,483,505,988,2083
30,90,150,483,505,988,2083
90,80,80,483,505,988,2203
-50,90,-130,483,505,988,2083
50,90,130,483,505,988,2083
70,90,110,483,505,988,2083
-160,90,-20,483,505,988,2083
-80,90,-100,483,505,988,2083
-120,90,-60,483,505,988,2083
60,90,120,483,505,988,2083
-110,-50,100,468,520,988,2102
100,90,80,483,505,988,2083
140,-30,140,479,509,988,2175
-130,-80,60,482,506,988,2039
-10,90,-170,483,505,988,2083
30,10,140,482,506,988,1988
-180,90,0,483,505,988,2083
40,90,140,483,505,988,2083
-150,90,-30,483,505,988,2083
180,90,0,483,505,988,2083
160,60,-170,495,493,988,2130
90,90,90,483,505,988,2083
-40,90,-140,483,505,988,2083
0,90,-180,483,505,988,2083
-170,90,-10,483,505,988,2083
160,90,20,483,505,988,2083
130,70,-140,480,508,988,2088
-70,90,-110,483,505,988,2083
-10,-60,180,474,514,988,2202
10,20,160,492,497,989,2056
-100,10,80,478,511,989,2035
-170,-40,170,485,504,989,2067
50,60,120,478,511,989,2174
-30,30,-10,491,498,989,2059
-90,0,-40,480,509,989,2055
-50,80,-120,488,501,989,2126
170,-80,-10,497,492,989,2113
0,0,-170,487,502,989,2075
130,50,40,481,508,989,2110
10,-70,0,485,505,990,2089
-140,-10,-180,473,517,990,1942
-60,-10,-150,464,526,990,2352
-50,20,-140,484,506,990,2106
20,10,-40,465,525,990,2104
120,30,0,477,513,990,2001
170,80,10,487,503,990,2084
-140,-10,180,473,517,990,1942
-70,60,-90,504,486,990,2155
130,30,10,471,519,990,2126
110,80,-120,471,519,990,2118
-50,30,-140,487,503,990,2141
160,60,20,492,499,991,2168
0,70,-180,492,499,991,2195
-120,-10,-150,493,498,991,2135
70,-10,40,472,519,991,1988
160,20,20,473,518,991,2153
-160,-30,40,480,511,991,2057
-100,20,120,492,499,991,2079
150,70,-160,497,494,991,2188
-160,-10,50,467,524,991,2208
170,40,20,486,505,991,2134
120,10,-150,482,509,991,2124
-140,-20,70,476,515,991,2175
100,-10,-130,479,512,991,2155
0,70,180,492,499,991,2195
-80,0,-140,478,514,992,2144
120,60,-130,481,511,992,2042
110,50,50,463,529,992,2130
-170,40,170,486,506,992,2256
-40,50,10,487,505,992,2103
130,10,-160,500,492,992,2057
20,0,170,493,499,992,2228
-160,-40,40,481,511,992,2178
-180,-70,0,488,504,992,2084
-130,-30,80,473,519,992,2241
180,-70,0,488,504,992,2084
60,80,110,499,494,993,2150
-140,70,-20,489,504,993,2047
-100,40,-40,487,506,993,2140
-70,30,-110,495,498,993,2178
150,0,180,483,511,994,2215
20,-50,-170,490,504,994,2165
-70,-10,-160,471,523,994,2192
-20,60,-150,478,516,994,2086
-140,-70,-150,493,501,994,2067
-40,30,0,486,508,994,2111
60,70,110,492,502,994,2090
150,0,-180,483,511,994,2215
20,20,150,480,514,994,2179
-160,0,30,481,513,994,2231
-40,-60,160,481,514,995,2156
160,70,-170,487,508,995,2272
-140,-70,50,486,509,995,2023
180,30,20,495,500,995,2159
-180,30,20,495,500,995,2159
180,40,10,492,503,995,2117
-30,-80,160,482,513,995,2224
30,-20,-20,481,514,995,2170
80,80,90,490,505,995,2158
150,-20,160,470,525,995,2127
-180,40,10,492,503,995,2117
110,60,60,481,514,995,2090
120,-10,-170,500,496,996,2117
70,-50,-140,488,508,996,2136
0,-80,-10,478,518,996,1980
50,80,120,501,495,996,2166
-110,-10,-120,498,498,996,2134
10,10,170,495,502,997,2242
-90,-10,-60,491,506,997,2000
70,0,110,480,517,997,2177
140,-70,-50,491,506,997,2139
-170,30,170,488,509,997,2136
-90,-50,120,488,509,997,2200
-50,40,-130,504,493,997,2134
100,80,70,484,513,997,2224
40,80,130,493,504,997,2175
-40,-20,-170,481,517,998,2136
170,20,20,469,529,998,2224
90,-40,-130,483,515,998,2095
180,20,20,480,518,998,2142
-90,20,-50,494,504,998,2114
10,-70,-170,490,508,998,2129
-180,20,20,480,518,998,2142
150,-40,140,466,532,998,2161
150,60,-160,492,506,998,2125
-140,-60,60,481,517,998,2036
180,-20,20,490,508,998,2107
-10,40,-160,482,516,998,2224
-180,-20,20,490,508,998,2107
-170,20,10,491,507,998,2178
140,70,-150,485,513,998,2087
-20,-70,170,485,513,998,2234
-50,50,-120,498,501,999,2246
100,20,-120,478,521,999,2137
0,50,180,481,518,999,2208
90,30,30,495,504,999,1966
80,-70,-120,493,506,999,2159
100,30,-120,483,516,999,2199
-30,-40,-40,503,496,999,1992
110,-30,120,481,518,999,2067
150,-60,-40,490,509,999,2204
0,50,-180,481,518,999,2208
-160,0,40,480,520,1000,2176
-130,-30,70,484,516,1000,2235
-130,50,-10,477,523,1000,2103
-110,-30,-110,512,488,1000,2104
-160,40,10,487,513,1000,2186
-10,-60,-20,491,510,1001,2060
40,-30,-180,497,504,1001,2220
-170,70,160,470,531,1001,2142
-160,20,20,484,517,1001,2154
40,-30,180,497,504,1001,2220
90,50,70,480,522,1002,2169
-60,0,-140,483,519,1002,2366
40,50,-60,479,523,1002,2014
-150,50,0,488,514,1002,2121
20,-40,-170,485,517,1002,2160
-60,20,-120,483,519,1002,2215
160,50,-170,500,502,1002,2065
-100,-40,120,462,540,1002,2174
-140,0,60,488,514,1002,2220
-180,30,10,486,517,1003,2220
70,70,100,491,512,1003,2117
150,-10,-20,500,503,1003,2120
-170,20,20,487,516,1003,2139
180,30,10,486,517,1003,2220
-80,-20,170,487,516,1003,2191
-100,40,100,498,505,1003,2053
-170,10,20,486,517,1003,2133
140,10,-10,477,526,1003,2079
-70,20,-100,482,521,1003,2234
0,60,-180,499,505,1004,2244
170,-10,0,491,513,1004,2137
-110,70,100,481,523,1004,2154
70,-80,-120,501,503,1004,2011
-110,50,-30,485,519,1004,2182
120,-10,-40,487,517,1004,1982
0,60,180,499,505,1004,2244
160,10,10,483,522,1005,2167
-70,50,50,503,502,1005,2218
-40,-10,-160,485,520,1005,2178
-100,0,-110,509,496,1005,2191
-150,0,40,494,511,1005,2170
100,-70,-100,492,513,1005,2119
-150,-20,180,488,517,1005,2059
140,60,-150,501,504,1005,2210
70,80,100,500,505,1005,2182
-150,-20,-180,488,517,1005,2059
-60,40,-120,504,501,1005,2203
-140,20,20,485,520,1005,2075
120,80,-130,478,528,1006,2115
-80,70,-80,493,513,1006,2210
90,-30,80,471,535,1006,2226
-60,-40,150,480,526,1006,2202
-150,40,10,499,508,1007,2182
30,80,140,498,509,1007,2206
170,20,180,461,546,1007,2118
170,20,-180,461,546,1007,2118
60,60,110,478,529,1007,2179
-80,10,40,515,492,1007,2042
-90,0,-170,501,506,1007,2142
-130,10,40,511,496,1007,2209
-160,-20,170,473,534,1007,2262
160,-50,-30,496,512,1008,2133
150,80,-160,490,518,1008,2190
30,-70,-160,488,520,1008,2149
-100,10,140,492,516,1008,2102
-140,80,-30,505,503,1008,2121
170,70,180,493,516,1009,2256
-80,-30,150,476,533,1009,2169
20,0,180,493,516,1009,2295
170,70,-180,493,516,1009,2256
-120,-80,70,495,514,1009,2089
-90,-20,-70,501,508,1009,2057
70,20,90,500,509,1009,2130
170,30,20,472,537,1009,2202
20,0,-180,493,516,1009,2295
-20,-10,-170,510,499,1009,2146
-80,-60,-80,509,500,1009,2060
100,80,-110,487,522,1009,2118
150,10,-10,485,524,1009,2154
-150,-80,-160,497,512,1009,2042
-40,50,-130,491,518,1009,2235
100,70,-110,487,523,1010,2094
160,10,0,488,522,1010,2118
0,10,-170,501,509,1010,2208
-70,10,-110,493,517,1010,2242
80,20,40,505,505,1010,2066
10,70,160,489,521,1010,2183
-30,70,-140,488,522,1010,2198
-80,30,-80,498,512,1010,2173
-120,50,120,495,516,1011,2179
-60,-20,180,490,521,1011,2156
-60,-20,-180,490,521,1011,2156
-140,50,140,494,517,1011,2287
20,-80,-160,490,521,1011,2087
110,-20,160,490,521,1011,2217
100,0,-30,501,510,1011,2265
-180,10,20,497,514,1011,2225
180,10,20,497,514,1011,2225
140,-20,160,491,520,1011,2107
-120,20,150,496,515,1011,2092
70,60,100,484,528,1012,2133
-50,-10,-160,478,534,1012,2247
160,-30,-20,495,517,1012,2081
-110,-80,80,501,511,1012,2126
-130,40,0,484,528,1012,2154
-150,-10,60,487,525,1012,2141
160,0,-10,501,511,1012,2131
-130,70,-30,499,514,1013,2084
-10,30,-160,488,525,1013,2213
70,-70,-130,497,516,1013,2167
10,10,-180,494,519,1013,2295
160,-30,150,472,541,1013,2221
170,-30,-10,502,511,1013,2010
-90,30,-60,497,516,1013,2152
10,10,180,494,519,1013,2295
80,60,90,489,524,1013,2139
-120,0,-170,495,518,1013,2163
-10,80,-170,496,517,1013,2169
100,10,-10,498,515,1013,2131
100,40,30,490,524,1014,2122
170,0,0,494,520,1014,2216
-170,-10,30,491,523,1014,2065
-130,-70,60,492,522,1014,2137
50,-10,-20,500,515,1015,2230
-150,0,50,490,525,1015,2199
80,-80,-110,498,517,1015,2045
160,-60,-30,500,515,1015,2170
-110,0,90,501,514,1015,2151
-110,-20,-110,518,498,1016,2163
-60,50,-110,502,514,1016,2218
-20,50,-150,496,520,1016,2215
120,80,50,489,527,1016,2247
-60,-60,-60,494,522,1016,2093
100,-20,180,490,526,1016,2288
100,-20,-180,490,526,1016,2288
-70,50,-100,505,511,1016,2219
-80,60,-70,482,534,1016,2215
-100,0,110,513,503,1016,2190
170,-50,-20,510,506,1016,2110
60,0,-40,481,536,1017,2047
50,-20,140,483,534,1017,2234
-120,10,30,506,511,1017,2204
80,-50,-130,491,526,1017,2310
-130,50,130,491,526,1017,2197
-100,0,120,503,514,1017,2151
-160,-20,40,497,520,1017,2226
160,0,170,496,521,1017,2188
-60,0,-20,515,502,1017,2094
110,60,-120,492,525,1017,2139
180,0,20,483,535,1018,2214
-130,-20,80,490,528,1018,2158
-40,-80,150,494,524,1018,2261
-80,20,60,525,493,1018,2208
-70,10,-120,485,533,1018,2273
-70,40,-110,502,516,1018,2238
-180,0,20,483,535,1018,2214
-90,-30,140,481,538,1019,2308
-40,-40,170,501,518,1019,2196
-180,-80,0,513,506,1019,2214
-130,-50,-140,494,525,1019,2134
-10,-50,-180,494,525,1019,2275
-150,-50,50,487,532,1019,2195
-30,-40,-180,493,526,1019,2207
0,40,-180,500,519,1019,2309
180,-80,0,513,506,1019,2214
-90,50,-70,516,503,1019,2298
0,40,180,500,519,1019,2309
-110,0,-150,516,503,1019,2075
180,80,0,506,513,1019,2209
-10,-50,180,494,525,1019,2275
-180,80,0,506,513,1019,2209
100,20,0,497,522,1019,2019
-70,-40,150,477,542,1019,2139
-30,-40,180,493,526,1019,2207
110,80,60,488,532,1020,2258
-70,0,-140,491,529,1020,2331
-60,60,40,507,513,1020,2201
-20,40,-150,501,519,1020,2224
-60,30,-130,506,514,1020,2194
10,-80,-170,496,524,1020,2152
10,10,160,496,524,1020,2178
-60,80,-110,496,524,1020,2172
130,80,-140,488,532,1020,2140
20,0,160,501,519,1020,2161
-80,10,-100,509,511,1020,2298
150,20,10,501,519,1020,2173
-70,-90,-80,503,518,1021,2010
-110,-90,-120,503,518,1021,2010
50,-90,40,503,518,1021,2010
110,-90,100,503,518,1021,2010
-120,-90,-130,503,518,1021,2010
20,-90,10,503,518,1021,2010
-150,-90,-160,503,518,1021,2010
170,-90,160,503,518,1021,2010
-180,-90,170,503,518,1021,2010
150,-90,140,503,518,1021,2010
-160,-90,-170,503,518,1021,2010
160,-90,150,503,518,1021,2010
100,-90,90,503,518,1021,2010
60,-90,50,503,518,1021,2010
-170,-90,-180,503,518,1021,2010
-20,-90,-30,503,518,1021,2010
-140,-90,-150,503,518,1021,2010
-90,50,-60,495,526,1021,2344
80,-90,70,503,518,1021,2010
-30,-90,-40,503,518,1021,2010
-90,-90,-100,503,518,1021,2010
-170,-90,180,503,518,1021,2010
-130,-90,-140,503,518,1021,2010
120,-90,110,503,518,1021,2010
70,-90,60,503,518,1021,2010
-40,-90,-50,503,518,1021,2010
-80,-90,-90,503,518,1021,2010
-60,10,-130,487,534,1021,2295
-170,60,0,503,518,1021,2125
90,-90,80,503,518,1021,2010
0,-90,-10,503,518,1021,2010
-60,-90,-70,503,518,1021,2010
180,-90,170,503,518,1021,2010
-50,-80,140,491,530,1021,2231
30,-90,20,503,518,1021,2010
-100,-90,-110,503,518,1021,2010
-10,-90,-20,503,518,1021,2010
10,-90,0,503,518,1021,2010
-50,-90,-60,503,518,1021,2010
130,-90,120,503,518,1021,2010
40,-90,30,503,518,1021,2010
140,-90,130,503,518,1021,2010
-120,-40,90,487,534,1021,2261
-50,-30,170,496,526,1022,2138
-90,20,90,512,510,1022,2237
-80,-40,140,491,531,1022,2228
140,80,-150,492,530,1022,2185
-170,-30,30,500,522,1022,2157
-160,-10,40,486,536,1022,2265
-90,0,-30,527,495,1022,2108
180,-10,20,502,521,1023,2152
-20,0,-30,491,532,1023,2224
80,-10,80,492,531,1023,2071
70,40,90,496,527,1023,2107
100,-20,-170,508,515,1023,2218
40,-60,-160,497,526,1023,2284
-180,-10,20,502,521,1023,2152
-130,80,-40,514,509,1023,2164
100,-40,90,483,540,1023,2103
-90,40,-60,512,512,1024,2161
160,80,-170,499,525,1024,2263
170,60,10,494,530,1024,2174
40,-30,170,516,508,1024,2126
-40,-20,-40,508,516,1024,2094
120,-30,130,504,520,1024,2208
30,-10,150,503,522,1025,2112
30,-40,-170,491,534,1025,2259
-10,-10,-170,505,520,1025,2200
80,70,90,493,532,1025,2163
-90,0,-10,521,504,1025,2195
10,-80,0,498,528,1026,2022
100,10,-120,483,543,1026,2292
-120,70,-40,511,515,1026,2183
50,-30,160,514,512,1026,2293
50,-40,180,517,509,1026,2113
120,60,50,498,528,1026,2209
-100,-80,90,509,517,1026,2131
50,-40,-180,517,509,1026,2113
-50,-50,-50,501,525,1026,2076
150,50,-160,515,511,1026,2127
110,-70,-90,490,536,1026,2185
90,70,-100,503,523,1026,2142
100,-20,120,489,537,1026,2312
20,-10,-30,497,529,1026,2254
-50,-40,-50,513,514,1027,2176
-80,-50,130,487,540,1027,2160
-110,10,170,506,521,1027,2206
-50,-60,150,485,542,1027,2231
-30,-10,-170,515,512,1027,2251
20,80,150,503,524,1027,2217
100,-20,-140,500,527,1027,2204
80,-10,70,479,548,1027,2200
-50,60,30,506,521,1027,2242
20,-10,180,500,528,1028,2389
-150,30,160,478,550,1028,2337
80,50,80,505,523,1028,2188
20,-10,-180,500,528,1028,2389
-70,10,20,528,500,1028,2150
-150,-40,-170,503,525,1028,2085
-120,-40,80,491,537,1028,2285
-20,-40,180,494,534,1028,2279
-20,-40,-180,494,534,1028,2279
-10,50,-20,506,522,1028,2196
-60,20,20,516,513,1029,2179
-140,10,30,487,542,1029,2152
-120,80,-50,509,520,1029,2193
150,-70,-40,505,524,1029,2207
160,30,20,478,551,1029,2333
130,80,40,494,535,1029,2254
50,-50,-160,510,519,1029,2239
-110,50,110,505,524,1029,2284
-150,20,20,497,532,1029,2051
110,-10,-160,505,524,1029,2268
-50,-40,160,503,527,1030,2161
-90,10,-70,491,539,1030,2244
-130,-40,70,487,543,1030,2181
150,-50,-40,506,525,1031,2164
-70,-80,120,496,535,1031,2214
-80,40,-90,515,516,1031,2192
-80,50,-90,512,519,1031,2168
0,20,-170,487,544,1031,2225
-80,0,-10,528,503,1031,2171
170,-40,-20,515,516,1031,2067
-60,-80,130,497,534,1031,2232
130,-30,-50,503,529,1032,2161
170,0,10,500,532,1032,2270
-30,30,-150,518,514,1032,2204
-30,-50,170,521,511,1032,2297
-80,-10,-40,525,507,1032,2132
-100,10,-20,515,517,1032,2183
90,70,80,489,543,1032,2176
-30,50,0,499,533,1032,2270
-70,-20,-180,488,544,1032,2391
-70,-20,180,488,544,1032,2391
-130,0,-180,495,538,1033,2221
-130,0,180,495,538,1033,2221
160,40,-170,502,531,1033,2192
130,40,30,502,531,1033,2286
30,60,-50,482,551,1033,2159
150,-40,-30,507,527,1034,2154
90,80,-100,501,533,1034,2160
-150,60,-10,508,526,1034,2196
90,-80,-100,505,529,1034,2099
110,20,-130,483,551,1034,2256
-80,-20,-60,502,532,1034,2196
20,-60,-170,512,522,1034,2222
50,-40,30,479,555,1034,2156
100,70,70,491,543,1034,2175
-40,40,-140,524,510,1034,2191
-90,70,-70,500,534,1034,2299
-90,-60,-90,522,513,1035,2030
110,-20,170,521,514,1035,2391
-100,20,-30,515,521,1036,2152
-100,10,160,522,514,1036,2231
-100,10,150,513,523,1036,2211
130,-50,-60,514,522,1036,2219
-140,-60,-150,505,531,1036,2114
-90,-80,100,509,527,1036,2157
70,0,0,510,526,1036,2124
20,-80,10,506,531,1037,2046
30,-20,180,486,551,1037,2394
30,-20,-180,486,551,1037,2394
140,50,-150,520,517,1037,2216
-60,-10,-160,492,545,1037,2329
-140,-20,60,497,540,1037,2341
70,30,90,491,547,1038,2112
170,80,180,503,535,1038,2305
-170,-60,10,504,534,1038,2213
-110,-10,-110,514,524,1038,2179
-70,-30,160,496,542,1038,2240
-80,-80,110,503,535,1038,2220
170,80,-180,503,535,1038,2305
150,30,20,491,547,1038,2234
-170,-70,10,505,533,1038,2244
0,-20,-30,486,552,1038,2189
-20,20,-160,520,518,1038,2231
120,-40,-70,508,530,1038,2195
-80,20,-80,500,539,1039,2352
0,-60,-10,510,529,1039,2193
80,-20,130,506,533,1039,2274
130,40,20,511,528,1039,2218
100,0,-120,488,551,1039,2301
-140,-50,60,493,546,1039,2259
-120,50,-20,491,548,1039,2192
120,70,50,504,536,1040,2292
-90,30,-70,505,535,1040,2110
-90,-40,130,473,567,1040,2316
-100,70,-60,497,543,1040,2341
80,-40,-150,500,540,1040,2053
-90,30,90,525,515,1040,2176
-40,0,-160,513,527,1040,2211
40,40,-60,488,553,1041,2128
-120,60,-30,502,539,1041,2326
-20,50,-10,514,527,1041,2320
110,70,60,500,541,1041,2226
-90,-20,140,498,543,1041,2262
-90,0,170,517,524,1041,2302
-110,80,-60,514,527,1041,2220
-40,60,20,496,545,1041,2167
-30,60,-140,503,538,1041,2173
-40,70,-130,502,539,1041,2246
100,-30,-110,498,544,1042,2156
-90,80,-80,508,534,1042,2247
-60,20,-130,507,535,1042,2284
-160,70,-10,517,525,1042,2234
150,-10,170,509,533,1042,2298
100,60,60,504,538,1042,2183
140,20,0,495,547,1042,2238
-160,30,10,512,530,1042,2254
-160,-80,-170,509,533,1042,2116
-160,50,0,509,533,1042,2250
140,80,30,503,540,1043,2289
70,-20,140,510,533,1043,2201
-170,80,160,502,541,1043,2399
-100,0,-100,523,520,1043,2281
100,60,-110,506,537,1043,2182
-140,50,-10,512,532,1044,2168
60,-20,140,496,548,1044,2209
160,50,20,510,534,1044,2268
-30,20,-160,516,528,1044,2296
-30,50,-140,519,525,1044,2346
-100,70,90,504,540,1044,2380
-150,50,150,507,537,1044,2321
160,40,20,502,542,1044,2313
-110,-10,100,506,538,1044,2279
-100,-10,120,514,530,1044,2230
130,60,40,509,536,1045,2358
160,-70,-30,513,532,1045,2230
10,80,160,515,530,1045,2279
-70,80,-100,504,541,1045,2220
-40,30,-150,508,537,1045,2309
-20,-50,-30,510,535,1045,2131
-150,40,0,505,540,1045,2190
180,20,10,502,544,1046,2307
-180,-20,10,503,543,1046,2287
60,-40,-180,505,541,1046,2261
-120,10,170,516,530,1046,2235
100,-80,-90,505,541,1046,2138
60,-40,180,505,541,1046,2261
110,-60,-90,498,548,1046,2208
180,70,0,513,533,1046,2286
180,-20,10,503,543,1046,2287
-10,0,-30,495,551,1046,2179
-60,-60,140,504,542,1046,2306
-180,20,10,502,544,1046,2307
-50,40,20,511,535,1046,2198
-40,-30,180,517,529,1046,2228
-180,70,0,513,533,1046,2286
-170,-20,30,504,542,1046,2179
130,70,40,508,538,1046,2391
-20,80,-160,515,531,1046,2228
-40,-30,-180,517,529,1046,2228
130,0,-20,512,535,1047,2113
60,20,-70,515,532,1047,2305
180,-30,10,494,553,1047,2213
70,10,-70,504,543,1047,2194
20,10,150,511,536,1047,2297
60,-80,-130,522,525,1047,2129
-150,20,160,522,525,1047,2387
-180,-30,10,494,553,1047,2213
20,-70,10,505,543,1048,2118
-80,0,-150,511,538,1049,2393
160,30,-170,518,531,1049,2284
-150,-60,40,504,545,1049,2135
-80,60,-80,535,514,1049,2199
-50,-20,-180,505,544,1049,2361
-10,70,-170,519,530,1049,2322
80,-10,110,502,547,1049,2330
-50,-20,180,505,544,1049,2361
-130,-60,70,500,549,1049,2200
150,80,20,511,538,1049,2324
-90,40,-80,520,530,1050,2253
70,0,-40,511,539,1050,2240
-110,10,10,520,530,1050,2319
-10,10,-30,501,549,1050,2258
150,10,-170,505,545,1050,2307
70,0,20,527,523,1050,2107
90,-30,-160,520,530,1050,2292
-90,60,-60,497,553,1050,2364
120,50,40,502,548,1050,2253
-60,40,-130,519,531,1050,2259
-110,-20,100,508,542,1050,2303
110,-20,180,529,522,1051,2256
100,-10,-60,504,547,1051,2242
30,-20,170,524,527,1051,2318
-170,80,-10,523,528,1051,2316
130,-30,140,527,524,1051,2280
80,80,-90,510,541,1051,2196
120,-70,-80,511,540,1051,2215
-100,80,-70,515,536,1051,2266
110,-20,-180,529,522,1051,2256
-120,-20,90,511,541,1052,2156
-140,40,0,517,535,1052,2342
-60,-20,170,502,550,1052,2266
-90,0,150,524,528,1052,2250
-150,-20,50,509,543,1052,2362
120,50,-130,509,543,1052,2164
-110,70,-50,509,543,1052,2287
-30,-30,-40,507,546,1053,2110
-130,10,30,509,544,1053,2156
-180,80,170,505,548,1053,2349
80,0,-60,519,534,1053,2254
180,80,170,505,548,1053,2349
-20,-60,170,501,552,1053,2299
-10,-40,-180,518,535,1053,2412
-10,-40,180,518,535,1053,2412
-160,-10,30,512,542,1054,2285
30,-20,160,526,528,1054,2424
70,-40,-170,512,542,1054,2132
170,-20,-10,525,529,1054,2185
-30,10,-20,517,537,1054,2264
-90,0,160,521,534,1055,2205
0,30,-180,506,549,1055,2402
-50,-10,-170,510,545,1055,2332
60,-70,-140,519,536,1055,2255
10,-10,-30,498,557,1055,2238
0,30,180,506,549,1055,2402
50,-10,130,514,541,1055,2324
130,60,-140,524,532,1056,2228
140,0,-170,514,542,1056,2258
130,-10,180,525,531,1056,2326
0,40,170,530,526,1056,2319
130,-10,-180,525,531,1056,2326
-170,-80,10,530,526,1056,2298
-140,0,40,512,544,1056,2218
30,-40,10,497,559,1056,2037
-90,-40,-80,513,543,1056,2187
140,70,30,504,553,1057,2386
80,0,-20,512,545,1057,2340
80,-20,70,487,570,1057,2300
160,20,-170,509,548,1057,2293
-80,80,-90,511,546,1057,2262
-140,-10,60,505,552,1057,2359
180,10,170,524,534,1058,2433
70,50,90,520,538,1058,2231
-170,20,170,517,541,1058,2456
-80,20,-90,500,558,1058,2354
0,70,170,524,534,1058,2273
-150,-10,50,501,557,1058,2443
-180,10,170,524,534,1058,2433
150,20,0,519,539,1058,2260
100,-20,-100,508,550,1058,2249
-100,0,40,519,539,1058,2293
-90,20,-60,530,529,1059,2333
-90,60,80,504,555,1059,2332
-70,30,-120,519,540,1059,2336
-170,10,10,515,544,1059,2264
-50,70,-120,524,536,1060,2307
90,-40,80,491,569,1060,2108
20,-20,180,520,540,1060,2386
0,-60,180,511,549,1060,2306
0,-60,-180,511,549,1060,2306
140,50,30,505,555,1060,2364
40,0,130,517,543,1060,2410
-140,0,50,521,539,1060,2367
20,-20,-180,520,540,1060,2386
110,-80,-80,516,545,1061,2164
60,10,-60,510,551,1061,2270
110,30,0,534,527,1061,1974
-110,-50,-110,515,546,1061,2176
70,-20,50,489,572,1061,2188
120,-50,110,503,558,1061,2264
110,50,-120,514,547,1061,2177
-90,50,-80,514,548,1062,2228
80,70,-90,520,542,1062,2135
-110,-40,100,505,557,1062,2302
90,40,50,524,538,1062,2259
-100,30,110,530,532,1062,2238
10,0,170,517,545,1062,2393
-100,10,170,540,522,1062,2225
-40,-50,160,513,549,1062,2282
0,-10,-30,502,560,1062,2345
-100,40,-60,527,535,1062,2339
90,20,10,516,546,1062,1953
-100,30,-40,520,542,1062,2355
-90,10,70,520,542,1062,2202
120,-80,-70,519,543,1062,2186
50,-80,-140,524,539,1063,2191
70,80,-80,511,552,1063,2219
-80,10,50,532,531,1063,2251
100,-10,-120,511,552,1063,2171
100,-30,100,504,559,1063,2257
-150,-70,-160,512,551,1063,2154
70,90,-80,507,557,1064,2313
180,90,170,507,557,1064,2313
0,-40,-20,524,540,1064,2143
-140,90,130,507,557,1064,2313
-120,90,110,507,557,1064,2313
-130,90,120,507,557,1064,2313
140,90,-150,507,557,1064,2313
-10,90,0,507,557,1064,2313
150,90,-160,507,557,1064,2313
-150,90,140,507,557,1064,2313
0,-70,180,515,549,1064,2315
0,-70,-180,515,549,1064,2315
0,90,-10,507,557,1064,2313
20,90,-30,507,557,1064,2313
90,0,-90,507,557,1064,2141
160,90,-170,507,557,1064,2313
-180,10,10,510,554,1064,2452
170,90,180,507,557,1064,2313
-80,90,70,507,557,1064,2313
-160,90,150,507,557,1064,2313
-60,90,50,507,557,1064,2313
50,90,-60,507,557,1064,2313
-40,90,30,507,557,1064,2313
130,90,-140,507,557,1064,2313
180,10,10,510,554,1064,2452
90,90,-100,507,557,1064,2313
-180,90,170,507,557,1064,2313
-30,-70,160,516,548,1064,2304
110,90,-120,507,557,1064,2313
30,90,-40,507,557,1064,2313
-70,90,60,507,557,1064,2313
80,-10,90,514,550,1064,2137
-30,90,20,507,557,1064,2313
60,90,-70,507,557,1064,2313
100,90,-110,507,557,1064,2313
-110,90,100,507,557,1064,2313
-90,90,80,507,557,1064,2313
120,90,-130,507,557,1064,2313
-50,90,40,507,557,1064,2313
-170,90,160,507,557,1064,2313
100,-20,-130,501,563,1064,2232
170,90,-180,507,557,1064,2313
10,90,-20,507,557,1064,2313
40,90,-50,507,557,1064,2313
-160,20,10,509,555,1064,2296
80,90,-90,507,557,1064,2313
-100,90,90,507,557,1064,2313
-20,90,10,507,557,1064,2313
-160,-50,30,508,557,1065,2160
20,-10,170,527,538,1065,2337
180,-40,0,523,542,1065,2181
110,50,30,516,549,1065,2248
160,10,-10,519,546,1065,2158
-180,-40,0,523,542,1065,2181
-110,-40,-110,532,534,1066,2226
-120,-90,60,519,547,1066,2299
50,-90,-130,519,547,1066,2299
-110,-90,70,519,547,1066,2299
-90,0,-180,535,531,1066,2339
20,-90,-160,519,547,1066,2299
-160,80,150,518,548,1066,2444
60,-90,-120,519,547,1066,2299
-150,-90,30,519,547,1066,2299
-140,-90,40,519,547,1066,2299
0,-90,-180,519,547,1066,2299
130,-90,-50,519,547,1066,2299
40,-90,-140,519,547,1066,2299
-70,-90,110,519,547,1066,2299
140,-90,-40,519,547,1066,2299
80,-90,-100,519,547,1066,2299
170,0,170,536,530,1066,2345
90,0,-30,524,542,1066,2402
-90,0,180,535,531,1066,2339
180,-90,0,519,547,1066,2299
-160,-90,20,519,547,1066,2299
10,-90,-170,519,547,1066,2299
-30,-90,150,519,547,1066,2299
90,-90,-90,519,547,1066,2299
-100,0,100,535,531,1066,2326
0,-90,180,519,547,1066,2299
-180,-90,0,519,547,1066,2299
-10,-90,170,519,547,1066,2299
160,-90,-20,519,547,1066,2299
-100,-90,80,519,547,1066,2299
-20,-90,160,519,547,1066,2299
-60,-90,120,519,547,1066,2299
70,-90,-110,519,547,1066,2299
30,-90,-150,519,547,1066,2299
40,-40,20,507,559,1066,2142
170,-90,-10,519,547,1066,2299
120,-90,-60,519,547,1066,2299
150,-90,-30,519,547,1066,2299
-170,-90,10,519,547,1066,2299
110,-90,-70,519,547,1066,2299
-90,-90,90,519,547,1066,2299
100,-90,-80,519,547,1066,2299
-40,-90,140,519,547,1066,2299
-80,-90,100,519,547,1066,2299
-130,-90,50,519,547,1066,2299
-50,-90,130,519,547,1066,2299
-130,40,140,525,542,1067,2318
0,60,170,535,532,1067,2272
90,-20,100,521,546,1067,2300
-70,40,50,544,523,1067,2347
-160,10,20,520,547,1067,2288
-120,10,20,535,532,1067,2369
-70,20,40,550,518,1068,2172
40,-30,160,533,535,1068,2397
-70,40,-120,533,535,1068,2332
-80,-20,160,510,559,1069,2304
120,20,-140,511,558,1069,2311
40,-10,130,524,545,1069,2242
100,50,50,515,554,1069,2346
-80,30,-90,512,557,1069,2313
90,-50,-120,523,546,1069,2355
30,30,-50,519,551,1070,2380
170,10,10,510,560,1070,2428
-120,-70,70,521,549,1070,2240
100,-20,-150,529,541,1070,2315
120,-20,170,537,533,1070,2378
-50,-60,-50,529,541,1070,2232
160,80,10,522,548,1070,2394
130,50,-140,533,537,1070,2320
-100,20,130,529,542,1071,2193
-150,30,10,520,551,1071,2286
-150,0,170,516,555,1071,2297
130,20,-150,522,549,1071,2259
90,60,70,514,557,1071,2238
-80,10,-120,520,551,1071,2382
70,10,90,533,538,1071,2361
-170,0,20,515,556,1071,2247
170,-60,-20,533,539,1072,2248
120,40,10,516,556,1072,2246
-120,40,130,512,560,1072,2297
-120,-30,90,508,564,1072,2348
-50,-50,150,509,563,1072,2400
110,-20,-70,524,549,1073,2146
140,-30,-40,525,548,1073,2242
0,-80,180,518,555,1073,2269
30,0,140,532,541,1073,2163
-60,30,30,545,528,1073,2234
-80,-10,180,517,556,1073,2382
140,-50,-50,524,549,1073,2261
-90,-30,130,504,569,1073,2384
110,60,50,513,560,1073,2269
10,0,180,516,557,1073,2464
130,-50,120,502,571,1073,2290
40,-20,0,524,549,1073,2261
0,-80,-180,518,555,1073,2269
-100,10,-130,528,545,1073,2380
-80,-10,-180,517,556,1073,2382
80,60,80,517,556,1073,2247
10,0,-180,516,557,1073,2464
-110,30,-20,523,551,1074,2409
-70,-10,-170,520,554,1074,2453
-10,0,-170,529,545,1074,2325
-100,40,-70,526,548,1074,2275
0,0,-30,499,575,1074,2308
-80,40,70,537,537,1074,2309
-150,10,20,527,547,1074,2278
-110,30,130,533,541,1074,2206
-100,0,30,527,548,1075,2406
-110,-40,90,520,555,1075,2398
170,-20,160,508,567,1075,2368
-140,30,10,518,557,1075,2360
150,-80,140,511,564,1075,2193
-70,-20,-50,539,536,1075,2308
60,80,-70,516,559,1075,2257
160,-20,160,505,570,1075,2269
-90,0,0,542,533,1075,2316
60,-40,40,487,588,1075,2304
-60,-10,-170,505,571,1076,2394
-40,-10,-170,531,545,1076,2331
130,30,0,518,558,1076,2285
-110,60,-40,510,566,1076,2426
80,10,10,523,553,1076,2218
-120,0,70,508,568,1076,2274
30,-80,20,522,554,1076,2113
-70,-20,170,512,564,1076,2370
140,20,-160,544,532,1076,2352
-30,-30,180,525,552,1077,2351
-80,30,-100,526,551,1077,2256
-30,-30,-180,525,552,1077,2351
-110,20,-10,536,541,1077,2333
-80,10,-110,533,544,1077,2346
-90,0,30,535,543,1078,2437
-90,0,10,552,526,1078,2301
-100,60,-50,506,572,1078,2497
-170,-80,-180,506,572,1078,2178
180,0,10,514,564,1078,2381
-170,-80,180,506,572,1078,2178
-180,0,10,514,564,1078,2381
-90,-10,140,522,556,1078,2245
140,-80,130,507,571,1078,2183
70,-10,120,513,565,1078,2414
0,50,170,543,536,1079,2322
-90,60,-70,545,534,1079,2279
-130,-10,70,519,560,1079,2234
20,-70,-170,524,555,1079,2332
-100,-60,-100,532,547,1079,2067
-100,50,100,538,541,1079,2399
170,50,10,520,559,1079,2335
140,30,10,522,557,1079,2421
-150,80,140,522,557,1079,2473
-140,80,130,524,555,1079,2474
-150,-40,40,518,562,1080,2272
110,-10,-50,518,562,1080,2140
-180,-80,170,503,577,1080,2184
130,-80,-60,527,553,1080,2252
180,-80,170,503,577,1080,2184
-110,0,-130,528,552,1080,2215
-10,60,-170,527,553,1080,2381
100,30,10,546,534,1080,2010
-150,-20,40,522,559,1081,2387
0,30,170,546,535,1081,2347
160,-20,-20,524,557,1081,2246
-150,0,30,541,540,1081,2289
-50,0,-20,528,553,1081,2283
-90,0,50,535,546,1081,2367
-160,50,160,531,550,1081,2375
110,50,40,524,557,1081,2416
-100,-10,-80,534,547,1081,2232
150,70,20,512,569,1081,2358
-100,0,50,538,543,1081,2298
-130,-20,70,521,560,1081,2294
160,-80,150,510,572,1082,2183
180,-30,0,527,555,1082,2249
-120,30,140,523,559,1082,2239
160,-40,150,513,569,1082,2335
-50,0,-150,529,553,1082,2425
-150,-10,40,520,562,1082,2294
40,-80,30,522,560,1082,2175
140,60,30,529,553,1082,2443
-130,-50,70,509,573,1082,2343
-180,-30,0,527,555,1082,2249
180,40,180,535,548,1083,2352
140,-80,-50,532,551,1083,2295
-180,40,180,535,548,1083,2352
180,40,-180,535,548,1083,2352
30,10,-40,526,557,1083,2245
-180,40,-180,535,548,1083,2352
50,80,-60,527,556,1083,2286
-70,-60,130,512,571,1083,2438
90,-20,120,526,557,1083,2410
10,-40,-10,516,568,1084,2295
70,60,90,532,552,1084,2322
140,-10,-180,543,541,1084,2392
-150,70,-20,553,531,1084,2335
-90,40,90,527,557,1084,2268
110,0,-140,512,572,1084,2378
-70,20,-110,528,556,1084,2428
140,-10,180,543,541,1084,2392
170,-80,160,507,577,1084,2228
-80,40,-100,538,546,1084,2337
-160,0,20,525,559,1084,2363
-110,40,-30,521,563,1084,2352
-80,-40,-70,534,550,1084,2252
-170,50,0,534,550,1084,2342
-30,80,-150,534,551,1085,2331
-100,50,-50,527,558,1085,2481
-180,60,0,534,551,1085,2321
120,-80,110,518,567,1085,2181
-170,-40,20,515,570,1085,2257
160,20,10,520,565,1085,2380
-20,0,-170,547,538,1085,2369
130,-70,-70,532,553,1085,2284
180,60,0,534,551,1085,2321
110,-50,100,507,579,1086,2308
-50,-20,170,521,565,1086,2421
-100,10,-180,552,534,1086,2350
50,-70,-150,537,549,1086,2368
160,-40,-30,542,544,1086,2228
-110,-30,100,522,564,1086,2385
100,-20,-110,517,569,1086,2331
60,60,100,531,555,1086,2371
-140,40,150,517,569,1086,2295
-100,10,180,552,534,1086,2350
170,-10,-10,523,564,1087,2276
-70,-30,150,516,571,1087,2352
-140,-40,50,519,568,1087,2328
20,-30,-10,516,571,1087,2186
160,70,10,522,565,1087,2421
-170,-30,170,529,558,1087,2355
80,-40,-160,526,561,1087,2218
50,-10,-10,525,562,1087,2357
-40,60,-130,522,565,1087,2357
130,-20,170,538,549,1087,2340
-70,10,-130,517,571,1088,2434
-110,0,-140,547,541,1088,2387
40,-80,-150,532,556,1088,2292
-40,-70,150,526,562,1088,2367
0,80,170,539,549,1088,2312
100,-20,-160,530,558,1088,2365
20,-10,160,531,557,1088,2419
-90,0,20,551,537,1088,2424
-50,-20,-40,541,548,1089,2299
130,40,10,538,551,1089,2346
-40,10,-160,532,557,1089,2349
-130,80,120,533,556,1089,2518
70,70,-80,517,572,1089,2156
60,-20,30,519,571,1090,2270
70,20,-80,508,582,1090,2393
-180,-10,10,512,578,1090,2371
-160,-10,170,508,582,1090,2325
-120,-60,80,518,572,1090,2336
30,-30,0,526,564,1090,2305
30,50,-50,528,562,1090,2213
100,50,40,528,562,1090,2351
180,-10,10,512,578,1090,2371
50,20,-60,533,558,1091,2388
-10,50,-170,524,567,1091,2438
130,-80,120,515,576,1091,2194
-70,0,-10,537,554,1091,2183
-110,-20,-100,542,549,1091,2270
110,-30,140,534,557,1091,2524
-100,-40,110,511,581,1092,2414
-70,-40,140,526,566,1092,2250
-160,80,-20,543,549,1092,2408
140,-20,170,526,566,1092,2377
100,-50,90,513,579,1092,2269
50,10,-50,522,571,1093,2292
-170,50,170,535,558,1093,2366
-130,0,60,515,578,1093,2348
-80,-30,140,516,577,1093,2375
-100,-20,110,533,560,1093,2319
-120,-30,80,525,568,1093,2364
110,90,60,536,558,1094,2410
-110,-10,-100,552,542,1094,2300
120,90,50,536,558,1094,2410
-20,90,-170,536,558,1094,2410
-20,70,-160,538,556,1094,2433
90,90,80,536,558,1094,2410
-130,90,-60,536,558,1094,2410
90,60,-100,533,561,1094,2215
-80,90,-110,536,558,1094,2410
-90,90,-100,536,558,1094,2410
140,40,20,510,584,1094,2336
20,90,150,536,558,1094,2410
40,90,130,536,558,1094,2410
-70,90,-120,536,558,1094,2410
150,90,20,536,558,1094,2410
-180,90,-10,536,558,1094,2410
-170,90,-20,536,558,1094,2410
-150,90,-40,536,558,1094,2410
180,90,-10,536,558,1094,2410
50,90,120,536,558,1094,2410
0,90,170,536,558,1094,2410
70,90,100,536,558,1094,2410
100,90,70,536,558,1094,2410
10,90,160,536,558,1094,2410
160,90,10,536,558,1094,2410
170,90,0,536,558,1094,2410
-30,90,-160,536,558,1094,2410
-120,90,-70,536,558,1094,2410
-10,90,-180,536,558,1094,2410
-10,90,180,536,558,1094,2410
-110,90,-80,536,558,1094,2410
-40,90,-150,536,558,1094,2410
60,90,110,536,558,1094,2410
-60,90,-130,536,558,1094,2410
80,90,90,536,558,1094,2410
60,40,100,534,560,1094,2266
-140,90,-50,536,558,1094,2410
40,-20,140,536,558,1094,2359
130,90,40,536,558,1094,2410
-100,90,-90,536,558,1094,2410
140,90,30,536,558,1094,2410
170,-70,-20,532,562,1094,2412
120,-30,140,528,566,1094,2462
-150,-30,40,534,560,1094,2293
-50,90,-140,536,558,1094,2410
30,90,140,536,558,1094,2410
-160,90,-30,536,558,1094,2410
10,-60,0,533,562,1095,2253
150,-30,150,533,562,1095,2412
-80,-40,130,518,577,1095,2415
-100,40,-50,537,558,1095,2453
50,-80,40,527,568,1095,2238
-110,10,180,539,556,1095,2371
140,-50,130,509,586,1095,2334
80,0,-50,526,569,1095,2288
-10,40,-170,531,564,1095,2539
-160,-40,30,532,563,1095,2385
-140,-30,50,530,565,1095,2391
-110,10,-180,539,556,1095,2371
50,60,110,529,566,1095,2382
-20,20,-20,534,561,1095,2366
120,40,-130,525,571,1096,2264
130,20,-10,547,549,1096,2232
-100,0,20,538,558,1096,2441
-160,-80,20,545,551,1096,2400
-160,40,0,538,558,1096,2431
-120,-50,80,523,573,1096,2426
70,-30,170,544,553,1097,2536
40,50,120,534,563,1097,2354
-100,50,-60,551,546,1097,2447
80,-30,70,511,586,1097,2201
-70,20,-120,521,576,1097,2461
70,0,-10,535,562,1097,2400
-90,-10,-50,546,551,1097,2139
-10,-80,170,526,571,1097,2376
-100,0,10,554,543,1097,2477
170,30,10,518,579,1097,2467
-20,-30,-180,524,574,1098,2342
-20,-30,180,524,574,1098,2342
-60,50,40,549,549,1098,2470
100,50,-110,534,564,1098,2327
-140,60,-20,534,564,1098,2223
-90,70,80,540,558,1098,2501
40,80,-50,540,558,1098,2318
-140,-60,50,525,573,1098,2297
-60,70,-110,541,557,1098,2394
-80,0,0,556,543,1099,2425
80,-30,-180,544,555,1099,2461
-120,80,110,536,563,1099,2513
80,-30,180,544,555,1099,2461
150,40,20,518,581,1099,2536
0,40,-30,531,568,1099,2299
20,60,-40,517,582,1099,2360
-110,0,80,543,557,1100,2323
0,-50,-180,545,555,1100,2433
110,-80,100,526,574,1100,2226
130,50,30,526,574,1100,2442
110,-40,-90,552,548,1100,2268
150,60,20,535,565,1100,2446
120,50,30,541,559,1100,2424
-90,-20,130,524,576,1100,2322
120,-30,150,531,569,1100,2520
0,-50,180,545,555,1100,2433
-80,0,-160,535,566,1101,2492
70,20,80,546,555,1101,2213
-180,30,-180,532,570,1102,2448
-90,10,-130,534,568,1102,2461
-80,30,70,549,553,1102,2394
-150,50,-10,530,572,1102,2363
130,-30,150,542,560,1102,2458
180,30,-180,532,570,1102,2448
180,30,180,532,570,1102,2448
120,0,-30,534,568,1102,2253
-120,-10,80,537,565,1102,2420
-180,30,180,532,570,1102,2448
130,-40,130,532,571,1103,2376
-30,40,-150,550,553,1103,2427
140,30,0,534,569,1103,2399
90,10,-100,519,584,1103,2405
-110,0,-120,553,550,1103,2344
170,10,0,536,567,1103,2426
-30,0,-170,555,548,1103,2267
-10,70,180,548,556,1104,2379
-120,30,-10,542,562,1104,2354
0,20,-180,544,560,1104,2520
-60,60,-110,551,553,1104,2419
-10,70,-180,548,556,1104,2379
-110,-70,80,540,564,1104,2338
-90,10,-80,535,569,1104,2441
0,20,170,548,556,1104,2463
50,50,110,538,566,1104,2446
0,20,180,544,560,1104,2520
140,40,-150,534,570,1104,2343
100,-80,90,534,570,1104,2266
20,20,-40,536,569,1105,2403
-100,-40,-90,551,554,1105,2390
-30,60,10,520,585,1105,2196
90,50,60,527,578,1105,2427
-130,50,-20,534,571,1105,2472
-90,0,40,547,558,1105,2379
-30,50,-150,537,569,1106,2542
-50,40,-140,551,555,1106,2408
-10,80,180,549,557,1106,2386
60,-30,160,535,571,1106,2501
-10,80,-180,549,557,1106,2386
100,-30,110,533,573,1106,2437
20,-60,10,535,571,1106,2238
80,0,-40,533,573,1106,2418
40,70,120,535,572,1107,2446
-10,-70,170,527,580,1107,2445
30,-30,180,530,577,1107,2498
150,30,10,529,578,1107,2363
-30,-60,160,537,570,1107,2430
30,-30,-180,530,577,1107,2498
120,-60,-80,537,571,1108,2345
160,0,-180,545,563,1108,2494
0,10,-180,540,568,1108,2490
-80,-60,120,528,580,1108,2426
60,-80,50,536,572,1108,2356
-50,0,-160,542,566,1108,2504
0,10,180,540,568,1108,2490
-160,-30,-180,522,586,1108,2429
-160,-30,180,522,586,1108,2429
160,0,180,545,563,1108,2494
-150,80,-30,547,561,1108,2428
-110,-60,90,522,586,1108,2376
-110,0,40,552,556,1108,2423
90,0,-80,544,565,1109,2299
-170,40,0,553,556,1109,2395
-40,-30,170,557,552,1109,2433
170,-30,-20,544,565,1109,2161
-80,30,-110,546,563,1109,2446
-60,-50,140,538,571,1109,2401
-130,40,-10,532,577,1109,2392
60,30,100,535,574,1109,2303
20,-30,180,549,561,1110,2474
-160,-30,30,553,557,1110,2449
-140,-20,50,538,572,1110,2496
100,-20,-120,539,571,1110,2362
50,40,110,536,574,1110,2320
20,-30,-180,549,561,1110,2474
-10,-30,-180,539,571,1110,2509
30,60,130,544,566,1110,2384
110,-30,130,532,578,1110,2505
-10,-30,180,539,571,1110,2509
50,0,120,550,561,1111,2415
-170,70,-10,544,567,1111,2444
-90,20,100,555,556,1111,2456
60,50,100,547,564,1111,2382
-90,10,80,544,567,1111,2329
-160,-70,20,545,566,1111,2371
-170,-50,10,534,577,1111,2339
-70,-20,160,534,577,1111,2408
90,-80,80,535,576,1111,2370
-90,10,-90,533,578,1111,2550
-110,0,50,547,565,1112,2420
-70,60,-100,552,560,1112,2440
10,-10,180,540,572,1112,2473
20,-40,0,533,579,1112,2351
-20,60,0,538,574,1112,2196
10,-10,-180,540,572,1112,2473
-170,10,170,548,564,1112,2480
-100,-60,100,521,591,1112,2396
90,-40,-140,533,580,1113,2368
-50,10,-150,546,567,1113,2464
-10,-30,-30,537,576,1113,2331
10,0,-30,521,592,1113,2392
110,40,-120,529,584,1113,2341
-120,40,-20,540,573,1113,2440
-10,-10,-30,526,587,1113,2360
140,-30,150,544,569,1113,2399
70,10,80,549,564,1113,2211
-110,10,0,566,547,1113,2381
170,30,-170,543,570,1113,2377
-100,10,-140,552,561,1113,2434
-130,-30,60,543,570,1113,2444
-20,30,-160,544,570,1114,2433
-160,-20,30,548,566,1114,2339
110,-30,150,535,579,1114,2420
-110,-50,90,537,577,1114,2449
-120,60,120,537,577,1114,2536
30,-50,-170,537,577,1114,2484
130,0,-160,552,562,1114,2371
150,-80,-40,544,570,1114,2364
-40,20,-160,552,562,1114,2376
170,80,0,550,565,1115,2472
180,0,170,528,587,1115,2362
-180,0,170,528,587,1115,2362
80,40,70,532,583,1115,2381
-40,80,-140,549,566,1115,2427
170,20,10,526,589,1115,2524
30,-10,140,540,575,1115,2359
-10,10,-170,549,567,1116,2394
30,-70,20,534,582,1116,2260
70,-60,-140,545,571,1116,2498
120,60,40,545,571,1116,2447
160,-10,170,560,556,1116,2372
0,20,-30,554,563,1117,2433
-60,0,-160,538,579,1117,2529
-60,10,-140,541,576,1117,2539
170,0,-10,545,572,1117,2407
-140,0,30,545,572,1117,2455
80,30,50,566,551,1117,2201
-100,60,-60,547,570,1117,2486
150,-70,140,528,589,1117,2388
-20,50,-160,534,584,1118,2543
-140,20,160,536,582,1118,2513
-130,30,0,541,577,1118,2476
-140,80,-40,547,571,1118,2463
-140,70,-30,558,560,1118,2419
-100,30,-60,544,574,1118,2368
-130,-40,-140,547,571,1118,2337
-10,-50,-20,533,585,1118,2382
-140,40,-10,554,564,1118,2389
-60,20,-140,559,559,1118,2508
-60,50,-120,562,556,1118,2428
30,80,-40,545,574,1119,2359
-80,-10,170,549,570,1119,2472
130,-70,120,529,590,1119,2423
-50,60,-120,543,576,1119,2430
-130,60,130,539,580,1119,2546
70,-20,130,548,572,1120,2482
-110,30,-30,539,581,1120,2520
-110,-10,90,554,566,1120,2474
150,-30,-30,544,576,1120,2327
80,20,-90,522,598,1120,2455
150,40,-160,548,572,1120,2423
80,-80,70,533,588,1121,2434
80,0,-30,549,572,1121,2488
-70,50,-110,560,561,1121,2542
140,-70,130,530,591,1121,2381
-30,-40,170,546,575,1121,2543
40,60,120,546,575,1121,2378
80,60,-90,546,575,1121,2408
-40,-20,180,558,563,1121,2415
-100,80,90,548,573,1121,2519
-40,-20,-180,558,563,1121,2415
-50,20,-150,558,563,1121,2467
-90,30,-80,552,570,1122,2437
30,40,-50,534,588,1122,2377
-150,20,10,550,572,1122,2375
-130,30,150,544,578,1122,2516
-160,-70,-170,526,596,1122,2375
-80,60,70,554,568,1122,2529
60,-10,20,540,582,1122,2318
10,-20,-180,533,589,1122,2437
10,-20,180,533,589,1122,2437
-180,-50,-10,566,557,1123,2299
0,20,160,563,560,1123,2298
-20,40,-160,549,574,1123,2492
-100,50,-70,556,567,1123,2424
50,70,110,547,576,1123,2491
160,-70,150,532,591,1123,2418
-100,-30,110,535,588,1123,2454
180,-50,-10,566,557,1123,2299
-110,80,100,554,569,1123,2500
110,-10,-150,537,586,1123,2381
-140,-10,50,546,577,1123,2475
-50,50,-130,568,555,1123,2434
-70,0,-150,551,572,1123,2523
-150,-50,40,527,596,1123,2378
100,-10,-70,532,592,1124,2332
0,0,180,544,580,1124,2538
30,-80,-160,548,576,1124,2381
10,-30,-20,550,574,1124,2423
-130,80,-50,553,571,1124,2517
-10,60,-10,546,578,1124,2314
0,0,-180,544,580,1124,2538
-90,-60,110,536,588,1124,2360
10,-70,-180,551,573,1124,2488
30,-60,20,545,579,1124,2287
10,-70,180,551,573,1124,2488
-90,-40,120,529,595,1124,2516
60,-60,-150,543,581,1124,2473
-10,30,-170,544,580,1124,2546
170,40,10,548,577,1125,2480
40,40,120,549,576,1125,2432
-150,40,160,539,586,1125,2451
90,-30,-170,550,575,1125,2464
-50,-70,140,540,585,1125,2369
-140,10,20,572,553,1125,2393
-130,20,10,544,581,1125,2387
90,-20,110,539,586,1125,2458
-50,80,40,533,592,1125,2556
-90,80,80,545,580,1125,2550
-80,50,70,556,569,1125,2327
-150,-80,30,560,566,1126,2490
10,0,160,566,560,1126,2374
-20,-10,-30,531,596,1127,2459
-130,10,170,550,577,1127,2413
80,50,-90,551,576,1127,2323
-110,60,-50,550,577,1127,2553
-160,60,-10,547,580,1127,2469
60,70,-70,540,587,1127,2214
-100,-20,-80,557,570,1127,2355
-80,-20,150,524,603,1127,2416
-20,-50,170,558,569,1127,2492
40,-70,30,553,574,1127,2345
-80,10,-130,543,585,1128,2624
160,20,0,551,577,1128,2451
-100,-10,110,549,579,1128,2470
-150,30,0,549,579,1128,2333
120,-70,110,524,604,1128,2448
-90,10,-120,555,573,1128,2498
-20,60,-160,550,579,1129,2538
20,80,-30,549,580,1129,2398
-60,0,-150,552,577,1129,2681
120,-20,-180,548,581,1129,2351
0,10,-30,544,585,1129,2445
-30,70,-150,556,573,1129,2511
120,-20,180,548,581,1129,2351
140,-70,-60,553,577,1130,2349
180,-20,0,546,584,1130,2403
-100,10,-120,559,571,1130,2511
-160,60,160,543,587,1130,2561
-180,-20,0,546,584,1130,2403
-160,-60,20,544,586,1130,2437
-120,80,-60,562,568,1130,2548
-150,-10,30,556,574,1130,2430
-60,-20,160,545,585,1130,2394
-50,-30,160,565,566,1131,2480
-10,20,-170,540,591,1131,2502
-140,60,140,546,585,1131,2626
180,50,-180,551,580,1131,2455
-20,-80,160,537,594,1131,2472
-10,40,-20,554,577,1131,2420
-20,80,-170,558,573,1131,2412
-180,50,180,551,580,1131,2455
180,50,180,551,580,1131,2455
-180,50,-180,551,580,1131,2455
130,-10,-170,561,570,1131,2266
-50,-10,-30,544,587,1131,2406
150,-50,140,530,601,1131,2422
170,40,-170,556,576,1132,2570
-100,10,-160,573,559,1132,2448
-130,10,20,566,566,1132,2468
-130,0,40,553,579,1132,2517
70,-80,60,533,599,1132,2399
-90,-70,100,556,577,1133,2389
120,-10,-160,553,580,1133,2412
-120,60,-40,555,578,1133,2515
-110,40,-60,569,564,1133,2443
150,50,20,541,592,1133,2545
90,70,70,547,586,1133,2491
-180,10,0,557,577,1134,2505
-100,-70,90,558,576,1134,2349
-40,50,-140,549,585,1134,2548
-50,-10,-180,557,577,1134,2483
-50,-10,180,557,577,1134,2483
70,-30,160,548,586,1134,2521
180,10,0,557,577,1134,2505
-100,10,-150,566,568,1134,2500
-130,60,-30,556,578,1134,2482
-60,-30,150,548,586,1134,2446
-10,-20,-30,531,604,1135,2463
170,-70,160,537,598,1135,2464
60,-50,-160,552,583,1135,2366
-120,-20,80,539,596,1135,2431
130,40,-140,553,583,1136,2458
-40,80,30,547,589,1136,2561
-50,0,-170,563,573,1136,2515
-60,-70,-60,559,577,1136,2250
-80,60,-90,560,577,1137,2490
140,40,10,536,601,1137,2471
10,40,150,564,573,1137,2443
-30,60,-150,542,595,1137,2595
40,-40,180,558,579,1137,2521
-60,80,50,547,590,1137,2561
90,-70,80,541,596,1137,2465
-70,70,-100,558,579,1137,2494
-100,10,-30,572,565,1137,2456
-130,-60,60,540,597,1137,2410
40,-40,-180,558,579,1137,2521
20,0,150,559,579,1138,2490
-100,30,-50,561,577,1138,2551
-70,30,50,589,549,1138,2305
70,0,30,563,575,1138,2299
-130,70,-40,562,576,1138,2476
-50,80,-130,559,579,1138,2510
10,-60,180,560,578,1138,2526
-130,-40,60,527,611,1138,2464
170,10,-10,555,583,1138,2468
10,-60,-180,560,578,1138,2526
-120,-20,-130,562,577,1139,2289
160,-10,-20,560,579,1139,2430
0,-30,180,549,590,1139,2538
70,-50,-150,552,587,1139,2395
100,70,60,560,579,1139,2512
150,-10,180,549,590,1139,2574
180,0,0,559,580,1139,2495
-180,0,0,559,580,1139,2495
0,-30,-180,549,590,1139,2538
150,-10,-180,549,590,1139,2574
80,-10,100,557,582,1139,2552
40,-50,-170,560,579,1139,2463
120,50,20,556,583,1139,2394
-50,30,-150,571,569,1140,2520
160,30,10,549,591,1140,2533
-100,0,-90,564,576,1140,2489
80,-70,70,550,590,1140,2343
-110,40,120,558,582,1140,2349
-90,20,-70,550,590,1140,2635
-80,10,60,565,575,1140,2405
-140,-30,-160,561,579,1140,2402
-70,-40,-60,558,582,1140,2389
-120,0,-160,566,574,1140,2431
-140,-50,50,538,602,1140,2402
-180,80,-10,563,578,1141,2506
-70,80,60,558,583,1141,2573
10,60,-30,545,596,1141,2405
-50,50,30,562,579,1141,2488
30,70,130,554,587,1141,2460
180,80,-10,563,578,1141,2506
90,50,-100,557,584,1141,2433
-30,80,20,551,590,1141,2535
10,10,150,562,580,1142,2501
-160,10,10,554,588,1142,2445
170,10,180,543,599,1142,2536
180,-70,170,538,604,1142,2469
-180,-70,170,538,604,1142,2469
50,70,-60,546,596,1142,2294
-70,-70,-70,561,581,1142,2252
100,-40,-110,559,583,1142,2386
70,0,-30,548,594,1142,2536
170,10,-180,543,599,1142,2536
30,-20,150,576,566,1142,2505
-60,-10,-180,549,594,1143,2599
80,70,80,545,598,1143,2479
160,60,10,568,575,1143,2511
130,50,20,553,590,1143,2413
-170,30,0,561,582,1143,2430
70,0,40,562,581,1143,2435
-60,-10,180,549,594,1143,2599
-80,0,10,577,566,1143,2443
-40,-10,-30,559,585,1144,2428
10,-30,180,544,600,1144,2445
-90,10,-110,564,580,1144,2535
10,-30,-180,544,600,1144,2445
-110,80,-70,573,571,1144,2566
80,10,-80,541,603,1144,2370
-70,-70,120,550,595,1145,2412
20,-80,-170,551,594,1145,2489
10,80,-20,553,592,1145,2442
120,20,-10,568,577,1145,2294
0,30,-30,566,579,1145,2468
-40,-40,160,560,586,1146,2513
170,70,0,551,595,1146,2524
0,-40,180,562,584,1146,2578
-20,80,10,563,583,1146,2504
0,-40,-180,562,584,1146,2578
-120,-40,70,551,595,1146,2498
-130,-50,60,534,612,1146,2453
10,20,150,560,586,1146,2449
110,70,50,563,583,1146,2544
-80,-70,110,551,595,1146,2408
-30,-20,180,561,586,1147,2493
180,-10,0,557,590,1147,2476
70,70,90,556,591,1147,2480
-90,10,90,575,572,1147,2471
-30,-20,-180,561,586,1147,2493
-180,50,0,561,586,1147,2542
-180,-10,0,557,590,1147,2476
180,50,0,561,586,1147,2542
0,10,170,564,583,1147,2541
-40,40,10,561,587,1148,2476
20,60,140,560,588,1148,2473
-130,-10,-160,573,575,1148,2360
-60,-10,-30,560,588,1148,2480
-170,-10,20,556,593,1149,2423
-100,-50,100,549,600,1149,2502
150,-70,-50,561,588,1149,2396
-100,0,0,583,566,1149,2446
110,10,-130,546,603,1149,2503
-150,0,20,566,583,1149,2451
-160,30,170,560,589,1149,2612
-170,-30,20,554,596,1150,2467
-150,60,150,556,594,1150,2589
100,-10,-80,548,602,1150,2444
120,0,-150,561,589,1150,2453
-110,20,150,563,587,1150,2466
120,-30,-70,572,578,1150,2494
110,-50,-90,571,579,1150,2506
-90,10,-100,563,587,1150,2593
-130,0,50,556,594,1150,2618
100,-60,90,554,596,1150,2441
80,-20,120,552,599,1151,2541
70,-10,50,546,605,1151,2461
-110,50,-40,544,607,1151,2657
-120,20,0,564,587,1151,2479
-170,60,170,543,608,1151,2565
-80,80,-100,572,579,1151,2572
-90,10,-140,564,587,1151,2532
-90,80,-90,573,579,1152,2575
150,30,0,565,587,1152,2498
110,-60,100,547,605,1152,2352
20,0,-30,548,604,1152,2487
40,70,-50,558,594,1152,2317
-20,10,-170,574,578,1152,2531
30,40,130,573,579,1152,2457
-80,20,-100,555,597,1152,2653
-90,30,100,585,568,1153,2571
160,-80,-30,559,594,1153,2438
-20,-20,180,558,595,1153,2551
-30,-10,-30,538,615,1153,2453
-100,30,120,572,581,1153,2388
-170,-70,180,533,620,1153,2462
-70,80,-110,569,584,1153,2571
10,30,150,570,583,1153,2538
-100,0,-60,568,585,1153,2425
-110,60,110,571,582,1153,2632
-20,-20,-180,558,595,1153,2551
-170,-70,-180,533,620,1153,2462
20,30,140,582,571,1153,2396
-50,-40,150,566,588,1154,2473
-180,-40,-10,581,573,1154,2301
-40,70,-140,566,588,1154,2542
180,-40,-10,581,573,1154,2301
70,30,80,560,594,1154,2473
140,-40,140,544,610,1154,2385
10,-10,170,557,597,1154,2675
-60,80,-120,568,586,1154,2547
30,-40,180,554,600,1154,2673
30,-40,-180,554,600,1154,2673
-40,40,-150,573,581,1154,2577
-40,0,-170,565,590,1155,2502
-30,10,-170,571,584,1155,2473
-80,70,70,578,577,1155,2660
100,-30,140,560,595,1155,2517
-120,-50,70,544,611,1155,2482
-130,-10,60,554,601,1155,2633
-80,70,-90,564,591,1155,2562
90,-50,80,548,608,1156,2336
70,60,-80,565,591,1156,2524
-100,80,-80,574,582,1156,2577
-130,20,160,565,591,1156,2427
-140,-10,40,575,581,1156,2494
-80,20,70,584,572,1156,2527
70,-70,60,559,597,1156,2430
-100,20,-40,575,582,1157,2592
0,30,160,571,586,1157,2427
60,20,100,559,598,1157,2367
-150,-30,-170,569,588,1157,2383
-70,-10,-30,577,580,1157,2448
80,-60,-130,557,600,1157,2557
-80,40,-110,573,584,1157,2532
0,80,-10,554,603,1157,2470
-110,-40,80,560,597,1157,2553
20,50,140,566,591,1157,2424
-60,-70,130,550,608,1158,2418
100,-30,-130,559,599,1158,2479
100,-70,90,549,609,1158,2528
110,-20,-170,565,593,1158,2553
30,-60,-170,563,595,1158,2583
-90,10,100,567,592,1159,2458
110,-70,100,546,613,1159,2506
-110,70,-60,570,589,1159,2516
0,-50,-10,567,592,1159,2460
120,-60,110,554,605,1159,2472
-110,0,-110,583,576,1159,2492
140,50,20,555,604,1159,2623
-30,30,-160,575,585,1160,2584
-50,-70,-50,564,596,1160,2285
-80,80,70,566,594,1160,2582
-70,-50,130,560,600,1160,2533
60,70,100,559,601,1160,2507
-140,-80,40,563,597,1160,2570
40,-10,-20,562,598,1160,2581
-100,30,-70,560,600,1160,2543
-110,0,30,570,590,1160,2532
-110,-30,90,549,612,1161,2555
-120,-10,70,560,601,1161,2537
-90,0,140,567,594,1161,2449
-90,-50,110,575,586,1161,2509
-70,10,30,591,571,1162,2355
-100,70,-70,573,589,1162,2526
90,-30,90,566,596,1162,2595
-150,-20,30,567,595,1162,2588
100,-30,-120,554,608,1162,2476
-100,-40,100,559,603,1162,2553
40,-30,150,573,589,1162,2554
-120,50,-30,549,614,1163,2642
-160,20,170,566,597,1163,2702
180,-30,-10,573,590,1163,2361
-170,80,-20,579,584,1163,2573
-60,30,-140,595,568,1163,2597
-110,-60,-110,576,587,1163,2305
-70,-10,-180,575,588,1163,2698
60,-20,130,559,604,1163,2412
-30,20,-10,582,581,1163,2444
-180,-30,-10,573,590,1163,2361
-70,-10,180,575,588,1163,2698
-130,-10,40,579,584,1163,2576
30,50,130,569,594,1163,2441
-180,-60,-10,583,581,1164,2433
130,60,30,568,596,1164,2583
180,-60,-10,583,581,1164,2433
-90,40,-90,585,579,1164,2509
-30,-50,160,574,590,1164,2586
-70,-20,150,571,593,1164,2485
-70,50,-120,596,568,1164,2507
-170,-20,20,554,611,1165,2525
90,40,-100,570,595,1165,2436
-10,60,-180,576,589,1165,2532
140,40,0,573,592,1165,2549
150,-40,-40,562,603,1165,2460
-10,60,180,576,589,1165,2532
-140,-30,40,575,591,1166,2559
-90,20,-80,552,614,1166,2575
30,-30,170,568,598,1166,2703
-100,-10,-70,580,586,1166,2431
70,50,-80,570,596,1166,2362
110,-80,-90,571,595,1166,2527
0,60,-20,565,601,1166,2403
-40,-60,150,558,608,1166,2444
-90,60,-80,582,584,1166,2611
-140,30,0,566,600,1166,2547
-30,80,-160,568,598,1166,2507
-80,0,20,593,573,1166,2578
-40,30,-160,589,578,1167,2557
150,20,-10,562,605,1167,2520
140,10,-160,576,591,1167,2565
-20,70,-170,570,597,1167,2502
110,40,10,558,609,1167,2187
30,70,-40,563,604,1167,2403
-110,50,-50,578,589,1167,2565
0,-20,-180,551,617,1168,2565
-10,80,0,569,599,1168,2476
50,-50,-170,562,606,1168,2499
170,-10,170,544,624,1168,2444
10,-40,180,561,607,1168,2620
-80,0,50,583,585,1168,2544
10,-40,-180,561,607,1168,2620
0,-20,180,551,617,1168,2565
-70,20,-130,566,602,1168,2701
-140,-20,40,570,598,1168,2573
50,-70,40,572,596,1168,2478
-120,-60,70,553,616,1169,2564
-120,-30,70,570,599,1169,2619
0,10,160,587,582,1169,2389
160,20,-10,563,606,1169,2392
-30,-80,150,555,614,1169,2534
-130,0,30,573,597,1170,2612
-180,-70,-10,572,598,1170,2548
0,40,160,573,597,1170,2509
100,-10,-110,553,617,1170,2485
-80,-50,120,579,591,1170,2608
180,-70,-10,572,598,1170,2548
-40,10,-10,582,588,1170,2451
-100,0,-80,589,581,1170,2524
10,50,150,567,604,1171,2475
-90,10,-150,578,593,1171,2680
150,40,10,574,597,1171,2581
20,40,140,576,595,1171,2546
-80,-70,-80,573,598,1171,2336
130,-60,-70,579,592,1171,2450
120,-80,-80,576,595,1171,2509
-140,-40,40,554,617,1171,2543
130,-40,-60,577,595,1172,2514
180,40,0,568,604,1172,2557
-180,40,0,568,604,1172,2557
-90,30,-90,573,599,1172,2443
-60,50,-130,599,573,1172,2564
10,-50,180,578,594,1172,2553
-90,-30,120,557,615,1172,2577
-130,-20,60,561,611,1172,2732
10,-50,-180,578,594,1172,2553
100,40,20,569,603,1172,2299
-110,30,-60,560,612,1172,2477
130,10,-150,577,595,1172,2468
50,-10,0,560,613,1173,2467
-120,70,-50,572,601,1173,2526
120,-40,120,567,606,1173,2596
50,-20,130,574,599,1173,2452
120,-20,-60,583,590,1173,2452
100,40,-110,582,592,1174,2565
70,0,-20,582,592,1174,2604
-120,0,50,578,596,1174,2609
60,-30,40,550,624,1174,2530
0,0,170,579,595,1174,2654
-120,0,60,562,612,1174,2612
-100,10,-170,595,579,1174,2559
-150,-70,30,575,599,1174,2540
-60,0,-170,578,596,1174,2550
-160,70,-20,585,590,1175,2596
-90,20,110,583,592,1175,2554
100,-30,150,570,605,1175,2483
-160,30,0,576,599,1175,2640
140,30,-150,575,600,1175,2559
0,-10,-180,570,605,1175,2554
0,-10,180,570,605,1175,2554
160,50,10,566,609,1175,2579
-110,40,-40,573,602,1175,2617
-150,-30,30,574,601,1175,2604
80,20,30,575,600,1175,2378
-10,-60,170,571,604,1175,2518
-80,50,-100,586,589,1175,2661
20,-20,170,572,604,1176,2585
60,-30,150,576,600,1176,2677
20,70,140,576,600,1176,2554
60,-70,50,564,612,1176,2539
-60,-30,-50,581,595,1176,2542
160,40,10,564,612,1176,2618
20,20,140,572,604,1176,2434
170,-20,-20,587,589,1176,2418
-110,-50,80,568,608,1176,2551
-180,30,0,575,601,1176,2551
-90,70,-80,574,602,1176,2527
180,30,0,575,601,1176,2551
80,-50,-140,563,613,1176,2505
110,-30,-90,582,594,1176,2274
20,-20,160,579,597,1176,2621
170,-30,160,556,621,1177,2545
-110,0,70,562,615,1177,2505
-170,-20,170,579,598,1177,2614
-80,20,-110,571,607,1178,2652
60,-10,120,580,598,1178,2630
-20,-70,160,566,612,1178,2576
50,30,110,564,614,1178,2497
-110,20,-20,585,593,1178,2545
130,-20,180,579,599,1178,2675
130,-20,-180,579,599,1178,2675
-70,0,-160,557,621,1178,2646
100,-80,-100,573,605,1178,2546
-70,10,-140,562,616,1178,2770
-120,0,40,581,598,1179,2672
90,-80,-110,571,608,1179,2593
-70,0,0,587,592,1179,2537
-140,10,170,564,615,1179,2536
10,70,150,577,602,1179,2629
-60,-10,170,577,602,1179,2543
-110,-30,-100,591,588,1179,2435
20,70,-30,562,617,1179,2427
100,-30,120,562,617,1179,2554
100,-30,130,568,612,1180,2651
-110,50,-60,590,590,1180,2647
-160,-10,20,576,604,1180,2539
-10,-20,-180,569,611,1180,2653
170,-80,-20,577,603,1180,2498
-10,-20,180,569,611,1180,2653
150,-60,-50,585,595,1180,2478
120,-20,-170,583,597,1180,2548
50,80,110,570,611,1181,2577
30,-30,160,582,599,1181,2603
50,-30,150,576,605,1181,2707
50,0,-30,569,612,1181,2557
-180,20,180,564,617,1181,2633
-110,-10,-90,591,590,1181,2539
170,50,-170,590,591,1181,2676
-40,0,-20,587,594,1181,2437
-180,20,-180,564,617,1181,2633
-150,-60,-160,561,620,1181,2522
30,20,130,581,600,1181,2391
10,-10,160,590,591,1181,2569
40,0,-30,545,636,1181,2661
180,20,180,564,617,1181,2633
180,20,-180,564,617,1181,2633
-100,0,-10,583,599,1182,2649
50,-40,170,582,600,1182,2546
10,-80,-180,569,613,1182,2577
-110,40,-50,597,585,1182,2598
120,70,40,573,609,1182,2590
10,-80,180,569,613,1182,2577
-60,-40,140,579,604,1183,2571
90,60,60,579,604,1183,2498
-180,60,180,571,612,1183,2657
-180,60,-180,571,612,1183,2657
180,60,-180,571,612,1183,2657
70,80,90,570,613,1183,2591
180,60,180,571,612,1183,2657
40,-70,-160,584,599,1183,2521
-130,-80,50,574,609,1183,2647
-40,80,-150,567,616,1183,2548
60,60,-70,575,608,1183,2524
110,-30,160,583,600,1183,2532
10,60,150,585,599,1184,2586
-180,70,-10,579,605,1184,2633
-40,60,-140,572,612,1184,2676
20,-40,-180,574,610,1184,2650
20,-40,180,574,610,1184,2650
170,20,0,571,613,1184,2661
-80,20,80,591,593,1184,2572
-90,50,90,581,603,1184,2590
180,70,-10,579,605,1184,2633
170,-40,160,556,629,1185,2607
-40,-70,-40,580,605,1185,2363
-180,20,0,573,612,1185,2613
-40,-50,-40,572,613,1185,2397
-160,0,170,563,622,1185,2596
30,0,-30,551,634,1185,2609
180,20,0,573,612,1185,2613
130,70,30,579,606,1185,2656
-170,60,-10,579,606,1185,2578
140,20,-10,569,616,1185,2468
-100,0,90,586,600,1186,2581
-100,0,60,575,611,1186,2556
-70,-10,170,578,608,1186,2561
90,40,40,590,596,1186,2464
10,70,-20,551,635,1186,2495
120,30,-130,565,621,1186,2541
-160,80,-30,585,602,1187,2651
140,-60,-60,588,599,1187,2512
0,0,160,595,592,1187,2460
-90,-10,130,576,611,1187,2488
-80,-10,-30,585,602,1187,2474
-90,10,-160,591,597,1188,2634
60,0,-30,580,608,1188,2604
-140,-50,-150,572,616,1188,2484
-150,70,-30,595,593,1188,2701
20,-20,-20,563,625,1188,2656
60,80,100,573,615,1188,2595
-170,-40,10,569,619,1188,2527
120,10,-140,575,613,1188,2638
-80,0,-170,571,617,1188,2633
-100,-10,100,575,614,1189,2673
-50,-60,140,565,624,1189,2568
-50,70,-130,584,605,1189,2658
-110,0,60,575,614,1189,2609
-140,20,10,573,616,1189,2622
10,-50,0,576,613,1189,2640
-110,-20,90,571,618,1189,2629
-100,60,-70,597,593,1190,2678
40,10,-40,572,618,1190,2562
-50,80,-140,569,621,1190,2628
-110,0,20,585,606,1191,2660
80,-60,70,560,631,1191,2588
90,-60,-120,550,641,1191,2643
130,-60,120,565,626,1191,2515
150,0,-20,581,610,1191,2582
-80,-10,160,578,613,1191,2625
-120,10,10,585,606,1191,2687
80,-80,-120,577,615,1192,2627
-80,0,30,592,600,1192,2581
40,20,-50,570,622,1192,2596
40,30,120,585,607,1192,2574
-170,0,10,574,618,1192,2531
-70,20,50,625,567,1192,2464
-150,60,-20,580,613,1193,2697
100,-10,-100,571,622,1193,2532
-60,40,-140,596,597,1193,2644
-130,-30,50,584,609,1193,2578
-50,10,-160,590,603,1193,2580
0,50,160,583,610,1193,2644
-60,10,10,599,594,1193,2500
130,-80,-70,592,601,1193,2535
-100,-40,90,587,606,1193,2662
40,80,120,580,613,1193,2605
-90,-20,120,575,619,1194,2513
-170,20,0,577,617,1194,2554
-170,-10,170,569,625,1194,2671
120,80,40,579,615,1194,2548
-40,-80,140,569,625,1194,2605
80,50,70,567,627,1194,2575
30,30,130,587,607,1194,2460
80,30,-90,574,621,1195,2659
140,-60,130,579,616,1195,2532
-120,0,30,580,615,1195,2633
150,0,-170,586,609,1195,2624
-90,0,60,594,601,1195,2521
100,60,50,593,602,1195,2599
-100,0,-50,585,610,1195,2653
-60,10,-160,584,611,1195,2577
-50,20,-160,599,596,1195,2545
-60,10,-150,582,613,1195,2716
-100,20,-50,596,600,1196,2632
-10,50,-180,595,601,1196,2640
-20,20,-170,585,611,1196,2687
150,-20,170,577,619,1196,2599
-70,30,-130,599,597,1196,2695
20,50,-40,592,604,1196,2490
170,60,0,594,602,1196,2694
-10,50,180,595,601,1196,2640
180,-20,-10,595,601,1196,2517
150,30,-160,586,610,1196,2742
90,-60,80,564,632,1196,2590
-180,-20,-10,595,601,1196,2517
-90,30,-100,600,596,1196,2659
100,-10,-90,568,629,1197,2468
-100,10,-110,598,599,1197,2703
-40,-20,170,598,599,1197,2628
-160,10,170,583,614,1197,2702
-80,50,-110,599,598,1197,2590
-150,-60,30,569,629,1198,2525
70,-30,150,590,608,1198,2656
-140,80,-50,582,616,1198,2675
-90,40,-100,585,613,1198,2654
140,0,-20,588,610,1198,2625
-40,-50,150,592,606,1198,2669
-100,40,110,587,611,1198,2535
80,-30,150,578,620,1198,2614
80,-30,170,576,622,1198,2682
120,-30,160,577,621,1198,2551
80,80,80,575,624,1199,2618
180,-80,-10,577,622,1199,2592
80,-40,70,556,643,1199,2471
-100,20,140,583,616,1199,2604
150,-20,-30,584,615,1199,2520
-160,40,170,598,601,1199,2709
-140,30,160,576,623,1199,2685
-180,-80,-10,577,622,1199,2592
-10,40,-180,590,610,1200,2632
80,-40,-170,596,604,1200,2597
150,20,-160,592,608,1200,2640
-130,-20,-150,602,598,1200,2582
130,50,10,587,613,1200,2582
-100,10,-40,585,615,1200,2608
110,-10,-140,577,623,1200,2737
140,-20,180,570,630,1200,2717
140,-20,-180,570,630,1200,2717
-10,40,180,590,610,1200,2632
-60,80,-130,579,621,1200,2646
-120,-20,70,582,619,1201,2764
-160,50,-10,570,631,1201,2813
-80,30,80,597,604,1201,2593
-140,-20,30,596,605,1201,2579
-10,30,-180,594,607,1201,2686
-10,30,180,594,607,1201,2686
-80,10,-140,588,613,1201,2762
50,-60,-160,595,607,1202,2585
-110,30,-50,599,603,1202,2616
-150,10,10,590,612,1202,2613
-170,0,170,565,637,1202,2582
80,-30,140,590,612,1202,2574
110,30,-120,578,624,1202,2507
50,-20,20,582,620,1202,2489
160,-60,-40,592,610,1202,2504
-140,50,-20,578,625,1203,2536
-140,-10,30,602,601,1203,2623
-20,10,-20,591,612,1203,2612
-90,20,-90,588,615,1203,2651
100,80,60,583,620,1203,2596
90,-30,140,588,615,1203,2646
-150,-10,20,592,611,1203,2628
90,-30,160,589,615,1204,2596
130,-30,160,578,626,1204,2643
-70,50,60,607,597,1204,2698
90,80,70,578,626,1204,2598
-90,50,-100,603,602,1205,2694
80,40,-90,569,636,1205,2547
-70,-30,140,571,634,1205,2626
70,-40,-180,591,614,1205,2578
70,-40,180,591,614,1205,2578
40,-40,170,610,595,1205,2640
-50,20,10,593,612,1205,2581
-100,0,-70,601,604,1205,2483
160,10,-170,577,629,1206,2609
-120,40,-50,602,604,1206,2698
160,-50,150,569,637,1206,2528
-20,-40,-30,574,632,1206,2470
-90,10,110,591,615,1206,2626
110,10,-20,582,625,1207,2593
0,70,-10,579,628,1207,2599
-120,-50,-120,605,602,1207,2434
120,10,-20,585,622,1207,2375
-30,-70,-30,592,615,1207,2469
140,50,10,584,623,1207,2555
130,40,0,576,631,1207,2617
-70,70,60,597,610,1207,2728
130,80,30,582,625,1207,2563
-130,-10,50,585,622,1207,2660
-150,80,-40,590,617,1207,2682
-90,10,150,595,613,1208,2656
-110,-60,80,573,635,1208,2652
-90,50,-90,600,608,1208,2715
30,-20,-10,589,619,1208,2628
-20,-40,170,581,627,1208,2702
-100,40,-80,602,606,1208,2570
-70,0,-170,586,622,1208,2857
-70,60,60,604,604,1208,2714
-100,-50,90,591,617,1208,2652
-100,-30,100,575,634,1209,2773
110,-40,110,585,624,1209,2613
110,-20,-80,588,621,1209,2488
-160,-50,20,560,649,1209,2525
150,-60,140,590,619,1209,2564
-120,-80,60,589,620,1209,2730
160,-70,-40,596,613,1209,2510
80,10,0,595,614,1209,2539
-100,0,-20,610,599,1209,2541
-30,-30,170,592,617,1209,2683
-80,20,-120,581,629,1210,2772
40,-60,30,580,630,1210,2441
-40,10,-170,602,608,1210,2639
-150,-40,30,578,632,1210,2619
-60,40,40,607,603,1210,2729
-130,30,-10,582,628,1210,2702
-40,70,30,586,624,1210,2589
-40,50,20,601,609,1210,2559
-50,60,-130,597,614,1211,2795
-150,20,0,602,609,1211,2514
30,80,130,588,623,1211,2596
-120,50,-50,605,606,1211,2688
-50,-10,170,599,612,1211,2663
-140,0,20,600,611,1211,2629
-130,-40,40,596,616,1212,2565
-130,50,-30,591,621,1212,2683
-100,10,-50,594,618,1212,2653
-30,-10,180,600,612,1212,2692
80,60,70,587,625,1212,2543
-130,-40,50,579,633,1212,2606
70,-80,-130,583,629,1212,2656
-50,30,20,585,627,1212,2683
-30,-10,-180,600,612,1212,2692
-110,30,-40,592,620,1212,2724
-10,20,-180,588,625,1213,2803
140,80,20,591,622,1213,2578
-140,70,-40,606,607,1213,2735
140,-80,-60,597,616,1213,2562
-10,20,180,588,625,1213,2803
140,-90,-50,592,622,1214,2648
-10,-90,160,592,622,1214,2648
-130,-90,40,592,622,1214,2648
60,-90,-130,592,622,1214,2648
-110,-90,60,592,622,1214,2648
-90,-90,80,592,622,1214,2648
-40,-90,130,592,622,1214,2648
110,20,-10,603,611,1214,2461
40,-90,-150,592,622,1214,2648
-70,-90,100,592,622,1214,2648
160,-90,-30,592,622,1214,2648
-120,-90,50,592,622,1214,2648
160,70,-160,608,606,1214,2627
-60,-90,110,592,622,1214,2648
180,-90,-10,592,622,1214,2648
150,80,10,594,620,1214,2645
150,-90,-40,592,622,1214,2648
-160,-90,10,592,622,1214,2648
-80,80,-110,583,631,1214,2680
10,-90,180,592,622,1214,2648
-80,-90,90,592,622,1214,2648
90,-90,-100,592,622,1214,2648
-140,-70,40,589,625,1214,2621
100,-90,-90,592,622,1214,2648
-20,-70,-20,598,616,1214,2511
70,0,100,590,624,1214,2759
-100,-90,70,592,622,1214,2648
-50,70,40,589,625,1214,2732
110,-90,-80,592,622,1214,2648
-70,80,-120,582,632,1214,2679
10,-90,-180,592,622,1214,2648
120,-90,-70,592,622,1214,2648
110,80,50,589,625,1214,2571
0,-90,170,592,622,1214,2648
130,-90,-60,592,622,1214,2648
40,10,120,588,626,1214,2500
-170,-90,0,592,622,1214,2648
-20,-90,150,592,622,1214,2648
-140,-90,30,592,622,1214,2648
30,-90,-160,592,622,1214,2648
170,-90,-20,592,622,1214,2648
-50,-90,120,592,622,1214,2648
70,-60,60,570,644,1214,2580
-180,-90,-10,592,622,1214,2648
50,-90,-140,592,622,1214,2648
140,-10,-170,604,610,1214,2662
-30,-90,140,592,622,1214,2648
20,-90,-170,592,622,1214,2648
80,-90,-110,592,622,1214,2648
-150,-90,20,592,622,1214,2648
-80,10,70,597,617,1214,2582
70,-90,-120,592,622,1214,2648
90,30,-100,577,638,1215,2625
160,30,0,595,620,1215,2650
80,-20,80,593,622,1215,2595
150,40,0,595,620,1215,2663
-120,20,160,586,629,1215,2617
140,70,20,586,630,1216,2704
-150,40,-10,576,640,1216,2582
-100,60,100,591,625,1216,2755
-30,70,-160,602,614,1216,2569
-120,40,-30,586,630,1216,2827
20,30,-40,601,615,1216,2604
-90,-70,-90,580,636,1216,2391
-110,-20,-90,617,600,1217,2509
-100,50,-80,603,614,1217,2731
-100,10,-60,584,633,1217,2740
-40,-40,-40,600,617,1217,2614
30,-10,130,589,628,1217,2546
110,60,40,600,617,1217,2640
-90,-40,110,593,624,1217,2709
-130,70,-50,606,611,1217,2782
-40,-60,-40,596,621,1217,2439
-60,0,-180,594,624,1218,2760
90,10,-10,592,626,1218,2585
-90,-10,-40,617,601,1218,2408
-60,0,180,594,624,1218,2760
-70,40,-130,619,599,1218,2737
-70,-40,130,600,618,1218,2606
-130,-50,50,588,630,1218,2602
40,-20,130,577,641,1218,2662
-100,0,70,590,628,1218,2628
-120,30,-50,595,624,1219,2650
90,0,-70,589,630,1219,2594
0,-10,170,596,623,1219,2765
-140,-50,40,577,642,1219,2665
-60,0,-10,605,614,1219,2407
-120,-10,-140,615,604,1219,2560
100,10,-110,581,638,1219,2632
140,-40,-50,583,636,1219,2707
-100,20,-60,592,627,1219,2670
-40,-10,180,611,608,1219,2644
-40,-10,-180,611,608,1219,2644
-80,0,40,606,613,1219,2647
-40,-30,-40,595,625,1220,2546
-90,-50,-80,618,602,1220,2548
90,0,-40,593,627,1220,2709
100,0,-110,577,643,1220,2625
-60,20,-150,606,614,1220,2719
50,60,-60,587,633,1220,2617
-110,20,-30,601,619,1220,2782
70,-30,140,594,627,1221,2669
160,30,-10,580,641,1221,2588
-110,0,-100,612,609,1221,2742
90,-30,150,600,621,1221,2683
-110,-30,80,608,614,1222,2674
-80,-30,130,579,643,1222,2588
-50,-50,140,590,632,1222,2683
-60,70,50,598,624,1222,2715
-80,-20,140,579,643,1222,2653
30,10,130,601,622,1223,2540
-100,0,80,600,623,1223,2570
-130,-60,50,589,634,1223,2597
-110,10,-170,612,611,1223,2727
0,-80,170,584,639,1223,2641
-30,40,0,591,632,1223,2602
-170,-70,0,589,634,1223,2684
-130,80,-60,587,636,1223,2711
-50,10,-170,610,613,1223,2640
90,50,50,600,624,1224,2634
170,50,0,610,614,1224,2690
-90,10,-170,606,618,1224,2590
90,-40,-150,595,629,1224,2666
100,-30,-140,595,629,1224,2587
120,60,30,587,637,1224,2717
30,-20,140,588,636,1224,2615
110,-20,-160,590,635,1225,2686
-110,-80,70,595,630,1225,2738
20,-10,150,606,619,1225,2804
-60,70,-120,594,631,1225,2743
60,0,110,600,625,1225,2645
140,60,-140,607,618,1225,2615
-90,80,-100,590,635,1225,2710
-120,80,-70,590,636,1226,2728
170,30,0,598,628,1226,2771
50,-60,40,593,633,1226,2559
80,-30,160,597,629,1226,2691
20,80,140,594,632,1226,2648
180,60,-10,600,626,1226,2730
170,70,-170,616,610,1226,2636
-180,70,-180,604,622,1226,2681
-180,60,-10,600,626,1226,2730
0,-10,160,621,605,1226,2597
180,70,180,604,622,1226,2681
-180,70,180,604,622,1226,2681
70,-10,110,590,636,1226,2683
-170,-80,0,590,636,1226,2707
180,70,-180,604,622,1226,2681
-60,20,-160,596,631,1227,2668
-130,-20,50,598,629,1227,2726
-130,0,-170,601,626,1227,2514
130,60,20,597,630,1227,2663
-120,50,-40,599,629,1228,2680
-120,70,-60,611,617,1228,2793
140,-10,-30,595,633,1228,2571
-120,30,-20,600,628,1228,2789
-130,40,-20,586,642,1228,2780
-20,30,-170,601,627,1228,2827
-50,-80,130,581,647,1228,2701
70,30,-80,589,639,1228,2744
-50,50,-140,602,626,1228,2670
40,20,120,600,628,1228,2677
-50,10,0,610,618,1228,2592
-30,20,-170,608,620,1228,2678
170,20,-10,598,631,1229,2697
-140,70,140,590,639,1229,2636
180,-10,-10,599,630,1229,2649
-80,70,-100,613,616,1229,2796
150,30,-10,594,635,1229,2766
-180,-10,-10,599,630,1229,2649
-40,20,-170,622,607,1229,2765
-60,-60,130,586,643,1229,2604
100,-30,160,603,626,1229,2670
-180,10,-10,598,632,1230,2651
-90,-30,-70,608,622,1230,2514
-60,-20,-40,622,608,1230,2635
130,30,-10,592,638,1230,2520
150,50,10,601,629,1230,2801
180,10,-10,598,632,1230,2651
-10,-50,170,586,645,1231,2791
100,-30,170,606,625,1231,2663
90,20,-100,584,647,1231,2716
-120,10,-180,595,636,1231,2600
-150,-50,30,592,639,1231,2616
-110,40,-70,613,618,1231,2735
-120,10,180,595,636,1231,2600
110,50,20,612,620,1232,2499
-40,-30,160,608,624,1232,2715
-130,-30,40,601,631,1232,2641
20,-50,180,589,643,1232,2790
160,-60,150,602,630,1232,2530
-100,-70,-100,604,628,1232,2485
-50,40,-150,613,619,1232,2706
-150,70,150,588,644,1232,2640
-110,60,-60,608,624,1232,2792
20,-50,-180,589,643,1232,2790
130,-40,140,573,659,1232,2574
170,40,0,606,627,1233,2651
-170,-10,10,598,635,1233,2809
140,60,20,600,633,1233,2801
70,60,80,601,632,1233,2656
100,-70,-110,595,639,1234,2808
100,50,30,610,624,1234,2478
-130,-10,30,611,623,1234,2674
-10,10,180,607,627,1234,2853
-120,-50,60,610,624,1234,2674
-10,10,-180,607,627,1234,2853
110,0,-130,594,640,1234,2703
0,70,160,597,637,1234,2792
-90,10,170,615,620,1235,2783
-140,-60,40,591,644,1235,2592
0,60,160,607,628,1235,2737
-80,-60,110,589,646,1235,2757
-20,40,-10,598,637,1235,2638
-130,60,-40,603,632,1235,2818
150,70,-150,610,625,1235,2645
-170,-50,0,612,623,1235,2668
150,60,-150,610,625,1235,2677
-170,-60,0,609,627,1236,2747
-30,70,20,610,626,1236,2634
170,-60,-30,611,625,1236,2628
-20,-20,-30,579,657,1236,2623
180,-60,170,599,637,1236,2696
-180,-60,170,599,637,1236,2696
140,-30,160,612,624,1236,2780
-110,80,-80,603,633,1236,2734
-50,0,-180,607,629,1236,2714
90,-30,170,600,636,1236,2825
-50,0,180,607,629,1236,2714
-140,-10,-170,611,626,1237,2572
170,30,-10,603,635,1238,2742
170,60,-170,611,627,1238,2731
-170,70,-20,612,626,1238,2748
170,20,-170,600,638,1238,2701
-110,50,-70,618,620,1238,2773
-60,60,-120,614,624,1238,2798
-20,40,-170,599,639,1238,2772
-10,-10,180,603,635,1238,2817
-10,-10,-180,603,635,1238,2817
-100,-80,80,597,641,1238,2768
-100,-60,90,592,646,1238,2672
-70,-60,120,586,652,1238,2717
10,-20,160,611,627,1238,2794
-110,10,-160,611,628,1239,2711
-160,60,-20,602,637,1239,2802
-10,-80,160,590,649,1239,2654
130,-10,-160,616,623,1239,2651
70,0,50,585,654,1239,2693
100,30,-110,592,647,1239,2749
-90,-40,100,611,628,1239,2789
-140,-30,30,599,640,1239,2687
-60,-80,120,584,655,1239,2755
30,-30,150,616,624,1240,2798
90,-30,130,595,645,1240,2708
-130,-20,40,616,624,1240,2635
-80,10,-150,606,634,1240,2782
-120,70,120,597,643,1240,2642
100,0,-40,609,631,1240,2805
70,40,-80,580,660,1240,2727
80,-50,70,576,665,1241,2583
90,-30,-180,611,630,1241,2651
90,-30,180,611,630,1241,2651
20,10,140,606,635,1241,2676
-80,60,-100,620,621,1241,2820
-70,60,-110,618,623,1241,2767
110,60,30,611,631,1242,2560
-120,-40,60,603,639,1242,2711
-20,70,10,598,644,1242,2742
100,-30,-150,617,625,1242,2823
-140,60,-30,606,636,1242,2778
-80,-20,-50,619,623,1242,2626
100,60,40,616,626,1242,2647
-90,-50,100,607,636,1243,2725
140,60,10,622,621,1243,2730
90,-70,-120,605,638,1243,2790
40,-50,30,602,641,1243,2504
50,20,110,587,656,1243,2627
150,-40,150,591,653,1244,2623
-80,20,90,624,620,1244,2713
-40,70,-150,620,624,1244,2647
-160,0,10,590,654,1244,2683
10,-20,170,595,649,1244,2812
-70,70,-110,616,628,1244,2764
110,20,-120,600,644,1244,2760
-110,-10,80,607,637,1244,2735
-80,-40,120,594,650,1244,2706
-110,10,-10,618,626,1244,2819
20,40,-40,607,638,1245,2706
-110,10,-120,609,636,1245,2771
170,-50,-30,605,640,1245,2592
-170,70,170,613,632,1245,2648
-110,10,-130,621,624,1245,2596
-120,20,-10,619,626,1245,2707
0,-70,170,608,637,1245,2700
150,-80,-50,609,636,1245,2657
-100,-20,100,601,644,1245,2648
-160,-40,20,600,646,1246,2714
-30,40,-160,615,631,1246,2825
-80,-10,150,596,650,1246,2723
160,40,0,601,645,1246,2831
150,70,10,601,645,1246,2718
30,-70,-170,610,636,1246,2734
-140,30,-10,606,640,1246,2676
-100,80,-90,605,642,1247,2743
-120,60,-50,606,641,1247,2797
-130,70,130,599,648,1247,2641
-110,10,-150,627,620,1247,2727
-70,-10,160,600,648,1248,2803
170,80,-170,610,638,1248,2717
-80,-50,-70,622,626,1248,2512
70,-50,60,588,660,1248,2645
20,-30,170,603,645,1248,2787
160,60,-160,623,625,1248,2734
60,-80,-140,602,646,1248,2777
-90,70,-90,619,629,1248,2855
-10,70,0,598,651,1249,2678
70,40,80,619,630,1249,2725
-30,-70,150,586,663,1249,2684
60,-40,170,619,630,1249,2730
30,0,130,621,628,1249,2788
-130,-70,50,606,643,1249,2694
160,30,-160,619,630,1249,2823
100,-40,100,606,644,1250,2760
10,80,150,608,642,1250,2678
-80,30,-120,619,631,1250,2854
130,10,-20,596,654,1250,2520
-90,-80,90,594,656,1250,2814
120,-40,130,581,669,1250,2659
-150,10,170,595,655,1250,2800
-90,10,160,623,627,1250,2715
160,-30,-30,620,630,1250,2624
-160,50,170,617,633,1250,2749
150,60,10,611,639,1250,2864
-80,-30,-60,622,628,1250,2643
-80,40,80,614,637,1251,2648
160,-10,-180,615,636,1251,2881
-110,70,-70,623,628,1251,2802
-160,-20,20,604,647,1251,2790
160,-10,180,615,636,1251,2881
-100,30,-80,603,648,1251,2762
-50,30,-160,638,613,1251,2791
-90,20,-100,604,647,1251,2870
-170,10,0,615,636,1251,2772
-100,30,-90,607,644,1251,2837
-100,-10,-60,617,634,1251,2520
-160,70,-30,627,624,1251,2792
-20,60,-170,602,649,1251,2659
100,-30,-170,610,642,1252,2661
10,0,150,615,637,1252,2734
-160,70,160,595,657,1252,2637
160,80,0,605,647,1252,2740
40,-20,10,604,648,1252,2627
120,60,20,608,645,1253,2634
180,-10,170,587,666,1253,2756
-120,-70,60,611,642,1253,2724
-180,-10,170,587,666,1253,2756
-170,-30,10,600,653,1253,2725
-110,-50,70,613,640,1253,2756
130,30,-140,602,651,1253,2767
-90,-60,100,607,647,1254,2752
-20,50,-170,608,646,1254,2790
-120,-60,-120,629,625,1254,2644
40,-30,140,623,631,1254,2739
-140,10,10,617,637,1254,2788
-120,-30,60,598,656,1254,2784
10,10,-30,596,659,1255,2800
-60,10,-170,621,634,1255,2781
-140,20,0,615,640,1255,2808
60,-60,50,600,655,1255,2655
-70,-80,110,599,656,1255,2779
-170,50,-10,618,637,1255,2787
-170,-60,180,595,660,1255,2729
-170,-60,-180,595,660,1255,2729
80,30,40,624,631,1255,2514
140,30,-10,595,660,1255,2566
-80,0,170,619,637,1256,2897
90,-30,120,614,643,1257,2775
-100,0,-30,626,631,1257,2771
-20,-10,-180,613,644,1257,2857
-40,40,-160,632,625,1257,2856
-20,-10,180,613,644,1257,2857
140,50,0,621,636,1257,2718
-180,0,-10,609,649,1258,2739
-10,0,180,604,654,1258,2826
180,0,-10,609,649,1258,2739
-10,0,-180,604,654,1258,2826
-160,20,0,622,636,1258,2780
-10,-70,-10,613,645,1258,2590
-120,-10,40,620,638,1258,2872
-10,20,170,612,646,1258,2747
60,10,-50,604,654,1258,2870
50,-30,140,609,649,1258,2784
-100,40,-90,605,654,1259,2856
-30,-60,150,609,650,1259,2902
30,-50,20,604,655,1259,2595
100,-40,-120,613,646,1259,2645
70,-40,60,604,655,1259,2574
80,-20,110,617,642,1259,2835
-80,-80,100,600,659,1259,2810
100,20,-110,588,672,1260,2870
150,-30,160,615,645,1260,2725
-80,0,-180,614,646,1260,2843
160,40,-160,640,620,1260,2904
-80,0,180,614,646,1260,2843
-120,-40,-120,622,638,1260,2590
-100,70,-80,620,640,1260,2816
90,-50,-130,606,654,1260,2635
-70,0,180,625,635,1260,2860
-70,0,-180,625,635,1260,2860
-90,0,130,614,647,1261,2781
-110,-70,70,610,651,1261,2783
-150,-20,20,613,648,1261,2774
-20,-60,160,618,643,1261,2736
90,-30,100,590,671,1261,2735
90,70,60,614,647,1261,2880
80,-70,-130,618,643,1261,2768
80,70,70,615,646,1261,2818
160,80,-160,623,638,1261,2781
40,-30,20,606,656,1262,2623
-90,-10,120,600,662,1262,2710
90,0,-50,603,659,1262,2741
-100,-50,80,614,648,1262,2786
80,40,60,606,656,1262,2609
-170,40,-180,619,644,1263,2802
-50,20,-170,616,647,1263,2693
-90,-30,110,605,658,1263,2936
-120,-60,60,604,659,1263,2736
-170,40,180,619,644,1263,2802
60,50,-70,608,655,1263,2638
170,-60,160,611,652,1263,2642
30,-20,130,618,646,1264,2703
70,20,70,614,650,1264,2561
20,-60,180,612,652,1264,2785
170,80,-10,617,647,1264,2773
-80,-50,110,608,656,1264,2737
20,-60,-180,612,652,1264,2785
0,80,160,611,653,1264,2733
160,70,0,608,656,1264,2781
-60,-50,130,612,652,1264,2777
-90,60,-90,625,640,1265,2870
-120,-30,50,614,651,1265,2699
10,-30,170,616,649,1265,2815
110,-10,-130,614,651,1265,2768
-40,-70,140,600,665,1265,2805
20,-20,150,628,637,1265,2854
60,30,-70,608,657,1265,2917
-110,0,-90,629,636,1265,2883
-110,30,140,604,661,1265,2714
100,70,50,626,639,1265,2869
140,70,-140,617,649,1266,2671
-90,-50,90,616,650,1266,2835
-90,60,-100,643,623,1266,2777
-120,-10,60,625,641,1266,2887
-50,70,-140,626,640,1266,2699
150,10,-160,613,653,1266,2611
100,10,-20,621,645,1266,2730
-140,-40,30,617,649,1266,2633
30,-50,180,603,664,1267,2867
-180,20,-10,614,653,1267,2742
-110,20,160,616,651,1267,2739
-10,30,170,634,633,1267,2719
180,20,-10,614,653,1267,2742
-120,50,-60,631,636,1267,2837
-160,-60,-170,602,665,1267,2788
-100,50,-90,636,631,1267,2841
160,-20,170,595,672,1267,2713
30,-50,-180,603,664,1267,2867
120,20,-130,604,664,1268,2821
-100,-10,40,624,644,1268,2797
-20,-80,150,607,661,1268,2707
-90,10,120,627,641,1268,2789
-10,-40,170,618,650,1268,2889
-150,60,160,618,650,1268,2890
-40,0,180,629,639,1268,2828
-10,30,-20,615,653,1268,2732
-40,0,-180,629,639,1268,2828
-110,-20,80,606,663,1269,2791
-10,10,160,625,644,1269,2702
-30,-40,160,624,645,1269,2802
140,0,-160,617,652,1269,2688
150,80,-150,616,653,1269,2805
160,20,-160,609,661,1270,2693
60,0,0,606,664,1270,2659
-70,20,-140,636,634,1270,2890
-160,-80,10,609,661,1270,2818
160,0,-20,635,635,1270,2733
-60,0,170,613,657,1270,2806
-80,-20,130,619,651,1270,2742
40,-40,160,629,641,1270,2885
-90,10,140,625,645,1270,2802
-130,50,140,633,638,1271,2859
-180,-20,170,636,635,1271,2947
180,-20,170,636,635,1271,2947
-80,60,-110,651,620,1271,2714
-120,-10,50,632,639,1271,2840
-110,20,-40,635,636,1271,2895
-110,70,110,607,664,1271,2730
-90,20,-110,611,660,1271,2928
0,-60,170,625,646,1271,2882
-40,50,-150,623,648,1271,2837
-30,50,-160,618,653,1271,2848
-150,60,-30,618,653,1271,2956
-70,0,10,630,642,1272,2701
-170,50,-180,613,659,1272,2857
-170,50,180,613,659,1272,2857
-80,0,60,634,638,1272,2724
140,20,-150,637,635,1272,2756
-50,-20,160,629,643,1272,2888
100,-50,-110,610,662,1272,2717
70,70,80,610,662,1272,2810
-90,0,100,609,664,1273,2843
170,-50,160,597,676,1273,2666
-100,10,-100,633,640,1273,2962
-140,50,150,626,647,1273,2968
-90,-20,-60,621,652,1273,2800
90,30,20,637,636,1273,2616
-160,60,170,624,650,1274,2825
-160,-20,-180,599,675,1274,2751
-160,-20,180,599,675,1274,2751
-90,10,180,639,636,1275,2837
-120,-20,60,618,657,1275,2924
110,70,40,625,650,1275,2881
-70,-50,120,612,663,1275,2730
-180,-50,-20,635,640,1275,2717
130,0,-150,623,652,1275,2671
180,-50,-20,635,640,1275,2717
-100,-10,90,616,659,1275,2866
-150,50,160,625,650,1275,2899
170,-70,-30,631,644,1275,2710
-90,10,-180,639,636,1275,2837
-110,0,10,635,640,1275,2767
-130,40,150,601,674,1275,2743
-120,40,140,611,665,1276,2763
90,-40,-160,624,652,1276,2894
130,60,10,626,650,1276,2757
-120,50,130,631,645,1276,2863
50,-10,120,619,657,1276,2789
-70,10,40,644,632,1276,2686
-120,-30,-120,629,648,1277,2655
-80,40,-120,635,642,1277,2888
-150,-10,-180,613,664,1277,2829
-150,-10,180,613,664,1277,2829
-90,0,120,627,650,1277,2838
-120,30,-40,643,634,1277,2903
-60,-10,160,633,644,1277,2696
-120,-40,50,619,658,1277,2698
-180,80,-20,624,654,1278,2791
160,50,-160,641,637,1278,2876
160,40,-10,616,662,1278,2797
150,50,0,627,651,1278,2813
50,-80,-150,608,670,1278,2831
-120,-20,50,646,632,1278,2826
110,-30,180,624,654,1278,2818
-100,0,-40,627,651,1278,2741
180,80,-20,624,654,1278,2791
130,60,-130,626,652,1278,2670
-70,20,-150,620,658,1278,2855
110,-30,-180,624,654,1278,2818
-170,-20,10,612,666,1278,2925
-30,-80,140,621,657,1278,2783
-120,40,-40,641,637,1278,2854
-80,-10,140,627,652,1279,2741
-70,10,-160,611,668,1279,2864
-130,0,20,636,643,1279,2802
20,-50,10,619,660,1279,2644
-80,20,-130,629,650,1279,2978
110,-40,120,626,653,1279,2823
120,40,0,619,660,1279,2636
-110,20,-50,631,649,1280,2764
-70,40,60,647,633,1280,2806
70,10,70,632,648,1280,2678
40,60,-50,611,669,1280,2724
150,50,-150,627,653,1280,2780
120,30,-10,623,658,1281,2617
180,50,-10,632,649,1281,2828
-100,60,-90,646,635,1281,2798
-180,80,-180,627,654,1281,2720
-70,10,-150,614,667,1281,2810
180,80,180,627,654,1281,2720
-10,70,170,614,667,1281,2852
-180,80,180,627,654,1281,2720
180,80,-180,627,654,1281,2720
90,0,-60,611,670,1281,2733
-180,50,-10,632,649,1281,2828
-10,-70,160,627,654,1281,2833
-130,50,-40,634,648,1282,2815
70,0,80,623,659,1282,2732
-130,20,0,620,662,1282,2888
-110,-40,70,605,677,1282,2818
-10,10,170,618,664,1282,2750
-170,60,-180,639,643,1282,2858
-170,60,180,639,643,1282,2858
-100,10,-70,631,651,1282,2842
-20,-30,170,621,661,1282,2874
-30,60,-160,629,653,1282,2728
60,-30,140,633,649,1282,2872
60,90,100,616,667,1283,2694
-90,40,100,619,664,1283,2809
-140,90,-60,616,667,1283,2694
0,-20,160,633,650,1283,2802
20,90,140,616,667,1283,2694
120,90,40,616,667,1283,2694
-170,90,-30,616,667,1283,2694
-110,90,-90,616,667,1283,2694
90,90,70,616,667,1283,2694
160,90,0,616,667,1283,2694
80,90,80,616,667,1283,2694
40,90,120,616,667,1283,2694
150,90,10,616,667,1283,2694
-10,90,170,616,667,1283,2694
-180,90,-20,616,667,1283,2694
-10,80,170,617,666,1283,2777
-130,90,-70,616,667,1283,2694
10,90,150,616,667,1283,2694
-80,90,-120,616,667,1283,2694
70,90,90,616,667,1283,2694
120,-30,170,627,656,1283,2775
-50,90,-150,616,667,1283,2694
30,90,130,616,667,1283,2694
-60,90,-140,616,667,1283,2694
-40,90,-160,616,667,1283,2694
140,90,20,616,667,1283,2694
-20,90,180,616,667,1283,2694
50,90,110,616,667,1283,2694
-120,90,-80,616,667,1283,2694
-20,90,-180,616,667,1283,2694
-150,90,-50,616,667,1283,2694
-30,90,-170,616,667,1283,2694
-100,90,-100,616,667,1283,2694
130,90,30,616,667,1283,2694
100,90,60,616,667,1283,2694
-90,90,-110,616,667,1283,2694
-70,90,-130,616,667,1283,2694
-160,90,-40,616,667,1283,2694
180,90,-20,616,667,1283,2694
-70,60,-120,648,635,1283,2754
40,-10,-10,626,657,1283,2954
170,90,-10,616,667,1283,2694
0,90,160,616,667,1283,2694
110,90,50,616,667,1283,2694
-110,30,-70,628,655,1283,2823
-30,0,-20,629,654,1283,2749
-30,50,10,611,673,1284,2631
140,80,-140,627,657,1284,2806
-10,40,170,632,652,1284,2820
120,70,-120,605,679,1284,2704
30,-30,10,625,659,1284,2651
-80,10,80,628,656,1284,2752
-110,10,-110,640,645,1285,2928
-60,10,-180,632,653,1285,2805
50,-40,160,635,650,1285,2890
-120,30,150,615,670,1285,2844
130,-30,170,615,670,1285,2734
-60,10,180,632,653,1285,2805
-80,0,160,623,662,1285,2868
-160,-30,20,618,668,1286,2866
60,60,90,611,675,1286,2789
-30,-20,170,631,655,1286,2832
160,-30,160,617,669,1286,2877
-160,40,-10,621,665,1286,2925
120,80,-120,614,672,1286,2806
-150,-80,20,630,656,1286,2889
-100,20,150,625,661,1286,2868
-60,30,40,641,646,1287,2746
80,-20,90,628,659,1287,2696
-60,20,30,654,633,1287,2651
120,-50,-80,648,639,1287,2755
-100,60,-80,630,658,1288,2941
-110,-10,40,632,656,1288,2789
110,-40,130,615,673,1288,2805
-90,20,-120,629,659,1288,3004
-100,-10,30,640,648,1288,2836
-110,20,-60,626,662,1288,2732
70,-30,60,616,672,1288,2770
70,0,90,627,661,1288,2850
-120,-50,50,630,658,1288,2756
10,50,-30,623,665,1288,2776
-50,60,40,644,644,1288,2907
60,0,-20,638,650,1288,2914
-150,50,-20,625,663,1288,2890
-170,30,-180,640,649,1289,2785
170,0,180,649,640,1289,3039
160,-80,-40,629,660,1289,2759
70,-20,120,626,663,1289,2858
-100,-10,50,646,643,1289,2894
170,0,-180,649,640,1289,3039
-40,20,0,642,647,1289,2727
70,50,80,622,667,1289,2757
70,30,70,633,656,1289,2498
-170,30,180,640,649,1289,2785
50,70,100,630,660,1290,2883
70,-70,-140,639,651,1290,2848
-90,10,130,634,656,1290,2859
110,-30,170,633,657,1290,2737
180,-60,-20,641,649,1290,2750
-180,-60,-20,641,649,1290,2750
70,10,-60,626,664,1290,2809
60,10,100,628,662,1290,2806
-130,10,10,629,662,1291,2952
-40,-40,150,626,665,1291,2864
30,-40,170,620,671,1291,2989
-110,50,120,626,665,1291,2908
-170,60,-20,633,658,1291,2958
-170,40,-10,631,660,1291,2912
20,-40,170,626,666,1292,3019
-120,0,-150,633,659,1292,2876
-50,0,170,640,652,1292,2938
-30,0,-180,633,659,1292,2856
-30,0,180,633,659,1292,2856
-100,-30,90,624,668,1292,2917
60,70,90,630,662,1292,2852
-20,-50,160,637,655,1292,2933
-100,20,-70,621,671,1292,2864
-120,40,-60,644,649,1293,2807
-60,30,-150,649,644,1293,2817
-150,30,-10,632,661,1293,2813
100,-60,-110,601,692,1293,2741
110,-70,-100,619,674,1293,2847
120,60,-120,621,672,1293,2748
130,80,-130,616,677,1293,2793
50,-50,40,621,672,1293,2760
50,60,100,628,665,1293,2802
160,50,0,626,667,1293,2968
50,-30,30,611,683,1294,2638
-140,-80,30,634,660,1294,2930
-150,70,-40,632,662,1294,2868
-160,80,160,634,660,1294,2721
80,20,20,647,647,1294,2695
-90,30,110,646,648,1294,2821
130,-10,-40,630,665,1295,2747
20,-30,150,628,667,1295,2929
50,10,110,629,666,1295,2665
-130,-30,-140,627,668,1295,2790
-160,-50,10,631,664,1295,2828
170,30,-20,642,654,1296,2788
80,-30,130,630,666,1296,2917
80,10,-70,631,665,1296,2931
-100,10,-80,633,663,1296,2920
120,-20,-160,639,657,1296,2818
-10,20,-20,627,669,1296,2863
160,-50,-40,647,649,1296,2777
-170,80,-30,631,666,1297,2817
-20,-30,-30,624,673,1297,2751
10,-40,170,632,665,1297,2861
-120,0,20,643,654,1297,2896
-160,80,-40,632,665,1297,2824
-20,80,180,620,678,1298,2785
-80,10,-160,622,676,1298,2962
170,-10,-20,646,652,1298,2719
-60,20,-170,641,657,1298,2873
-170,80,170,637,661,1298,2750
-20,80,-180,620,678,1298,2785
100,-30,-160,644,654,1298,2827
-90,20,120,654,644,1298,2841
120,0,-140,623,675,1298,2862
-160,-60,10,637,661,1298,2875
-110,-10,50,638,661,1299,2956
-90,60,90,632,667,1299,2945
20,-30,160,630,669,1299,2911
-110,-10,70,621,678,1299,2908
170,70,-10,631,668,1299,2798
-90,-20,110,623,676,1299,2837
-110,-70,-110,640,659,1299,2706
-120,10,0,647,652,1299,2927
-120,60,-60,630,669,1299,2935
160,60,0,640,659,1299,2991
150,40,-10,637,662,1299,2865
0,-20,170,628,672,1300,2872
-120,20,-50,634,666,1300,2830
-100,-70,80,614,686,1300,2855
-130,-20,30,651,649,1300,2798
40,70,110,636,664,1300,2862
-70,30,60,657,643,1300,2855
-110,10,-140,665,635,1300,2982
140,60,0,636,664,1300,2867
-50,-30,150,643,657,1300,2907
120,70,30,638,662,1300,2913
40,-80,-160,625,675,1300,2908
10,-50,170,620,680,1300,2973
-140,60,-40,628,673,1301,2926
-60,60,50,650,651,1301,2912
-10,50,170,633,668,1301,2938
50,-50,-180,642,659,1301,2767
50,-50,180,642,659,1301,2767
-170,-40,0,634,667,1301,2810
-30,30,-170,654,648,1302,2923
-130,-50,40,644,658,1302,2670
-120,70,-70,630,672,1302,2892
-140,0,-180,632,670,1302,2858
-100,70,100,636,666,1302,2857
-140,0,180,632,670,1302,2858
130,0,-30,639,663,1302,2682
130,70,-130,623,679,1302,2689
-140,70,-50,628,674,1302,2892
20,-30,0,610,693,1303,2792
-60,70,-130,634,669,1303,2774
-90,0,110,625,678,1303,2775
0,-40,170,627,676,1303,3013
-80,-40,110,633,670,1303,2849
-60,-20,150,632,671,1303,2891
-30,-60,-30,620,683,1303,2589
-70,-50,-60,642,661,1303,2641
-60,30,-160,660,644,1304,2987
-180,30,-170,615,689,1304,2925
-140,80,140,638,666,1304,2801
40,-50,180,632,672,1304,2917
-30,80,-170,625,679,1304,2840
40,-50,-180,632,672,1304,2917
-90,-10,30,646,658,1304,2931
-90,-10,40,640,664,1304,2934
-130,40,-40,650,654,1304,2850
-130,40,-30,639,665,1304,2919
180,30,-170,615,689,1304,2925
-50,-70,130,627,678,1305,2873
110,60,-110,626,679,1305,2647
-80,-30,120,624,681,1305,3012
50,30,-60,619,686,1305,2942
30,20,-40,621,684,1305,2810
-150,20,170,642,663,1305,3120
-110,-60,70,623,683,1306,2812
-130,80,130,643,663,1306,2821
-90,-10,50,635,671,1306,2945
-130,70,-60,629,677,1306,2919
-120,-20,40,650,656,1306,2897
110,70,-110,620,686,1306,2665
-150,30,170,641,665,1306,2892
-60,30,-170,655,651,1306,2907
160,10,-20,624,682,1306,2803
-130,60,-50,633,673,1306,2921
90,60,50,636,671,1307,2806
90,-30,110,628,679,1307,2826
110,10,-120,613,694,1307,2955
-160,-70,10,627,680,1307,2883
-140,40,-20,642,665,1307,2800
60,-50,-170,637,670,1307,2699
40,0,120,643,665,1308,2934
170,40,-10,643,665,1308,2944
-40,-80,130,635,673,1308,2857
-70,10,-170,641,667,1308,3068
-110,60,-70,640,668,1308,2976
100,70,-100,624,684,1308,2610
120,-40,-80,675,634,1309,2704
-110,-50,60,643,666,1309,2752
130,-20,-50,629,680,1309,2606
-110,40,130,652,657,1309,2763
-120,30,-60,640,669,1309,2919
160,0,-170,646,663,1309,2977
120,-50,120,630,680,1310,2762
120,-10,-150,643,667,1310,2833
-140,-20,-160,652,658,1310,2830
-150,80,-50,638,672,1310,2829
-180,10,-180,635,675,1310,3134
-150,80,150,637,673,1310,2746
100,-30,-180,644,666,1310,2976
100,-30,180,644,666,1310,2976
180,10,-180,635,675,1310,3134
60,-30,130,643,667,1310,2924
-180,10,180,635,675,1310,3134
-130,40,-50,653,657,1310,2968
180,10,180,635,675,1310,3134
20,90,-20,623,688,1311,2918
40,90,-40,623,688,1311,2918
50,90,-50,623,688,1311,2918
30,90,-30,623,688,1311,2918
180,90,180,623,688,1311,2918
140,90,-140,623,688,1311,2918
-140,90,140,623,688,1311,2918
-20,90,20,623,688,1311,2918
180,90,-180,623,688,1311,2918
-170,90,170,623,688,1311,2918
-80,90,80,623,688,1311,2918
70,90,-70,623,688,1311,2918
120,90,-120,623,688,1311,2918
-10,-30,170,627,684,1311,3005
0,90,0,623,688,1311,2918
-180,90,-180,623,688,1311,2918
170,90,-170,623,688,1311,2918
-50,90,50,623,688,1311,2918
-100,90,100,623,688,1311,2918
90,90,-90,623,688,1311,2918
180,30,-10,635,676,1311,2775
-40,90,40,623,688,1311,2918
160,90,-160,623,688,1311,2918
130,90,-130,623,688,1311,2918
10,90,-10,623,688,1311,2918
-70,90,70,623,688,1311,2918
-160,90,160,623,688,1311,2918
-130,90,130,623,688,1311,2918
-60,90,60,623,688,1311,2918
100,-40,-130,627,684,1311,2712
-110,90,110,623,688,1311,2918
-140,50,-30,627,684,1311,2949
60,90,-60,623,688,1311,2918
-10,90,10,623,688,1311,2918
-50,40,30,647,664,1311,2879
100,90,-100,623,688,1311,2918
-80,30,90,647,664,1311,2820
-30,90,30,623,688,1311,2918
-90,90,90,623,688,1311,2918
-180,30,-10,635,676,1311,2775
110,90,-110,623,688,1311,2918
-180,90,180,623,688,1311,2918
150,90,-150,623,688,1311,2918
80,90,-80,623,688,1311,2918
-120,90,120,623,688,1311,2918
-90,-60,90,629,682,1311,2882
-150,90,150,623,688,1311,2918
-150,-30,20,635,677,1312,2915
170,10,-170,642,670,1312,2961
-70,20,60,651,661,1312,2904
-70,10,50,651,661,1312,2852
170,40,-20,652,660,1312,2903
-140,60,150,635,677,1312,3010
-50,60,-140,652,661,1313,3004
-160,50,-20,638,675,1313,2999
-90,20,-150,654,659,1313,3023
-40,60,30,644,670,1314,2769
60,0,-10,627,687,1314,2839
180,-50,170,626,688,1314,2751
140,-20,-40,629,685,1314,2718
-110,-20,70,649,665,1314,2993
-100,30,130,641,673,1314,2821
110,80,40,646,668,1314,2881
130,70,20,649,665,1314,2870
-180,-50,170,626,688,1314,2751
90,80,60,648,666,1314,2982
60,-50,50,619,696,1315,2874
-110,-40,60,652,663,1315,2851
170,60,-10,657,658,1315,3001
-150,-20,-170,633,682,1315,2852
-90,0,70,640,675,1315,2869
30,60,-40,624,691,1315,2847
-10,-40,-20,633,682,1315,2882
30,70,120,646,670,1316,2837
-20,-40,160,647,669,1316,3013
-100,-40,80,631,685,1316,2951
-10,0,160,638,678,1316,2808
110,80,-110,620,696,1316,2813
-100,20,-90,647,669,1316,2977
-100,10,-90,644,672,1316,3033
-70,20,-160,652,664,1316,2948
40,-60,-170,637,679,1316,2887
-120,-10,-130,657,660,1317,2794
-100,-60,80,626,691,1317,2851
-100,-10,20,668,649,1317,2897
-50,-80,-50,627,690,1317,2714
-60,-40,-50,638,679,1317,2878
0,-50,170,641,676,1317,2997
-80,50,-120,645,672,1317,2946
-70,50,-130,659,658,1317,2947
-110,10,-20,662,656,1318,2829
60,-50,180,658,660,1318,2803
50,-10,10,627,691,1318,2619
70,-20,60,612,706,1318,2869
120,50,10,631,687,1318,2813
60,-50,-180,658,660,1318,2803
110,0,-40,631,687,1318,2909
-100,20,-80,649,670,1319,2959
30,-40,160,646,673,1319,2953
-140,40,160,642,677,1319,2967
60,-70,-150,656,663,1319,2967
110,-10,-60,633,686,1319,2740
150,50,-10,649,670,1319,2877
-100,-50,70,642,677,1319,2811
180,40,-10,649,671,1320,2825
60,40,-70,632,688,1320,2764
-100,50,110,631,689,1320,2946
-180,-40,170,626,694,1320,2824
-180,40,-10,649,671,1320,2825
-110,50,-80,662,658,1320,2943
-130,50,-50,657,663,1320,2954
140,50,-140,657,663,1320,2763
180,-40,170,626,694,1320,2824
120,-40,140,623,698,1321,2728
-70,-80,-70,637,684,1321,2735
0,-40,160,636,685,1321,2925
20,-70,180,633,688,1321,2935
130,-20,-170,660,661,1321,2889
20,-70,-180,633,688,1321,2935
-150,0,10,642,680,1322,2899
-170,0,0,655,667,1322,2935
140,70,10,654,668,1322,2870
-70,70,-120,641,681,1322,2862
-120,60,-70,644,678,1322,2875
80,80,70,646,676,1322,2947
-40,-10,170,652,670,1322,2920
-60,-50,120,632,690,1322,2815
-60,-80,-60,633,689,1322,2727
60,-20,40,628,695,1323,2772
-90,-10,20,664,659,1323,2878
-50,-80,120,643,680,1323,2899
130,50,-130,645,678,1323,2741
100,80,50,650,673,1323,2944
-90,-10,-30,660,663,1323,2799
70,-30,130,660,663,1323,2851
-110,80,110,652,671,1323,2890
-140,-10,20,658,665,1323,2769
140,40,-10,643,681,1324,2815
170,50,-10,648,676,1324,2918
-40,-60,140,637,687,1324,2898
-50,10,180,650,674,1324,2934
-90,-10,110,636,688,1324,2929
-50,10,-180,650,674,1324,2934
-110,60,-80,657,667,1324,2890
90,80,-90,644,680,1324,2774
-170,70,-30,655,670,1325,2906
-100,20,-110,643,682,1325,3143
-180,-30,170,625,700,1325,2899
-100,-50,-90,670,655,1325,2871
180,-30,170,625,700,1325,2899
-110,70,-80,646,680,1326,2923
-40,80,-160,645,681,1326,2852
70,-50,-160,633,693,1326,2806
-110,40,-80,661,665,1326,3089
-130,-80,40,651,675,1326,2975
-120,80,120,653,673,1326,2870
-110,-20,50,654,672,1326,2924
-10,20,160,659,667,1326,2850
-80,-50,100,647,679,1326,2928
-40,-80,-40,642,684,1326,2760
-180,70,-20,653,673,1326,2861
-160,60,-30,654,672,1326,3002
180,70,-20,653,673,1326,2861
-80,-70,100,626,701,1327,2937
-100,20,-100,664,663,1327,3079
180,40,-170,631,696,1327,2873
30,-30,140,645,682,1327,2946
-40,60,-150,653,674,1327,2903
-60,60,-130,668,659,1327,2940
-180,40,-170,631,696,1327,2873
-90,-70,90,628,699,1327,2933
-130,60,140,653,674,1327,3053
-30,-80,-30,651,677,1328,2815
-100,20,160,648,680,1328,2915
-10,60,170,640,688,1328,2942
-40,10,-180,649,679,1328,2998
0,0,150,663,665,1328,2904
60,-20,120,649,679,1328,3024
70,0,60,643,685,1328,2905
0,-30,170,640,688,1328,2954
-40,10,180,649,679,1328,2998
150,60,0,646,682,1328,2944
0,-30,160,638,690,1328,2979
-120,30,-30,645,684,1329,2999
-30,10,-180,647,682,1329,2931
0,50,-20,635,694,1329,2915
40,-10,120,650,679,1329,2878
-40,30,-170,662,667,1329,2983
110,-20,-130,651,678,1329,2906
-140,80,-60,649,680,1329,2892
-30,10,180,647,682,1329,2931
-120,-70,-120,657,672,1329,2859
-130,60,-60,649,680,1329,2888
170,-80,-30,647,682,1329,2869
-150,60,-40,658,671,1329,2970
170,-40,-30,675,654,1329,2780
10,-30,160,644,686,1330,2999
30,-10,-20,627,703,1330,2952
90,70,-90,656,674,1330,2652
-50,-40,140,646,684,1330,2891
-160,70,-40,656,674,1330,2889
-70,30,-140,682,648,1330,2997
70,80,80,651,679,1330,2985
-90,0,80,630,700,1330,2778
90,20,0,650,680,1330,2781
0,-10,150,652,678,1330,2836
-140,-40,-150,648,682,1330,2811
-70,-20,140,650,681,1331,2891
-50,80,-150,646,685,1331,2923
-100,-20,90,635,696,1331,2930
0,-70,0,636,695,1331,2718
-130,-30,30,662,669,1331,2938
80,-20,100,640,691,1331,2957
120,80,30,658,673,1331,2893
-70,-10,150,640,692,1332,3025
-150,70,-50,656,676,1332,2964
130,-50,-70,663,669,1332,2906
-130,30,-50,655,677,1332,2971
-60,-40,130,638,694,1332,2833
-170,30,-10,644,688,1332,2940
-80,-10,50,659,673,1332,2965
-90,30,-110,657,675,1332,3013
-20,10,-180,641,691,1332,3017
-20,10,180,641,691,1332,3017
150,70,-10,659,673,1332,2997
-90,-50,80,654,679,1333,2906
-20,0,-180,636,697,1333,3050
-20,0,180,636,697,1333,3050
130,-30,-60,664,669,1333,2881
-70,-50,110,652,681,1333,2850
-110,-30,60,660,673,1333,2967
170,-20,170,630,704,1334,3091
-30,20,-180,653,681,1334,2966
-70,0,170,655,679,1334,2949
40,60,110,662,672,1334,2959
-110,30,-80,642,692,1334,2952
-60,50,50,674,660,1334,3017
-30,20,180,653,681,1334,2966
-70,10,-180,650,685,1335,2911
-30,-50,150,651,684,1335,3039
-70,10,180,650,685,1335,2911
110,0,-120,640,695,1335,2929
-110,-30,50,670,665,1335,2961
20,10,-30,626,709,1335,2969
-70,-70,110,628,707,1335,2960
150,10,-20,636,700,1336,2753
120,-70,-90,655,681,1336,2899
50,50,-60,651,685,1336,2885
-100,-10,60,654,682,1336,2901
-160,30,-10,660,676,1336,2998
-170,20,-180,650,686,1336,3006
10,-10,150,667,669,1336,3031
-170,20,180,650,686,1336,3006
30,-80,-170,633,704,1337,3002
-150,-70,20,646,691,1337,3056
120,70,20,653,684,1337,2908
-150,-50,-160,642,695,1337,2889
70,-10,60,629,708,1337,2863
-70,80,-130,654,683,1337,2989
-60,80,-140,653,684,1337,2975
140,-40,150,629,708,1337,2853
-20,-80,-20,647,690,1337,2871
0,-50,160,648,690,1338,3021
-10,-20,170,648,690,1338,3107
120,50,-120,651,687,1338,2859
-100,-10,80,648,690,1338,2969
0,10,150,670,668,1338,2981
-90,70,-100,650,688,1338,2937
-170,-50,-180,652,686,1338,2951
-80,-60,100,645,693,1338,2893
-90,50,-110,662,676,1338,2970
-170,-50,180,652,686,1338,2951
-130,80,-70,657,681,1338,2920
-100,80,100,658,680,1338,2922
-120,-10,30,664,674,1338,2982
-90,20,-140,656,683,1339,3101
-60,-70,120,631,708,1339,2942
-80,0,150,657,682,1339,2919
180,-70,-20,664,675,1339,2886
60,-10,30,654,685,1339,2731
-90,-10,60,664,675,1339,2917
-10,-60,160,663,676,1339,3073
-180,-70,-20,664,675,1339,2886
-60,-30,140,656,684,1340,2950
100,80,-100,643,697,1340,2817
130,70,10,660,680,1340,2985
80,-40,180,658,682,1340,2864
80,-40,-180,658,682,1340,2864
60,80,90,657,683,1340,2999
-150,40,170,652,688,1340,2994
-140,10,0,669,671,1340,3032
150,-20,-180,638,703,1341,2921
150,-20,180,638,703,1341,2921
-180,50,-170,662,679,1341,2974
-90,20,-130,660,681,1341,3141
100,0,-100,642,699,1341,3020
180,50,-170,662,679,1341,2974
130,80,20,667,675,1342,2930
-80,80,-120,660,682,1342,2999
-120,60,130,659,683,1342,3099
-10,0,170,650,692,1342,3010
180,50,-20,667,675,1342,3028
10,-20,150,668,674,1342,3091
-180,50,-20,667,675,1342,3028
-80,70,-110,648,694,1342,2913
-120,-80,50,660,683,1343,2973
-30,-50,-30,646,697,1343,2748
160,50,-10,664,679,1343,2973
-180,60,-20,678,665,1343,2891
180,60,-20,678,665,1343,2891
0,-30,-20,641,702,1343,2949
-100,70,-90,655,688,1343,2937
-140,60,-50,657,687,1344,2984
180,-30,-20,668,676,1344,2871
-160,10,0,658,686,1344,3050
-140,-50,30,652,692,1344,2776
-180,-30,-20,668,676,1344,2871
-80,-80,-80,650,694,1344,2779
10,20,-30,662,682,1344,2912
-90,-40,90,656,689,1345,3033
-130,30,-40,666,679,1345,2999
-70,-60,110,660,685,1345,3001
-120,-40,40,664,681,1345,2904
0,40,150,655,690,1345,2938
-80,80,80,661,685,1346,2943
20,60,-30,643,703,1346,2970
-110,-30,70,644,702,1346,3010
10,-40,160,659,688,1347,3079
70,10,40,658,689,1347,2923
-170,50,-20,679,668,1347,3106
-20,-70,150,652,695,1347,2945
-60,40,-150,681,666,1347,2987
150,-10,-170,657,690,1347,2982
-10,-10,160,665,682,1347,2948
-50,0,-10,655,692,1347,2793
-50,40,-160,667,680,1347,3077
-60,-80,110,656,691,1347,2948
-120,10,-170,655,692,1347,2920
-120,-30,40,679,668,1347,2835
180,20,-20,659,689,1348,2970
90,10,-90,650,698,1348,3008
-120,20,-40,675,673,1348,2973
-110,-10,60,654,694,1348,3118
-90,40,-110,669,679,1348,3073
-30,40,-170,668,680,1348,2995
-160,-40,10,654,694,1348,2952
-180,20,-20,659,689,1348,2970
-70,-40,120,646,702,1348,2902
-20,70,-180,646,703,1349,2934
-20,70,180,646,703,1349,2934
80,-30,120,663,686,1349,2881
-90,80,-110,668,681,1349,2987
0,30,150,657,692,1349,2932
-110,-80,60,652,697,1349,2954
70,-40,170,653,696,1349,3045
10,-60,170,658,691,1349,2977
-140,70,-60,674,675,1349,3012
150,-50,-50,677,672,1349,2875
100,60,-100,651,699,1350,2854
150,60,-10,666,684,1350,2961
0,20,150,649,701,1350,3036
-50,-60,130,639,711,1350,2967
170,20,-20,673,677,1350,2931
-140,40,-30,663,687,1350,3029
-170,-30,0,664,686,1350,2947
10,-20,-20,641,709,1350,3069
-120,80,-80,660,691,1351,2962
-180,-40,-20,661,690,1351,2864
-80,10,90,672,679,1351,2886
-100,-10,-50,671,680,1351,2758
-60,50,-140,673,678,1351,2996
120,-10,-50,646,705,1351,2840
-150,10,0,654,697,1351,2971
180,-40,-20,661,690,1351,2864
-20,50,0,657,694,1351,2938
-20,-60,-20,660,691,1351,2754
-180,40,-20,650,701,1351,2958
180,40,-20,650,701,1351,2958
-90,-10,100,641,710,1351,3023
-110,0,0,676,676,1352,2942
-30,-30,160,660,692,1352,3017
-90,-30,100,648,704,1352,3054
-70,80,70,656,696,1352,2971
-100,-30,-80,670,682,1352,2913
-130,30,-20,660,692,1352,3110
-180,-20,-20,667,685,1352,2867
-140,0,10,670,682,1352,3010
80,-30,80,637,715,1352,2907
50,10,-40,637,715,1352,3038
-60,-60,120,652,700,1352,3008
-120,20,-20,665,687,1352,3089
180,-20,-20,667,685,1352,2867
110,-20,-140,661,692,1353,3018
-90,80,90,665,688,1353,2925
20,-50,170,645,708,1353,3054
20,0,140,659,694,1353,2935
110,-20,-150,644,709,1353,2970
20,-10,140,658,695,1353,2983
140,70,0,664,689,1353,3009
160,70,-20,658,696,1354,2986
140,10,-150,665,689,1354,2931
-100,-60,70,666,688,1354,2899
30,80,120,652,702,1354,3073
-80,-50,90,645,709,1354,2914
-50,-50,130,659,695,1354,2944
-70,30,-150,666,688,1354,3068
-70,40,-140,676,678,1354,3069
-110,10,-30,658,697,1355,3044
-20,30,-180,653,702,1355,3059
130,-50,130,653,702,1355,2869
-100,50,-100,669,686,1355,3015
-110,-10,-80,677,678,1355,2976
-100,-10,10,678,677,1355,2916
-110,0,-80,686,669,1355,3045
-20,30,180,653,702,1355,3059
10,-40,0,654,702,1356,2854
-60,0,0,670,686,1356,2913
-90,0,90,650,706,1356,2959
-40,20,180,667,689,1356,2993
-80,-40,100,664,692,1356,3001
-80,20,100,682,674,1356,2998
-40,20,-180,667,689,1356,2993
-170,-10,0,662,694,1356,3084
-150,-60,20,655,701,1356,2964
-90,20,130,665,691,1356,3008
100,20,-10,664,693,1357,2777
-70,-80,100,663,694,1357,2967
-80,-10,130,654,703,1357,3008
-70,-50,100,651,706,1357,2832
40,80,110,659,698,1357,3069
150,-30,-40,658,699,1357,2956
150,-10,-30,659,698,1357,2896
-20,20,180,652,706,1358,3049
-20,20,-180,652,706,1358,3049
50,80,100,656,702,1358,3045
130,-70,-80,667,691,1358,2870
-140,-20,20,676,682,1358,2914
-110,-40,50,676,682,1358,2921
80,80,-80,670,688,1358,2846
20,60,130,667,691,1358,2958
130,20,-140,668,691,1359,3001
-40,-20,160,659,700,1359,2986
180,30,-20,657,702,1359,2982
-50,-40,130,668,691,1359,3031
-70,-30,130,660,699,1359,3021
20,-40,160,665,694,1359,2976
-80,10,-170,678,681,1359,3142
40,-30,130,656,703,1359,2911
-180,30,-20,657,702,1359,2982
-130,70,-70,672,687,1359,2985
120,-30,-180,668,692,1360,2906
50,-70,-160,670,690,1360,3060
120,-30,180,668,692,1360,2906
110,50,-110,651,709,1360,2917
100,-40,110,662,698,1360,2928
160,40,-20,655,706,1361,2987
-160,-10,10,649,712,1361,3069
20,-20,140,671,690,1361,3009
-80,30,-130,685,676,1361,3123
-30,-20,-30,655,706,1361,2852
-110,-60,60,662,699,1361,2924
-110,-20,60,674,688,1362,3000
140,80,10,676,686,1362,3002
10,60,140,645,717,1362,3103
60,30,90,664,698,1362,2980
-100,-80,70,662,700,1362,2954
110,-30,-170,650,712,1362,3055
-90,-20,100,655,708,1363,3009
-20,50,180,663,700,1363,3003
50,-40,150,670,693,1363,3086
-150,-50,20,658,705,1363,2874
-110,60,120,664,699,1363,3088
-20,50,-180,663,700,1363,3003
-110,80,-90,669,694,1363,3027
20,70,130,665,699,1364,2948
60,-10,110,652,712,1364,2960
50,0,110,676,688,1364,2932
-10,30,160,673,691,1364,3006
-170,20,-10,661,703,1364,2981
-110,-10,30,683,681,1364,3013
70,10,50,666,699,1365,2986
-90,-60,80,672,693,1365,2927
-90,70,90,661,704,1365,3014
-100,20,-120,667,698,1365,3119
-110,-40,-100,688,677,1365,2935
-10,-20,150,669,696,1365,3002
140,10,-20,659,707,1366,2925
-100,80,-100,672,694,1366,3068
-160,40,-20,666,700,1366,3159
60,-40,160,672,694,1366,3020
-30,-10,170,666,700,1366,3063
110,70,30,668,698,1366,2890
-110,20,-70,658,708,1366,3116
30,60,120,676,690,1366,2979
-120,50,-70,667,700,1367,2953
170,50,-20,665,702,1367,3031
-180,60,-170,688,679,1367,3027
70,20,-70,651,716,1367,3093
180,60,-170,688,679,1367,3027
-80,20,-140,671,696,1367,3144
-30,70,-170,665,703,1368,2979
-140,-70,30,658,710,1368,3118
-40,50,-160,665,703,1368,3052
-40,30,10,670,698,1368,2940
-90,-80,-90,663,705,1368,2858
20,80,130,663,705,1368,3089
-120,-20,-120,681,687,1368,2885
-90,-10,10,697,671,1368,3056
-150,50,-30,665,704,1369,3069
0,-20,150,684,685,1369,2916
30,-30,130,677,692,1369,2895
-50,30,-170,672,697,1369,3063
-130,60,-70,684,685,1369,2904
110,-60,-100,644,725,1369,2891
60,40,90,657,712,1369,2901
-80,20,-150,661,709,1370,3120
-120,0,10,668,702,1370,3137
50,-40,40,650,720,1370,2864
-10,-10,170,669,701,1370,3150
-100,60,-100,670,700,1370,2917
50,-20,120,673,697,1370,2966
110,-10,-120,663,707,1370,2919
50,40,-60,643,728,1371,2915
-80,0,140,667,704,1371,2972
-80,-80,90,658,713,1371,2970
-80,10,-180,672,699,1371,3172
-80,10,180,672,699,1371,3172
-40,-30,150,674,697,1371,3033
-20,40,180,669,702,1371,3002
-20,40,-180,669,702,1371,3002
170,-30,-30,677,694,1371,2837
150,70,0,674,697,1371,3020
40,30,-50,663,708,1371,3057
-160,60,-40,677,694,1371,3023
150,80,0,678,693,1371,3064
-100,20,-150,694,677,1371,3070
-180,20,-170,672,700,1372,3171
180,20,-170,672,700,1372,3171
-70,10,60,673,699,1372,3005
-80,-60,90,674,698,1372,2921
-90,-80,80,664,708,1372,2991
90,40,30,679,693,1372,2760
-130,30,160,675,697,1372,3132
-50,50,-150,673,700,1373,3041
160,60,-10,674,699,1373,3058
30,-10,120,679,694,1373,3039
-70,-20,-40,683,690,1373,3041
160,-40,160,656,718,1374,2879
-170,-20,0,674,700,1374,2987
80,40,50,687,687,1374,2962
-100,-20,-70,682,692,1374,2955
-20,60,180,666,708,1374,3017
-20,60,-180,666,708,1374,3017
160,30,-20,667,707,1374,2953
-150,60,-50,689,686,1375,3007
70,0,70,677,698,1375,2845
0,-40,-10,663,712,1375,2984
60,0,10,658,717,1375,2858
-130,20,-10,659,716,1375,3153
-120,70,-80,677,699,1376,3062
-140,50,-40,666,710,1376,3106
10,-70,10,660,716,1376,2836
-100,40,-100,669,707,1376,3132
140,40,-140,689,687,1376,2877
20,-80,180,653,723,1376,3089
20,-80,-180,653,723,1376,3089
180,70,-30,682,695,1377,2991
-180,70,-30,682,695,1377,2991
60,50,90,668,709,1377,2977
-170,60,-30,673,704,1377,3001
-110,10,-100,687,690,1377,3183
120,10,-130,651,726,1377,3081
70,-10,100,685,692,1377,3145
110,40,-110,655,722,1377,2913
-60,-50,110,672,705,1377,2859
10,40,140,680,697,1377,2864
-120,60,-80,672,706,1378,2911
-110,60,-90,665,713,1378,2906
-30,50,-170,671,707,1378,3000
-130,-10,20,676,702,1378,3049
-90,20,-160,684,694,1378,3094
-70,20,-170,677,701,1378,3128
90,10,-20,664,715,1379,3012
-130,-60,-130,681,698,1379,3002
130,50,0,659,720,1379,2978
80,-50,-150,674,705,1379,3043
20,50,130,678,701,1379,2931
-150,40,-20,666,713,1379,3161
130,-30,180,661,718,1379,2885
-150,-40,20,660,719,1379,2916
130,-30,-180,661,718,1379,2885
-50,20,-180,682,698,1380,3011
-50,20,180,682,698,1380,3011
140,-50,-60,678,702,1380,2967
-110,20,-90,683,697,1380,3218
-100,-10,70,675,705,1380,3044
90,-40,-170,686,694,1380,2883
130,-40,150,662,718,1380,2887
-70,30,-170,690,691,1381,2988
-70,40,-150,683,698,1381,3001
-140,20,-10,682,699,1381,3040
-90,60,-110,677,704,1381,2973
70,10,60,681,701,1382,2975
-100,-40,70,679,703,1382,3026
-40,0,170,666,716,1382,3090
-60,80,60,664,718,1382,3019
-30,60,20,663,719,1382,2983
140,-20,-170,668,714,1382,2915
-140,60,-60,691,692,1383,2988
100,30,0,674,709,1383,2836
-130,10,180,667,716,1383,2994
-110,20,-80,667,716,1383,3136
30,-20,0,659,724,1383,2980
-130,10,-180,667,716,1383,2994
-110,30,-90,668,716,1384,3133
-150,70,-60,671,713,1384,3091
-100,20,-130,692,692,1384,3156
-70,30,-160,696,688,1384,3147
-70,0,20,699,685,1384,2930
10,-30,150,673,711,1384,3070
60,20,-60,666,718,1384,2936
70,10,30,683,702,1385,3012
180,-80,-20,671,714,1385,2969
110,-80,-100,682,703,1385,3010
-80,20,-160,679,706,1385,3298
-180,-80,-20,671,714,1385,2969
-120,20,-30,689,696,1385,3096
-180,80,-30,682,704,1386,3044
130,40,-130,689,697,1386,2980
10,50,140,689,697,1386,3041
-70,-60,100,682,704,1386,3049
40,-40,150,703,683,1386,3049
170,70,-30,676,710,1386,3016
0,-30,150,689,697,1386,3055
-80,-30,110,664,722,1386,3145
-80,50,80,686,700,1386,3009
-130,20,170,678,708,1386,3247
170,0,-170,663,723,1386,3038
-20,0,-20,669,717,1386,2923
80,70,-80,670,716,1386,2824
180,80,-30,682,704,1386,3044
150,40,-150,692,695,1387,2875
-100,-30,80,672,715,1387,3133
70,80,-70,678,709,1387,2897
-130,50,-60,670,717,1387,3078
110,-40,140,669,718,1387,2979
-60,10,20,696,691,1387,2868
100,-40,-140,678,709,1387,2892
-60,10,170,674,714,1388,3068
-40,-50,140,688,700,1388,3111
-100,30,-100,671,717,1388,3166
170,80,-20,676,712,1388,3090
100,70,40,688,700,1388,2894
70,-60,-150,676,712,1388,3034
-10,-80,-10,678,710,1388,2926
-130,20,-50,684,704,1388,3038
-110,-30,-90,696,693,1389,2862
110,-40,-100,661,728,1389,2839
10,30,-30,693,696,1389,3006
70,-20,110,665,724,1389,3097
-130,20,-40,694,695,1389,3036
160,80,-10,681,709,1390,3094
-40,70,-160,674,716,1390,2996
-130,-60,40,678,712,1390,2950
100,50,-100,677,713,1390,3143
60,-60,-160,675,715,1390,3050
-160,70,170,688,702,1390,3067
-60,0,160,685,705,1390,3032
-10,50,-10,678,713,1391,3047
150,0,-160,667,724,1391,3051
100,-40,140,675,717,1392,3006
-80,-20,120,673,719,1392,3058
-140,40,-40,683,709,1392,3115
-10,-10,150,686,706,1392,3018
-20,-20,170,661,731,1392,3197
0,-40,150,684,708,1392,3121
60,0,20,679,713,1392,3017
-160,40,180,682,710,1392,3075
160,-40,-40,692,700,1392,2914
-170,10,-10,662,730,1392,3096
-100,20,180,675,717,1392,3092
80,10,-10,686,706,1392,2961
-160,40,-180,682,710,1392,3075
-100,20,-180,675,717,1392,3092
70,-50,-170,682,711,1393,3023
90,-40,90,653,740,1393,3002
110,-50,110,671,722,1393,3004
160,20,-20,675,719,1394,3081
-130,-50,-130,684,710,1394,2989
-170,40,-20,694,700,1394,3154
-130,-70,40,679,715,1394,3111
-130,10,0,687,707,1394,3205
-160,50,-30,687,707,1394,3166
10,60,-20,670,724,1394,3074
10,-50,160,678,716,1394,3055
-20,30,-10,671,723,1394,2989
10,-70,170,667,727,1394,3151
-10,10,-20,666,728,1394,3011
80,50,60,668,726,1394,2881
10,40,-30,678,717,1395,3061
-10,-60,-10,693,702,1395,2944
-170,50,-30,687,708,1395,3057
-110,50,-90,691,704,1395,3107
-160,70,-50,689,706,1395,3085
-50,50,40,696,699,1395,3201
130,-20,-160,695,700,1395,2926
-140,70,-70,676,719,1395,3094
-120,40,-70,697,699,1396,3177
-180,-10,-20,690,706,1396,2945
40,-50,170,678,718,1396,3091
20,-10,-20,658,738,1396,3136
-80,60,80,685,711,1396,3182
100,-80,-110,678,718,1396,3028
-170,60,-40,678,718,1396,3153
-170,70,-40,699,697,1396,3081
160,50,-20,671,725,1396,3030
180,-10,-20,690,706,1396,2945
80,-30,110,682,714,1396,2965
-140,-60,30,680,716,1396,2921
-50,-50,120,678,718,1396,3045
-50,30,180,697,700,1397,3091
160,70,-150,674,723,1397,2871
100,-40,150,673,724,1397,2865
-50,30,-180,697,700,1397,3091
80,60,60,689,708,1397,3040
70,10,10,693,705,1398,2947
-170,80,-40,686,712,1398,3099
-20,60,10,674,724,1398,3028
140,0,-150,681,717,1398,2960
-100,20,170,687,711,1398,3160
-40,-40,130,702,696,1398,3130
-140,20,170,692,706,1398,3248
-110,10,-50,688,711,1399,3001
-60,40,-160,687,712,1399,3095
-10,-40,160,662,737,1399,3189
-40,40,-170,687,712,1399,3129
0,50,150,689,710,1399,3146
-20,20,170,677,722,1399,3110
10,-30,-10,675,724,1399,2987
-40,80,40,670,730,1400,3122
20,-40,10,668,732,1400,2954
-10,-50,160,679,721,1400,3146
70,10,20,697,703,1400,2866
90,-80,-120,679,721,1400,3051
-90,50,100,678,722,1400,3008
-30,60,-170,685,715,1400,3017
100,-40,120,682,718,1400,3112
160,60,-20,683,717,1400,3046
30,-40,150,695,706,1401,3176
140,-30,-50,683,718,1401,3179
120,-40,150,681,720,1401,3088
130,40,-10,688,713,1401,2961
90,70,50,693,708,1401,3053
-120,30,-70,681,720,1401,3166
-120,-60,50,689,712,1401,2914
-80,40,-130,704,698,1402,3196
-30,10,-10,693,709,1402,2955
-80,-10,40,690,712,1402,3095
-50,10,170,690,712,1402,3174
140,-30,170,686,716,1402,3136
-30,-70,140,671,731,1402,3031
-60,20,-180,688,714,1402,3043
-60,20,180,688,714,1402,3043
-50,80,50,674,729,1403,3077
-100,-20,80,677,726,1403,3171
50,20,-50,678,725,1403,3012
-90,20,180,701,702,1403,3045
-90,20,-180,701,702,1403,3045
-90,-10,90,676,727,1403,3080
150,30,-150,691,712,1403,3023
180,60,-30,686,717,1403,3129
-180,60,-30,686,717,1403,3129
-100,-80,-100,684,720,1404,2936
-170,20,-20,692,712,1404,3098
-100,40,120,694,710,1404,3018
10,80,140,679,725,1404,3128
40,80,-40,683,721,1404,2904
100,0,-50,672,732,1404,3138
-70,-10,-20,703,701,1404,3060
-120,10,-10,698,706,1404,3096
60,-30,120,697,707,1404,3023
-70,-30,-50,698,706,1404,3037
-70,-40,110,671,733,1404,3001
-110,20,170,692,712,1404,3195
80,-60,-140,674,731,1405,3087
30,50,120,684,721,1405,3015
-100,20,-140,715,690,1405,3156
70,10,-50,662,743,1405,3216
-90,-10,-20,706,699,1405,2948
40,-40,30,678,727,1405,2925
-100,-20,50,683,722,1405,3072
-30,-40,150,694,711,1405,3134
-140,20,-40,707,699,1406,3190
-90,-50,70,706,700,1406,3047
-10,40,160,693,713,1406,3210
-110,10,-90,703,703,1406,3336
-170,30,-20,685,721,1406,3065
-50,70,-150,680,726,1406,2998
170,60,-20,688,719,1407,3069
110,-40,160,684,723,1407,2920
-80,-10,-20,712,695,1407,2950
-40,60,-160,692,715,1407,3058
120,-80,-90,697,710,1407,3018
-110,10,-60,688,719,1407,3146
30,-60,-180,683,725,1408,3152
50,0,-20,685,723,1408,3164
30,-60,180,683,725,1408,3152
-60,-40,120,687,721,1408,3081
-110,70,-90,689,719,1408,3101
60,80,-60,680,728,1408,2920
70,20,60,665,743,1408,3007
10,70,140,675,734,1409,3083
-120,-70,50,676,733,1409,3107
-50,-70,120,685,724,1409,3061
-170,30,-30,700,709,1409,3206
50,80,-50,684,725,1409,2916
-40,40,20,703,706,1409,3073
60,-40,50,647,762,1409,2973
-60,40,50,703,706,1409,3177
110,30,-110,683,726,1409,2957
-100,-50,60,700,710,1410,3020
170,0,-20,678,732,1410,3058
-80,10,170,689,721,1410,3183
-160,20,-180,690,720,1410,3207
-120,50,-80,688,722,1410,3126
-160,20,180,690,720,1410,3207
-70,30,70,697,713,1410,3157
-110,-20,40,692,718,1410,3093
170,70,-20,696,715,1411,3108
-60,50,-150,706,705,1411,3064
-110,40,-90,689,722,1411,3223
-170,-60,-10,687,724,1411,2988
-130,30,-30,696,715,1411,3215
170,70,-160,688,723,1411,2957
50,-30,130,689,722,1411,3096
70,-30,120,686,725,1411,3064
-160,-50,-170,680,732,1412,3054
-80,10,160,692,720,1412,3146
170,40,-160,701,711,1412,3079
120,-30,-170,677,735,1412,3006
150,20,-20,676,736,1412,3120
160,70,-10,686,726,1412,3105
50,-50,170,698,714,1412,2922
-60,-50,-50,695,717,1412,2920
90,-40,160,690,722,1412,3148
90,-40,140,691,722,1413,2945
-20,10,170,674,739,1413,3096
20,-70,20,679,734,1413,2954
-160,30,180,696,717,1413,3187
-90,-10,0,707,706,1413,3109
-160,30,-180,696,717,1413,3187
110,-40,150,683,730,1413,3008
150,90,0,687,727,1414,3247
-10,90,160,687,727,1414,3247
40,90,110,687,727,1414,3247
90,90,60,687,727,1414,3247
-120,90,-90,687,727,1414,3247
80,-50,-160,681,733,1414,3157
-180,90,-30,687,727,1414,3247
70,90,80,687,727,1414,3247
0,90,150,687,727,1414,3247
-70,90,-140,687,727,1414,3247
110,90,40,687,727,1414,3247
10,30,140,691,723,1414,3058
-60,70,-140,686,728,1414,3026
-40,90,-170,687,727,1414,3247
-160,90,-50,687,727,1414,3247
10,90,140,687,727,1414,3247
160,90,-10,687,727,1414,3247
-70,-70,100,682,732,1414,3097
-100,90,-110,687,727,1414,3247
130,90,20,687,727,1414,3247
60,90,90,687,727,1414,3247
50,90,100,687,727,1414,3247
-80,90,-130,687,727,1414,3247
180,90,-30,687,727,1414,3247
20,90,130,687,727,1414,3247
-110,90,-100,687,727,1414,3247
30,90,120,687,727,1414,3247
170,90,-20,687,727,1414,3247
-150,90,-60,687,727,1414,3247
-140,80,-70,699,715,1414,3228
-60,90,-150,687,727,1414,3247
-130,-40,30,694,720,1414,3014
-20,-30,160,678,736,1414,3254
-30,90,180,687,727,1414,3247
-30,90,-180,687,727,1414,3247
-140,90,-70,687,727,1414,3247
60,-40,150,695,719,1414,3104
-170,90,-40,687,727,1414,3247
100,90,50,687,727,1414,3247
120,90,30,687,727,1414,3247
-50,90,-160,687,727,1414,3247
-130,90,-80,687,727,1414,3247
140,90,10,687,727,1414,3247
-90,90,-120,687,727,1414,3247
80,90,70,687,727,1414,3247
-20,90,170,687,727,1414,3247
-100,20,-160,713,701,1414,3045
-30,-40,-30,684,730,1414,3017
-100,-40,60,708,707,1415,3030
-100,-30,60,711,704,1415,3038
-80,10,100,701,714,1415,3075
-90,-10,-10,707,708,1415,3032
0,-80,0,689,726,1415,3021
-40,-40,140,698,717,1415,3146
100,-40,130,687,729,1416,3035
-80,60,-120,688,728,1416,3074
-110,20,-110,685,731,1416,3248
20,-20,120,711,705,1416,3032
-90,30,-120,695,721,1416,3379
80,-40,130,683,733,1416,2950
-140,30,-20,677,739,1416,3222
-10,-30,150,700,716,1416,3168
120,40,-120,686,730,1416,3157
10,-80,170,668,748,1416,3156
-160,-20,10,680,737,1417,3198
170,50,-160,721,696,1417,3148
-170,70,180,697,720,1417,3148
100,-50,-120,689,728,1417,3078
-160,20,-10,690,727,1417,3126
-70,20,70,702,715,1417,3198
-20,0,170,679,738,1417,3295
-170,70,-180,697,720,1417,3148
-50,-10,160,690,727,1417,3185
-130,0,10,695,722,1417,3198
-20,-60,150,688,729,1417,3178
50,-60,-170,691,726,1417,3135
-110,0,-70,721,696,1417,3143
-110,10,-40,709,709,1418,3111
-150,50,-40,697,721,1418,3131
-160,40,-30,716,702,1418,3179
-160,30,-20,701,717,1418,3211
-150,80,-60,697,721,1418,3217
-80,-40,90,679,739,1418,3127
-80,70,80,698,720,1418,3156
30,0,120,702,716,1418,3072
30,-40,20,691,727,1418,2906
-120,20,-60,703,716,1419,3157
-50,-40,120,691,728,1419,3154
20,-20,130,718,701,1419,2998
-160,60,-50,687,732,1419,3113
-10,-50,150,677,742,1419,3166
-60,-10,-20,693,726,1419,3122
30,-50,170,678,741,1419,3303
-10,-40,150,677,743,1420,3140
40,50,110,684,736,1420,3106
140,-50,140,695,725,1420,3048
-40,-50,130,703,717,1420,3257
-170,-70,-10,701,719,1420,3094
-140,50,-50,707,714,1421,3204
-20,80,20,685,736,1421,3110
-90,30,120,698,723,1421,3166
60,20,90,691,730,1421,3102
-100,-20,60,709,712,1421,3162
-130,80,-80,704,718,1422,3256
-60,-60,110,695,727,1422,3123
-20,0,160,690,732,1422,3072
-100,30,140,692,730,1422,3205
-80,40,-140,697,725,1422,3138
80,-40,160,696,726,1422,3219
-50,50,-160,701,721,1422,3022
-60,-70,110,678,744,1422,3105
40,50,-50,692,730,1422,3185
-170,-80,-10,683,739,1422,3104
-160,-90,0,676,747,1423,3121
-40,-70,130,681,742,1423,3046
110,-90,-90,676,747,1423,3121
60,-90,-140,676,747,1423,3121
-40,-90,120,676,747,1423,3121
-60,-90,100,676,747,1423,3121
-70,50,-140,706,717,1423,3092
-110,-90,50,676,747,1423,3121
140,-90,-60,676,747,1423,3121
-110,10,-80,700,723,1423,3246
30,80,-30,694,729,1423,2999
120,-90,-80,676,747,1423,3121
-170,-90,-10,676,747,1423,3121
-50,-90,110,676,747,1423,3121
40,-90,-160,676,747,1423,3121
130,-10,-150,689,734,1423,2978
100,-90,-100,676,747,1423,3121
20,40,130,678,745,1423,2984
-180,-90,-20,676,747,1423,3121
30,-90,-170,676,747,1423,3121
70,-90,-130,676,747,1423,3121
170,-90,-30,676,747,1423,3121
20,-90,180,676,747,1423,3121
20,-90,-180,676,747,1423,3121
-150,-90,10,676,747,1423,3121
10,-90,170,676,747,1423,3121
0,60,-10,700,723,1423,3088
80,-90,-120,676,747,1423,3121
-30,-90,130,676,747,1423,3121
-140,-90,20,676,747,1423,3121
160,-90,-40,676,747,1423,3121
-10,60,0,696,727,1423,3054
-160,-30,10,680,743,1423,3115
-10,-90,150,676,747,1423,3121
90,-90,-110,676,747,1423,3121
-130,-90,30,676,747,1423,3121
-70,-90,90,676,747,1423,3121
-20,-90,140,676,747,1423,3121
50,-90,-150,676,747,1423,3121
-130,50,-70,696,727,1423,3184
150,-90,-50,676,747,1423,3121
0,-90,160,676,747,1423,3121
90,-40,150,678,745,1423,3054
-120,-90,40,676,747,1423,3121
-100,-90,60,676,747,1423,3121
180,-90,-20,676,747,1423,3121
40,-70,-170,702,721,1423,3265
-80,-90,80,676,747,1423,3121
130,-90,-70,676,747,1423,3121
-90,-90,70,676,747,1423,3121
-110,20,-100,696,728,1424,3308
-150,20,-10,697,727,1424,3145
170,10,-20,692,732,1424,3132
-110,30,150,694,730,1424,3211
-160,80,-50,700,724,1424,3159
10,-10,-20,688,736,1424,3164
170,60,-30,701,723,1424,3172
80,-80,-130,689,735,1424,3126
-150,70,160,711,713,1424,3148
-50,-30,-40,702,722,1424,3113
110,-20,-120,684,740,1424,3096
140,80,0,701,723,1424,3028
160,-20,-30,709,716,1425,3106
-20,-50,-20,695,730,1425,3004
-130,70,-80,691,734,1425,3102
-30,80,30,683,742,1425,3164
-150,40,-30,700,725,1425,3293
110,-30,-100,680,745,1425,2942
-40,30,-180,696,730,1426,3228
170,60,-160,708,718,1426,3108
-70,0,160,680,746,1426,3293
170,-10,-180,695,731,1426,3254
-170,-50,-10,704,722,1426,3206
-180,70,-40,693,733,1426,3120
180,50,-30,699,727,1426,3166
-10,-80,150,688,738,1426,3200
170,-10,180,695,731,1426,3254
-40,30,180,696,730,1426,3228
-160,50,-40,702,724,1426,3160
90,50,40,711,715,1426,2962
-180,50,-30,699,727,1426,3166
180,70,-40,693,733,1426,3120
-90,20,140,699,727,1426,3134
20,-10,120,710,716,1426,3026
-120,30,-80,694,732,1426,3212
-140,-30,20,691,736,1427,3054
-110,-50,50,704,723,1427,3057
80,20,-80,689,738,1427,3352
130,-80,-80,704,723,1427,3065
-180,0,-180,691,736,1427,3149
160,10,-160,687,740,1427,3135
-180,0,180,691,736,1427,3149
180,0,180,691,736,1427,3149
-140,70,150,701,726,1427,3217
20,-20,-10,697,730,1427,3275
-100,70,-100,695,732,1427,3137
-100,-30,50,708,719,1427,3130
180,0,-180,691,736,1427,3149
-80,-70,90,684,743,1427,3083
-130,-70,-130,713,715,1428,3104
150,80,-10,708,720,1428,3009
-120,20,-80,699,729,1428,3222
0,-80,160,678,751,1429,3184
-30,0,170,699,730,1429,3229
20,-40,150,699,730,1429,3242
0,80,0,696,733,1429,3066
-60,-40,110,685,744,1429,3132
-160,-10,180,691,738,1429,3293
-80,0,70,707,722,1429,3161
-160,-10,-180,691,738,1429,3293
-170,-40,180,683,746,1429,3148
-110,-10,20,700,729,1429,3148
-170,-40,-180,683,746,1429,3148
100,-40,170,707,723,1430,3079
50,50,100,690,740,1430,3091
30,10,-30,676,754,1430,3223
140,-80,-70,705,725,1430,3115
-90,-40,80,693,737,1430,3178
-30,30,-180,697,734,1431,3260
20,80,-20,695,736,1431,3042
-30,30,180,697,734,1431,3260
110,-30,-160,698,733,1431,3048
-70,-10,140,701,730,1431,3151
0,80,150,700,731,1431,3211
10,20,140,687,744,1431,3124
-170,10,-180,706,726,1432,3238
0,-60,160,687,745,1432,3162
-160,30,-30,716,716,1432,3327
140,-70,-70,708,724,1432,2998
-30,-60,140,703,729,1432,3281
0,60,150,676,756,1432,3243
-20,-10,170,683,749,1432,3326
-170,10,180,706,726,1432,3238
-70,0,50,715,717,1432,3172
-180,70,-170,697,736,1433,3096
-20,-40,150,687,746,1433,3311
-10,-20,160,700,733,1433,3166
-50,40,-170,703,730,1433,3252
-120,-10,-120,704,729,1433,3108
60,-30,50,689,744,1433,2963
-30,30,0,714,719,1433,3075
110,30,-10,696,737,1433,2986
-80,-10,60,720,713,1433,3083
-160,40,-40,710,723,1433,3226
-110,-80,-110,700,733,1433,2987
180,70,-170,697,736,1433,3096
-70,50,-150,729,704,1433,3136
170,20,-160,687,747,1434,3166
-30,-50,140,707,727,1434,3309
100,40,-100,701,733,1434,3210
-30,-40,140,703,731,1434,3164
-90,-10,80,703,731,1434,3094
-10,50,160,704,730,1434,3191
-70,10,170,705,730,1435,3242
-10,80,10,693,742,1435,3111
70,-50,-180,705,730,1435,3222
-20,-50,150,684,751,1435,3305
-10,-60,150,699,736,1435,3251
70,-50,180,705,730,1435,3222
-50,-20,150,707,729,1436,3246
-140,-10,10,701,735,1436,3173
-140,30,-30,713,723,1436,3236
-70,60,-130,704,732,1436,3104
-20,30,170,707,729,1436,3234
180,40,-30,707,729,1436,3188
-180,40,-30,707,729,1436,3188
-110,-70,60,694,742,1436,3096
-90,70,-110,705,732,1437,3127
-180,-10,180,660,777,1437,3139
180,-10,-180,660,777,1437,3139
-150,-10,10,701,736,1437,3139
-130,70,140,714,723,1437,3250
180,-10,180,660,777,1437,3139
50,-10,110,701,736,1437,3135
70,-10,90,697,740,1437,3185
-180,-10,-180,660,777,1437,3139
-120,80,-90,709,728,1437,3264
-40,50,-170,706,731,1437,3187
-150,40,-40,724,714,1438,3293
10,10,140,700,739,1439,3119
130,80,10,705,734,1439,3095
120,0,-40,692,747,1439,3141
110,-30,-130,694,745,1439,3206
10,-80,10,701,739,1440,3035
60,-50,170,708,732,1440,3234
70,70,-70,702,738,1440,3007
80,-40,140,700,740,1440,3045
110,-50,-100,685,755,1440,3108
-60,50,-160,724,716,1440,3127
-60,30,180,713,727,1440,3093
-60,30,-180,713,727,1440,3093
170,30,-160,688,752,1440,3010
-140,50,-60,714,727,1441,3218
130,10,-140,721,720,1441,3111
-80,40,90,697,744,1441,3044
160,80,-20,713,728,1441,3024
-140,30,-40,723,718,1441,3307
110,20,-110,683,758,1441,3165
0,-60,0,704,737,1441,3067
-40,-20,-30,706,735,1441,3118
150,30,-20,689,753,1442,3060
-30,-30,140,711,731,1442,3247
-80,30,-140,700,742,1442,3266
-150,60,-60,708,734,1442,3095
70,-80,-140,701,742,1443,3211
-20,-40,140,704,739,1443,3278
-70,70,-130,700,743,1443,3097
-80,-60,-70,726,717,1443,3090
-20,-30,140,722,721,1443,3262
-60,-10,150,718,725,1443,3140
-100,-30,70,702,741,1443,3263
80,20,10,706,737,1443,3051
-80,-10,120,695,748,1443,3200
160,-10,-170,689,754,1443,3137
20,0,130,698,746,1444,3120
0,-70,160,690,754,1444,3244
100,-50,100,699,745,1444,3112
-20,-10,150,714,730,1444,3271
-80,50,-130,723,722,1445,3191
-120,0,0,712,733,1445,3217
0,-20,-20,690,755,1445,3165
-150,0,180,699,746,1445,3291
-70,70,70,708,737,1445,3229
-30,10,170,711,734,1445,3326
-50,-10,-20,705,740,1445,3051
-150,0,-180,699,746,1445,3291
110,-20,-90,713,732,1445,2941
-50,-60,120,714,731,1445,3223
180,10,-20,719,727,1446,3081
-120,-20,30,706,740,1446,3131
-20,-80,140,707,739,1446,3231
-90,-60,-80,725,721,1446,3036
-120,70,130,710,736,1446,3271
-10,60,160,694,752,1446,3294
-100,60,110,714,732,1446,3198
-10,-30,160,699,747,1446,3305
-180,10,-20,719,727,1446,3081
-70,-30,120,688,758,1446,3268
-110,0,-10,701,745,1446,3204
-90,20,170,738,709,1447,3106
-180,60,-40,700,747,1447,3251
-110,80,-100,721,726,1447,3293
180,60,-40,700,747,1447,3251
-80,-50,80,726,721,1447,3086
-100,-10,0,713,734,1447,3205
90,-50,-140,686,762,1448,3164
40,40,-50,699,749,1448,3139
150,70,-140,685,763,1448,2960
70,10,0,703,745,1448,3017
-100,-20,70,702,746,1448,3211
-90,-10,70,709,739,1448,3203
-130,-20,20,705,743,1448,3166
120,-60,-90,698,750,1448,3149
-130,40,-60,716,732,1448,3250
-80,10,150,718,730,1448,3129
-120,70,-90,706,742,1448,3185
-10,0,150,710,739,1449,3186
90,-40,130,706,743,1449,3060
-50,60,-150,707,742,1449,3211
120,-40,160,691,758,1449,3103
20,-60,20,692,757,1449,2970
-160,-80,0,693,756,1449,3177
90,60,-90,715,734,1449,3175
-30,20,170,705,744,1449,3246
70,30,60,705,744,1449,3111
-110,10,-70,700,749,1449,3333
-50,-30,140,702,748,1450,3265
-10,10,150,714,736,1450,3217
0,-10,-20,702,749,1451,3129
-170,-30,-180,694,757,1451,3176
-170,-30,180,694,757,1451,3176
160,60,-150,703,748,1451,3127
70,-40,160,718,733,1451,3203
150,-70,-60,721,730,1451,3060
-90,80,-120,720,732,1452,3317
-40,10,170,709,743,1452,3199
-150,50,-50,726,726,1452,3182
20,-10,130,707,745,1452,3053
10,80,-10,698,754,1452,3051
-140,50,160,724,728,1452,3352
120,-10,-140,690,762,1452,3231
-80,-60,80,721,731,1452,3249
120,80,20,717,735,1452,3117
20,-30,140,711,742,1453,3225
-170,-40,-10,732,721,1453,3304
-30,-20,160,710,743,1453,3334
-140,0,0,725,728,1453,3283
-180,0,-20,706,747,1453,3157
-100,80,-110,725,728,1453,3302
-80,70,-120,701,752,1453,3117
-10,80,160,704,749,1453,3279
120,-20,-70,715,738,1453,3158
180,0,-20,706,747,1453,3157
10,-40,150,713,740,1453,3223
0,70,150,695,758,1453,3186
-130,-10,-150,719,734,1453,3188
-150,-20,10,716,738,1454,3336
170,80,-30,725,729,1454,3015
-70,-20,130,701,753,1454,3294
-120,20,-70,710,744,1454,3260
-80,-20,110,714,740,1454,3206
70,40,70,703,751,1454,3002
110,-10,-70,704,750,1454,3095
-40,-60,130,717,737,1454,3379
-100,-20,40,726,728,1454,3287
130,-40,-70,720,734,1454,3186
30,-50,160,688,767,1455,3242
-120,40,-80,714,741,1455,3364
-160,0,0,716,739,1455,3301
-170,0,-180,702,753,1455,3289
-10,0,-20,701,754,1455,3133
-170,0,180,702,753,1455,3289
-30,-30,150,706,749,1455,3293
-120,0,-130,718,737,1455,3186
0,-50,150,715,741,1456,3273
-70,-40,100,690,766,1456,3129
70,-40,150,702,754,1456,3297
-150,60,170,714,742,1456,3158
-90,20,150,712,744,1456,3273
-150,50,170,723,733,1456,3320
160,-30,170,706,750,1456,3303
40,0,110,712,744,1456,3081
120,-30,-160,702,754,1456,3037
40,0,-20,701,756,1457,3299
100,-40,160,711,746,1457,3088
40,-40,140,722,735,1457,3288
40,-10,0,702,755,1457,3148
30,-20,120,721,736,1457,3163
50,-20,30,707,750,1457,3071
-140,30,170,704,753,1457,3307
-150,-80,10,689,769,1458,3181
-70,10,70,700,758,1458,3295
-20,-20,150,712,746,1458,3358
-90,-20,90,705,754,1459,3204
-120,-50,40,715,744,1459,3159
60,-40,140,702,757,1459,3065
40,-20,120,718,741,1459,3154
-100,-70,70,697,762,1459,3095
-20,-30,150,716,743,1459,3262
150,-30,170,713,746,1459,3270
-120,0,-140,734,725,1459,3287
60,10,-40,692,767,1459,3408
-30,-80,130,714,746,1460,3224
-80,80,-130,730,730,1460,3360
40,-20,20,698,762,1460,3178
-110,20,-120,715,745,1460,3265
100,-40,-150,713,747,1460,3277
-60,60,-140,719,741,1460,3219
120,30,-120,694,766,1460,3183
-170,70,-50,720,740,1460,3186
90,50,-90,714,746,1460,3296
-90,-60,70,721,740,1461,3241
50,40,100,702,759,1461,3130
50,-10,20,700,761,1461,3014
90,-50,-150,702,760,1462,3239
-120,-80,-120,716,746,1462,3133
-130,0,-160,730,732,1462,3101
70,-30,110,716,746,1462,3150
-140,40,-50,720,742,1462,3269
60,0,100,710,752,1462,3371
-70,80,-140,734,728,1462,3383
140,-10,-160,717,746,1463,3165
90,-40,170,719,744,1463,3239
-90,-70,80,698,765,1463,3112
-150,30,-20,716,747,1463,3403
110,80,30,727,736,1463,3168
-130,-80,30,694,769,1463,3198
-80,-10,20,743,720,1463,3201
70,-40,130,708,756,1464,3127
60,70,-60,724,740,1464,3109
70,-10,70,696,768,1464,3194
-20,0,150,721,743,1464,3170
80,-50,-170,722,742,1464,3223
150,-80,-60,726,738,1464,3160
-20,40,170,722,742,1464,3325
-70,-60,-60,739,725,1464,3125
110,-40,170,708,756,1464,3191
40,-50,160,720,745,1465,3170
-170,40,-30,718,747,1465,3243
-110,0,-60,729,736,1465,3172
-120,-10,20,720,745,1465,3256
-120,10,-20,722,743,1465,3390
-100,-80,60,699,766,1465,3174
180,80,-170,707,759,1466,2993
-60,70,60,715,751,1466,3208
-10,70,160,698,768,1466,3311
-180,80,-170,707,759,1466,2993
-110,-80,50,698,768,1466,3185
50,-40,140,713,753,1466,3101
-90,-40,70,734,733,1467,3188
90,10,-80,704,763,1467,3241
-90,-80,70,701,766,1467,3206
-50,-40,-40,705,762,1467,3250
-10,-50,-10,713,755,1468,3215
-70,60,70,733,735,1468,3351
-80,30,100,734,735,1469,3315
-120,0,-100,733,737,1470,3258
-90,20,160,738,732,1470,3259
-110,70,-100,719,751,1470,3241
-140,60,160,717,753,1470,3167
-90,-30,90,710,760,1470,3319
60,-80,-150,716,754,1470,3278
-60,20,40,734,736,1470,3092
-70,-50,90,727,743,1470,3158
-80,30,-150,728,742,1470,3392
-70,20,-180,717,754,1471,3266
-50,70,50,726,745,1471,3262
-70,20,180,717,754,1471,3266
-140,-80,20,701,771,1472,3240
150,20,-150,726,746,1472,3061
-130,-80,-130,730,742,1472,3220
-20,-50,140,722,750,1472,3248
-110,70,120,717,756,1473,3308
100,30,-100,720,753,1473,3208
80,70,60,741,732,1473,3199
-100,20,-170,743,730,1473,3272
-130,-50,30,725,748,1473,3244
-90,-20,50,731,742,1473,3305
-70,-60,90,728,745,1473,3279
-170,-10,-10,724,749,1473,3370
-150,40,-50,732,741,1473,3398
-130,30,-60,721,752,1473,3317
80,60,-80,718,755,1473,3363
130,-40,160,721,753,1474,3244
90,20,-90,686,788,1474,3408
-80,-80,80,703,771,1474,3215
-160,-70,0,704,770,1474,3282
-140,60,-70,728,746,1474,3215
100,10,-100,686,788,1474,3247
-120,20,170,712,762,1474,3269
-180,80,-40,736,738,1474,3010
30,-40,140,739,735,1474,3330
180,80,-40,736,738,1474,3010
110,0,-110,698,777,1475,3224
80,-40,170,719,756,1475,3207
110,60,20,718,757,1475,3112
-20,80,170,717,758,1475,3352
-40,-30,140,721,754,1475,3302
-70,40,70,740,736,1476,3247
-80,-10,-10,742,734,1476,3150
-20,-10,160,704,772,1476,3297
30,30,-40,722,754,1476,3236
-40,-80,120,721,755,1476,3218
-80,-10,30,739,737,1476,3303
140,20,-20,721,755,1476,3184
-170,80,-50,736,741,1477,3041
50,-50,160,734,743,1477,3219
-160,50,-180,720,757,1477,3255
-160,50,180,720,757,1477,3255
10,0,140,722,755,1477,3262
10,-60,10,703,774,1477,3154
130,-30,-170,739,738,1477,3311
-60,-80,100,713,764,1477,3244
-60,80,-150,733,744,1477,3407
-130,30,-70,713,765,1478,3368
120,-40,170,702,776,1478,3148
-120,-10,-100,737,741,1478,3155
-50,-80,110,714,764,1478,3210
-40,-10,160,711,767,1478,3378
-120,-80,40,705,773,1478,3235
-80,-10,0,738,741,1479,3296
100,0,-80,722,757,1479,3198
-140,-70,-140,733,747,1480,3320
-10,-70,150,716,764,1480,3331
-70,0,60,733,747,1480,3305
80,10,-60,720,760,1480,3291
-100,30,-110,726,754,1480,3545
-120,0,-120,740,740,1480,3229
30,40,120,702,779,1481,3170
-20,10,160,720,761,1481,3215
-90,-20,40,732,749,1481,3270
80,-40,150,720,761,1481,3254
-100,70,-110,719,762,1481,3286
20,-80,20,724,757,1481,3092
60,10,90,729,752,1481,3326
70,-20,100,714,768,1482,3259
-170,60,-50,710,772,1482,3270
-80,-30,100,720,762,1482,3432
-60,-50,100,724,758,1482,3218
-130,40,-70,731,751,1482,3371
-70,-80,90,708,774,1482,3250
100,0,-90,723,759,1482,3324
-70,0,40,727,755,1482,3257
-30,40,180,726,756,1482,3348
-30,40,-180,726,756,1482,3348
-100,-60,60,734,749,1483,3273
-150,30,-40,750,733,1483,3405
130,30,-130,721,762,1483,3272
-150,0,0,739,744,1483,3389
-160,70,-60,719,764,1483,3160
-120,-10,-110,733,750,1483,3137
70,-40,140,714,769,1483,3135
120,60,10,719,764,1483,3178
90,-40,120,721,762,1483,3141
-60,-30,130,711,772,1483,3316
-60,-70,100,723,761,1484,3340
-170,80,180,722,762,1484,3079
-10,-30,140,735,749,1484,3227
70,20,50,712,772,1484,3273
30,-70,30,725,759,1484,3113
-160,20,-20,724,760,1484,3426
-170,80,-180,722,762,1484,3079
-30,-40,130,735,750,1485,3313
-30,-30,-30,715,770,1485,3231
-80,-40,80,733,752,1485,3185
170,80,-160,715,770,1485,3012
150,40,-20,734,751,1485,3229
-50,-20,-30,717,768,1485,3279
120,-20,-150,719,766,1485,3232
-30,50,-180,724,762,1486,3374
40,20,-40,710,776,1486,3376
-140,-30,-150,723,763,1486,3238
-30,50,180,724,762,1486,3374
-170,50,-40,729,757,1486,3310
-80,10,110,731,755,1486,3379
-120,10,-40,742,744,1486,3303
-120,10,-30,754,732,1486,3265
20,30,130,736,751,1487,3158
-170,-30,-10,727,760,1487,3370
60,-10,40,709,778,1487,3140
-160,-50,0,716,771,1487,3311
-170,0,-10,722,765,1487,3235
-10,-10,-20,712,775,1487,3334
-110,-10,-70,744,743,1487,3153
-90,-20,60,726,761,1487,3276
130,60,0,726,762,1488,3163
-10,-50,140,731,757,1488,3340
-100,-10,-10,738,750,1488,3293
-90,30,-130,724,764,1488,3449
-80,0,90,727,761,1488,3252
-70,40,-160,749,740,1489,3253
-70,-30,110,715,774,1489,3386
20,-50,160,733,756,1489,3308
-50,0,160,725,765,1490,3408
110,-30,-120,701,789,1490,3313
110,-10,-110,712,778,1490,3210
80,30,30,720,770,1490,3084
100,60,30,731,759,1490,3071
-30,0,160,731,760,1491,3347
100,80,40,745,746,1491,3201
-80,20,110,751,740,1491,3293
140,50,-10,733,758,1491,3148
10,-30,140,735,756,1491,3239
-120,-20,-110,738,753,1491,3232
-110,0,-20,745,746,1491,3250
170,40,-30,745,746,1491,3271
30,-60,30,727,764,1491,3180
-170,30,-170,722,769,1491,3297
110,10,-110,705,786,1491,3337
40,40,110,712,779,1491,3195
150,60,-140,716,775,1491,3053
-40,-20,150,719,773,1492,3329
90,40,-90,730,762,1492,3165
-130,20,-20,716,776,1492,3479
80,-30,90,722,770,1492,3319
-160,80,-60,743,749,1492,3149
60,-20,110,718,774,1492,3293
40,-10,110,734,758,1492,3223
70,60,-70,721,771,1492,3358
140,30,-140,731,761,1492,3217
30,-80,30,737,755,1492,3098
20,-60,170,710,782,1492,3392
20,-30,130,749,743,1492,3247
-10,-40,140,749,743,1492,3310
-50,-30,130,725,767,1492,3423
-80,0,130,715,777,1492,3307
-90,70,-120,735,757,1492,3316
-160,30,-40,744,748,1492,3364
-20,50,170,745,748,1493,3312
100,40,10,733,760,1493,3180
-90,40,110,744,749,1493,3308
-100,-60,-90,742,751,1493,3122
170,-30,170,730,763,1493,3390
90,-40,100,724,770,1494,3188
-120,10,-160,737,757,1494,3427
-120,50,140,746,748,1494,3362
-80,0,80,736,758,1494,3190
-80,20,170,733,761,1494,3263
140,-30,-180,714,780,1494,3272
70,-10,80,710,784,1494,3249
-80,60,-130,737,757,1494,3295
-170,40,-170,713,781,1494,3356
140,-30,180,714,780,1494,3272
-130,20,-30,733,761,1494,3383
-40,50,30,737,757,1494,3313
-130,20,-60,731,764,1495,3423
-90,-70,70,733,762,1495,3277
-20,60,170,725,770,1495,3384
40,10,-30,717,778,1495,3370
-120,40,150,738,758,1496,3280
-90,50,-120,742,754,1496,3361
-70,20,80,742,754,1496,3291
-120,30,160,740,756,1496,3479
-40,70,40,728,768,1496,3367
-160,-60,0,713,783,1496,3291
20,-40,140,740,757,1497,3291
50,-20,110,736,761,1497,3323
-120,20,-90,744,753,1497,3303
80,30,-80,722,775,1497,3324
120,20,-120,719,779,1498,3163
80,-40,80,700,798,1498,3160
-140,40,-60,730,768,1498,3449
-70,-70,90,732,766,1498,3317
90,-60,-130,725,773,1498,3330
-50,-50,110,738,760,1498,3425
-170,-20,-10,745,754,1499,3311
-110,20,-180,734,765,1499,3359
80,10,-20,736,763,1499,3364
-110,-60,50,730,769,1499,3285
-60,40,-170,748,751,1499,3270
-130,50,150,748,751,1499,3474
-90,60,100,729,770,1499,3312
-110,20,180,734,765,1499,3359
-150,-40,-160,724,775,1499,3269
-90,-20,80,725,774,1499,3217
140,-40,160,710,790,1500,3190
30,-20,10,721,779,1500,3148
-50,60,-160,738,762,1500,3342
-10,20,150,729,771,1500,3354
-150,30,-30,730,770,1500,3467
-60,30,50,753,748,1501,3303
160,-80,-50,736,765,1501,3252
-50,80,-160,734,767,1501,3424
140,-40,-60,742,759,1501,3243
50,0,-10,726,775,1501,3301
-180,10,-170,728,773,1501,3193
180,10,-170,728,773,1501,3193
-10,-20,140,755,746,1501,3238
120,-30,-80,769,733,1502,3124
160,-90,160,738,764,1502,3205
60,60,-60,724,778,1502,3318
180,-90,-180,738,764,1502,3205
110,-90,110,738,764,1502,3205
120,-90,120,738,764,1502,3205
90,-90,90,738,764,1502,3205
70,-90,70,738,764,1502,3205
150,-90,150,738,764,1502,3205
90,-40,-180,726,776,1502,3249
90,-40,180,726,776,1502,3249
170,-90,170,738,764,1502,3205
100,0,-60,730,772,1502,3327
180,-90,180,738,764,1502,3205
100,-90,100,738,764,1502,3205
60,-90,60,738,764,1502,3205
140,-90,140,738,764,1502,3205
80,-90,80,738,764,1502,3205
130,-90,130,738,764,1502,3205
-180,-90,-180,738,764,1502,3205
-20,-90,-20,738,764,1502,3205
-120,-90,-120,738,764,1502,3205
20,0,-20,728,774,1502,3343
-10,-90,-10,738,764,1502,3205
-60,-90,-60,738,764,1502,3205
10,-90,10,738,764,1502,3205
-40,-90,-40,738,764,1502,3205
-70,-90,-70,738,764,1502,3205
30,-90,30,738,764,1502,3205
-110,-90,-110,738,764,1502,3205
50,-90,50,738,764,1502,3205
30,-70,180,728,774,1502,3432
-130,-90,-130,738,764,1502,3205
30,-70,-180,728,774,1502,3432
-100,-90,-100,738,764,1502,3205
-80,-90,-80,738,764,1502,3205
-50,-90,-50,738,764,1502,3205
0,-90,0,738,764,1502,3205
-180,-90,180,738,764,1502,3205
40,-90,40,738,764,1502,3205
-170,-90,-170,738,764,1502,3205
-140,-90,-140,738,764,1502,3205
-150,-90,-150,738,764,1502,3205
-30,-90,-30,738,764,1502,3205
-90,-90,-90,738,764,1502,3205
20,-90,20,738,764,1502,3205
-160,-90,-160,738,764,1502,3205
-90,-20,70,740,762,1502,3321
-130,60,-80,736,767,1503,3305
-40,-50,120,756,747,1503,3550
10,0,-20,712,791,1503,3399
-80,30,-160,749,754,1503,3469
-60,-20,140,723,780,1503,3420
-160,80,170,726,778,1504,3088
0,40,-20,736,768,1504,3312
-60,-60,100,746,758,1504,3355
170,50,-30,739,765,1504,3310
-80,-70,80,736,768,1504,3331
-90,60,-120,738,766,1504,3364
-150,-70,10,715,789,1504,3367
-30,30,170,739,765,1504,3363
-80,20,-170,734,770,1504,3448
-30,80,180,726,779,1505,3404
-70,0,30,744,761,1505,3279
-140,20,-50,752,753,1505,3404
-30,80,-180,726,779,1505,3404
-30,-20,150,732,773,1505,3546
-70,-40,90,731,774,1505,3213
-90,20,-170,749,756,1505,3271
-120,0,-110,745,760,1505,3246
-110,-30,40,729,776,1505,3324
170,-20,180,729,777,1506,3393
-100,60,-110,738,768,1506,3396
-20,20,-10,728,778,1506,3213
-140,-60,-140,735,771,1506,3262
-90,-20,-50,741,765,1506,3217
100,20,-100,712,794,1506,3271
150,-10,-160,718,788,1506,3316
170,-20,-180,729,777,1506,3393
-20,-20,160,723,783,1506,3399
-140,-20,10,737,769,1506,3413
50,70,-50,747,759,1506,3290
100,-40,180,731,776,1507,3299
0,-10,140,745,762,1507,3386
90,30,10,722,785,1507,3126
-140,-40,20,733,774,1507,3343
-50,-70,110,727,780,1507,3419
10,-10,140,734,773,1507,3479
-50,20,170,762,745,1507,3325
-110,-70,50,732,775,1507,3287
-110,-50,-100,739,768,1507,3202
-20,-60,140,732,775,1507,3306
100,-40,-180,731,776,1507,3299
140,30,-20,729,779,1508,3249
160,80,-150,724,784,1508,3122
0,-20,140,756,752,1508,3374
50,-30,40,706,802,1508,3185
130,-60,-80,730,778,1508,3258
-110,0,-50,742,766,1508,3258
-110,30,-100,739,770,1509,3380
-100,-40,-80,743,766,1509,3209
60,-10,100,737,772,1509,3285
-40,-30,130,734,775,1509,3272
150,-50,150,729,781,1510,3393
120,20,-20,740,770,1510,3259
100,-40,-160,735,775,1510,3305
-80,10,140,731,779,1510,3397
-80,-10,100,737,773,1510,3331
-80,-20,-40,768,742,1510,3281
-60,-30,120,736,774,1510,3461
110,-40,180,740,771,1511,3155
-40,60,-170,754,757,1511,3355
-130,10,-40,770,741,1511,3182
-90,40,-120,749,762,1511,3451
-80,50,-140,763,748,1511,3285
110,-40,-180,740,771,1511,3155
-90,-30,80,739,773,1512,3425
-130,0,0,736,776,1512,3356
-170,-20,-180,728,784,1512,3434
-170,-20,180,728,784,1512,3434
50,0,0,728,784,1512,3295
-160,60,-60,735,777,1512,3284
-30,-50,130,746,767,1513,3451
80,-40,120,736,777,1513,3194
-20,-70,140,733,780,1513,3416
-140,-80,-140,742,771,1513,3307
-40,20,170,737,777,1514,3299
-170,20,-30,755,759,1514,3354
10,-20,140,745,769,1514,3490
160,-20,180,737,777,1514,3272
-100,-70,60,740,774,1514,3244
-120,30,-90,756,758,1514,3437
160,-20,-180,737,777,1514,3272
-80,-10,10,758,756,1514,3305
50,-80,-160,733,781,1514,3404
110,40,0,744,771,1515,3280
150,-40,-50,734,781,1515,3308
-160,60,-180,740,775,1515,3215
130,20,-20,746,769,1515,3212
-160,60,180,740,775,1515,3215
-140,30,-50,753,762,1515,3411
-40,80,-170,727,788,1515,3436
-90,-30,70,749,766,1515,3325
-90,-30,60,744,771,1515,3438
-150,10,-10,760,756,1516,3456
-130,-40,-130,729,787,1516,3192
-130,60,150,733,783,1516,3376
70,-40,120,733,783,1516,3169
110,-20,-100,712,804,1516,3249
-110,-20,-80,742,774,1516,3291
-20,70,170,722,794,1516,3448
150,80,-140,738,779,1517,3243
-160,-10,0,750,767,1517,3488
70,-20,70,722,795,1517,3306
-100,-20,30,757,760,1517,3353
150,-40,160,724,793,1517,3221
170,-20,-30,746,771,1517,3311
90,-50,90,725,792,1517,3046
-140,10,-10,750,767,1517,3385
-90,30,-140,742,775,1517,3371
60,-30,110,737,781,1518,3155
30,-10,-10,734,784,1518,3440
-50,-60,110,751,767,1518,3465
-30,-10,160,743,775,1518,3447
-150,30,-50,740,778,1518,3573
170,-80,-40,757,761,1518,3316
-70,60,-140,746,772,1518,3266
-150,20,-40,764,755,1519,3409
-170,50,-170,724,795,1519,3257
-160,-30,0,732,787,1519,3417
-120,-60,40,750,769,1519,3328
-120,-30,30,738,781,1519,3354
-60,70,-150,743,777,1520,3485
100,50,20,745,775,1520,3044
90,-50,-160,723,797,1520,3225
60,-20,100,742,778,1520,3264
50,-40,130,742,778,1520,3198
-110,0,-40,751,769,1520,3236
20,20,130,758,762,1520,3114
170,30,-30,754,766,1520,3224
80,-30,100,740,781,1521,3390
-30,-60,130,750,771,1521,3457
-150,80,160,733,788,1521,3118
-110,-40,40,742,779,1521,3384
-100,-10,-40,749,772,1521,3167
110,50,10,771,750,1521,3061
-50,70,-160,749,772,1521,3498
60,0,30,749,772,1521,3338
-70,50,70,744,777,1521,3433
60,-20,50,737,784,1521,3207
-110,50,130,762,759,1521,3422
0,-30,140,744,778,1522,3346
-140,20,-20,733,789,1522,3562
20,10,130,754,768,1522,3201
-140,-70,20,736,786,1522,3392
160,-30,-40,749,773,1522,3223
-40,0,-10,746,776,1522,3277
40,-40,130,748,774,1522,3264
80,50,-80,742,780,1522,3336
-150,80,-70,764,759,1523,3253
-80,-10,90,754,770,1524,3313
-130,40,160,746,778,1524,3385
-150,50,-60,751,773,1524,3460
-120,-70,40,739,785,1524,3339
-130,-20,-140,751,773,1524,3309
-130,20,-70,751,773,1524,3353
140,60,-10,750,775,1525,3228
-100,40,-110,748,777,1525,3576
-40,0,160,739,786,1525,3545
120,0,-130,730,795,1525,3370
-80,0,100,740,785,1525,3366
-60,60,-150,754,771,1525,3336
40,-80,40,755,770,1525,3176
140,60,-130,731,794,1525,3174
-60,-60,-50,745,781,1526,3222
-100,70,110,748,778,1526,3412
20,20,-30,731,795,1526,3399
-40,-70,120,742,784,1526,3443
-160,-40,-170,730,797,1527,3356
50,30,100,730,797,1527,3317
-30,-70,130,745,782,1527,3496
-140,80,150,739,788,1527,3153
-120,0,-90,758,769,1527,3296
-160,50,-50,755,772,1527,3422
-150,70,-70,748,779,1527,3199
110,10,-30,742,785,1527,3307
50,0,100,748,779,1527,3314
-60,10,160,746,782,1528,3350
-90,-40,-70,742,786,1528,3214
-100,-40,50,744,784,1528,3421
-130,-70,30,739,789,1528,3385
-90,50,-130,760,768,1528,3393
-70,-20,120,734,794,1528,3433
140,70,-130,731,797,1528,3192
-20,20,160,758,770,1528,3403
40,70,-40,762,767,1529,3326
120,-40,180,748,781,1529,3295
120,-40,-180,748,781,1529,3295
-40,40,-180,746,784,1530,3399
-90,30,130,744,786,1530,3490
-40,40,180,746,784,1530,3399
-70,70,-140,748,782,1530,3453
-20,-10,-20,727,803,1530,3384
-40,-10,-20,746,784,1530,3326
-150,-80,-150,756,774,1530,3374
-30,60,-180,739,791,1530,3367
-30,60,180,739,791,1530,3367
-80,-30,90,749,781,1530,3541
-180,30,-30,741,790,1531,3323
30,0,-20,731,800,1531,3389
40,-50,150,776,755,1531,3383
100,0,-70,770,761,1531,3351
-60,-40,100,761,770,1531,3353
-40,70,-170,754,777,1531,3491
-40,30,170,754,777,1531,3335
40,-60,-180,739,792,1531,3471
180,30,-30,741,790,1531,3323
-80,0,120,740,791,1531,3356
-30,40,10,749,782,1531,3426
40,-60,180,739,792,1531,3471
-80,70,-130,748,784,1532,3405
90,80,50,761,771,1532,3317
-40,-60,120,762,770,1532,3553
160,-70,-50,758,774,1532,3284
-80,50,90,751,781,1532,3271
-50,-50,-40,761,771,1532,3257
10,-10,130,750,783,1533,3290
90,30,-90,733,800,1533,3450
-130,-10,10,752,781,1533,3434
-140,-50,20,750,783,1533,3353
-70,-10,130,733,800,1533,3456
30,-30,120,746,787,1533,3353
-80,-40,-60,740,793,1533,3182
-110,-10,10,762,771,1533,3350
-70,20,90,757,776,1533,3492
-140,10,-180,744,790,1534,3539
-10,-30,-20,739,795,1534,3427
-110,60,-100,756,778,1534,3500
-140,10,180,744,790,1534,3539
20,-30,10,727,807,1534,3276
-160,10,180,746,789,1535,3547
150,50,-20,764,771,1535,3361
-160,0,-180,739,796,1535,3576
-160,10,-180,746,789,1535,3547
60,-40,130,750,785,1535,3263
0,0,-20,723,812,1535,3460
-160,0,180,739,796,1535,3576
-30,-30,130,750,785,1535,3396
-80,20,-180,753,783,1536,3423
-110,40,140,758,778,1536,3388
-80,20,180,753,783,1536,3423
-50,50,-170,765,771,1536,3277
-140,40,170,762,775,1537,3364
-170,-10,180,754,783,1537,3598
70,10,-10,745,792,1537,3262
110,-30,-150,748,789,1537,3423
-160,10,-10,752,785,1537,3502
-170,-10,-180,754,783,1537,3598
-150,20,-30,762,775,1537,3496
100,10,-30,744,794,1538,3289
-90,60,-130,763,775,1538,3286
-30,70,-180,735,803,1538,3514
-30,70,180,735,803,1538,3514
-130,10,-10,750,788,1538,3633
-70,0,150,747,791,1538,3493
-80,-20,60,772,766,1538,3392
30,30,120,737,801,1538,3370
-90,70,-130,771,768,1539,3355
-80,-10,110,742,797,1539,3404
70,70,70,762,777,1539,3447
-140,0,-170,738,801,1539,3337
70,10,-20,757,782,1539,3436
-160,-40,0,750,789,1539,3459
50,-80,50,751,788,1539,3229
-100,50,-110,760,779,1539,3446
20,-30,120,770,770,1540,3440
-110,50,-100,760,780,1540,3506
40,-80,-170,735,805,1540,3466
-30,-10,-20,757,783,1540,3401
-150,20,-20,750,790,1540,3597
-120,10,-50,763,777,1540,3263
-50,30,30,765,776,1541,3347
-110,20,-130,778,763,1541,3312
-170,10,-20,752,789,1541,3397
-170,40,-40,757,785,1542,3560
150,60,-20,764,778,1542,3333
-120,10,-100,764,778,1542,3564
-120,10,-80,765,777,1542,3613
-150,-10,0,769,773,1542,3563
-90,40,-130,754,788,1542,3488
-130,80,140,743,799,1542,3193
0,-40,140,750,793,1543,3434
-150,-60,10,734,809,1543,3409
160,50,-150,773,770,1543,3418
-130,-30,20,758,785,1543,3388
-80,-20,50,772,771,1543,3335
-60,-10,140,755,788,1543,3520
-160,20,-30,765,779,1544,3503
10,-60,160,749,795,1544,3426
100,-50,-130,749,795,1544,3352
150,-20,-170,762,782,1544,3317
30,50,-40,751,793,1544,3381
-140,20,-30,758,786,1544,3510
20,-50,150,736,808,1544,3397
-130,-60,30,765,779,1544,3348
-110,-20,30,761,784,1545,3536
30,70,-30,768,777,1545,3349
0,10,-20,740,805,1545,3337
130,-20,-150,746,799,1545,3187
-30,70,30,750,795,1545,3384
-130,10,-170,758,787,1545,3341
-20,-20,140,755,791,1546,3463
80,10,-50,724,822,1546,3508
-50,10,10,776,770,1546,3399
10,-50,150,755,791,1546,3389
90,-40,110,758,788,1546,3396
-120,40,-90,763,783,1546,3676
140,0,-30,753,793,1546,3301
-150,-30,10,743,804,1547,3478
-150,60,-70,753,794,1547,3300
150,10,-150,762,785,1547,3253
-140,80,-80,779,768,1547,3364
70,-70,-150,763,784,1547,3457
170,10,-160,748,799,1547,3515
150,-20,-40,758,789,1547,3432
110,-30,-110,739,808,1547,3288
-160,-20,0,747,800,1547,3456
-100,50,120,763,785,1548,3485
70,50,70,747,801,1548,3370
70,10,-40,743,805,1548,3620
-90,-20,30,758,790,1548,3358
50,-30,110,760,788,1548,3352
-50,10,160,757,791,1548,3481
-60,60,60,761,787,1548,3450
-140,30,-60,759,790,1549,3553
-120,50,-90,761,788,1549,3627
-120,60,-90,753,796,1549,3482
-140,70,-80,759,790,1549,3302
-50,20,20,772,777,1549,3308
170,-70,-40,761,788,1549,3328
-110,40,-100,769,780,1549,3603
-80,10,120,766,784,1550,3532
-100,-10,-20,768,782,1550,3333
140,80,-130,761,789,1550,3408
110,-10,-80,753,797,1550,3238
-60,20,170,778,772,1550,3430
-130,40,-80,747,804,1551,3555
70,30,-70,744,807,1551,3523
160,60,-30,765,787,1552,3419
-70,10,160,753,799,1552,3462
-110,0,-30,756,796,1552,3467
-80,0,110,740,812,1552,3496
-160,-80,-160,746,806,1552,3445
-140,-60,20,754,798,1552,3438
110,-30,-140,756,796,1552,3508
10,-40,140,748,804,1552,3461
70,60,70,764,789,1553,3411
-100,40,130,757,796,1553,3534
-50,60,50,772,782,1554,3486
-90,-40,60,750,804,1554,3424
-30,-20,140,758,796,1554,3452
-100,30,-120,765,789,1554,3603
30,-80,180,751,804,1555,3547
60,-60,-170,739,816,1555,3473
-150,-50,10,744,811,1555,3367
70,20,40,743,812,1555,3384
-160,40,-50,757,798,1555,3513
80,80,60,767,788,1555,3414
160,0,-160,765,790,1555,3430
40,-30,30,746,809,1555,3244
30,-80,-180,751,804,1555,3547
70,-50,170,781,775,1556,3467
-10,-10,140,769,787,1556,3449
-120,80,130,752,804,1556,3236
-10,-20,-20,757,799,1556,3445
50,10,-30,746,810,1556,3581
40,-70,40,758,798,1556,3275
110,-20,-110,742,814,1556,3354
0,-50,0,770,787,1557,3334
-90,-30,50,763,794,1557,3354
-60,-30,-40,772,785,1557,3457
-30,40,170,755,802,1557,3401
-100,70,-120,778,780,1558,3396
-140,50,-70,761,797,1558,3463
60,-50,160,791,767,1558,3556
100,-40,-170,763,796,1559,3352
80,-50,180,765,794,1559,3413
-30,-10,150,749,810,1559,3617
80,-50,-180,765,794,1559,3413
-130,50,-80,758,802,1560,3594
-120,-30,-110,777,783,1560,3509
-140,-10,-160,749,811,1560,3328
-100,-10,-30,771,789,1560,3292
70,-40,110,775,785,1560,3273
130,30,-20,751,809,1560,3332
-170,-80,-170,756,805,1561,3426
-80,-10,70,762,799,1561,3414
-80,-20,100,755,806,1561,3360
-130,30,-80,767,794,1561,3489
120,10,-120,744,817,1561,3273
40,-10,10,753,808,1561,3241
50,-30,120,768,793,1561,3282
180,-80,-180,760,801,1561,3455
-180,-80,180,760,801,1561,3455
50,-60,170,762,799,1561,3511
180,-80,180,760,801,1561,3455
-180,-80,-180,760,801,1561,3455
80,40,-80,771,790,1561,3575
-60,-20,-30,776,785,1561,3405
-140,40,-70,769,793,1562,3521
110,-80,110,763,799,1562,3441
-130,70,-90,777,785,1562,3418
-100,50,-120,768,794,1562,3478
60,-30,100,765,797,1562,3325
130,0,-140,786,776,1562,3287
-80,-30,80,786,776,1562,3471
0,30,-20,777,785,1562,3531
-120,60,140,761,802,1563,3495
150,-30,180,754,809,1563,3535
-130,80,-90,787,776,1563,3451
-60,-20,130,748,815,1563,3600
-150,-70,-150,749,814,1563,3456
150,-30,-180,754,809,1563,3535
-120,10,-90,784,779,1563,3597
-140,10,-40,791,772,1563,3369
150,-80,150,761,803,1564,3508
140,-10,-40,756,808,1564,3417
-100,40,-120,779,785,1564,3601
-40,10,0,754,810,1564,3466
30,10,120,768,797,1565,3403
-80,10,130,789,776,1565,3529
-90,30,-150,774,791,1565,3489
110,-40,-110,767,798,1565,3253
20,-70,170,765,800,1565,3554
-100,60,-120,773,792,1565,3357
0,20,-20,756,810,1566,3414
-110,-10,-60,781,785,1566,3266
0,0,140,760,806,1566,3522
160,40,-150,786,780,1566,3496
100,-80,100,760,806,1566,3399
-180,-80,-30,764,802,1566,3410
-40,-20,140,755,811,1566,3613
-110,80,120,754,812,1566,3274
180,-80,-30,764,802,1566,3410
-150,-40,10,752,814,1566,3522
70,80,70,776,791,1567,3459
-100,-30,40,767,800,1567,3415
160,-80,160,762,805,1567,3532
80,-70,-140,770,797,1567,3410
-160,-70,-160,756,811,1567,3609
120,-60,120,755,812,1567,3402
30,-40,130,793,774,1567,3488
0,-60,150,777,790,1567,3555
-170,60,-170,778,790,1568,3522
130,-40,170,739,829,1568,3363
-20,30,160,755,813,1568,3452
50,60,-50,745,823,1568,3487
-50,-40,110,798,770,1568,3410
-130,20,-80,771,797,1568,3362
60,-60,-180,757,812,1569,3467
60,-60,180,757,812,1569,3467
30,-30,20,754,815,1569,3206
30,40,-40,764,806,1570,3505
180,50,-40,766,804,1570,3612
-70,0,140,761,809,1570,3445
-150,-10,-170,746,824,1570,3556
-180,50,-40,766,804,1570,3612
-120,-10,-90,779,791,1570,3336
130,70,-120,750,821,1571,3442
170,-40,170,743,828,1571,3587
-10,-60,140,773,798,1571,3668
-80,-40,70,771,800,1571,3355
20,70,-20,774,798,1572,3430
110,20,-20,773,799,1572,3432
60,-70,-160,779,793,1572,3474
-40,60,40,770,802,1572,3521
-50,-60,-40,770,803,1573,3373
-50,-20,140,757,816,1573,3711
-100,30,150,762,811,1573,3621
10,0,130,772,801,1573,3326
-50,40,-180,775,799,1574,3475
130,20,-130,763,811,1574,3448
-50,40,180,775,799,1574,3475
140,20,-140,783,791,1574,3507
50,20,-40,751,823,1574,3589
-120,-40,30,773,801,1574,3448
140,-80,140,767,807,1574,3496
-80,-30,70,781,794,1575,3504
120,-50,-90,760,815,1575,3499
-150,40,-180,775,800,1575,3475
-160,50,-60,772,803,1575,3493
-150,40,180,775,800,1575,3475
-110,20,-170,770,805,1575,3515
-70,20,170,767,808,1575,3573
-80,40,100,778,797,1575,3532
-10,30,150,751,824,1575,3538
90,-80,90,768,808,1576,3410
-30,10,160,769,807,1576,3553
70,-30,100,765,811,1576,3288
60,-80,60,769,807,1576,3354
-120,0,-10,782,794,1576,3386
140,-60,-70,769,808,1577,3372
50,-60,-180,785,792,1577,3555
40,10,110,771,806,1577,3337
50,-60,180,785,792,1577,3555
120,-80,120,766,811,1577,3494
-80,30,110,772,805,1577,3572
-70,10,80,769,808,1577,3418
-50,40,40,788,789,1577,3459
-80,60,-140,785,793,1578,3339
-120,0,-80,793,785,1578,3512
120,50,0,780,798,1578,3314
-120,-10,10,771,807,1578,3510
160,-10,-30,769,809,1578,3417
-80,70,-140,788,790,1578,3390
-70,30,80,778,800,1578,3454
80,10,-30,776,802,1578,3561
170,-80,170,767,812,1579,3526
20,50,-30,769,810,1579,3563
50,10,100,765,814,1579,3385
50,-10,100,791,789,1580,3333
70,10,-30,761,819,1580,3628
-110,70,-110,782,798,1580,3467
-110,80,-110,787,793,1580,3566
130,80,-120,776,804,1580,3538
50,-20,100,767,814,1581,3407
180,-50,-30,788,793,1581,3402
-50,-20,130,757,824,1581,3671
-180,-50,-30,788,793,1581,3402
40,-30,120,790,791,1581,3422
-120,-20,20,770,811,1581,3535
-150,70,170,784,797,1581,3568
-120,80,-100,787,795,1582,3531
-110,20,-150,785,797,1582,3457
-80,-10,80,786,796,1582,3406
30,-60,170,762,820,1582,3623
110,-40,-120,763,819,1582,3302
-120,70,-100,781,802,1583,3520
130,-80,130,772,811,1583,3506
120,-50,130,767,816,1583,3446
50,-70,50,774,810,1584,3462
10,-20,130,780,804,1584,3442
-170,50,-50,769,815,1584,3503
-100,80,110,755,829,1584,3320
110,-40,-170,778,806,1584,3413
160,30,-30,756,829,1585,3400
-170,-80,-20,770,815,1585,3489
90,10,-70,779,806,1585,3475
-90,70,100,774,812,1586,3491
110,-10,-90,751,835,1586,3492
70,50,-70,765,821,1586,3531
-60,50,60,787,799,1586,3562
-130,10,-30,803,783,1586,3593
-70,-40,-50,763,823,1586,3485
130,-60,130,754,833,1587,3472
30,0,110,781,806,1587,3535
-140,70,160,773,814,1587,3591
-50,-10,150,776,811,1587,3648
-80,-20,90,766,821,1587,3539
150,50,-140,754,833,1587,3381
20,-80,170,758,829,1587,3580
-20,70,20,772,815,1587,3479
110,-60,110,758,829,1587,3422
80,-80,80,774,813,1587,3454
160,30,-150,764,824,1588,3408
60,30,-60,769,819,1588,3659
170,-60,-40,792,796,1588,3277
-120,10,-110,784,804,1588,3577
130,-20,-60,782,806,1588,3239
30,-10,110,767,821,1588,3714
30,-50,150,793,795,1588,3375
-110,30,160,782,806,1588,3650
-130,-30,-130,765,823,1588,3446
70,-70,70,785,803,1588,3506
-70,-10,120,760,829,1589,3498
-160,10,-20,782,807,1589,3585
-80,20,160,777,812,1589,3499
-70,40,-170,767,822,1589,3399
-50,30,170,797,792,1589,3484
110,0,-50,758,831,1589,3521
-80,-20,70,783,806,1589,3610
60,0,90,764,826,1590,3632
-70,-20,110,766,824,1590,3525
90,10,-30,776,814,1590,3452
-20,-60,130,789,801,1590,3644
60,-10,50,775,815,1590,3363
-70,60,-150,800,791,1591,3481
-20,10,150,768,823,1591,3463
-60,-20,120,771,820,1591,3702
-140,20,-60,773,818,1591,3541
10,-80,160,768,823,1591,3582
60,20,-50,771,821,1592,3674
170,60,-40,782,810,1592,3380
60,10,-30,771,821,1592,3633
-120,10,-120,786,806,1592,3417
70,-80,70,768,824,1592,3401
140,50,-130,767,825,1592,3281
-70,-30,100,764,828,1592,3566
130,60,-120,756,837,1593,3362
-170,-10,-20,783,810,1593,3569
80,-70,80,774,819,1593,3475
90,60,40,778,815,1593,3350
-160,-30,-170,757,837,1594,3449
-20,10,-10,779,815,1594,3520
30,-50,30,768,826,1594,3386
70,30,50,781,813,1594,3378
-120,10,-60,770,825,1595,3599
-120,20,-180,764,831,1595,3534
0,20,140,769,826,1595,3442
20,0,120,800,795,1595,3443
-90,80,100,769,826,1595,3335
-40,-40,120,793,802,1595,3484
-100,80,-120,800,795,1595,3586
20,-40,130,797,798,1595,3578
-120,20,180,764,831,1595,3534
-110,60,130,771,824,1595,3556
-120,20,-100,777,818,1595,3659
-130,10,-20,791,804,1595,3663
-150,-20,0,793,803,1596,3652
-30,50,20,793,803,1596,3556
-10,40,-10,761,835,1596,3645
110,-10,-100,772,824,1596,3407
-60,60,-160,798,798,1596,3465
-150,40,-60,785,812,1597,3509
70,20,-60,758,839,1597,3629
150,-60,-60,781,816,1597,3404
170,20,-30,787,810,1597,3436
-130,30,170,786,811,1597,3714
-110,20,-160,791,807,1598,3631
80,-50,160,794,804,1598,3521
180,30,-160,742,856,1598,3507
70,-30,70,769,829,1598,3538
-110,20,-140,809,789,1598,3549
180,40,-160,762,836,1598,3431
-170,-30,-20,796,802,1598,3481
-180,40,-160,762,836,1598,3431
-180,30,-160,742,856,1598,3507
-100,-20,-60,791,808,1599,3563
0,40,140,783,816,1599,3505
0,-50,140,778,821,1599,3634
40,-60,40,789,810,1599,3464
120,10,-30,782,817,1599,3532
-140,-10,0,801,799,1600,3662
-150,50,-70,784,816,1600,3506
-120,-40,-110,799,801,1600,3487
-180,-70,-30,786,814,1600,3423
180,-70,-30,786,814,1600,3423
80,20,0,775,825,1600,3470
10,-70,160,779,821,1600,3691
120,-10,-130,763,837,1600,3575
120,0,-120,752,848,1600,3566
180,-40,-30,789,812,1601,3419
-40,10,160,785,816,1601,3602
160,-60,-50,793,808,1601,3324
-170,20,-170,775,826,1601,3550
120,40,-10,784,817,1601,3423
40,20,110,756,845,1601,3439
-180,-40,-30,789,812,1601,3419
-70,30,-180,780,822,1602,3471
120,80,-110,778,824,1602,3573
90,-70,90,788,814,1602,3555
10,70,-10,786,816,1602,3575
-70,30,180,780,822,1602,3471
70,-20,90,782,821,1603,3580
50,30,-50,787,816,1603,3653
-80,-20,40,805,798,1603,3466
-50,-30,120,765,838,1603,3627
140,-60,140,745,858,1603,3539
-110,30,-110,784,819,1603,3627
-80,80,90,765,838,1603,3378
140,40,-20,781,823,1604,3542
80,-40,110,782,822,1604,3496
100,-70,100,780,824,1604,3589
-60,0,10,796,808,1604,3547
-20,-30,130,798,806,1604,3442
-70,-10,50,791,813,1604,3552
-150,30,-180,784,821,1605,3549
70,40,-70,776,829,1605,3666
-120,-50,30,796,809,1605,3454
-80,20,120,787,818,1605,3653
-150,30,180,784,821,1605,3549
40,0,100,801,804,1605,3421
-140,-30,10,779,827,1606,3652
-180,50,-160,785,821,1606,3524
0,50,140,790,816,1606,3528
-80,-20,80,790,816,1606,3499
-160,-80,-10,784,822,1606,3533
-180,20,-30,778,828,1606,3490
30,20,120,768,838,1606,3550
180,50,-160,785,821,1606,3524
180,20,-30,778,828,1606,3490
180,-30,-30,788,819,1607,3379
140,-20,-160,792,815,1607,3472
130,-30,-160,795,812,1607,3505
180,20,-160,766,841,1607,3640
-180,20,-160,766,841,1607,3640
-180,-30,-30,788,819,1607,3379
-60,-70,-50,790,817,1607,3308
-150,30,-60,780,827,1607,3744
-90,50,110,780,827,1607,3601
120,60,-110,754,854,1608,3445
-80,-70,70,777,831,1608,3500
-70,-70,-60,792,816,1608,3341
0,-80,150,775,833,1608,3637
-80,40,-150,796,812,1608,3682
130,-50,140,791,817,1608,3533
60,80,80,794,814,1608,3535
-70,-70,80,777,831,1608,3546
-110,-80,40,771,837,1608,3473
110,-70,110,758,850,1608,3571
30,20,-30,770,838,1608,3570
10,-30,0,777,832,1609,3608
-30,20,0,786,823,1609,3599
-80,60,90,789,820,1609,3717
60,-40,120,789,820,1609,3331
60,70,80,808,801,1609,3610
-110,-60,-100,793,816,1609,3371
-110,-90,40,774,836,1610,3561
60,-70,60,771,839,1610,3572
-10,-90,140,774,836,1610,3561
90,-50,170,792,818,1610,3474
110,-90,-100,774,836,1610,3561
-120,10,-150,794,816,1610,3527
170,-10,-170,759,851,1610,3440
130,-90,-80,774,836,1610,3561
-30,-90,120,774,836,1610,3561
40,-20,110,782,828,1610,3511
120,-90,-90,774,836,1610,3561
-120,-90,30,774,836,1610,3561
-40,-90,110,774,836,1610,3561
-180,-90,-30,774,836,1610,3561
-70,-90,80,774,836,1610,3561
-80,-90,70,774,836,1610,3561
80,-90,-130,774,836,1610,3561
-100,-90,50,774,836,1610,3561
40,-90,-170,774,836,1610,3561
160,-90,-50,774,836,1610,3561
140,-90,-70,774,836,1610,3561
60,-90,-150,774,836,1610,3561
30,-90,180,774,836,1610,3561
-140,-90,10,774,836,1610,3561
170,-90,-40,774,836,1610,3561
20,-90,170,774,836,1610,3561
10,-90,160,774,836,1610,3561
90,-90,-120,774,836,1610,3561
-150,-90,0,774,836,1610,3561
-60,-90,90,774,836,1610,3561
100,-90,-110,774,836,1610,3561
30,-90,-180,774,836,1610,3561
110,-50,120,757,853,1610,3477
-20,-90,130,774,836,1610,3561
-50,-90,100,774,836,1610,3561
-130,-90,20,774,836,1610,3561
-90,-90,60,774,836,1610,3561
0,-90,150,774,836,1610,3561
150,-90,-60,774,836,1610,3561
180,-90,-30,774,836,1610,3561
-170,-90,-20,774,836,1610,3561
70,-90,-140,774,836,1610,3561
-160,-90,-10,774,836,1610,3561
50,-90,-160,774,836,1610,3561
-10,-80,140,778,833,1611,3625
0,-10,130,784,827,1611,3563
-90,-80,60,769,842,1611,3472
110,40,-100,784,827,1611,3472
130,10,-130,791,820,1611,3552
-160,70,-180,793,818,1611,3575
-20,-40,-20,772,839,1611,3482
130,-70,130,754,857,1611,3560
-160,70,180,793,818,1611,3575
-30,0,150,776,835,1611,3644
20,-50,20,804,807,1611,3395
-130,70,150,799,812,1611,3660
-70,-10,60,788,824,1612,3595
60,30,80,780,832,1612,3393
120,-30,-150,787,825,1612,3448
-100,-80,50,774,838,1612,3469
-150,50,-180,804,808,1612,3487
-150,50,180,804,808,1612,3487
160,90,-20,791,822,1613,3608
-80,90,-140,791,822,1613,3608
-60,90,-160,791,822,1613,3608
-160,90,-60,791,822,1613,3608
-20,-50,130,806,807,1613,3613
-30,90,170,791,822,1613,3608
-70,80,80,779,834,1613,3429
-70,90,-150,791,822,1613,3608
10,90,130,791,822,1613,3608
70,90,70,791,822,1613,3608
50,90,90,791,822,1613,3608
-150,90,-70,791,822,1613,3608
-90,-50,60,797,816,1613,3522
30,90,110,791,822,1613,3608
60,90,80,791,822,1613,3608
130,90,10,791,822,1613,3608
-90,90,-130,791,822,1613,3608
-120,90,-100,791,822,1613,3608
-10,90,150,791,822,1613,3608
110,90,30,791,822,1613,3608
140,90,0,791,822,1613,3608
-140,90,-80,791,822,1613,3608
-180,90,-40,791,822,1613,3608
-100,90,-120,791,822,1613,3608
80,90,60,791,822,1613,3608
180,90,-40,791,822,1613,3608
-170,90,-50,791,822,1613,3608
30,-10,0,790,823,1613,3485
0,90,140,791,822,1613,3608
40,90,100,791,822,1613,3608
90,90,50,791,822,1613,3608
-130,90,-90,791,822,1613,3608
100,90,40,791,822,1613,3608
-40,90,180,791,822,1613,3608
-40,90,-180,791,822,1613,3608
20,90,120,791,822,1613,3608
120,90,20,791,822,1613,3608
150,90,-10,791,822,1613,3608
-110,90,-110,791,822,1613,3608
170,90,-30,791,822,1613,3608
-20,90,160,791,822,1613,3608
-50,90,-170,791,822,1613,3608
-60,0,150,804,810,1614,3670
-80,70,90,775,839,1614,3491
-80,-30,60,788,826,1614,3522
80,10,-40,776,838,1614,3713
-70,40,80,778,836,1614,3556
-30,-80,120,790,824,1614,3589
0,-70,150,805,809,1614,3641
-130,60,-90,784,830,1614,3635
-20,40,0,793,821,1614,3559
-40,-20,130,770,844,1614,3624
120,70,-110,775,839,1614,3539
-80,-30,-50,812,803,1615,3557
20,-20,0,774,841,1615,3552
80,20,-70,781,834,1615,3606
50,20,100,771,844,1615,3427
-130,10,-50,804,811,1615,3582
-180,-60,-30,802,813,1615,3401
110,-40,-130,793,822,1615,3583
180,-60,-30,802,813,1615,3401
-90,-70,60,784,832,1616,3470
-80,-70,-70,802,814,1616,3386
160,-20,-170,751,865,1616,3572
50,-70,-170,792,824,1616,3689
-90,-30,-60,792,824,1616,3461
0,70,0,792,824,1616,3603
-100,-70,50,792,824,1616,3489
-10,40,150,787,829,1616,3578
100,-60,100,763,853,1616,3550
-20,-10,140,795,822,1617,3582
-100,-50,50,797,820,1617,3493
-80,30,-170,791,826,1617,3493
140,-40,170,776,841,1617,3557
-140,-80,10,777,840,1617,3529
-110,-70,40,783,834,1617,3515
-60,20,50,798,820,1618,3543
90,-70,-130,787,831,1618,3533
-20,40,160,779,839,1618,3497
-10,70,10,785,833,1618,3601
-10,-20,130,803,815,1618,3540
-160,40,-170,782,836,1618,3469
170,-50,-40,788,830,1618,3542
10,-10,120,802,817,1619,3458
-130,-40,20,816,803,1619,3572
-120,-50,-110,808,811,1619,3468
-140,60,-80,785,834,1619,3543
-110,-10,0,806,813,1619,3504
-60,-70,90,795,824,1619,3567
-140,10,-20,799,820,1619,3732
90,20,-10,793,826,1619,3394
-140,-50,-140,781,839,1620,3571
-100,60,120,785,835,1620,3657
10,-50,10,801,819,1620,3580
140,-70,140,767,853,1620,3606
80,40,40,813,807,1620,3376
120,-70,120,752,868,1620,3548
120,-10,-60,786,834,1620,3385
90,40,20,791,829,1620,3369
-170,30,-40,795,826,1621,3658
20,-60,160,790,831,1621,3673
-40,-10,150,785,836,1621,3796
110,80,-100,786,835,1621,3605
-20,50,160,784,837,1621,3517
100,-50,140,774,848,1622,3533
-100,-60,50,791,831,1622,3595
0,30,140,801,821,1622,3496
130,50,-120,779,843,1622,3389
-100,-20,20,810,813,1623,3559
-70,0,70,786,837,1623,3690
-10,50,0,797,826,1623,3549
80,-40,90,767,856,1623,3430
-130,-80,20,777,846,1623,3546
-20,-80,130,795,829,1624,3614
-170,-50,-20,804,820,1624,3459
-50,-70,-40,797,827,1624,3377
-170,-40,-20,829,796,1625,3491
-120,-80,30,777,848,1625,3513
-60,-10,130,789,836,1625,3700
10,-20,120,825,800,1625,3610
10,-30,130,807,818,1625,3625
-80,20,130,813,813,1626,3672
-160,20,-40,823,803,1626,3661
160,-50,160,784,842,1626,3799
-150,10,180,783,843,1626,3849
-150,10,-180,783,843,1626,3849
-10,-70,140,806,820,1626,3645
-160,30,-50,800,826,1626,3674
60,0,40,781,846,1627,3584
180,-20,-180,793,834,1627,3783
-180,-20,-180,793,834,1627,3783
-80,-80,70,774,853,1627,3507
-90,-70,-80,811,816,1627,3448
180,-20,180,793,834,1627,3783
-80,80,-140,821,806,1627,3637
-180,-20,180,793,834,1627,3783
-70,70,-150,805,822,1627,3446
10,50,-20,787,840,1627,3665
-20,-40,130,801,827,1628,3579
-50,60,-170,815,813,1628,3547
-120,10,-140,803,825,1628,3711
-60,30,60,797,831,1628,3714
130,50,-10,802,826,1628,3424
-160,0,-10,789,839,1628,3794
-30,-60,120,801,827,1628,3651
60,20,80,786,842,1628,3515
140,-10,-150,803,825,1628,3507
150,0,-30,793,835,1628,3617
-90,80,-130,820,808,1628,3650
-170,90,-180,785,844,1629,3594
-110,90,120,785,844,1629,3594
180,90,-170,785,844,1629,3594
-130,90,140,785,844,1629,3594
10,90,0,785,844,1629,3594
100,90,-90,785,844,1629,3594
60,90,-50,785,844,1629,3594
-10,90,20,785,844,1629,3594
-80,90,90,785,844,1629,3594
-160,90,170,785,844,1629,3594
-150,90,160,785,844,1629,3594
-90,90,100,785,844,1629,3594
90,90,-80,785,844,1629,3594
50,90,-40,785,844,1629,3594
30,90,-20,785,844,1629,3594
-40,90,50,785,844,1629,3594
170,90,-160,785,844,1629,3594
-70,90,80,785,844,1629,3594
160,90,-150,785,844,1629,3594
-50,90,60,785,844,1629,3594
70,90,-60,785,844,1629,3594
130,90,-120,785,844,1629,3594
-100,90,110,785,844,1629,3594
-170,90,180,785,844,1629,3594
150,90,-140,785,844,1629,3594
110,90,-100,785,844,1629,3594
80,-50,80,767,862,1629,3565
-30,90,40,785,844,1629,3594
60,10,-20,801,828,1629,3670
140,90,-130,785,844,1629,3594
80,90,-70,785,844,1629,3594
20,90,-10,785,844,1629,3594
120,30,-20,780,849,1629,3352
-130,-10,0,803,826,1629,3580
-180,90,-170,785,844,1629,3594
40,90,-30,785,844,1629,3594
50,-10,30,787,842,1629,3356
-140,90,150,785,844,1629,3594
-120,90,130,785,844,1629,3594
-60,90,70,785,844,1629,3594
120,90,-110,785,844,1629,3594
0,90,10,785,844,1629,3594
-20,90,30,785,844,1629,3594
-40,-60,-30,795,835,1630,3452
-110,60,-110,810,820,1630,3552
-150,20,-50,812,818,1630,3706
-90,40,-140,804,826,1630,3778
10,10,-20,773,858,1631,3616
-10,50,150,783,848,1631,3598
-170,10,-30,805,826,1631,3705
-20,-70,130,815,816,1631,3724
-150,-80,0,782,850,1632,3552
-110,-50,40,802,830,1632,3423
-30,20,160,810,822,1632,3676
40,-60,160,786,846,1632,3646
0,10,140,782,850,1632,3584
180,40,-40,804,829,1633,3599
-60,80,70,786,847,1633,3552
160,50,-30,803,830,1633,3513
20,-10,110,820,813,1633,3616
-180,40,-40,804,829,1633,3599
-30,-10,140,792,842,1634,3612
-60,40,60,816,818,1634,3701
40,-50,40,792,842,1634,3528
-150,0,-10,807,827,1634,3790
100,-50,-150,769,865,1634,3527
50,80,90,803,831,1634,3611
40,0,-10,809,825,1634,3650
-60,-30,110,779,855,1634,3639
-60,20,60,818,816,1634,3741
-110,-60,40,800,834,1634,3534
-60,10,30,818,816,1634,3434
60,-10,90,794,841,1635,3605
-40,50,180,804,831,1635,3481
-40,50,-180,804,831,1635,3481
90,-50,150,813,822,1635,3480
10,-40,130,808,828,1636,3555
-170,-20,-20,797,839,1636,3569
-30,-20,130,810,826,1636,3761
40,-60,170,810,826,1636,3731
70,20,30,791,845,1636,3566
-170,0,-20,821,816,1637,3690
110,70,-100,781,856,1637,3580
-140,30,-70,809,828,1637,3621
-120,-10,0,806,831,1637,3535
100,-50,-140,781,856,1637,3591
-120,-60,30,785,853,1638,3558
140,10,-140,799,839,1638,3494
-120,50,150,810,828,1638,3720
-120,10,-70,791,847,1638,3739
50,-50,150,842,796,1638,3675
-40,-80,110,798,841,1639,3616
-70,-40,80,812,827,1639,3553
90,-60,90,751,888,1639,3731
80,-60,-170,795,844,1639,3522
-90,40,120,805,835,1640,3694
-80,20,150,819,821,1640,3650
-70,80,-150,824,816,1640,3668
40,-10,100,810,830,1640,3615
-70,-60,80,805,835,1640,3682
180,60,-50,805,836,1641,3667
150,-70,150,777,864,1641,3674
-50,-80,100,801,840,1641,3609
-180,60,-50,805,836,1641,3667
-50,50,50,801,840,1641,3671
100,-80,-120,802,839,1641,3631
110,-50,-110,787,854,1641,3585
-120,20,-110,806,835,1641,3679
70,-60,-160,768,873,1641,3691
-120,10,-130,818,824,1642,3655
-20,20,150,803,839,1642,3795
-50,-70,100,804,839,1643,3625
0,-20,130,785,858,1643,3644
100,80,-90,801,842,1643,3587
-150,10,-20,793,850,1643,3700
90,-80,-130,800,843,1643,3636
-170,-70,-20,806,838,1644,3613
-20,50,10,807,837,1644,3661
60,40,-60,800,844,1644,3692
30,-50,140,839,805,1644,3670
-40,-70,110,812,832,1644,3724
60,-40,110,817,827,1644,3491
100,50,-90,798,846,1644,3600
90,-50,-170,802,842,1644,3569
-90,-30,40,810,835,1645,3525
-50,-10,140,810,835,1645,3816
-130,-20,10,803,842,1645,3586
-70,20,100,820,825,1645,3728
-60,-80,90,797,848,1645,3589
-80,-50,70,801,844,1645,3589
30,-20,20,780,865,1645,3465
-120,-70,30,804,841,1645,3553
40,10,100,809,837,1646,3550
90,-50,130,806,840,1646,3586
100,-60,-120,776,870,1646,3661
-120,-20,-100,812,834,1646,3458
130,70,0,810,836,1646,3522
-120,70,140,814,832,1646,3804
170,50,-40,824,823,1647,3616
70,-60,180,800,847,1647,3545
120,20,-110,783,864,1647,3523
100,60,-90,807,840,1647,3480
-60,-60,90,812,835,1647,3710
-150,-60,-150,786,861,1647,3697
70,-60,-180,800,847,1647,3545
160,20,-150,779,868,1647,3464
100,70,-90,785,863,1648,3513
110,-50,-120,794,854,1648,3468
60,50,-60,803,845,1648,3736
160,-40,170,795,853,1648,3612
130,-10,-50,796,852,1648,3515
-30,-70,120,819,830,1649,3800
60,60,80,806,843,1649,3612
160,40,-30,802,847,1649,3611
10,-60,150,821,828,1649,3634
110,60,-100,778,871,1649,3508
90,80,-80,814,836,1650,3549
140,-30,-170,795,855,1650,3515
40,60,-40,786,864,1650,3593
100,10,-90,780,870,1650,3744
-70,-10,-10,808,842,1650,3569
70,80,-60,799,851,1650,3563
-70,-80,80,793,857,1650,3556
160,20,-30,800,850,1650,3523
70,-20,80,790,861,1651,3541
-150,-30,-160,806,845,1651,3649
20,30,-30,817,834,1651,3560
60,10,80,777,874,1651,3757
80,80,-70,812,839,1651,3572
-130,50,160,803,848,1651,3720
40,30,110,776,875,1651,3638
150,70,-20,825,827,1652,3551
-30,50,170,809,843,1652,3525
-70,-10,0,809,843,1652,3677
-100,30,-140,817,835,1652,3733
110,50,-100,786,866,1652,3479
50,0,10,784,868,1652,3524
-50,0,0,809,843,1652,3580
100,-50,160,825,827,1652,3519
-90,-60,60,814,839,1653,3649
120,-20,-140,791,862,1653,3715
60,-60,60,795,858,1653,3618
10,-50,140,794,859,1653,3668
-170,-70,-170,785,868,1653,3744
-110,30,-120,811,843,1654,3749
130,10,-30,797,857,1654,3638
90,50,30,811,843,1654,3515
-40,-50,-30,812,843,1655,3441
-60,80,-160,836,819,1655,3750
-100,-70,-90,824,831,1655,3558
-50,-60,100,811,844,1655,3748
-40,-60,110,810,845,1655,3702
30,60,-30,800,855,1655,3698
140,70,-10,819,836,1655,3546
-150,20,-180,806,849,1655,3815
80,-80,-140,806,849,1655,3676
80,-60,80,797,858,1655,3792
-130,-50,20,812,843,1655,3615
-150,20,180,806,849,1655,3815
0,-30,-10,813,843,1656,3771
160,-70,160,786,870,1656,3693
130,0,-40,830,826,1656,3520
-70,30,90,806,850,1656,3702
120,-40,-90,810,846,1656,3383
-90,30,140,814,842,1656,3756
-140,50,170,822,834,1656,3678
-90,-20,20,827,829,1656,3636
-50,-40,100,822,834,1656,3572
-100,30,160,794,863,1657,3785
-140,10,-30,828,829,1657,3673
150,-60,150,773,884,1657,3666
50,-60,50,806,851,1657,3663
-120,30,-100,822,836,1658,3700
150,-40,170,791,867,1658,3641
-10,0,140,798,860,1658,3755
-50,80,-170,839,819,1658,3706
-40,-30,-30,808,850,1658,3689
70,-50,150,823,835,1658,3521
-10,-30,130,815,843,1658,3588
110,-50,150,788,870,1658,3572
-100,30,-130,823,836,1659,3781
-110,70,130,820,839,1659,3910
40,80,100,809,850,1659,3637
-80,-60,70,811,849,1660,3665
120,-40,-170,818,842,1660,3545
140,-50,150,811,849,1660,3702
-100,30,-150,832,829,1661,3724
80,50,50,803,858,1661,3653
140,40,-130,813,848,1661,3418
-20,-20,-20,810,852,1662,3697
40,-20,30,794,869,1663,3484
30,80,110,804,859,1663,3620
-110,50,-110,826,837,1663,3648
120,70,10,803,860,1663,3662
70,-80,-150,815,848,1663,3718
-130,0,-10,808,855,1663,3695
100,30,-10,803,860,1663,3627
-70,-30,90,826,837,1663,3680
70,-40,70,797,867,1664,3716
0,50,-10,800,864,1664,3588
130,40,-120,796,868,1664,3496
-90,30,-160,815,849,1664,3669
-120,80,140,797,867,1664,3480
130,-40,180,811,854,1665,3622
10,-20,-10,793,872,1665,3843
130,-40,-180,811,854,1665,3622
120,50,-110,787,878,1665,3543
-110,-30,30,810,855,1665,3702
100,-50,110,791,875,1666,3591
-30,0,-10,798,868,1666,3612
160,70,-30,831,835,1666,3633
180,60,-160,820,847,1667,3742
-180,60,-160,820,847,1667,3742
60,80,-50,807,860,1667,3564
20,10,-20,792,875,1667,3737
90,-50,160,816,851,1667,3473
-130,80,150,798,869,1667,3491
-160,-20,-170,802,865,1667,3664
-40,-10,140,804,863,1667,3863
-80,20,140,832,835,1667,3728
120,-10,-120,811,857,1668,3608
-50,-50,100,817,851,1668,3696
10,50,130,816,852,1668,3576
180,-70,180,789,879,1668,3737
-180,-70,-180,789,879,1668,3737
180,-70,-180,789,879,1668,3737
-70,0,130,803,865,1668,3719
150,0,-150,842,826,1668,3619
-130,-60,20,801,867,1668,3626
-30,-60,-20,819,849,1668,3617
-20,-20,130,840,828,1668,3714
-150,10,-30,837,831,1668,3643
-70,-80,-60,829,839,1668,3650
110,-80,-110,811,857,1668,3670
-10,80,150,831,837,1668,3681
-60,10,40,819,849,1668,3694
-180,-70,180,789,879,1668,3737
-50,20,160,838,830,1668,3900
0,60,140,813,855,1668,3663
-30,-70,-20,813,856,1669,3596
40,20,-30,809,860,1669,3732
-140,60,170,816,853,1669,3630
-70,10,90,839,830,1669,3713
10,80,130,822,847,1669,3616
-130,20,-90,811,858,1669,3807
-60,40,-180,819,850,1669,3538
-60,40,180,819,850,1669,3538
110,-40,-160,810,860,1670,3470
60,20,-40,800,870,1670,3763
80,-50,150,822,848,1670,3417
110,0,-100,806,864,1670,3543
-40,-40,110,832,838,1670,3580
-40,-30,120,819,852,1671,3791
-110,50,140,820,851,1671,3794
60,40,80,830,841,1671,3666
50,70,90,811,860,1671,3723
-40,20,160,829,842,1671,3842
-70,-40,70,804,867,1671,3588
-150,40,-70,827,845,1672,3682
-70,70,80,809,863,1672,3618
-160,-70,-10,819,853,1672,3758
60,-60,170,825,847,1672,3616
90,70,-80,814,858,1672,3505
50,40,-50,821,851,1672,3615
-40,20,10,811,861,1672,3724
80,-50,170,834,838,1672,3636
50,0,20,796,876,1672,3478
-120,60,-100,816,857,1673,3763
-70,10,150,832,841,1673,3778
-40,40,170,820,853,1673,3610
-130,-70,20,807,866,1673,3740
30,-60,160,821,853,1674,3813
-110,-10,-50,847,827,1674,3605
50,-40,120,819,855,1674,3590
-40,-70,-30,814,860,1674,3524
50,-20,40,811,864,1675,3601
110,-50,130,812,863,1675,3639
20,80,120,814,861,1675,3662
100,-70,-120,819,856,1675,3721
-60,-80,-50,829,846,1675,3616
20,-20,110,834,842,1676,3633
-80,-80,-70,831,845,1676,3655
80,-50,120,826,850,1676,3633
-50,-10,130,814,862,1676,3778
70,-30,90,777,900,1677,3595
20,40,-30,817,860,1677,3803
60,-80,-160,830,847,1677,3806
-50,80,60,817,860,1677,3659
-60,70,-160,836,841,1677,3659
40,-70,-180,815,863,1678,3873
130,-30,-70,847,831,1678,3651
50,-60,160,837,841,1678,3631
40,-70,180,815,863,1678,3873
-90,-20,-40,848,830,1678,3699
-140,0,-10,822,857,1679,3757
-70,0,80,830,849,1679,3719
-70,-10,40,818,861,1679,3751
-10,-40,-10,820,859,1679,3657
-90,70,110,828,851,1679,3869
-170,70,-170,826,853,1679,3659
-10,-50,130,821,858,1679,3766
40,-10,20,788,891,1679,3640
130,0,-130,831,849,1680,3656
-40,80,180,847,833,1680,3731
90,10,-40,811,869,1680,3813
-90,60,110,823,857,1680,3819
160,-60,160,786,894,1680,3692
-120,0,-20,833,847,1680,3676
-30,-50,120,829,851,1680,3780
-100,-30,-70,840,840,1680,3668
10,60,130,826,854,1680,3676
-40,80,-180,847,833,1680,3731
100,-50,170,819,861,1680,3594
160,-30,-180,817,863,1680,3785
160,-30,180,817,863,1680,3785
100,20,-90,798,883,1681,3614
70,-50,160,853,828,1681,3850
70,20,20,815,866,1681,3773
-100,70,120,829,852,1681,3950
40,-40,120,826,856,1682,3601
50,10,-20,827,855,1682,3894
-80,-40,60,827,855,1682,3552
20,-40,20,811,871,1682,3601
-160,10,-30,841,841,1682,3744
-160,50,-170,830,853,1683,3545
-180,30,-40,840,843,1683,3777
0,80,140,828,855,1683,3639
30,10,-20,801,882,1683,3763
180,30,-40,840,843,1683,3777
-70,-20,-30,827,856,1683,3796
70,-60,70,817,866,1683,3583
70,-60,-170,797,886,1683,3702
90,60,-80,838,845,1683,3621
160,10,-30,804,880,1684,3701
-70,-50,80,820,864,1684,3591
120,-20,-130,810,874,1684,3763
-70,10,100,826,858,1684,3758
-170,-60,-20,842,842,1684,3557
170,-10,-30,839,845,1684,3739
-30,80,170,849,835,1684,3764
-50,0,150,823,861,1684,3733
-110,40,-110,825,860,1685,3785
40,-40,40,798,887,1685,3596
70,40,60,823,862,1685,3612
-60,-40,90,830,856,1686,3652
150,40,-140,823,863,1686,3743
-90,-40,50,813,873,1686,3596
0,-40,130,823,863,1686,3776
120,-80,-100,822,864,1686,3701
110,-40,-140,820,866,1686,3804
170,-70,170,800,886,1686,3779
50,80,-40,807,880,1687,3589
160,-50,-50,809,878,1687,3830
-110,80,130,803,884,1687,3541
80,-50,140,837,850,1687,3542
10,-30,120,836,851,1687,3815
60,0,50,818,869,1687,3560
60,30,-50,813,875,1688,3638
120,-50,140,825,863,1688,3752
120,40,-110,803,885,1688,3573
-120,-60,-110,849,839,1688,3562
20,60,120,825,864,1689,3786
-140,-20,0,834,855,1689,3832
-60,-50,90,823,866,1689,3575
-180,50,-50,829,860,1689,3789
180,50,-50,829,860,1689,3789
30,-20,110,819,871,1690,3783
-70,0,120,828,862,1690,3834
60,-20,90,777,913,1690,3597
-100,-40,40,832,858,1690,3856
-160,40,-60,851,839,1690,3749
-70,50,80,837,854,1691,3737
-110,-20,20,831,860,1691,3847
-10,-40,130,843,848,1691,3790
-120,20,-170,832,859,1691,3684
-140,-20,-150,824,867,1691,3743
-80,50,100,823,869,1692,3809
-40,60,-180,825,867,1692,3724
160,0,-30,822,870,1692,3718
-40,60,180,825,867,1692,3724
-40,-40,-30,812,881,1693,3767
-110,-40,-90,843,850,1693,3555
-80,50,-150,814,879,1693,3608
120,-20,-120,819,874,1693,3652
60,10,20,800,893,1693,3596
70,-50,140,837,857,1694,3480
-180,10,-30,815,879,1694,3665
-140,80,160,809,885,1694,3464
180,10,-30,815,879,1694,3665
-70,30,170,832,862,1694,3771
-140,-40,10,826,868,1694,3717
-130,60,160,814,881,1695,3762
-160,-10,-10,821,874,1695,3897
10,-40,10,834,862,1696,3734
100,-50,150,805,891,1696,3519
110,-50,140,811,885,1696,3759
-100,80,120,811,885,1696,3542
50,-30,100,845,852,1697,3558
70,-50,70,803,894,1697,3798
40,80,-30,815,882,1697,3642
40,0,0,838,859,1697,3676
50,-10,90,820,878,1698,3717
-40,80,50,829,869,1698,3729
-20,80,160,848,850,1698,3744
-160,-20,-10,826,872,1698,3878
-120,0,-70,845,853,1698,3758
-170,10,-170,829,869,1698,3788
-150,-30,0,816,882,1698,3851
-80,70,100,841,857,1698,3756
-70,-10,70,823,875,1698,3785
-130,0,-150,830,869,1699,3839
40,30,-40,833,866,1699,3823
30,-60,150,825,875,1700,3810
90,-50,180,844,856,1700,3583
-100,-20,10,843,857,1700,3778
-80,40,-160,831,869,1700,3709
90,-50,140,807,893,1700,3575
90,-50,-180,844,856,1700,3583
40,-20,100,845,855,1700,3714
110,30,-100,812,888,1700,3667
-140,-60,10,823,878,1701,3718
-140,-50,10,821,880,1701,3769
-20,0,140,823,878,1701,3687
140,30,-130,828,873,1701,3638
-170,40,-50,840,861,1701,3726
10,40,130,831,870,1701,3639
120,30,-110,811,891,1702,3626
-60,30,170,840,862,1702,3782
-10,60,150,813,889,1702,3828
-170,80,-170,804,898,1702,3529
-70,-20,100,819,883,1702,3927
-40,-50,110,854,848,1702,3742
-160,-30,-10,842,860,1702,3894
180,0,-170,819,884,1703,3849
30,-10,10,823,880,1703,3465
-30,30,160,829,874,1703,3835
-20,-30,-20,838,865,1703,3857
-60,20,160,837,866,1703,3736
-180,0,-170,819,884,1703,3849
-140,50,-80,831,872,1703,3814
-150,-70,0,826,878,1704,3714
-180,-30,180,812,892,1704,3874
180,-30,-180,812,892,1704,3874
-70,-30,80,834,870,1704,3714
-150,10,-40,863,841,1704,3739
130,-10,-140,845,859,1704,3696
-60,70,70,821,883,1704,3697
180,-30,180,812,892,1704,3874
-180,-30,-180,812,892,1704,3874
30,80,-20,821,884,1705,3678
20,-50,140,852,853,1705,3699
-180,-20,-30,826,879,1705,3551
50,-50,50,810,895,1705,3798
20,60,-20,827,878,1705,3705
180,-20,-30,826,879,1705,3551
-30,80,40,846,859,1705,3790
50,10,90,822,883,1705,3775
-70,-10,110,817,888,1705,3692
0,-40,0,831,875,1706,3662
-170,30,-160,830,876,1706,3716
-10,-70,0,829,877,1706,3655
50,0,90,820,886,1706,3659
-70,50,-160,839,867,1706,3709
-40,50,40,843,864,1707,3824
60,10,70,812,895,1707,3612
0,-30,130,839,868,1707,3852
50,50,-50,836,871,1707,3859
-50,30,40,855,852,1707,3862
90,30,0,833,874,1707,3542
-90,30,-170,828,879,1707,3730
110,-50,170,852,855,1707,3638
40,10,-20,821,887,1708,3903
80,70,-70,828,880,1708,3544
-60,-10,-10,845,863,1708,3768
-80,30,-180,838,871,1709,3847
-80,30,180,838,871,1709,3847
10,60,-10,852,857,1709,3727
-110,-10,-10,845,864,1709,3772
70,20,10,833,876,1709,3694
-110,40,150,837,873,1710,3902
0,-60,140,839,871,1710,3846
-180,0,-30,829,881,1710,3687
100,-50,120,825,885,1710,3804
180,0,-30,829,881,1710,3687
70,-30,80,810,900,1710,3654
-140,-40,-140,834,876,1710,3723
150,-20,-160,828,883,1711,3692
90,-50,100,810,901,1711,3725
90,50,-80,832,879,1711,3809
150,80,-130,818,894,1712,3707
-160,-60,-10,843,869,1712,3731
-50,70,-170,853,859,1712,3832
-90,80,110,800,912,1712,3591
140,-20,-50,831,882,1713,3640
-30,60,30,848,865,1713,3774
-90,30,150,828,885,1713,3926
-10,20,140,844,869,1713,3788
-60,0,140,836,877,1713,3890
-70,10,140,832,882,1714,3871
170,70,-40,847,867,1714,3690
100,-50,130,820,894,1714,3781
-50,-80,-40,843,871,1714,3646
-80,40,110,823,891,1714,3890
-90,30,170,845,869,1714,3757
40,70,100,824,891,1715,3780
110,70,20,832,883,1715,3719
-140,20,-70,864,851,1715,3701
-160,80,180,809,906,1715,3474
-160,80,-180,809,906,1715,3474
-40,-80,-30,840,876,1716,3683
-150,80,170,817,899,1716,3484
-120,30,170,847,869,1716,3789
120,-20,-80,832,884,1716,3655
-90,-20,10,858,858,1716,3758
-130,20,-180,842,874,1716,3880
100,40,-90,842,874,1716,3786
-130,20,180,842,874,1716,3880
-40,30,20,844,872,1716,3826
80,-40,100,806,910,1716,3725
130,-80,-90,836,880,1716,3711
-160,30,-170,845,872,1717,3802
80,30,20,822,895,1717,3603
-60,20,70,840,877,1717,3894
160,10,-150,836,881,1717,3809
-20,80,30,858,859,1717,3773
170,40,-40,837,881,1718,3875
180,70,-160,831,887,1718,3735
-80,30,120,841,877,1718,3953
110,10,-100,834,884,1718,3754
-180,70,-160,831,887,1718,3735
-60,10,50,837,881,1718,3853
60,-30,60,830,888,1718,3647
-60,-10,120,823,895,1718,3823
60,-40,60,825,894,1719,3750
-30,-40,120,847,872,1719,3831
30,-30,110,833,886,1719,3762
-70,-10,100,828,891,1719,3767
-140,20,-180,852,867,1719,3962
-70,60,80,850,869,1719,3883
-70,20,160,842,877,1719,3775
-120,-30,20,839,880,1719,3807
-170,20,-40,853,866,1719,3953
-160,-40,-10,849,870,1719,3828
-130,50,-90,836,883,1719,3872
90,20,-80,826,893,1719,4011
-140,20,180,852,867,1719,3962
-150,60,180,842,878,1720,3576
-150,60,-180,842,878,1720,3576
-50,-30,110,854,866,1720,3850
-60,-30,100,851,869,1720,3846
50,20,-30,822,898,1720,3858
170,30,-150,845,875,1720,3647
60,10,0,831,889,1720,3747
130,-50,-80,835,885,1720,3795
-30,10,150,834,886,1720,3864
-30,-50,-20,836,885,1721,3686
110,-50,160,831,890,1721,3636
60,10,-10,834,887,1721,3878
170,80,-150,820,901,1721,3566
-110,-70,-100,863,858,1721,3700
-90,30,160,827,894,1721,3929
160,-10,-160,826,895,1721,3902
-90,30,-180,832,889,1721,3761
50,-80,-170,840,881,1721,3894
-90,30,180,832,889,1721,3761
-130,30,-90,845,877,1722,3887
-70,30,100,854,868,1722,3957
-120,50,-100,853,869,1722,3923
20,-10,-10,825,897,1722,3990
-60,10,60,863,860,1723,3872
70,-40,100,821,902,1723,3719
-10,10,140,836,887,1723,3812
20,80,-10,836,888,1724,3733
20,-60,150,825,899,1724,3931
-170,60,-60,837,887,1724,3843
140,80,-120,821,903,1724,3719
-70,70,90,844,880,1724,3692
-100,50,130,851,873,1724,3832
-90,-80,-80,849,876,1725,3779
60,10,10,829,896,1725,3683
-120,-20,10,849,876,1725,3895
80,-60,-150,799,926,1725,3772
160,80,-140,823,902,1725,3635
-20,-70,-10,842,883,1725,3683
100,20,-20,836,889,1725,3672
30,-70,170,847,879,1726,3939
0,-70,10,846,880,1726,3654
-20,-60,-10,853,873,1726,3769
-40,0,150,829,897,1726,3959
-130,10,-60,837,889,1726,3926
-120,0,-60,846,880,1726,3960
-150,-10,-10,847,879,1726,3940
60,-50,60,831,896,1727,3711
140,-40,180,825,902,1727,3806
160,0,-150,850,877,1727,3832
-10,-10,130,859,868,1727,3953
-90,50,-140,838,889,1727,3997
-140,-70,10,826,901,1727,3716
140,-40,-180,825,902,1727,3806
50,30,-40,838,890,1728,3842
170,-40,-40,847,881,1728,3716
-80,-30,50,859,869,1728,3669
-180,70,-50,842,886,1728,3733
10,80,0,843,885,1728,3776
-50,70,60,842,886,1728,3820
-120,20,-120,869,859,1728,3806
-150,-60,0,835,893,1728,3771
180,70,-50,842,886,1728,3733
-40,30,160,841,888,1729,3942
-80,30,170,830,899,1729,3775
170,0,-160,838,891,1729,3874
70,-50,130,859,871,1730,3755
40,-60,150,860,870,1730,3700
-100,30,180,836,894,1730,3864
30,70,110,842,888,1730,3806
-100,30,-180,836,894,1730,3864
100,-50,-180,862,869,1731,3770
100,-50,180,862,869,1731,3770
-160,0,-20,864,867,1731,3924
170,-50,170,831,900,1731,3914
-160,-50,-10,853,879,1732,3781
100,10,-40,845,887,1732,3808
150,30,-140,847,885,1732,3658
-170,40,-160,834,898,1732,3707
150,20,-140,841,891,1732,3669
90,-60,-160,831,901,1732,3646
180,80,-160,816,916,1732,3595
-70,-30,70,833,899,1732,3781
-180,80,-160,816,916,1732,3595
-120,40,160,846,886,1732,3864
170,70,-150,833,899,1732,3806
-80,60,100,857,875,1732,4040
10,30,130,842,891,1733,3788
-120,40,-100,857,876,1733,4017
10,20,-20,832,901,1733,3962
10,20,130,850,883,1733,3751
70,70,-60,838,895,1733,3705
-30,60,170,852,882,1734,3779
160,70,-140,810,924,1734,3796
80,-50,130,839,896,1735,3746
80,60,-70,848,887,1735,3777
60,-20,60,849,886,1735,3833
150,-30,-170,824,911,1735,3941
0,-50,130,836,899,1735,3918
120,-40,-160,840,895,1735,3755
-110,-40,30,856,879,1735,3837
90,30,-80,825,910,1735,3892
110,-60,-110,829,907,1736,3946
-10,20,-10,851,885,1736,4005
-30,-30,120,859,877,1736,3845
-170,0,-30,861,876,1737,3781
120,10,-110,835,902,1737,3647
170,-60,170,823,914,1737,3836
120,-50,160,836,901,1737,3816
-100,30,-160,865,872,1737,3832
130,80,-110,827,910,1737,3748
10,-10,110,847,890,1737,3914
10,10,130,859,878,1737,3864
-10,-60,130,848,890,1738,4030
180,-40,180,832,906,1738,3940
180,-40,-180,832,906,1738,3940
-180,-40,180,832,906,1738,3940
-180,-40,-180,832,906,1738,3940
-90,-50,-70,860,879,1739,3855
130,-50,150,846,893,1739,3803
-80,-20,30,856,883,1739,3768
-20,-30,120,853,886,1739,3917
140,50,-20,858,881,1739,3628
-70,-30,-40,868,871,1739,3862
-100,40,-130,853,886,1739,3966
20,70,120,846,893,1739,3923
60,50,80,831,908,1739,3869
-70,10,110,845,895,1740,3811
-100,40,140,842,898,1740,3966
120,-50,150,835,905,1740,3824
30,-40,30,844,896,1740,3631
-130,-10,-140,861,879,1740,3866
-150,-50,0,851,889,1740,3797
-70,0,110,851,890,1741,4042
170,10,-30,850,892,1742,3727
-120,0,-30,872,870,1742,3833
-50,-20,120,844,898,1742,3967
-10,70,150,861,881,1742,3907
-10,80,20,861,881,1742,3800
0,60,0,834,908,1742,3860
120,-30,-90,858,885,1743,3746
-160,-60,-160,830,913,1743,3947
-70,-20,50,863,880,1743,3934
120,-30,-120,839,904,1743,3888
180,40,-50,865,879,1744,3894
-60,-20,110,857,887,1744,4091
-180,40,-50,865,879,1744,3894
-60,50,-170,851,894,1745,3716
-180,-10,-30,836,909,1745,3765
-120,-10,-80,882,863,1745,3841
-70,-20,60,856,889,1745,3870
180,-10,-30,836,909,1745,3765
70,30,-60,840,905,1745,3969
-70,-20,70,843,903,1746,3851
-150,-20,-160,824,922,1746,3863
40,-50,140,887,859,1746,3923
60,30,70,845,901,1746,3761
110,-40,-150,853,893,1746,3772
-30,-80,-20,854,892,1746,3807
30,60,110,847,899,1746,3860
-140,40,-80,851,895,1746,3883
140,-30,-60,858,888,1746,3793
110,-70,-110,847,899,1746,3908
-10,60,10,861,885,1746,4032
90,10,-60,863,883,1746,3954
170,-30,-180,849,898,1747,3952
40,40,-40,864,883,1747,3876
-160,-10,-20,866,881,1747,4012
170,-30,180,849,898,1747,3952
110,50,0,861,886,1747,3716
-80,80,100,826,921,1747,3683
60,20,70,821,926,1747,3651
130,30,-120,859,889,1748,3740
140,0,-140,850,898,1748,3730
-30,-10,130,858,890,1748,3864
-60,20,80,867,881,1748,3953
80,-60,-160,845,903,1748,3895
-100,30,170,862,886,1748,3974
-70,10,130,866,883,1749,3965
10,0,120,853,896,1749,3716
-10,30,-10,876,873,1749,3895
150,30,-30,875,874,1749,3808
-140,10,-50,859,891,1750,3856
20,-20,10,848,902,1750,3612
60,-40,100,864,886,1750,3776
140,-80,-80,853,897,1750,3732
20,0,110,860,891,1751,4078
100,-50,-160,850,901,1751,3801
-170,70,-60,856,895,1751,3788
-20,30,150,863,888,1751,3885
10,-20,110,875,876,1751,3898
0,80,10,856,895,1751,3801
-120,60,150,856,896,1752,3914
-30,0,140,855,897,1752,3854
-130,-20,-130,849,903,1752,3882
10,70,130,865,888,1753,3978
0,70,140,865,888,1753,3969
90,10,-50,830,923,1753,3873
70,30,40,845,909,1754,3685
-50,50,180,861,893,1754,3870
-60,30,70,850,904,1754,3806
-100,-30,30,863,891,1754,3910
150,10,-30,837,917,1754,3756
-50,50,-180,861,893,1754,3870
-70,10,120,870,884,1754,3941
130,40,-20,856,898,1754,3687
100,50,10,854,901,1755,3816
-50,40,50,859,896,1755,3939
150,70,-130,827,928,1755,3752
-40,-10,130,857,898,1755,4025
50,-20,90,845,910,1755,3763
-60,-40,-40,855,900,1755,3909
50,60,90,856,900,1756,3834
60,-10,60,854,902,1756,3848
-120,0,-50,867,889,1756,3860
60,-50,150,896,860,1756,4040
170,-20,-170,837,919,1756,3916
130,-40,-170,879,877,1756,3768
-20,-40,120,864,892,1756,3934
-20,-80,-10,864,892,1756,3797
-40,70,50,864,893,1757,3893
-40,70,-180,870,887,1757,3944
-40,70,180,870,887,1757,3944
0,0,130,864,893,1757,3777
110,0,-90,845,912,1757,3877
180,-10,-170,848,909,1757,3963
50,-40,110,867,890,1757,3735
60,-30,90,838,919,1757,3732
-180,-10,-170,848,909,1757,3963
-160,60,-70,850,908,1758,3840
-70,0,90,853,905,1758,3949
-100,30,-170,857,901,1758,3873
-20,60,160,842,916,1758,3804
170,0,-30,851,907,1758,3906
60,10,40,865,893,1758,3849
-60,-40,80,846,912,1758,3791
20,-30,20,850,908,1758,3764
20,-30,110,858,901,1759,3876
-90,60,-140,872,887,1759,3964
20,50,120,854,905,1759,3957
-110,-30,-80,896,863,1759,3983
40,-30,110,849,910,1759,3785
-170,-60,-170,846,913,1759,4064
-100,-20,-50,881,878,1759,3812
100,70,30,865,894,1759,3721
20,-70,160,866,894,1760,4039
80,-60,-180,870,890,1760,3770
-100,-80,-90,864,896,1760,3880
-170,0,-170,861,899,1760,3856
-30,70,170,872,888,1760,3989
60,-50,140,858,902,1760,3792
-60,10,150,861,899,1760,4047
-70,0,100,852,908,1760,4020
-40,40,30,885,875,1760,4029
80,-60,180,870,890,1760,3770
170,20,-150,859,901,1760,3861
-70,20,110,875,885,1760,4022
-110,-20,-70,873,888,1761,3912
-120,-70,-110,869,892,1761,3811
170,40,-150,867,895,1762,3785
130,-30,-150,854,908,1762,3758
-20,60,20,875,887,1762,4079
100,10,-80,863,899,1762,4025
40,-80,180,857,905,1762,4036
-130,40,-90,868,894,1762,4007
30,-10,20,850,912,1762,3483
-150,20,-60,886,876,1762,3872
40,-80,-180,857,905,1762,4036
-150,0,-20,877,885,1762,3964
150,-80,-70,857,905,1762,3738
120,-10,-110,834,929,1763,3755
-140,30,-180,867,896,1763,4030
-140,30,180,867,896,1763,4030
10,-70,20,842,921,1763,3854
0,-20,120,861,903,1764,4077
-30,-40,110,865,899,1764,3853
110,20,-100,870,894,1764,3929
10,-60,20,851,914,1765,3752
70,-50,120,859,906,1765,3830
10,-70,150,861,904,1765,4156
150,-30,-50,862,903,1765,3795
-130,10,-90,888,877,1765,3979
70,20,-50,867,898,1765,4005
-50,10,150,868,897,1765,3951
-170,50,-60,854,911,1765,3924
50,10,-10,860,906,1766,3945
-50,40,170,864,902,1766,3834
-80,60,-150,865,901,1766,3898
-60,20,90,885,881,1766,4064
-70,-10,90,850,916,1766,3798
-70,-20,90,863,904,1767,3841
40,-30,100,876,892,1768,3745
-180,-60,180,840,928,1768,4001
-150,-50,-150,839,929,1768,3861
-180,-60,-180,840,928,1768,4001
180,-60,-180,840,928,1768,4001
180,-60,180,840,928,1768,4001
-110,-10,-20,869,899,1768,3956
-130,20,-100,870,898,1768,4041
-110,-20,10,877,892,1769,4043
-130,-30,10,871,898,1769,3956
170,90,-150,842,928,1770,3874
20,90,0,842,928,1770,3874
110,90,-90,842,928,1770,3874
-100,90,120,842,928,1770,3874
10,90,10,842,928,1770,3874
60,10,50,860,910,1770,3767
60,90,-40,842,928,1770,3874
-10,90,30,842,928,1770,3874
-120,90,140,842,928,1770,3874
30,90,-10,842,928,1770,3874
-30,90,50,842,928,1770,3874
80,90,-60,842,928,1770,3874
-150,90,170,842,928,1770,3874
70,90,-50,842,928,1770,3874
-50,0,140,866,904,1770,4022
-110,90,130,842,928,1770,3874
-80,90,100,842,928,1770,3874
130,90,-110,842,928,1770,3874
150,90,-130,842,928,1770,3874
-20,-10,130,875,895,1770,3918
100,90,-80,842,928,1770,3874
40,90,-20,842,928,1770,3874
-180,90,-160,842,928,1770,3874
-160,90,-180,842,928,1770,3874
-90,90,110,842,928,1770,3874
-50,90,70,842,928,1770,3874
30,0,-10,859,911,1770,4002
-40,90,60,842,928,1770,3874
-140,90,160,842,928,1770,3874
50,90,-30,842,928,1770,3874
120,90,-100,842,928,1770,3874
-170,90,-170,842,928,1770,3874
90,90,-70,842,928,1770,3874
160,90,-140,842,928,1770,3874
180,90,-160,842,928,1770,3874
-60,90,80,842,928,1770,3874
0,90,20,842,928,1770,3874
-160,90,180,842,928,1770,3874
140,90,-120,842,928,1770,3874
-130,90,150,842,928,1770,3874
50,20,-20,839,931,1770,3733
-70,90,90,842,928,1770,3874
-20,90,40,842,928,1770,3874
-30,70,40,878,893,1771,3922
10,-60,140,847,924,1771,3969
30,0,100,873,898,1771,3917
60,10,30,862,909,1771,3829
60,70,-50,866,905,1771,3827
120,20,-30,870,902,1772,3935
-160,60,-170,864,908,1772,3777
-130,-60,-120,874,898,1772,3768
-110,40,-120,871,901,1772,3937
80,60,50,859,913,1772,3783
-130,10,-70,880,892,1772,3907
-120,-30,-100,884,889,1773,3822
-20,-50,-10,860,913,1773,3692
-10,-60,0,866,907,1773,3819
100,40,0,848,925,1773,3742
50,-40,100,861,912,1773,3764
-20,70,160,869,904,1773,3909
100,30,-90,874,900,1774,3899
-70,-10,10,880,894,1774,3885
-20,-50,120,869,905,1774,4007
-60,0,60,882,892,1774,4078
40,20,-20,845,929,1774,3941
-70,80,90,841,933,1774,3800
0,-80,10,868,906,1774,3884
-160,10,-40,892,883,1775,4018
-70,-20,80,864,911,1775,3845
-40,-40,100,871,904,1775,3914
90,40,-80,867,908,1775,3988
170,50,-150,864,911,1775,3861
70,-60,170,877,898,1775,3752
-70,40,90,875,901,1776,3977
-10,-80,0,860,916,1776,3806
160,-20,-40,868,909,1777,4009
0,-60,10,852,925,1777,3901
50,-10,40,865,912,1777,3858
20,-40,120,893,884,1777,4096
-20,0,-10,862,915,1777,4010
-180,10,-160,844,933,1777,3979
-70,60,90,888,889,1777,4075
180,10,-160,844,933,1777,3979
170,60,-150,863,915,1778,3861
60,-50,130,860,918,1778,3721
-60,-30,90,874,904,1778,4011
0,-90,140,861,918,1779,3971
-180,-90,-40,861,918,1779,3971
50,-90,-170,861,918,1779,3971
170,-90,-50,861,918,1779,3971
40,0,10,853,926,1779,3821
-30,-90,110,861,918,1779,3971
100,-90,-120,861,918,1779,3971
80,40,-70,850,929,1779,4004
-20,-90,120,861,918,1779,3971
-150,-90,-10,861,918,1779,3971
180,-90,-40,861,918,1779,3971
-10,-90,130,861,918,1779,3971
90,-90,-130,861,918,1779,3971
-170,-90,-30,861,918,1779,3971
-40,-90,100,861,918,1779,3971
-160,-90,-20,861,918,1779,3971
-50,-90,90,861,918,1779,3971
10,-90,150,861,918,1779,3971
160,-90,-60,861,918,1779,3971
-110,-90,30,861,918,1779,3971
-80,30,160,876,903,1779,3943
-60,-90,80,861,918,1779,3971
-120,-90,20,861,918,1779,3971
-90,-90,50,861,918,1779,3971
140,-90,-80,861,918,1779,3971
130,-90,-90,861,918,1779,3971
-130,-90,10,861,918,1779,3971
150,-90,-70,861,918,1779,3971
10,40,-20,851,928,1779,3962
-70,-90,70,861,918,1779,3971
110,-90,-110,861,918,1779,3971
-100,-90,40,861,918,1779,3971
-130,0,-20,884,895,1779,3944
70,-90,-150,861,918,1779,3971
60,-90,-160,861,918,1779,3971
30,10,110,870,909,1779,3762
80,-90,-140,861,918,1779,3971
40,-90,-180,861,918,1779,3971
-80,-90,60,861,918,1779,3971
40,-90,180,861,918,1779,3971
20,-90,160,861,918,1779,3971
120,-90,-100,861,918,1779,3971
140,10,-30,845,934,1779,3925
30,-90,170,861,918,1779,3971
-140,-90,0,861,918,1779,3971
120,80,-100,853,927,1780,3802
140,-30,-160,876,904,1780,3850
0,-30,120,882,898,1780,4023
130,-50,160,842,938,1780,3993
-130,40,170,884,897,1781,3974
40,-10,30,870,911,1781,3767
80,20,-60,857,924,1781,3819
20,30,120,850,931,1781,3942
160,-30,-170,839,942,1781,3982
-140,0,-20,886,896,1782,4054
120,-30,-130,870,912,1782,3825
-130,-50,-120,863,919,1782,3866
-140,30,-80,882,900,1782,3941
60,0,80,850,932,1782,3939
-110,30,170,854,928,1782,4246
-150,-40,0,875,908,1783,4032
10,-40,120,885,898,1783,4074
-70,-10,80,863,920,1783,3920
110,30,-20,880,904,1784,3927
110,-50,-130,874,910,1784,4025
30,-40,120,874,910,1784,3924
-120,30,-110,884,900,1784,4051
20,-60,140,860,924,1784,3938
-60,70,80,866,919,1785,3843
-130,10,-80,879,906,1785,4023
-110,-80,-100,875,910,1785,3987
0,-10,120,874,911,1785,4109
80,40,30,867,918,1785,3742
170,30,-40,878,907,1785,4020
-40,-30,110,870,915,1785,3942
-80,-20,-30,893,893,1786,3960
-30,40,160,864,922,1786,3949
140,70,-120,850,936,1786,3897
-160,70,-70,869,917,1786,3874
-80,-50,60,865,921,1786,3887
-160,20,-50,878,908,1786,3994
30,20,-20,866,921,1787,4013
110,-50,180,871,916,1787,3892
110,-50,-180,871,916,1787,3892
70,60,-60,871,916,1787,3962
120,0,-110,853,934,1787,3718
150,20,-30,885,902,1787,3901
90,-50,120,855,933,1788,3940
120,-20,-110,839,949,1788,3912
40,50,-40,873,915,1788,4036
-100,50,-130,881,907,1788,4062
-120,0,-40,894,894,1788,3919
-50,-50,90,888,900,1788,3872
-90,-30,30,873,915,1788,3891
20,-50,130,906,883,1789,3979
-110,60,140,866,923,1789,4054
-80,30,130,904,885,1789,3993
-60,10,70,871,918,1789,4021
-150,0,-30,889,900,1789,3992
-60,10,80,883,906,1789,4009
-160,20,-170,875,915,1790,4031
60,20,-30,846,944,1790,4013
-60,80,80,857,933,1790,3829
50,-40,50,856,934,1790,3935
150,-10,-150,887,903,1790,3855
-170,30,-50,885,905,1790,3906
110,40,-10,868,923,1791,3815
80,50,-70,873,918,1791,4009
-160,-20,-20,877,914,1791,4026
-60,60,70,871,920,1791,3982
-40,10,150,882,909,1791,4168
60,-60,160,891,900,1791,3726
-150,0,-170,864,928,1792,4089
30,-60,140,903,889,1792,3838
-100,60,-130,881,911,1792,3920
-60,-10,110,885,907,1792,4061
70,20,0,885,907,1792,3985
80,30,-70,872,920,1792,3997
120,70,-100,858,935,1793,3745
20,-60,30,865,928,1793,3928
50,20,90,883,910,1793,3984
70,-50,110,889,904,1793,3949
30,-30,30,867,926,1793,3744
20,10,120,886,907,1793,4128
-10,-30,120,894,899,1793,4007
-160,30,-60,906,887,1793,3885
-90,50,120,887,906,1793,3972
60,-50,120,886,908,1794,3926
-110,50,-120,898,896,1794,4070
40,20,100,884,910,1794,3907
-100,-50,-80,895,899,1794,3770
-40,-50,100,897,898,1795,3934
-80,40,-170,883,912,1795,3864
-70,30,110,882,914,1796,4158
-150,-20,-10,878,918,1796,4086
120,-70,-100,859,937,1796,4009
140,-20,-150,890,906,1796,3974
140,-50,160,864,933,1797,3941
-90,-20,0,892,905,1797,4038
-20,70,30,882,915,1797,3969
150,-50,160,871,926,1797,4009
-60,50,70,882,915,1797,4140
-60,-50,80,875,922,1797,3932
-10,30,140,884,913,1797,4019
140,20,-130,880,917,1797,3781
-80,30,150,882,916,1798,4329
10,-30,10,875,923,1798,3832
70,40,-60,887,911,1798,4118
90,-60,-150,862,936,1798,4154
30,-10,100,902,896,1798,4018
-70,-10,30,882,917,1799,4037
-70,-50,70,872,927,1799,3819
-80,-50,-60,896,904,1800,3901
-70,20,150,898,902,1800,3996
10,-10,-10,865,935,1800,4175
-20,-60,120,882,918,1800,4145
30,-80,170,877,923,1800,4067
160,-80,-60,875,925,1800,3800
-120,-40,20,883,918,1801,3975
50,70,-40,875,926,1801,3885
30,30,-30,883,918,1801,4027
-10,10,-10,871,930,1801,3927
150,-50,-60,865,936,1801,4121
120,-50,-180,892,910,1802,3878
60,0,70,854,948,1802,3872
120,-50,180,892,910,1802,3878
110,10,-40,875,927,1802,3931
150,40,-30,890,912,1802,3985
80,20,-10,876,927,1803,3821
50,-30,50,854,949,1803,3994
-70,60,-160,882,921,1803,3937
20,-80,160,881,923,1804,4125
10,-80,20,875,929,1804,4002
-60,40,70,895,909,1804,4043
-90,40,130,878,926,1804,4221
-160,50,-70,887,917,1804,3917
-50,-40,90,880,924,1804,3871
-150,30,-70,898,906,1804,3983
-70,50,90,887,918,1805,4032
-30,20,150,892,913,1805,4171
-140,-10,-10,884,922,1806,4190
130,30,-30,881,925,1806,3764
50,-70,-180,893,914,1807,4077
-170,50,-160,862,945,1807,3877
50,0,30,879,928,1807,3775
50,-20,50,876,931,1807,3910
140,30,-30,878,929,1807,3890
50,-70,180,893,914,1807,4077
170,-10,-160,875,932,1807,4023
30,-20,100,902,905,1807,3881
-90,-50,50,875,933,1808,3950
180,-50,180,861,947,1808,4075
-180,-50,-180,861,947,1808,4075
-10,-40,120,882,926,1808,4107
80,-50,90,881,927,1808,3984
-180,-50,180,861,947,1808,4075
20,-70,30,865,943,1808,3976
180,-50,-180,861,947,1808,4075
90,-50,110,860,948,1808,3987
150,50,-30,898,910,1808,3930
20,-10,0,893,916,1809,4078
50,50,90,878,931,1809,3997
130,70,-110,854,955,1809,3863
40,10,-10,874,935,1809,4010
-140,0,-30,919,891,1810,4037
20,20,-20,870,940,1810,4137
90,-60,-140,862,948,1810,4016
-60,0,50,879,931,1810,4112
20,40,120,878,933,1811,3916
60,-10,80,862,949,1811,3918
60,-70,-170,882,929,1811,3974
160,60,-140,870,941,1811,3884
-70,40,-180,881,930,1811,3874
-70,40,180,881,930,1811,3874
120,-50,170,879,932,1811,3892
130,20,-30,891,921,1812,4030
120,0,-50,878,935,1813,4086
-160,0,-30,902,911,1813,3933
-40,-60,100,903,910,1813,4089
170,-80,-50,877,936,1813,3858
-40,0,140,876,937,1813,4070
-100,-20,0,884,930,1814,4031
-140,70,170,896,918,1814,3988
-150,70,-80,876,938,1814,3997
-70,-80,70,867,948,1815,4145
-130,-40,-120,875,940,1815,3905
-80,-30,40,894,921,1815,3997
130,-10,-130,873,942,1815,3885
0,-50,120,905,910,1815,4130
-60,0,130,864,952,1816,4077
140,80,-10,880,936,1816,3891
50,40,90,878,938,1816,4136
150,60,-130,857,959,1816,3984
-50,-60,90,898,918,1816,4016
-50,-30,-30,908,908,1816,4118
120,50,-10,915,902,1817,3955
-50,-70,90,889,928,1817,4238
40,60,100,880,938,1818,3986
-120,20,-160,890,928,1818,4093
160,80,-30,875,943,1818,3910
-70,-30,60,887,931,1818,3907
120,-10,-70,877,941,1818,3933
50,-60,150,898,921,1819,3854
-50,-30,100,905,914,1819,4055
-100,60,130,898,921,1819,4114
-120,-20,-90,890,929,1819,3837
90,20,-20,887,932,1819,4012
70,-40,80,889,931,1820,3910
40,-30,40,867,953,1820,3875
-140,20,-80,894,926,1820,3928
-70,20,120,903,917,1820,4139
10,30,-20,906,915,1821,4198
-150,50,-80,895,926,1821,4013
-130,-30,-120,892,929,1821,4066
-50,-10,-10,902,919,1821,3994
30,-50,130,923,898,1821,4200
-40,-80,100,885,936,1821,4227
-30,-60,110,899,922,1821,4180
-120,-10,-10,896,926,1822,3947
-30,-50,110,900,922,1822,4001
10,-50,130,921,901,1822,4010
120,80,10,881,942,1823,3995
-130,0,-30,923,900,1823,3994
-80,-80,60,882,941,1823,4082
130,80,0,889,935,1824,3885
-160,-10,-170,890,934,1824,4154
40,0,90,875,949,1824,3975
-50,80,70,891,933,1824,3923
60,-10,70,879,945,1824,3889
100,-60,-130,886,938,1824,4182
-160,-30,-20,900,924,1824,3972
0,-70,140,885,940,1825,4171
-170,40,-60,915,910,1825,3986
-60,-70,80,880,945,1825,4250
40,-10,90,897,929,1826,3937
0,70,10,904,922,1826,4030
-160,0,-170,868,958,1826,4214
-60,0,20,911,916,1827,4010
-120,20,-150,890,937,1827,4145
110,0,-80,885,942,1827,4039
-10,-20,120,905,922,1827,4092
-120,20,-130,906,921,1827,4083
0,-40,120,918,909,1827,4117
40,30,-30,875,952,1827,4035
-20,-80,120,902,925,1827,4237
-130,30,-100,890,937,1827,3990
40,-70,170,901,926,1827,4174
150,10,-140,886,941,1827,3954
-30,-80,110,893,934,1827,4243
-60,10,140,902,925,1827,4184
-150,40,-80,905,923,1828,4059
150,80,-20,884,944,1828,3879
80,30,10,878,950,1828,3879
80,-50,110,889,940,1829,4077
40,0,20,896,933,1829,3855
90,70,40,885,944,1829,3877
10,-80,150,888,941,1829,4169
40,70,-30,890,939,1829,3947
-100,-20,-10,894,936,1830,4051
10,70,0,909,921,1830,4016
100,-50,-170,903,927,1830,4009
-140,70,-90,889,941,1830,4063
120,-30,-140,889,941,1830,4107
130,20,-120,883,947,1830,3954
-170,80,-60,882,948,1830,3941
-10,70,20,898,932,1830,4082
-110,30,-130,899,931,1830,4231
-60,30,80,909,922,1831,4174
120,60,-100,868,963,1831,3911
-60,0,70,893,938,1831,4109
0,-20,110,921,910,1831,4303
-80,-60,60,884,947,1831,4092
130,50,-110,885,946,1831,3833
120,50,-100,877,954,1831,3965
120,-60,-100,854,977,1831,4147
110,70,-90,878,954,1832,3826
-80,30,140,911,921,1832,4252
20,-20,20,878,954,1832,3867
-90,-60,50,892,940,1832,4155
110,-50,-140,888,944,1832,4105
110,80,-90,875,957,1832,3819
70,20,-40,859,973,1832,4166
-150,70,180,921,911,1832,3943
-70,40,100,908,924,1832,4144
-150,70,-180,921,911,1832,3943
-30,-30,110,909,923,1832,3917
-100,40,150,901,932,1833,4158
170,-40,-180,868,965,1833,4051
120,-30,-100,880,953,1833,3949
170,-40,180,868,965,1833,4051
140,60,-120,873,960,1833,4031
130,-70,-90,872,962,1834,4019
-50,70,70,907,927,1834,3945
-130,-20,0,897,937,1834,4120
90,20,-70,889,945,1834,4075
110,20,-30,905,929,1834,4111
130,10,-120,900,934,1834,4028
110,10,-90,886,949,1835,3916
50,10,0,888,947,1835,3988
-40,-70,100,898,937,1835,4330
-20,10,140,881,954,1835,4170
170,-30,-40,879,956,1835,3877
180,80,-50,890,946,1836,3942
170,80,-40,888,948,1836,3916
-10,-50,120,898,938,1836,4254
-50,60,60,891,945,1836,4162
-130,70,160,908,928,1836,4011
60,-20,70,885,951,1836,3947
-180,80,-50,890,946,1836,3942
-110,-50,30,896,940,1836,4155
50,30,90,895,941,1836,4165
130,60,-110,890,946,1836,3865
-110,50,150,901,935,1836,4134
150,-40,-180,882,955,1837,4115
20,-80,30,884,953,1837,4149
-10,-50,0,892,945,1837,4002
-30,-20,-20,893,944,1837,4127
170,10,-150,888,949,1837,4076
150,-40,180,882,955,1837,4115
-120,50,160,917,920,1837,4186
-50,-80,90,893,944,1837,4212
-130,50,-100,913,925,1838,4181
0,-60,130,887,951,1838,4174
-40,50,170,898,940,1838,4153
-120,-80,-110,895,943,1838,4172
30,-70,150,896,942,1838,4235
10,-30,110,912,926,1838,4191
-130,-70,-120,882,956,1838,3979
110,0,-60,895,944,1839,4069
60,0,60,895,944,1839,3917
30,0,0,903,936,1839,4036
-160,10,-170,902,937,1839,4187
-60,-80,80,886,953,1839,4186
120,10,-40,899,940,1839,4130
-180,-80,-40,890,949,1839,3952
180,-80,-40,890,949,1839,3952
-130,10,-160,908,931,1839,4132
-60,-60,80,898,942,1840,4043
-130,50,170,901,939,1840,4128
110,-60,-120,880,960,1840,4043
-170,-10,-170,891,949,1840,4146
-10,0,-10,896,945,1841,4108
-150,60,-80,891,950,1841,3965
-50,30,160,895,946,1841,4091
-50,20,30,913,928,1841,4171
-90,-80,50,876,965,1841,4079
140,-50,-70,878,963,1841,4183
-50,-20,110,905,937,1842,4249
0,-20,-10,900,942,1842,4195
-30,-70,110,908,935,1843,4312
-100,50,140,899,944,1843,4135
70,-70,-160,888,955,1843,4027
-130,-20,-120,908,935,1843,4134
-20,40,150,894,949,1843,4200
120,-30,-110,880,964,1844,4131
140,10,-130,912,932,1844,4043
-110,30,-160,913,931,1844,4203
70,20,-30,874,970,1844,4122
0,-80,140,904,940,1844,4182
-20,-70,120,911,933,1844,4266
120,40,-100,891,953,1844,4022
30,70,-20,891,953,1844,3953
-90,40,-150,905,939,1844,4311
160,50,-140,892,952,1844,3843
60,60,-50,900,944,1844,4117
-160,80,-70,885,959,1844,4013
-60,-20,100,907,938,1845,4217
10,-60,130,898,947,1845,4055
160,-10,-150,918,927,1845,4029
-20,30,0,886,959,1845,4063
60,-70,170,912,933,1845,4027
-160,40,-160,890,955,1845,4004
-10,-80,130,900,945,1845,4203
30,-70,160,915,931,1846,4109
-120,70,150,903,943,1846,4010
-150,40,-170,904,942,1846,4121
30,30,110,869,977,1846,4147
-170,-80,-30,889,957,1846,3968
60,-20,80,864,982,1846,4164
-130,10,-100,906,940,1846,4102
180,20,-40,898,949,1847,4151
-180,20,-40,898,949,1847,4151
-70,50,-170,905,942,1847,3967
-70,-10,20,908,940,1848,4068
-170,-10,-30,908,940,1848,3981
-60,-10,60,912,936,1848,4252
50,-50,140,942,906,1848,4250
50,10,10,888,960,1848,3914
-70,20,140,915,934,1849,4139
10,-20,0,889,960,1849,4205
-60,60,80,911,938,1849,4132
-60,0,120,900,950,1850,4181
70,-70,-180,899,951,1850,4031
-130,30,180,912,938,1850,4219
-60,30,90,925,925,1850,4265
100,10,-70,889,961,1850,4069
70,-70,180,899,951,1850,4031
-60,20,100,918,932,1850,4275
-40,-20,120,905,945,1850,4184
-140,-30,0,891,959,1850,4184
-130,30,-180,912,938,1850,4219
160,50,-40,910,940,1850,4017
-110,70,140,907,943,1850,4097
20,-60,130,909,941,1850,4054
30,40,-30,888,962,1850,4075
-90,70,-140,910,941,1851,4139
130,-20,-140,912,939,1851,4166
120,-10,-100,889,962,1851,3928
-80,-40,50,926,925,1851,3984
-110,-10,-40,923,928,1851,4044
-60,-40,70,930,921,1851,4067
140,20,-30,912,939,1851,4170
70,50,-60,886,966,1852,4126
-30,30,150,898,954,1852,4223
-130,-10,-120,927,925,1852,4166
30,10,100,909,943,1852,3953
30,-60,40,912,940,1852,4197
120,-40,-150,897,955,1852,3982
40,-70,160,892,961,1853,4165
0,-60,120,904,949,1853,4161
-30,10,0,889,964,1853,4138
-10,-70,130,906,947,1853,4249
-30,50,160,901,952,1853,4239
-60,-50,70,918,935,1853,4206
-70,-50,-50,914,940,1854,4081
-130,0,-110,915,939,1854,4118
20,70,-10,907,947,1854,4008
-160,40,-70,919,936,1855,4112
-150,80,-80,893,963,1856,4081
-20,-50,110,902,954,1856,4298
-110,30,-150,929,928,1857,4176
40,10,90,899,958,1857,4022
-20,-30,110,917,940,1857,4200
-60,10,90,929,929,1858,4360
-80,50,110,915,943,1858,4123
-140,50,-90,908,950,1858,4160
-160,-80,-20,895,963,1858,3986
-130,60,-100,915,943,1858,4128
-70,30,160,907,951,1858,4124
-100,-50,40,899,960,1859,4086
-130,-80,-120,908,951,1859,4261
70,-40,90,885,974,1859,3952
130,0,-120,901,958,1859,4065
110,60,10,911,948,1859,4107
-140,40,180,909,950,1859,4094
-100,-80,40,883,976,1859,4091
-140,40,-180,909,950,1859,4094
10,-70,140,902,958,1860,4083
-140,-10,-150,911,949,1860,3992
-120,20,-140,916,944,1860,4277
-180,30,-150,913,947,1860,3971
180,30,-150,913,947,1860,3971
140,-10,-140,904,956,1860,4056
-120,-10,-70,928,932,1860,4078
-70,20,130,943,917,1860,4259
100,80,-80,885,976,1861,3875
-70,-70,70,895,966,1861,4202
-80,-20,20,919,942,1861,4093
-70,-60,70,906,955,1861,4093
-40,40,40,915,946,1861,4207
50,-70,170,899,962,1861,4102
-130,70,-100,922,939,1861,4161
-170,-30,-170,902,959,1861,4218
160,-40,-180,894,968,1862,4092
90,40,10,896,966,1862,3979
120,60,0,914,948,1862,4164
160,-40,-50,891,971,1862,4110
160,-40,180,894,968,1862,4092
160,40,-140,897,965,1862,3858
-40,0,130,909,953,1862,4244
140,-40,-170,909,953,1862,4255
-140,50,-180,901,962,1863,3969
30,50,110,888,975,1863,4045
-50,30,50,914,949,1863,4180
-140,50,180,901,962,1863,3969
110,60,-90,898,965,1863,4067
-130,0,-120,925,939,1864,4159
-20,30,140,905,959,1864,4277
-90,60,120,913,952,1865,4220
-140,60,-90,896,969,1865,4043
-60,-30,80,916,949,1865,4092
20,0,-10,904,961,1865,4160
-170,-30,-30,914,951,1865,4227
-50,-10,120,900,965,1865,4205
-40,80,60,893,972,1865,3998
20,-70,150,912,953,1865,4165
-150,10,-50,938,928,1866,4183
-110,-10,-30,918,948,1866,4059
10,-50,20,901,965,1866,4041
-70,-40,60,910,956,1866,4074
-70,-20,40,935,931,1866,4106
-130,-80,10,895,971,1866,4011
-80,40,120,903,963,1866,4431
0,-10,-10,893,973,1866,4183
50,-70,160,927,940,1867,4032
-170,20,-160,919,948,1867,4098
60,-30,70,894,973,1867,4017
130,-50,170,900,968,1868,4168
-130,0,-40,949,919,1868,4186
-80,60,110,929,939,1868,4276
-110,60,-120,914,954,1868,4175
-140,10,-60,934,934,1868,4128
60,-30,80,912,957,1869,4156
40,-20,90,911,958,1869,3970
80,20,-20,908,961,1869,4155
-50,-40,80,926,943,1869,4105
-150,-80,-10,902,967,1869,4014
-110,-80,30,889,980,1869,4040
-30,50,30,927,942,1869,4284
-110,-30,20,910,959,1869,4315
130,-60,140,886,984,1870,4161
-30,0,130,920,950,1870,4316
-170,60,-160,909,961,1870,4061
60,-50,110,927,943,1870,3991
0,40,-10,891,979,1870,4153
-40,-20,-20,905,965,1870,4142
0,-50,10,925,946,1871,4265
-80,-70,60,904,967,1871,4187
-10,0,130,905,966,1871,4318
110,80,20,922,949,1871,4095
90,-60,-170,926,946,1872,3917
100,-60,-150,904,968,1872,4093
-20,-20,120,931,941,1872,4172
-140,80,-90,904,968,1872,4166
-170,-40,-170,910,963,1873,4193
-30,10,140,919,954,1873,4300
80,20,-30,906,967,1873,4194
150,-20,-150,892,981,1873,4040
-100,70,-130,923,951,1874,4122
-100,70,130,926,948,1874,4143
-120,-80,20,890,984,1874,4013
-10,-60,120,921,953,1874,4283
30,-70,40,900,974,1874,4218
60,-70,180,908,966,1874,4163
30,-20,30,906,968,1874,4012
40,20,-10,898,976,1874,4050
60,-70,-180,908,966,1874,4163
-140,10,-170,916,958,1874,4230
-60,-30,70,916,959,1875,4209
40,-60,140,920,955,1875,4034
20,-50,30,889,986,1875,4106
-30,30,10,931,944,1875,4246
150,-40,-170,891,985,1876,4204
-160,70,-170,940,936,1876,4017
-50,0,130,917,959,1876,4361
70,-60,160,918,958,1876,4080
-160,-50,-160,896,980,1876,4299
-90,40,150,937,940,1877,4278
-70,30,150,911,966,1877,4171
60,10,60,915,962,1877,4039
0,-70,130,921,956,1877,4045
30,50,-30,913,964,1877,4211
130,-40,-160,920,958,1878,4128
-110,-20,0,924,954,1878,4336
20,20,120,908,970,1878,4206
-30,40,20,925,953,1878,4376
-140,-70,-130,913,965,1878,4181
120,-40,-120,904,974,1878,4205
110,50,-90,908,971,1879,4047
150,-10,-40,901,978,1879,4061
-150,-10,-20,930,949,1879,4306
-130,0,-140,905,974,1879,4271
50,60,-40,915,964,1879,4262
-80,50,-160,921,959,1880,4038
-100,-60,40,921,959,1880,4249
130,60,-10,916,964,1880,4016
80,30,0,922,958,1880,3966
130,40,-110,924,956,1880,4100
90,80,-70,890,990,1880,3956
-90,-20,-30,926,954,1880,4022
-130,20,-170,919,961,1880,4242
60,20,60,909,971,1880,4044
100,60,20,907,974,1881,4057
-150,50,-170,909,972,1881,3932
-130,-10,-130,912,969,1881,4339
-130,-10,-10,914,967,1881,4173
30,-80,40,899,982,1881,4270
-90,70,120,919,962,1881,4173
-80,70,-150,922,960,1882,4201
20,-10,100,928,954,1882,4277
-130,10,-110,929,953,1882,4147
-60,0,110,934,948,1882,4277
0,10,130,915,967,1882,4034
-120,70,-110,935,948,1883,4103
-130,40,-100,939,944,1883,4186
120,-60,130,888,995,1883,4172
-90,-70,50,911,972,1883,4170
-110,70,-120,939,945,1884,4115
-120,50,-110,946,938,1884,4281
-30,-40,-20,908,976,1884,4249
-130,-10,-110,930,954,1884,4154
10,-20,10,920,964,1884,4124
20,-70,140,918,966,1884,4339
100,-60,110,883,1001,1884,4198
-100,-70,40,925,960,1885,4191
0,-30,0,912,973,1885,4284
40,30,100,921,964,1885,4153
-140,-80,0,905,980,1885,4037
100,70,-80,913,972,1885,4026
20,-20,100,930,955,1885,4105
90,50,20,932,953,1885,4041
-110,30,-140,949,936,1885,4215
-60,60,-170,924,961,1885,4183
-130,-40,10,920,966,1886,4183
-10,40,140,935,951,1886,4265
-140,0,-160,911,975,1886,4132
-130,0,-100,924,962,1886,3965
-110,30,-180,923,963,1886,4211
-110,30,180,923,963,1886,4211
-170,-50,-170,910,976,1886,4199
-10,-50,110,940,946,1886,4190
60,20,-20,902,984,1886,4152
80,-50,100,896,991,1887,4157
50,10,20,910,977,1887,3900
100,-60,-140,919,968,1887,4284
-70,-30,50,933,954,1887,4141
-90,40,140,945,942,1887,4279
-120,-20,0,929,958,1887,4255
10,-50,120,931,956,1887,4198
-140,30,-90,911,977,1888,4055
-20,50,150,904,985,1889,4278
-60,-10,70,927,962,1889,4283
-140,0,-40,957,932,1889,4147
-60,30,160,915,974,1889,4226
140,60,-20,929,960,1889,3990
120,20,-100,925,965,1890,4159
40,-70,150,937,953,1890,4072
-60,20,110,939,951,1890,4376
-30,-20,120,927,963,1890,4358
-130,0,-90,943,947,1890,4029
-90,-40,40,923,967,1890,3970
60,30,-40,923,967,1890,4176
50,-30,90,917,974,1891,4128
40,-40,110,922,969,1891,4047
60,50,-50,908,983,1891,4202
-20,20,140,914,977,1891,4311
40,0,30,916,975,1891,4101
-60,50,80,928,964,1892,4239
-130,10,-120,950,942,1892,4289
80,80,-60,892,1000,1892,4063
50,-50,130,918,974,1892,4068
130,-10,-120,928,964,1892,4121
-40,20,150,919,973,1892,4310
0,20,130,920,972,1892,4235
-110,-50,-90,942,951,1893,4052
140,-70,-80,916,977,1893,4179
10,0,-10,919,975,1894,4091
120,-20,-90,921,973,1894,4152
-130,20,-110,935,959,1894,4203
-60,10,110,937,957,1894,4330
-60,40,80,929,965,1894,4223
40,-30,90,918,976,1894,4107
-120,-50,20,912,983,1895,4173
120,-20,-100,907,988,1895,4135
-60,10,100,931,964,1895,4338
-30,80,50,906,989,1895,4107
-120,60,160,935,961,1896,4165
10,-20,100,929,967,1896,4117
-120,60,-110,940,956,1896,4223
0,0,-10,903,993,1896,4231
-150,10,-170,915,981,1896,4420
-80,70,110,928,968,1896,4203
40,-20,40,910,987,1897,4043
20,10,-10,912,985,1897,4192
-130,80,-100,929,968,1897,4256
30,20,110,915,982,1897,4231
-30,-60,100,929,968,1897,4257
-150,-30,-10,924,973,1897,4222
80,70,50,915,983,1898,4034
0,60,10,925,973,1898,4173
180,20,-150,902,996,1898,4232
90,20,-30,922,976,1898,4216
-90,50,130,924,974,1898,4209
-180,20,-150,902,996,1898,4232
-20,-40,110,939,960,1899,4264
-110,40,160,927,972,1899,4282
70,-70,-170,923,976,1899,4360
-40,0,0,907,992,1899,4214
-40,60,50,939,961,1900,4214
180,-20,-170,926,974,1900,4321
120,40,-20,922,978,1900,4057
70,30,-50,926,974,1900,4203
110,0,-70,924,976,1900,4224
-180,-20,-170,926,974,1900,4321
0,-30,110,943,957,1900,4447
-110,30,-170,922,978,1900,4305
170,20,-40,931,969,1900,4170
-180,0,-160,904,997,1901,4216
-180,30,-50,947,954,1901,4319
180,30,-50,947,954,1901,4319
180,0,-160,904,997,1901,4216
-20,0,130,935,966,1901,4295
120,-50,-100,907,994,1901,4268
30,0,90,937,965,1902,4086
-70,60,100,936,966,1902,4346
-50,10,20,942,960,1902,4110
-40,-50,90,933,969,1902,4222
0,0,120,918,984,1902,4332
-50,-50,80,938,964,1902,4136
30,-50,40,924,978,1902,4214
-60,-10,0,932,971,1903,4255
110,-50,-170,934,969,1903,4094
40,-80,50,910,993,1903,4342
-120,40,-110,940,963,1903,4264
40,50,100,908,996,1904,4091
100,20,-30,938,966,1904,4290
120,-50,-170,926,978,1904,4185
60,40,-50,933,971,1904,4264
-20,-60,110,941,964,1905,4270
-40,-30,100,948,957,1905,4260
-60,-20,80,931,974,1905,4269
20,0,100,929,977,1906,4294
-90,40,-160,943,963,1906,4254
-120,30,-120,941,965,1906,4408
-90,-20,-10,947,960,1907,4226
-20,50,20,933,974,1907,4193
70,40,50,941,966,1907,4004
100,30,-80,921,986,1907,4165
150,50,-130,926,981,1907,4142
110,20,-90,929,978,1907,4226
-140,10,-70,954,954,1908,4164
-30,-50,100,939,969,1908,4307
-60,-10,100,922,986,1908,4214
20,-50,120,959,949,1908,4353
-40,-10,-10,933,975,1908,4172
-60,-20,70,933,975,1908,4400
140,0,-40,925,983,1908,4257
160,30,-140,919,989,1908,3976
130,-20,-70,913,996,1909,4233
-110,60,150,933,976,1909,4240
130,-50,-180,922,987,1909,4189
130,-50,180,922,987,1909,4189
40,40,100,917,993,1910,4268
70,50,60,924,986,1910,4172
-80,-60,-60,933,977,1910,4087
100,80,30,927,983,1910,4187
-60,0,80,941,969,1910,4367
-10,60,20,931,979,1910,4206
-110,-70,30,926,984,1910,4176
110,-60,120,901,1010,1911,4198
120,-40,-100,932,979,1911,4173
90,30,-10,926,985,1911,4159
-120,-10,-20,938,973,1911,4288
-10,-40,0,918,993,1911,4333
-10,-70,120,941,970,1911,4170
-140,40,-90,947,964,1911,4170
-80,40,180,946,966,1912,4198
-80,40,-180,946,966,1912,4198
80,50,40,950,962,1912,4115
-60,-20,60,945,967,1912,4433
-180,40,-150,936,976,1912,4027
180,40,-150,936,976,1912,4027
30,0,20,913,999,1912,3916
50,0,80,914,998,1912,4205
140,-60,150,906,1006,1912,4241
0,-40,110,964,949,1913,4427
10,0,110,946,967,1913,4201
-30,-40,100,951,962,1913,4299
120,-40,-130,917,996,1913,4165
160,-20,-160,926,988,1914,4325
120,-40,-110,931,983,1914,4305
30,10,-10,912,1003,1915,4287
-10,50,10,918,997,1915,4345
40,-10,40,916,999,1915,4023
-10,-60,110,946,969,1915,4416
-140,-80,-130,935,980,1915,4383
120,30,-100,918,997,1915,4292
-170,-20,-30,944,972,1916,4233
-50,20,150,928,988,1916,4387
-130,60,170,928,988,1916,4113
130,-40,-80,930,987,1917,4360
-90,40,-170,932,985,1917,4267
-120,80,-110,948,969,1917,4275
0,-50,110,954,963,1917,4359
-10,50,140,931,986,1917,4296
-70,70,100,935,983,1918,4274
10,10,-10,906,1012,1918,4340
70,30,30,913,1005,1918,4115
-50,-20,-20,948,970,1918,4274
-30,-30,-20,944,974,1918,4330
80,-70,-150,915,1003,1918,4263
150,-70,-70,950,969,1919,4227
130,30,-110,939,980,1919,4338
30,-30,100,933,986,1919,4154
0,-10,110,953,966,1919,4362
-170,20,-50,949,970,1919,4347
-60,20,150,931,989,1920,4319
-60,-20,90,944,976,1920,4342
70,20,-20,922,998,1920,4292
40,-70,50,929,991,1920,4377
30,0,10,931,989,1920,4228
-170,70,-160,941,979,1920,4087
170,0,-150,931,990,1921,4245
-50,50,60,947,974,1921,4325
120,10,-100,922,999,1921,4057
-100,-30,20,951,970,1921,4285
-40,-40,90,946,975,1921,4215
-170,30,-60,950,971,1921,4183
100,20,-80,933,988,1921,4339
130,50,-20,966,955,1921,4126
0,10,-10,914,1007,1921,4344
40,60,-30,945,976,1921,4296
-10,-20,110,970,952,1922,4348
-90,-60,-70,951,971,1922,4104
50,30,-30,920,1002,1922,4380
60,20,20,911,1011,1922,4240
-50,10,80,969,953,1922,4302
30,-20,90,933,990,1923,4174
120,-50,-110,937,986,1923,4282
60,20,10,924,999,1923,4147
-100,40,160,936,987,1923,4400
-110,80,-120,953,970,1923,4300
80,-60,170,951,972,1923,4270
-70,-50,60,954,969,1923,4209
150,-50,170,911,1012,1923,4251
60,40,70,936,987,1923,4123
40,-40,100,948,975,1923,4237
-60,0,100,933,990,1923,4466
100,60,-80,937,986,1923,4211
-60,0,40,920,1004,1924,4378
-50,60,-180,938,986,1924,4315
-50,60,180,938,986,1924,4315
140,50,-120,924,1000,1924,4090
60,20,50,925,999,1924,4189
80,20,-50,938,986,1924,4491
-100,-20,-40,969,956,1925,4149
10,-70,130,933,992,1925,4463
80,30,-60,939,986,1925,4269
160,40,-40,958,967,1925,4178
-100,-90,-90,919,1007,1926,4369
10,-90,20,919,1007,1926,4369
-50,-90,-40,919,1007,1926,4369
-180,-90,-170,919,1007,1926,4369
90,-90,100,919,1007,1926,4369
110,-90,120,919,1007,1926,4369
-70,-90,-60,919,1007,1926,4369
-140,-90,-130,919,1007,1926,4369
20,-90,30,919,1007,1926,4369
-60,40,170,939,987,1926,4186
140,-90,150,919,1007,1926,4369
70,80,-50,898,1028,1926,4091
-130,-90,-120,919,1007,1926,4369
-20,-90,-10,919,1007,1926,4369
160,-90,170,919,1007,1926,4369
60,-90,70,919,1007,1926,4369
-110,-90,-100,919,1007,1926,4369
40,-90,50,919,1007,1926,4369
0,-90,10,919,1007,1926,4369
-160,-90,-150,919,1007,1926,4369
-80,-90,-70,919,1007,1926,4369
170,-90,180,919,1007,1926,4369
170,-90,-180,919,1007,1926,4369
70,-90,80,919,1007,1926,4369
130,-90,140,919,1007,1926,4369
120,-90,130,919,1007,1926,4369
-30,-90,-20,919,1007,1926,4369
180,-90,-170,919,1007,1926,4369
30,-90,40,919,1007,1926,4369
-170,-90,-160,919,1007,1926,4369
150,-90,160,919,1007,1926,4369
50,-90,60,919,1007,1926,4369
-40,-90,-30,919,1007,1926,4369
-150,-90,-140,919,1007,1926,4369
100,-90,110,919,1007,1926,4369
80,-90,90,919,1007,1926,4369
-120,-90,-110,919,1007,1926,4369
60,20,0,932,994,1926,4150
-90,-90,-80,919,1007,1926,4369
-10,-90,0,919,1007,1926,4369
-60,-90,-50,919,1007,1926,4369
0,-40,10,937,990,1927,4264
-140,-60,-130,934,993,1927,4183
50,0,40,930,997,1927,4165
-40,-20,110,952,975,1927,4339
-60,30,100,957,971,1928,4278
-60,50,180,951,977,1928,4132
20,-10,10,923,1005,1928,4313
-60,50,-180,951,977,1928,4132
60,30,60,934,995,1929,4182
-160,20,-60,962,967,1929,4207
60,-40,70,936,993,1929,4349
-10,-30,-10,935,994,1929,4392
-30,-10,-10,948,981,1929,4310
-40,70,60,944,985,1929,4171
-50,-30,80,953,976,1929,4355
-40,40,160,933,996,1929,4322
-70,-60,-50,942,987,1929,4190
130,-20,-120,936,993,1929,4231
-60,-50,-40,947,982,1929,4178
30,-70,140,955,974,1929,4227
50,20,-10,927,1003,1930,4231
-150,30,-170,930,1000,1930,4404
-100,60,140,959,971,1930,4292
-150,30,-80,949,981,1930,4267
100,10,-50,937,993,1930,4349
160,-50,170,918,1013,1931,4337
90,30,-70,928,1003,1931,4525
-30,60,40,965,966,1931,4385
30,20,-10,932,999,1931,4197
120,0,-100,932,999,1931,4093
150,60,-30,933,998,1931,4196
-50,-10,110,947,985,1932,4369
-150,20,-170,941,991,1932,4397
-70,30,120,964,968,1932,4400
-10,40,0,931,1002,1933,4181
140,40,-30,961,972,1933,4169
-140,80,170,940,993,1933,4159
130,-50,-170,965,968,1933,4264
180,50,-150,934,999,1933,4216
90,-60,160,951,982,1933,4195
-180,50,-150,934,999,1933,4216
-150,20,-70,973,960,1933,4186
30,40,110,916,1018,1934,4286
-50,10,140,929,1006,1935,4469
-50,20,40,953,982,1935,4389
-120,40,170,957,978,1935,4430
-10,10,130,944,991,1935,4314
-140,-20,-10,943,993,1936,4454
40,10,0,934,1002,1936,4252
-60,70,90,941,995,1936,4337
-20,-50,100,966,970,1936,4270
-170,10,-40,957,979,1936,4337
140,-50,170,924,1012,1936,4375
-60,10,120,955,982,1937,4515
90,80,40,944,993,1937,4238
-10,-10,-10,936,1001,1937,4379
90,70,-70,934,1003,1937,4280
50,10,80,921,1016,1937,4404
-170,-40,-30,966,972,1938,4131
-60,40,90,971,967,1938,4331
-40,10,140,938,1000,1938,4374
50,-70,150,938,1000,1938,4248
-50,20,50,965,973,1938,4316
-160,30,-70,970,968,1938,4268
-20,-70,110,946,992,1938,4227
60,20,30,933,1006,1939,4395
20,10,110,943,996,1939,4370
-50,20,90,973,966,1939,4335
-120,30,180,938,1001,1939,4476
60,-70,160,939,1000,1939,4218
-120,30,-180,938,1001,1939,4476
10,-40,20,961,978,1939,4255
-50,-60,80,946,993,1939,4331
-60,60,90,951,988,1939,4345
30,30,-20,932,1007,1939,4290
-130,80,160,944,995,1939,4147
-60,-20,-20,956,983,1939,4287
-10,-30,110,982,957,1939,4364
140,0,-130,929,1011,1940,4255
-80,-30,-40,966,974,1940,4410
-60,0,30,934,1006,1940,4359
-60,-10,50,950,990,1940,4416
50,-10,50,931,1009,1940,4211
-50,20,60,940,1001,1941,4475
150,20,-130,936,1005,1941,4065
90,-60,150,960,981,1941,4172
-100,40,-160,960,982,1942,4281
20,0,90,959,983,1942,4264
-140,20,-90,946,996,1942,4289
-120,-40,-100,975,967,1942,4176
-60,-30,60,957,985,1942,4316
-120,80,150,943,999,1942,4138
-140,-10,-20,964,978,1942,4386
-10,80,30,927,1016,1943,4202
-60,-10,80,961,982,1943,4352
-100,80,-130,952,991,1943,4352
-110,-60,30,940,1003,1943,4294
140,-10,-50,938,1005,1943,4286
-120,-30,10,959,984,1943,4343
-170,-20,-170,946,997,1943,4474
150,30,-130,947,996,1943,4123
-50,10,90,972,972,1944,4389
-90,60,130,971,973,1944,4358
120,-10,-80,959,985,1944,4327
-80,50,120,959,985,1944,4279
10,-10,100,958,986,1944,4202
-150,-10,-160,935,1009,1944,4282
0,30,130,952,992,1944,4271
-70,40,110,952,992,1944,4370
-70,50,100,973,971,1944,4297
-70,70,-160,963,981,1944,4433
-90,-30,-50,963,982,1945,4329
50,10,30,952,993,1945,4225
170,50,-50,959,986,1945,4226
60,20,40,931,1014,1945,4192
150,40,-130,937,1008,1945,4149
-150,80,180,944,1001,1945,4258
-160,50,-160,940,1005,1945,4021
-150,80,-180,944,1001,1945,4258
70,70,60,937,1008,1945,4201
10,60,0,952,994,1946,4335
-20,80,40,941,1005,1946,4158
-40,-60,90,950,996,1946,4304
110,-70,-120,936,1010,1946,4344
90,-80,-140,945,1001,1946,4323
-30,-30,100,972,974,1946,4363
50,-50,120,944,1002,1946,4132
130,10,-110,946,1000,1946,4259
170,-60,-50,962,984,1946,4243
170,-70,-50,968,979,1947,4254
110,-60,-130,958,989,1947,4351
-50,-30,90,957,990,1947,4389
30,-40,110,974,973,1947,4222
20,-40,30,928,1020,1948,4282
130,20,-110,932,1016,1948,4383
-60,20,140,947,1001,1948,4486
130,-10,-60,954,994,1948,4254
-70,-20,-20,951,997,1948,4336
-60,10,130,956,993,1949,4598
0,80,20,922,1028,1950,4310
-50,20,70,970,980,1950,4459
100,50,-80,956,994,1950,4465
50,-50,110,967,983,1950,4407
90,-60,100,924,1026,1950,4469
-20,60,30,976,975,1951,4423
130,0,-110,948,1003,1951,4178
150,-60,160,935,1016,1951,4364
100,-80,-130,942,1009,1951,4279
170,-30,-170,940,1011,1951,4351
50,40,-40,939,1012,1951,4289
50,-80,60,934,1017,1951,4428
90,-70,-140,929,1022,1951,4391
-130,-50,10,959,993,1952,4314
60,-60,150,965,987,1952,4267
-50,0,10,955,997,1952,4425
-30,-70,100,960,992,1952,4306
50,-70,60,957,995,1952,4391
160,30,-40,965,987,1952,4295
110,-80,-120,948,1005,1953,4315
-140,-30,-140,944,1009,1953,4340
70,60,60,952,1001,1953,4292
-20,40,10,947,1006,1953,4410
0,20,-10,942,1011,1953,4551
-110,-20,-10,949,1004,1953,4434
80,-70,-170,949,1005,1954,4195
-40,30,150,932,1022,1954,4438
180,60,-150,939,1015,1954,4315
20,60,-10,963,991,1954,4446
160,-70,-60,968,986,1954,4290
-180,60,-150,939,1015,1954,4315
-50,-20,100,961,993,1954,4425
90,20,-60,942,1012,1954,4354
80,80,50,956,999,1955,4288
170,-20,-40,935,1020,1955,4314
50,-10,80,913,1042,1955,4286
-100,-60,-80,970,985,1955,4215
60,90,-30,951,1005,1956,4288
-140,90,170,951,1005,1956,4288
-50,90,80,951,1005,1956,4288
30,90,0,951,1005,1956,4288
180,90,-150,951,1005,1956,4288
-100,90,130,951,1005,1956,4288
-40,-70,90,965,991,1956,4360
0,90,30,951,1005,1956,4288
80,90,-50,951,1005,1956,4288
-100,-40,30,951,1005,1956,4307
140,90,-110,951,1005,1956,4288
-130,90,160,951,1005,1956,4288
90,90,-60,951,1005,1956,4288
20,90,10,951,1005,1956,4288
60,-40,90,968,988,1956,4435
-40,90,70,951,1005,1956,4288
-160,90,-170,951,1005,1956,4288
160,90,-130,951,1005,1956,4288
-20,90,50,951,1005,1956,4288
-120,90,150,951,1005,1956,4288
-150,90,-180,951,1005,1956,4288
-170,90,-160,951,1005,1956,4288
-180,90,-150,951,1005,1956,4288
130,90,-100,951,1005,1956,4288
110,90,-80,951,1005,1956,4288
-150,90,180,951,1005,1956,4288
-60,90,90,951,1005,1956,4288
-110,90,140,951,1005,1956,4288
-70,90,100,951,1005,1956,4288
40,90,-10,951,1005,1956,4288
170,90,-140,951,1005,1956,4288
-30,90,60,951,1005,1956,4288
150,90,-120,951,1005,1956,4288
-140,60,180,952,1004,1956,4124
-90,90,120,951,1005,1956,4288
-80,90,110,951,1005,1956,4288
100,90,-70,951,1005,1956,4288
10,90,20,951,1005,1956,4288
50,90,-20,951,1005,1956,4288
-140,60,-180,952,1004,1956,4124
120,90,-90,951,1005,1956,4288
-10,90,40,951,1005,1956,4288
70,90,-40,951,1005,1956,4288
-90,40,160,962,995,1957,4548
-110,80,140,957,1000,1957,4168
-70,30,140,982,975,1957,4462
-160,-10,-30,964,993,1957,4403
50,50,-40,946,1011,1957,4405
-150,-80,-140,954,1003,1957,4389
120,-50,-130,949,1008,1957,4425
100,-60,160,952,1005,1957,4249
-50,50,170,950,1008,1958,4323
-100,40,-140,939,1019,1958,4404
110,40,-90,951,1008,1959,4353
160,-60,-60,948,1011,1959,4186
50,80,-30,919,1040,1959,4206
70,20,-10,941,1019,1960,4342
50,30,-10,945,1015,1960,4230
-150,-70,-140,956,1004,1960,4399
10,10,120,963,997,1960,4530
-40,-10,120,967,993,1960,4519
110,-50,-150,962,998,1960,4165
70,80,60,958,1003,1961,4258
-70,80,100,956,1005,1961,4215
-50,30,60,955,1006,1961,4451
-80,-20,0,958,1003,1961,4365
100,-70,-130,949,1012,1961,4514
120,30,-30,964,997,1961,4446
-80,-20,10,973,988,1961,4504
-20,-10,-10,956,1005,1961,4214
130,-60,-90,924,1037,1961,4359
-130,0,-80,973,989,1962,4313
30,80,100,969,994,1963,4352
0,-80,130,970,993,1963,4398
50,-20,80,958,1005,1963,4455
80,-60,150,951,1012,1963,4267
-90,80,120,961,1002,1963,4182
60,80,-40,914,1049,1963,4189
-50,10,70,986,977,1963,4506
30,-60,130,962,1001,1963,4193
50,-80,-180,975,988,1963,4434
50,-80,180,975,988,1963,4434
-110,-20,-60,987,977,1964,4326
-20,-60,100,975,989,1964,4525
-60,-60,-40,963,1001,1964,4325
30,-80,160,974,990,1964,4503
-180,10,-40,965,1000,1965,4499
100,-60,150,967,998,1965,4274
50,30,-20,985,980,1965,4415
-50,20,80,987,978,1965,4459
-130,0,-50,968,997,1965,4461
-50,-40,-30,950,1015,1965,4467
130,-20,-130,946,1019,1965,4283
180,10,-40,965,1000,1965,4499
-150,-40,-150,967,998,1965,4391
180,80,-150,942,1024,1966,4347
80,-80,-150,964,1002,1966,4385
-180,80,-150,942,1024,1966,4347
-50,40,60,962,1004,1966,4447
120,-10,-90,964,1002,1966,4299
90,-60,140,961,1005,1966,4227
20,30,-20,957,1009,1966,4437
70,-80,-160,969,997,1966,4360
-40,-30,90,973,994,1967,4403
-10,-40,110,992,975,1967,4486
120,-50,-120,954,1013,1967,4394
10,-40,110,988,979,1967,4581
-80,40,130,979,988,1967,4517
110,30,-90,961,1006,1967,4457
80,20,-40,934,1033,1967,4468
40,20,0,944,1023,1967,4153
-140,-40,0,971,996,1967,4336
40,10,20,959,1008,1967,4152
90,-60,130,945,1022,1967,4318
180,-30,-170,944,1024,1968,4326
60,20,-10,951,1017,1968,4258
20,50,-20,962,1006,1968,4501
-180,-30,-170,944,1024,1968,4326
80,-70,-160,968,1000,1968,4547
140,40,-120,959,1009,1968,4246
100,-60,140,944,1025,1969,4248
-120,-60,20,949,1020,1969,4323
40,-80,170,982,987,1969,4511
80,-60,140,979,990,1969,4122
-100,80,130,965,1004,1969,4194
-60,-60,70,974,995,1969,4453
180,-70,-40,970,1000,1970,4248
30,-10,90,955,1015,1970,4348
0,40,130,977,993,1970,4421
70,30,20,962,1008,1970,4363
30,20,100,983,987,1970,4416
-150,-10,-30,988,982,1970,4356
-60,-40,60,993,977,1970,4393
-90,80,-140,972,998,1970,4383
170,40,-50,965,1005,1970,4350
-50,-70,-30,962,1008,1970,4321
-180,-70,-40,970,1000,1970,4248
-110,40,170,948,1022,1970,4444
-70,90,-160,963,1008,1971,4399
0,50,130,960,1011,1971,4339
60,90,70,963,1008,1971,4399
180,90,-50,963,1008,1971,4399
160,90,-30,963,1008,1971,4399
-30,90,160,963,1008,1971,4399
-120,90,-110,963,1008,1971,4399
120,90,10,963,1008,1971,4399
30,90,100,963,1008,1971,4399
-10,90,140,963,1008,1971,4399
140,90,-10,963,1008,1971,4399
90,90,40,963,1008,1971,4399
-130,90,-100,963,1008,1971,4399
10,90,120,963,1008,1971,4399
100,90,30,963,1008,1971,4399
-110,90,-120,963,1008,1971,4399
-180,90,-50,963,1008,1971,4399
110,90,20,963,1008,1971,4399
-160,90,-70,963,1008,1971,4399
20,90,110,963,1008,1971,4399
130,90,0,963,1008,1971,4399
-90,90,-140,963,1008,1971,4399
-60,0,90,974,997,1971,4608
30,60,-20,976,995,1971,4433
70,90,60,963,1008,1971,4399
-170,90,-60,963,1008,1971,4399
-60,90,-170,963,1008,1971,4399
-20,90,150,963,1008,1971,4399
90,50,-70,978,993,1971,4466
-40,90,170,963,1008,1971,4399
80,90,50,963,1008,1971,4399
-50,90,180,963,1008,1971,4399
40,90,90,963,1008,1971,4399
-100,90,-130,963,1008,1971,4399
-80,90,-150,963,1008,1971,4399
50,90,80,963,1008,1971,4399
150,90,-20,963,1008,1971,4399
-140,90,-90,963,1008,1971,4399
-150,90,-80,963,1008,1971,4399
-50,90,-180,963,1008,1971,4399
0,90,130,963,1008,1971,4399
170,90,-40,963,1008,1971,4399
70,-50,80,939,1033,1972,4533
30,-10,30,948,1024,1972,4407
-150,0,-40,983,989,1972,4495
-40,60,170,968,1004,1972,4479
140,-30,-150,960,1012,1972,4377
-130,0,-130,966,1006,1972,4539
-80,80,-150,960,1013,1973,4397
-90,-30,20,968,1005,1973,4283
40,80,-20,933,1040,1973,4296
90,-60,-180,970,1003,1973,4381
90,-60,180,970,1003,1973,4381
20,-30,30,968,1005,1973,4357
-80,80,110,959,1014,1973,4233
20,-30,100,970,1003,1973,4185
-60,-30,-30,973,1001,1974,4276
-30,60,160,970,1004,1974,4516
60,30,-10,954,1020,1974,4255
80,60,-60,959,1015,1974,4433
50,20,80,946,1028,1974,4483
-170,-80,-160,960,1015,1975,4480
80,-60,160,973,1002,1975,4343
-80,40,150,955,1020,1975,4461
30,-40,40,949,1026,1975,4300
180,-10,-160,943,1033,1976,4421
110,-80,120,952,1024,1976,4392
-180,-10,-160,943,1033,1976,4421
-130,40,180,983,993,1976,4628
-130,40,-180,983,993,1976,4628
90,60,30,952,1024,1976,4277
-130,-30,0,971,1005,1976,4561
-40,30,30,976,1000,1976,4665
-10,-30,100,976,1001,1977,4358
-50,-20,80,976,1001,1977,4641
150,0,-140,960,1017,1977,4464
130,10,-40,955,1022,1977,4430
40,20,90,979,998,1977,4270
20,80,0,945,1032,1977,4407
100,30,-20,973,1004,1977,4359
0,30,-10,958,1019,1977,4539
60,-80,-170,986,991,1977,4408
-160,-80,-150,963,1014,1977,4454
110,-60,130,952,1026,1978,4423
-160,80,-170,952,1026,1978,4268
40,-50,130,1004,974,1978,4510
0,50,0,968,1010,1978,4531
10,80,10,946,1032,1978,4362
-10,-10,120,991,987,1978,4480
160,20,-140,937,1041,1978,4199
-50,60,80,966,1012,1978,4410
-30,-50,90,992,987,1979,4350
-160,-40,-20,990,989,1979,4299
170,80,-140,954,1025,1979,4399
-30,70,50,954,1025,1979,4356
90,60,-70,962,1017,1979,4361
20,-10,20,947,1033,1980,4244
-130,-10,-20,973,1007,1980,4447
110,-50,-160,987,993,1980,4339
100,-60,170,959,1021,1980,4238
40,-60,50,946,1034,1980,4403
-80,40,140,992,989,1981,4600
-50,30,90,995,986,1981,4411
10,-60,120,959,1022,1981,4337
120,-80,-110,960,1021,1981,4369
-70,-40,50,979,1002,1981,4262
-130,10,-150,972,1009,1981,4583
120,-80,130,958,1024,1982,4438
40,10,10,947,1035,1982,4280
70,-70,170,973,1009,1982,4250
100,-80,110,960,1022,1982,4359
-100,-40,-70,1000,982,1982,4359
120,-40,-140,978,1004,1982,4331
10,-50,110,967,1015,1982,4490
-30,80,60,965,1018,1983,4332
70,-60,140,977,1006,1983,4367
-130,-10,-100,966,1017,1983,4266
60,80,70,979,1005,1984,4308
-10,-80,120,974,1010,1984,4431
-150,60,-170,959,1025,1984,4323
170,-20,-160,958,1027,1985,4313
10,-80,140,986,999,1985,4431
-170,40,-150,962,1023,1985,4237
-180,10,-150,949,1036,1985,4318
-50,60,70,953,1032,1985,4471
50,30,80,952,1033,1985,4363
180,10,-150,949,1036,1985,4318
50,80,80,976,1010,1986,4300
-140,20,-170,986,1000,1986,4580
-30,-20,110,986,1000,1986,4440
130,-10,-110,948,1038,1986,4245
0,-20,100,988,998,1986,4617
40,0,40,960,1026,1986,4354
20,-70,130,964,1023,1987,4495
140,-50,-180,957,1030,1987,4450
0,-30,100,1003,984,1987,4768
40,80,90,979,1008,1987,4295
-20,-30,100,998,989,1987,4503
90,-80,100,959,1028,1987,4421
-80,-20,-10,979,1008,1987,4477
-170,80,-160,952,1035,1987,4318
140,-50,180,957,1030,1987,4450
-130,0,-70,987,1001,1988,4400
-60,70,-170,989,999,1988,4494
-120,-70,20,952,1036,1988,4371
80,70,-60,961,1027,1988,4403
150,-30,-160,973,1015,1988,4572
20,-80,150,984,1004,1988,4494
130,40,-30,986,1002,1988,4305
-60,80,90,970,1019,1989,4314
40,-70,140,954,1035,1989,4368
30,10,90,978,1011,1989,4329
-50,-70,80,969,1020,1989,4421
-60,50,90,1004,985,1989,4359
80,-80,90,963,1026,1989,4407
110,-60,-140,977,1013,1990,4479
-20,-20,110,987,1003,1990,4502
110,-60,150,946,1044,1990,4386
-10,-60,10,966,1025,1991,4260
30,80,-10,945,1046,1991,4389
-120,-10,-60,981,1010,1991,4342
0,-40,100,978,1013,1991,4432
100,-60,-160,987,1005,1992,4277
60,-70,70,967,1025,1992,4434
100,40,-10,958,1034,1992,4103
-110,70,150,981,1011,1992,4365
-20,60,150,989,1003,1992,4516
-40,80,70,970,1022,1992,4356
170,60,-50,981,1011,1992,4488
80,40,-60,964,1029,1993,4669
140,-20,-60,977,1016,1993,4440
140,-60,-80,969,1024,1993,4420
150,-40,-60,960,1033,1993,4451
70,-60,150,981,1012,1993,4332
-50,70,80,967,1026,1993,4443
-60,-10,90,964,1029,1993,4509
-130,20,-120,1016,977,1993,4514
-50,50,70,963,1031,1994,4577
60,-80,70,950,1044,1994,4495
-130,0,-60,994,1000,1994,4449
-170,30,-150,963,1031,1994,4388
130,-30,-120,959,1036,1995,4415
-40,50,50,982,1013,1995,4577
80,50,-60,965,1030,1995,4501
-100,-20,-30,977,1018,1995,4286
20,20,-10,952,1043,1995,4478
-140,-70,0,985,1011,1996,4445
70,70,-50,959,1037,1996,4378
-150,-20,-20,991,1005,1996,4533
-40,70,70,976,1020,1996,4499
-80,-20,-20,970,1026,1996,4430
40,30,-20,974,1022,1996,4480
-160,-30,-160,947,1049,1996,4423
130,20,-40,978,1019,1997,4536
-100,-20,-20,962,1035,1997,4398
-40,10,10,975,1022,1997,4510
130,-20,-110,965,1032,1997,4246
-90,-20,-20,978,1019,1997,4452
-130,30,-110,985,1013,1998,4459
-70,40,150,984,1014,1998,4577
70,30,10,964,1034,1998,4234
130,-80,140,971,1027,1998,4439
-50,0,70,1009,989,1998,4468
-40,-30,80,1002,997,1999,4533
20,-40,110,1003,996,1999,4651
0,-30,10,982,1017,1999,4259
70,-50,90,962,1037,1999,4575
50,20,10,966,1033,1999,4241
130,-30,-80,966,1033,1999,4514
-130,10,-130,992,1008,2000,4529
130,40,-100,1002,998,2000,4397
-130,-70,10,971,1029,2000,4436
-20,10,130,964,1036,2000,4733
160,60,-40,977,1023,2000,4403
110,-60,140,976,1025,2001,4450
140,-20,-140,969,1032,2001,4557
-180,-80,-170,975,1026,2001,4549
20,40,-20,948,1053,2001,4373
-150,-70,-10,990,1011,2001,4428
180,-80,-170,975,1026,2001,4549
160,20,-40,977,1024,2001,4270
-50,-10,60,999,1002,2001,4538
-40,-70,-20,967,1035,2002,4371
-20,70,40,966,1036,2002,4354
-160,30,-160,970,1032,2002,4420
50,-60,140,984,1018,2002,4430
-180,40,-60,986,1016,2002,4337
180,40,-60,986,1016,2002,4337
-170,-70,-30,989,1013,2002,4360
140,-40,-160,988,1015,2003,4457
-50,10,60,985,1018,2003,4482
-30,50,40,991,1012,2003,4565
0,-10,100,996,1007,2003,4298
-90,40,170,978,1026,2004,4622
-10,20,130,976,1028,2004,4566
-20,-40,100,1006,998,2004,4442
10,-10,0,980,1024,2004,4329
-50,80,80,972,1032,2004,4334
-60,20,120,1006,999,2005,4519
-20,-80,110,996,1009,2005,4448
60,70,-40,974,1031,2005,4322
60,70,70,973,1032,2005,4411
80,-60,130,976,1029,2005,4284
110,40,-20,981,1024,2005,4202
-80,-40,-50,987,1018,2005,4412
-110,40,-130,975,1030,2005,4636
60,30,-20,957,1048,2005,4410
-50,0,120,976,1029,2005,4622
50,-30,60,976,1029,2005,4493
-40,60,60,964,1041,2005,4441
180,70,-150,968,1038,2006,4294
-180,70,-150,968,1038,2006,4294
-100,70,140,991,1015,2006,4373
-160,-40,-160,974,1032,2006,4514
50,20,0,967,1039,2006,4359
-30,-60,90,1006,1000,2006,4532
-20,-40,-10,958,1049,2007,4414
-70,80,-160,982,1025,2007,4433
-20,20,0,988,1019,2007,4454
-60,30,110,1014,993,2007,4591
-170,10,-160,971,1036,2007,4462
100,40,-80,981,1027,2008,4576
-80,60,120,992,1016,2008,4451
-100,40,170,983,1025,2008,4679
0,-70,120,974,1034,2008,4651
-160,60,-160,959,1049,2008,4277
70,-80,80,960,1048,2008,4440
-10,-70,10,980,1029,2009,4363
0,10,120,982,1027,2009,4536
-60,-70,-40,976,1033,2009,4431
-120,30,-130,998,1012,2010,4720
90,-70,100,968,1042,2010,4676
160,10,-140,972,1038,2010,4464
-160,-70,-20,988,1022,2010,4369
-120,-20,-10,997,1014,2011,4536
170,-10,-150,972,1039,2011,4422
170,-80,-180,975,1036,2011,4423
-70,40,170,977,1034,2011,4454
-30,20,140,977,1034,2011,4554
-120,70,160,990,1021,2011,4316
160,-40,-170,973,1038,2011,4477
-80,40,160,987,1024,2011,4495
170,-80,180,975,1036,2011,4423
-60,40,100,1001,1010,2011,4464
110,-60,170,995,1017,2012,4401
80,30,-10,990,1022,2012,4310
100,20,-70,982,1030,2012,4537
-50,-10,70,1011,1001,2012,4553
130,-20,-100,971,1042,2013,4263
70,-50,100,980,1033,2013,4516
-140,-50,-130,993,1020,2013,4426
100,-70,110,968,1046,2014,4657
30,-30,90,980,1034,2014,4381
-100,40,-150,991,1023,2014,4496
80,-60,90,953,1061,2014,4738
-50,20,140,978,1036,2014,4603
-10,60,140,980,1035,2015,4618
-20,-70,0,977,1038,2015,4333
110,-70,120,959,1056,2015,4687
90,-60,170,986,1029,2015,4441
-50,10,50,1003,1012,2015,4608
-70,50,110,992,1023,2015,4520
20,80,110,987,1028,2015,4425
130,-80,-100,979,1036,2015,4448
130,-40,-150,989,1026,2015,4606
-30,-30,90,997,1018,2015,4521
150,-60,-70,967,1048,2015,4251
180,-60,-40,1003,1013,2016,4423
-180,-60,-40,1003,1013,2016,4423
70,30,-20,979,1037,2016,4287
60,-40,80,984,1032,2016,4604
70,60,-50,981,1035,2016,4523
-40,10,130,1000,1017,2017,4595
-40,-50,80,997,1020,2017,4547
-50,0,60,1006,1011,2017,4492
-90,50,140,983,1034,2017,4590
-130,-20,-10,985,1032,2017,4652
120,0,-90,965,1053,2018,4251
20,0,0,974,1044,2018,4572
-30,-10,120,1004,1014,2018,4610
120,20,-40,984,1035,2019,4670
-50,70,-180,999,1020,2019,4539
-50,70,180,999,1020,2019,4539
-150,10,-60,1001,1018,2019,4503
160,-60,170,971,1049,2020,4572
-180,-40,-170,988,1032,2020,4462
180,-40,-170,988,1032,2020,4462
90,40,-70,982,1038,2020,4500
-50,30,150,975,1045,2020,4671
-50,0,110,995,1025,2020,4562
120,-60,140,965,1056,2021,4492
50,70,-30,991,1030,2021,4335
-80,-50,50,1005,1016,2021,4445
0,-20,0,971,1050,2021,4590
120,-60,150,975,1046,2021,4459
40,-50,50,967,1054,2021,4503
-70,-70,-50,997,1024,2021,4440
-150,20,-80,1009,1012,2021,4447
70,-60,130,983,1038,2021,4276
-50,30,80,1006,1015,2021,4573
-50,-80,80,1004,1017,2021,4428
-70,30,130,1013,1009,2022,4673
-40,-80,90,999,1023,2022,4419
-50,-60,-30,993,1029,2022,4403
110,-60,-180,988,1034,2022,4429
110,-60,180,988,1034,2022,4429
120,-60,-110,970,1052,2022,4338
-50,-50,-30,979,1043,2022,4262
150,-20,-50,970,1052,2022,4519
-30,-70,-10,970,1052,2022,4393
-50,30,70,996,1027,2023,4451
150,10,-130,972,1051,2023,4304
-30,40,30,999,1024,2023,4577
80,-60,120,1000,1023,2023,4590
-90,-40,-60,989,1034,2023,4344
-50,-10,80,1003,1020,2023,4621
60,-90,-170,1009,1015,2024,4468
70,-90,-160,1009,1015,2024,4468
-110,-90,20,1009,1015,2024,4468
-20,-90,110,1009,1015,2024,4468
-70,-90,60,1009,1015,2024,4468
50,-90,-180,1009,1015,2024,4468
130,-90,-100,1009,1015,2024,4468
-180,-90,-50,1009,1015,2024,4468
150,-90,-80,1009,1015,2024,4468
150,30,-40,1006,1018,2024,4371
-150,-90,-20,1009,1015,2024,4468
30,-30,40,973,1051,2024,4401
-60,-90,70,1009,1015,2024,4468
-140,-90,-10,1009,1015,2024,4468
-160,-90,-30,1009,1015,2024,4468
-100,-90,30,1009,1015,2024,4468
130,50,-100,999,1025,2024,4454
-40,-20,80,1027,997,2024,4688
120,-90,-110,1009,1015,2024,4468
-120,-90,10,1009,1015,2024,4468
170,-90,-60,1009,1015,2024,4468
100,-90,-130,1009,1015,2024,4468
-50,20,100,1002,1022,2024,4537
90,-90,-140,1009,1015,2024,4468
10,-90,140,1009,1015,2024,4468
-130,-90,0,1009,1015,2024,4468
-30,-90,100,1009,1015,2024,4468
-50,-90,80,1009,1015,2024,4468
-40,-90,90,1009,1015,2024,4468
-90,-90,40,1009,1015,2024,4468
80,-90,-150,1009,1015,2024,4468
110,-90,-120,1009,1015,2024,4468
40,-90,170,1009,1015,2024,4468
0,-90,130,1009,1015,2024,4468
160,-20,-150,1005,1019,2024,4562
20,-90,150,1009,1015,2024,4468
-80,-90,50,1009,1015,2024,4468
140,-90,-90,1009,1015,2024,4468
-170,-90,-40,1009,1015,2024,4468
160,-90,-70,1009,1015,2024,4468
-10,-90,120,1009,1015,2024,4468
180,-90,-50,1009,1015,2024,4468
140,-80,150,975,1049,2024,4468
50,-90,180,1009,1015,2024,4468
30,-90,160,1009,1015,2024,4468
-50,10,130,984,1041,2025,4824
-30,-40,90,1012,1013,2025,4517
-180,60,-60,1000,1025,2025,4476
40,50,-30,968,1057,2025,4630
180,60,-60,1000,1025,2025,4476
-60,-20,50,1014,1011,2025,4675
-30,-80,100,1005,1020,2025,4407
-20,-10,120,985,1040,2025,4666
-60,30,150,997,1028,2025,4428
50,-60,60,985,1041,2026,4563
10,20,120,966,1060,2026,4620
0,0,110,1001,1025,2026,4534
-60,80,-170,982,1044,2026,4467
100,10,-60,983,1044,2027,4516
-10,70,30,971,1056,2027,4348
-40,-40,80,1000,1027,2027,4641
120,-70,-110,982,1045,2027,4450
130,-30,-140,999,1029,2028,4401
-50,-20,90,987,1041,2028,4821
-150,70,-170,978,1050,2028,4322
0,-60,20,975,1053,2028,4327
-10,50,20,991,1038,2029,4723
150,-80,160,978,1051,2029,4468
-120,30,-150,999,1030,2029,4504
-90,50,-150,972,1057,2029,4406
60,-50,70,978,1051,2029,4646
130,-60,160,989,1040,2029,4649
100,-60,180,986,1043,2029,4525
60,30,-30,995,1034,2029,4636
100,-60,-180,986,1043,2029,4525
-20,80,50,983,1047,2030,4367
-10,-20,-10,979,1051,2030,4529
-150,-40,-10,996,1034,2030,4507
-50,-20,70,1009,1021,2030,4600
130,0,-50,984,1046,2030,4517
-130,-20,-110,1004,1026,2030,4344
-90,70,130,1000,1031,2031,4450
-130,-10,-90,1020,1011,2031,4429
30,10,0,981,1050,2031,4556
-140,-50,0,999,1032,2031,4512
-70,-30,40,1003,1028,2031,4541
10,80,120,984,1047,2031,4540
-120,-10,-30,1002,1029,2031,4652
160,80,-130,977,1054,2031,4454
10,70,10,969,1062,2031,4513
10,20,-10,1000,1031,2031,4614
-50,-30,70,1004,1027,2031,4491
-20,-60,0,982,1049,2031,4459
140,-40,-70,983,1048,2031,4654
50,-20,70,995,1036,2031,4695
-140,10,-80,1002,1030,2032,4558
0,-10,90,988,1044,2032,4256
160,-80,170,981,1051,2032,4459
-60,-80,70,1003,1029,2032,4505
-130,-60,10,976,1057,2033,4446
140,80,-110,981,1052,2033,4392
70,-70,160,1014,1019,2033,4531
0,70,20,971,1062,2033,4490
80,-70,90,980,1053,2033,4604
-80,-30,30,1005,1028,2033,4592
20,0,10,996,1038,2034,4504
-180,-50,-40,1010,1024,2034,4370
-60,50,100,1017,1017,2034,4591
140,60,-110,995,1039,2034,4384
180,-50,-40,1010,1024,2034,4370
-110,50,160,1002,1033,2035,4649
40,-60,130,1003,1032,2035,4501
-40,70,170,1014,1022,2036,4586
40,-50,120,1006,1030,2036,4470
130,60,-100,999,1037,2036,4363
150,40,-40,1021,1015,2036,4429
140,-50,-170,998,1038,2036,4653
100,-60,130,976,1060,2036,4591
30,-20,40,977,1059,2036,4468
-120,-50,-100,994,1043,2037,4404
-170,0,-160,980,1057,2037,4544
-130,70,170,989,1048,2037,4345
-80,70,120,993,1044,2037,4465
30,-70,130,986,1051,2037,4534
50,-30,80,991,1046,2037,4820
120,-70,130,960,1077,2037,4639
110,60,0,992,1045,2037,4416
-70,60,110,999,1038,2037,4520
-40,-60,-20,1004,1033,2037,4487
70,40,-50,981,1057,2038,4674
-100,50,150,1001,1037,2038,4666
-10,-20,100,1022,1016,2038,4675
-150,-30,-150,1010,1028,2038,4583
140,70,-110,1003,1035,2038,4425
120,60,-90,999,1039,2038,4445
-170,50,-150,984,1054,2038,4220
-90,-70,-70,997,1041,2038,4532
110,10,-80,983,1056,2039,4695
50,-40,90,994,1045,2039,4602
-90,40,180,1000,1039,2039,4460
40,-40,50,962,1077,2039,4619
-90,40,-180,1000,1039,2039,4460
20,-20,30,997,1042,2039,4563
70,-70,80,992,1047,2039,4494
-40,-20,90,1008,1031,2039,4792
-40,20,140,990,1049,2039,4690
-20,-50,90,1034,1006,2040,4508
-10,-40,100,1008,1032,2040,4426
140,50,-30,1018,1022,2040,4404
-140,-20,-140,1002,1038,2040,4578
110,50,-10,1005,1035,2040,4521
110,20,-80,979,1061,2040,4514
-80,-70,-60,1009,1032,2041,4389
-60,20,130,1024,1017,2041,4732
-120,50,170,995,1046,2041,4751
-60,-10,40,991,1051,2042,4610
-160,-70,-150,987,1055,2042,4627
-100,-30,-60,1004,1038,2042,4548
60,60,-40,990,1052,2042,4604
70,50,-50,979,1063,2042,4717
-10,80,40,989,1054,2043,4368
-80,-40,40,1005,1038,2043,4567
150,80,-120,977,1066,2043,4446
130,-30,-110,966,1077,2043,4431
140,30,-40,1010,1033,2043,4355
-70,70,110,991,1052,2043,4507
-120,-30,-90,1026,1017,2043,4392
90,-70,-150,1007,1036,2043,4661
10,0,100,992,1051,2043,4653
80,-70,-180,985,1059,2044,4428
60,-50,100,999,1045,2044,4553
70,30,0,1002,1042,2044,4413
-50,-10,100,1000,1044,2044,4621
80,-70,180,985,1059,2044,4428
80,-70,170,1003,1041,2044,4535
-160,10,-50,1011,1034,2045,4585
110,-60,160,995,1050,2045,4416
130,-30,-130,989,1056,2045,4551
120,-50,-160,1002,1043,2045,4664
-120,-20,-80,1023,1022,2045,4510
140,-10,-130,997,1048,2045,4399
100,-60,120,980,1065,2045,4505
-50,40,160,1007,1038,2045,4564
130,70,-100,994,1051,2045,4389
70,-60,80,986,1059,2045,4764
-40,-60,80,1031,1015,2046,4614
70,40,40,983,1063,2046,4337
-140,70,-180,1007,1039,2046,4370
90,-70,-160,1007,1039,2046,4409
-170,-50,-30,1012,1034,2046,4567
-140,70,180,1007,1039,2046,4370
100,-60,-170,1006,1040,2046,4558
-140,30,-170,989,1057,2046,4563
0,-60,110,1004,1043,2047,4609
70,30,-10,1002,1045,2047,4343
40,70,-20,1012,1035,2047,4446
-100,40,-170,980,1067,2047,4519
60,-60,140,993,1054,2047,4390
-30,10,130,1006,1041,2047,4876
40,-30,50,969,1078,2047,4629
-120,30,-140,1014,1033,2047,4630
50,-20,60,968,1079,2047,4539
100,60,10,1009,1038,2047,4417
-170,-10,-160,978,1070,2048,4715
160,70,-130,982,1066,2048,4371
-50,20,110,1027,1021,2048,4695
-150,-60,-140,984,1064,2048,4558
-50,-50,70,1025,1023,2048,4574
170,40,-140,989,1059,2048,4351
-50,0,80,1018,1030,2048,4597
10,50,-10,1009,1039,2048,4684
0,60,130,1011,1038,2049,4710
-180,50,-60,1008,1041,2049,4491
-90,80,130,1017,1032,2049,4378
180,50,-60,1008,1041,2049,4491
-50,-20,60,1015,1034,2049,4587
-10,0,120,991,1058,2049,4819
110,50,-80,992,1058,2050,4542
-20,50,30,1006,1044,2050,4629
-70,40,120,1018,1032,2050,4790
90,20,-40,987,1064,2051,4532
-30,70,160,1009,1042,2051,4623
-50,40,70,999,1052,2051,4616
10,-60,30,977,1075,2052,4532
30,70,-10,1005,1047,2052,4491
90,40,0,993,1059,2052,4347
-30,70,60,1000,1052,2052,4582
10,10,110,989,1063,2052,4815
60,-60,130,1013,1040,2053,4521
70,-60,120,1001,1052,2053,4469
150,-50,-180,982,1071,2053,4684
50,20,20,992,1061,2053,4255
140,30,-120,997,1056,2053,4410
10,-10,90,1028,1025,2053,4495
20,20,0,993,1060,2053,4453
170,70,-140,975,1078,2053,4387
-80,50,-170,1018,1035,2053,4472
150,-50,180,982,1071,2053,4684
-70,50,180,1019,1035,2054,4628
130,-60,150,981,1073,2054,4533
-50,10,30,997,1057,2054,4852
-30,40,150,992,1062,2054,4701
20,-10,90,991,1063,2054,4517
-10,30,130,1001,1053,2054,4750
80,30,-30,1002,1052,2054,4579
-110,-40,20,1007,1047,2054,4510
-70,50,-180,1019,1035,2054,4628
-40,30,50,1010,1044,2054,4606
-50,80,180,1006,1049,2055,4569
-180,-20,-160,988,1067,2055,4648
-50,80,-180,1006,1049,2055,4569
60,50,70,1004,1051,2055,4457
40,-40,90,1010,1045,2055,4409
180,-20,-160,988,1067,2055,4648
-10,-50,100,1023,1032,2055,4569
0,80,130,995,1060,2055,4619
-10,10,120,988,1067,2055,4706
20,70,0,987,1069,2056,4511
-130,50,-180,996,1060,2056,4587
-120,40,180,997,1059,2056,4604
-40,-80,-20,1011,1045,2056,4510
170,30,-50,1011,1045,2056,4517
-40,30,40,1032,1024,2056,4611
-120,30,-170,1023,1033,2056,4624
-130,50,180,996,1060,2056,4587
-120,40,-180,997,1059,2056,4604
-90,-50,40,1011,1046,2057,4624
-60,-70,70,1003,1054,2057,4557
150,-40,-160,994,1063,2057,4724
50,-10,60,986,1071,2057,4742
120,-60,160,992,1065,2057,4549
20,-60,120,1010,1047,2057,4509
160,-30,-160,982,1076,2058,4429
-30,20,10,1004,1054,2058,4673
-40,10,80,1041,1017,2058,4660
110,-60,-170,987,1071,2058,4621
-80,50,130,1009,1049,2058,4752
-70,-60,60,1010,1048,2058,4564
-10,-70,110,1018,1040,2058,4753
-50,0,90,1027,1031,2058,4757
-30,-60,-10,1000,1058,2058,4516
-130,20,-160,1014,1045,2059,4613
-120,30,-160,994,1065,2059,4621
-20,70,150,1021,1038,2059,4624
-100,60,150,1011,1048,2059,4471
120,-60,-120,1002,1057,2059,4558
170,-50,-180,999,1061,2060,4594
130,-70,140,970,1090,2060,4687
-40,40,50,1012,1048,2060,4526
170,-50,180,999,1061,2060,4594
10,40,-10,966,1094,2060,4608
0,-70,20,999,1061,2060,4578
-40,60,70,1001,1059,2060,4613
-20,60,40,1009,1051,2060,4537
50,-40,60,998,1063,2061,4726
-160,-20,-160,976,1085,2061,4618
170,-40,-170,988,1073,2061,4549
30,10,10,1008,1053,2061,4611
170,10,-40,1015,1046,2061,4551
120,80,-90,1001,1060,2061,4347
170,30,-140,990,1071,2061,4334
-80,40,170,1011,1051,2062,4495
110,20,-40,1001,1061,2062,4768
30,-20,80,998,1064,2062,4507
50,0,50,994,1068,2062,4666
-40,-50,-20,993,1069,2062,4370
110,30,-30,1026,1036,2062,4644
150,70,-120,1002,1060,2062,4397
140,10,-40,1001,1061,2062,4739
-140,20,-100,1011,1052,2063,4517
-140,10,-90,1017,1046,2063,4783
50,30,0,1010,1053,2063,4366
-110,80,150,1026,1037,2063,4371
-20,10,0,1019,1044,2063,4696
-70,40,140,1016,1048,2064,4772
20,20,110,1034,1030,2064,4665
-70,80,110,1021,1043,2064,4406
-50,10,100,1034,1030,2064,4722
-60,70,100,1004,1060,2064,4553
-70,-30,-30,1018,1046,2064,4603
30,20,0,1002,1062,2064,4396
-40,20,20,1015,1050,2065,4643
-40,-20,100,1030,1035,2065,4746
-30,60,50,1019,1046,2065,4488
10,-70,120,1012,1053,2065,4693
-30,-80,-10,1003,1062,2065,4595
-50,-80,-30,1022,1043,2065,4498
0,-50,20,1005,1060,2065,4424
-20,-70,100,1033,1033,2066,4790
-10,-60,100,1015,1051,2066,4587
-30,-30,80,1028,1038,2066,4777
-60,-50,60,1031,1035,2066,4550
40,-20,50,995,1071,2066,4604
-110,40,-160,1016,1050,2066,4667
170,50,-140,995,1071,2066,4471
-10,80,140,1010,1056,2066,4635
120,60,-10,1009,1057,2066,4435
120,70,-90,997,1070,2067,4405
10,-10,10,997,1070,2067,4528
-180,0,-150,1003,1064,2067,4560
-30,-20,100,1028,1039,2067,4741
-100,80,140,1032,1035,2067,4384
180,0,-150,1003,1064,2067,4560
-80,80,120,1029,1038,2067,4393
-50,50,80,1020,1047,2067,4586
-30,80,160,1012,1055,2067,4646
130,80,-100,1002,1066,2068,4438
10,-30,20,1005,1063,2068,4529
130,30,-100,1031,1037,2068,4594
80,40,20,1005,1063,2068,4650
-110,-60,-90,1014,1054,2068,4476
160,0,-140,1022,1046,2068,4558
-50,10,110,1030,1039,2069,4653
10,-50,30,994,1075,2069,4478
160,-50,-180,997,1072,2069,4501
80,50,30,1011,1058,2069,4498
160,-50,180,997,1072,2069,4501
60,-70,150,1031,1038,2069,4577
-160,-20,-30,1028,1041,2069,4627
-130,80,170,1030,1039,2069,4416
-70,40,160,1003,1067,2070,4611
140,50,-110,1020,1050,2070,4459
-160,70,-160,1000,1070,2070,4386
-100,50,160,1026,1044,2070,4822
50,70,80,1023,1047,2070,4567
-50,-40,70,1033,1037,2070,4595
0,60,20,1014,1056,2070,4613
110,70,-80,998,1072,2070,4501
90,-60,110,991,1080,2071,4614
-50,-10,0,1014,1057,2071,4673
-170,60,-150,989,1082,2071,4513
50,60,-30,991,1080,2071,4572
-90,60,-150,1009,1062,2071,4600
170,-30,-160,993,1078,2071,4632
50,10,40,985,1087,2072,4437
40,-20,80,1006,1066,2072,4684
-20,-30,90,1026,1046,2072,4531
-170,50,-70,1019,1053,2072,4626
30,30,100,1013,1059,2072,4547
-30,30,140,1000,1072,2072,4761
-120,80,160,1028,1044,2072,4387
-20,-20,-10,1019,1053,2072,4829
-130,10,-140,1009,1064,2073,4620
10,-30,100,1051,1022,2073,4669
-100,-30,10,1033,1040,2073,4625
-40,0,80,1035,1038,2073,4742
150,0,-40,980,1093,2073,4716
50,40,80,995,1078,2073,4691
-10,60,30,998,1075,2073,4430
-50,40,90,1036,1037,2073,4556
-40,-10,110,1016,1057,2073,4661
-70,-80,-50,1021,1052,2073,4483
-120,-10,-50,1036,1037,2073,4543
80,30,-20,1011,1063,2074,4550
120,50,-90,1011,1063,2074,4597
-60,60,100,1024,1050,2074,4678
-130,-30,-110,1019,1055,2074,4616
-120,-70,-100,1025,1050,2075,4398
30,-10,80,1014,1061,2075,4500
20,10,100,1035,1041,2076,4593
50,0,70,996,1080,2076,4685
-120,40,-120,1040,1036,2076,4740
10,80,20,1003,1073,2076,4411
130,60,-20,1014,1062,2076,4571
90,30,-20,1007,1069,2076,4436
90,-70,-180,1024,1053,2077,4517
-140,-10,-30,1026,1051,2077,4667
-10,-30,0,1002,1075,2077,4683
90,-70,180,1024,1053,2077,4517
40,40,-30,1002,1075,2077,4582
-20,80,150,1012,1065,2077,4666
40,60,-20,1003,1074,2077,4576
20,0,80,1007,1070,2077,4623
130,70,-10,1012,1065,2077,4608
150,-30,-150,1018,1059,2077,4565
130,-30,-100,983,1094,2077,4457
50,-10,70,998,1079,2077,4840
-140,-40,-130,1008,1070,2078,4669
140,20,-40,1013,1065,2078,4747
140,30,-110,1006,1072,2078,4487
180,20,-50,1018,1060,2078,4709
100,60,-70,1013,1065,2078,4627
-50,40,80,1029,1049,2078,4682
-160,20,-160,997,1081,2078,4758
-180,20,-50,1018,1060,2078,4709
-170,0,-40,1021,1057,2078,4578
-60,-80,-40,1025,1054,2079,4518
-110,-20,-50,1059,1020,2079,4577
40,20,20,1008,1071,2079,4341
-30,0,0,1010,1069,2079,4573
140,-80,-90,1013,1066,2079,4604
140,-70,150,976,1104,2080,4713
110,60,-80,1011,1069,2080,4638
70,-80,-170,1029,1051,2080,4860
-50,-10,90,1020,1060,2080,4692
50,-30,70,1007,1074,2081,4835
50,10,70,985,1096,2081,4632
-150,-20,-150,1007,1074,2081,4534
-110,60,160,1012,1069,2081,4487
30,10,20,1018,1063,2081,4445
-100,50,-140,1019,1062,2081,4720
40,10,80,1008,1073,2081,4642
-90,60,140,1021,1060,2081,4597
-70,-50,50,1031,1050,2081,4437
-170,30,-70,1023,1058,2081,4526
0,80,30,1003,1078,2081,4368
-70,-80,60,1029,1052,2081,4543
-70,-70,60,1022,1060,2082,4662
90,40,-60,1009,1073,2082,4719
-20,40,20,1017,1065,2082,4779
-140,-60,0,1008,1074,2082,4672
170,60,-140,1001,1081,2082,4448
40,20,10,1005,1077,2082,4674
-160,20,-70,1025,1057,2082,4578
-20,-40,90,1027,1055,2082,4510
-70,-20,-10,1011,1071,2082,4608
-130,20,-130,1025,1057,2082,4764
-10,70,140,1016,1067,2083,4674
90,-60,120,1002,1081,2083,4693
-50,60,90,1036,1047,2083,4684
-70,40,130,1034,1049,2083,4802
60,-60,70,1000,1083,2083,4685
20,-60,40,1019,1064,2083,4680
20,-70,120,1018,1065,2083,4721
70,30,-40,1008,1076,2084,4659
130,-40,-120,1000,1084,2084,4595
100,50,0,1021,1063,2084,4688
50,-50,100,1034,1050,2084,4419
-40,80,170,1022,1062,2084,4629
30,30,-10,1015,1069,2084,4676
-50,0,100,1022,1062,2084,4843
-60,80,100,1031,1053,2084,4443
-80,60,-160,999,1086,2085,4678
170,20,-140,1016,1069,2085,4482
-10,-10,110,1037,1048,2085,4869
-160,-50,-20,1032,1053,2085,4666
140,70,-20,1020,1065,2085,4565
100,-70,-140,1019,1066,2085,4651
40,-10,80,1005,1080,2085,4645
-170,20,-150,1009,1077,2086,4648
-160,0,-40,1040,1046,2086,4613
70,30,-30,1011,1075,2086,4687
-100,40,-180,1022,1064,2086,4764
-100,40,180,1022,1064,2086,4764
-30,-40,80,1032,1055,2087,4730
130,-10,-100,1011,1076,2087,4400
40,-50,110,1016,1071,2087,4543
180,30,-60,1042,1045,2087,4568
50,40,-30,1013,1074,2087,4721
-140,80,-180,1038,1049,2087,4459
100,70,-70,1015,1072,2087,4567
20,10,0,1010,1077,2087,4672
120,50,-20,1019,1068,2087,4522
30,0,30,1001,1086,2087,4556
110,10,-50,1011,1076,2087,4720
-20,-60,90,1044,1043,2087,4665
-140,80,180,1038,1049,2087,4459
-180,30,-60,1042,1045,2087,4568
30,50,-20,988,1099,2087,4740
-20,-80,0,1021,1066,2087,4640
-150,-50,-10,1017,1070,2087,4688
160,60,-130,1001,1086,2087,4514
-170,-70,-160,1017,1071,2088,4720
110,40,-80,1014,1074,2088,4756
-50,-30,60,1033,1055,2088,4740
100,30,-70,1008,1080,2088,4761
10,-40,30,1001,1088,2089,4641
30,-60,120,1014,1075,2089,4541
50,-50,60,1007,1082,2089,4864
150,70,-30,1038,1051,2089,4592
30,-10,40,1012,1077,2089,4645
130,10,-100,1011,1078,2089,4562
30,-40,50,1009,1080,2089,4499
10,50,120,1020,1069,2089,4658
-110,-20,-20,1035,1055,2090,4652
-110,-40,-80,1041,1049,2090,4590
-80,-80,50,1029,1061,2090,4639
-40,50,160,1018,1072,2090,4637
-170,40,-70,1036,1054,2090,4523
90,-70,-170,1016,1074,2090,4623
60,50,-40,1025,1065,2090,4930
60,60,70,1020,1070,2090,4649
110,30,-80,1024,1067,2091,4660
-50,50,90,1028,1063,2091,4708
160,-10,-40,1004,1087,2091,4738
140,20,-110,1023,1068,2091,4469
-40,10,60,1037,1054,2091,4786
100,20,-40,1005,1086,2091,4654
-40,0,70,1045,1047,2092,4686
-20,70,50,1018,1074,2092,4616
-150,30,-90,1018,1074,2092,4630
150,0,-130,1005,1087,2092,4516
0,-20,10,1022,1071,2093,4672
-110,-30,10,1046,1047,2093,4696
-30,-60,80,1029,1064,2093,4613
-140,0,-150,1022,1071,2093,4523
160,-30,-50,1007,1086,2093,4696
-10,0,110,1030,1063,2093,4822
30,0,80,1012,1082,2094,4707
50,20,70,1005,1089,2094,4609
-40,-40,70,1017,1077,2094,4659
120,-50,-140,1018,1077,2095,4587
-70,-40,-40,1042,1053,2095,4799
-130,40,-110,1032,1063,2095,4747
40,10,30,1007,1088,2095,4464
-120,60,170,1021,1074,2095,4478
40,0,80,1009,1086,2095,4626
-40,0,120,1033,1062,2095,4964
-40,-30,70,1040,1056,2096,4612
-140,-30,-10,1026,1070,2096,4883
-40,50,60,1000,1096,2096,4821
-180,-40,-40,1022,1074,2096,4582
-20,40,140,1030,1066,2096,4880
180,-40,-40,1022,1074,2096,4582
-80,-60,50,1023,1073,2096,4586
150,60,-120,1024,1072,2096,4492
20,40,110,1016,1080,2096,4585
140,10,-120,1037,1060,2097,4743
-100,-70,-80,1027,1070,2097,4536
0,50,20,1028,1069,2097,4619
-90,-80,-70,1031,1066,2097,4515
50,-60,130,1033,1065,2098,4512
-90,-40,30,1045,1053,2098,4602
-140,30,-100,1020,1078,2098,4501
110,80,-80,1018,1080,2098,4345
170,10,-140,1011,1087,2098,4636
-100,-50,30,1030,1069,2099,4727
140,-60,160,1012,1087,2099,4627
-80,-80,-60,1029,1070,2099,4487
60,30,50,1015,1084,2099,4529
-140,10,-160,1027,1072,2099,4738
20,-50,40,1007,1092,2099,4611
10,-40,100,1061,1039,2100,4848
60,40,-40,1011,1089,2100,4773
60,30,10,1009,1091,2100,4567
150,-70,160,993,1107,2100,4707
130,-50,-90,1019,1081,2100,4738
10,10,0,1020,1080,2100,4633
10,30,-10,1025,1075,2100,4863
-170,-60,-30,1031,1070,2101,4694
80,40,10,1019,1082,2101,4591
90,60,20,1030,1071,2101,4531
-40,-10,70,1049,1052,2101,4666
60,-80,-180,1039,1062,2101,4880
-40,10,70,1039,1062,2101,4675
60,-80,180,1039,1062,2101,4880
90,30,-60,1014,1088,2102,4724
120,-60,180,1037,1065,2102,4633
140,40,-110,1016,1086,2102,4564
130,-40,-110,1002,1100,2102,4612
-30,40,40,1038,1064,2102,4837
120,-60,-180,1037,1065,2102,4633
120,40,-90,1033,1069,2102,4723
90,20,-50,1007,1095,2102,4861
-50,-60,70,1052,1051,2103,4717
160,70,-40,1042,1061,2103,4641
-130,30,-170,1042,1061,2103,4741
-140,40,-170,1028,1075,2103,4773
-160,40,-80,1045,1058,2103,4651
-50,70,90,1044,1060,2104,4559
40,-80,160,1048,1056,2104,4920
140,0,-120,1034,1070,2104,4570
110,-70,-130,1023,1081,2104,4628
-30,50,50,1019,1085,2104,4698
130,-50,-110,1015,1089,2104,4589
-40,-20,70,1058,1046,2104,4694
-130,20,-140,1019,1085,2104,4691
120,10,-90,1010,1094,2104,4457
40,70,90,1035,1069,2104,4643
10,-80,130,1049,1055,2104,4952
0,-50,100,1050,1055,2105,4793
-30,-50,80,1053,1052,2105,4671
80,-80,-160,1035,1070,2105,4814
170,-50,-50,1045,1060,2105,4546
10,-70,30,1025,1080,2105,4681
160,-70,170,1007,1098,2105,4705
-60,30,120,1048,1057,2105,4942
-70,-20,30,1032,1073,2105,4817
30,-50,120,1059,1046,2105,4787
10,30,120,1019,1086,2105,4746
20,10,90,1039,1067,2106,4558
-130,-10,-30,1047,1059,2106,4819
-110,-70,-90,1031,1075,2106,4478
-150,-60,-10,1043,1063,2106,4789
120,40,-30,1025,1081,2106,4457
-170,20,-60,1042,1064,2106,4565
-30,60,60,1025,1081,2106,4715
-60,30,140,1035,1071,2106,4728
-50,30,100,1063,1044,2107,4783
-20,20,130,1011,1096,2107,4842
-60,-10,10,1045,1062,2107,4708
50,-70,140,1042,1065,2107,4663
-10,30,0,1002,1106,2108,4572
-110,50,-130,1038,1070,2108,4747
10,60,120,1042,1066,2108,4769
-160,-60,-150,1032,1076,2108,4801
20,-20,90,1006,1103,2109,4661
140,20,-120,1012,1097,2109,4677
120,70,0,1040,1070,2110,4691
50,-80,170,1049,1061,2110,4902
20,-10,30,1014,1096,2110,4471
60,30,20,1012,1098,2110,4576
150,-10,-140,1038,1073,2111,4823
-40,-30,-20,1036,1075,2111,4805
-90,50,-160,1025,1086,2111,4731
-110,40,-150,1059,1052,2111,4860
170,-60,180,1013,1098,2111,4748
160,-10,-140,1039,1072,2111,4622
-30,0,120,1039,1072,2111,5072
170,-60,-180,1013,1098,2111,4748
30,-80,150,1049,1062,2111,4945
-50,20,120,1068,1043,2111,4860
80,40,-50,1007,1105,2112,4851
-10,50,30,1050,1062,2112,4572
40,-20,70,1013,1099,2112,4636
-60,-30,50,1040,1072,2112,4750
-150,-50,-140,1032,1080,2112,4702
120,-60,-130,1022,1091,2113,4716
-130,20,-150,1033,1080,2113,4787
40,-80,150,1038,1075,2113,4667
-160,50,-80,1025,1088,2113,4635
20,-10,80,1031,1082,2113,4682
60,-60,120,1029,1084,2113,4561
130,20,-100,1041,1072,2113,4770
150,-80,-80,1034,1080,2114,4671
-50,0,50,1044,1070,2114,4764
-80,-70,50,1051,1063,2114,4662
-180,-70,-170,1025,1089,2114,4801
30,-40,100,1055,1059,2114,4728
-20,-20,100,1043,1071,2114,4748
-20,0,120,1048,1066,2114,5042
180,-70,-170,1025,1089,2114,4801
20,-70,40,1041,1073,2114,4757
20,80,10,1011,1103,2114,4528
100,40,-60,1038,1076,2114,4843
60,40,-20,1035,1079,2114,4702
140,0,-110,1052,1063,2115,4474
100,50,-70,1025,1090,2115,4667
-10,-10,100,1055,1060,2115,5019
-10,-80,10,1026,1089,2115,4718
170,70,-50,1029,1086,2115,4706
-140,0,-50,1053,1062,2115,4946
40,30,-10,1020,1095,2115,4606
50,50,-30,1029,1086,2115,4885
-40,-10,80,1065,1051,2116,4753
-50,10,120,1054,1062,2116,4859
100,-70,-170,1024,1092,2116,4600
30,-30,80,1050,1066,2116,4664
40,30,90,1037,1079,2116,4606
10,40,120,1048,1068,2116,4698
120,0,-60,1023,1093,2116,4684
-20,-30,-10,1018,1099,2117,4842
-10,-50,10,1032,1085,2117,4663
100,80,-70,1010,1107,2117,4471
-140,50,-170,1022,1095,2117,4589
60,30,40,1012,1105,2117,4539
20,-80,140,1059,1058,2117,4942
-40,40,60,1039,1078,2117,4801
-170,10,-150,1014,1103,2117,4816
40,-10,60,1025,1093,2118,4689
-100,-80,-80,1048,1070,2118,4623
60,40,60,1045,1073,2118,4593
100,-70,-150,1042,1076,2118,4611
-90,-80,40,1035,1083,2118,4640
40,-10,70,1042,1076,2118,4761
-30,30,20,1033,1085,2118,4973
-150,10,-70,1065,1053,2118,4637
120,-50,-150,1034,1084,2118,4672
120,-60,-160,1032,1086,2118,4878
120,20,-90,1010,1108,2118,4574
-110,40,-180,1037,1082,2119,4770
0,20,120,1035,1084,2119,4836
-180,-20,-40,1037,1082,2119,4661
100,-80,-140,1042,1077,2119,4768
110,-60,-160,1022,1097,2119,4755
-110,40,180,1037,1082,2119,4770
180,-20,-40,1037,1082,2119,4661
150,50,-40,1054,1065,2119,4649
10,60,10,1041,1078,2119,4807
140,10,-110,1044,1076,2120,4511
-110,50,170,1042,1078,2120,4809
40,30,0,1040,1080,2120,4532
90,40,-50,1044,1077,2121,4782
30,40,-20,1029,1092,2121,4813
20,50,-10,1009,1112,2121,4757
0,50,10,1021,1100,2121,4868
40,40,-20,1026,1095,2121,4767
40,50,-20,1033,1088,2121,4831
-30,-20,90,1053,1069,2122,4878
130,-50,-160,1027,1095,2122,4752
-30,-70,90,1056,1066,2122,4860
130,-50,-150,1043,1079,2122,4903
80,60,40,1020,1102,2122,4711
-180,-30,-40,1021,1102,2123,4783
180,-30,-40,1021,1102,2123,4783
-140,50,-100,1032,1091,2123,4601
-40,-50,70,1030,1093,2123,4579
10,50,0,1018,1105,2123,4862
50,30,70,1041,1083,2124,4617
40,-10,50,1028,1096,2124,4683
10,0,90,1049,1075,2124,4800
-140,-10,-140,1042,1082,2124,4738
150,-30,-60,1039,1085,2124,4738
150,-50,-170,1039,1085,2124,4794
-120,-10,-40,1043,1081,2124,4763
-40,0,110,1059,1065,2124,4777
-10,70,40,1039,1085,2124,4690
110,70,10,1034,1090,2124,4764
50,-80,160,1045,1080,2125,4674
-110,40,-140,1045,1080,2125,4841
150,20,-40,1047,1078,2125,4658
-30,-50,-10,1024,1101,2125,4579
-130,60,180,1027,1098,2125,4429
-130,60,-180,1027,1098,2125,4429
20,0,20,1043,1082,2125,4744
-170,-40,-160,1038,1087,2125,4770
-90,50,150,1042,1083,2125,4838
-50,10,40,1045,1080,2125,4889
70,50,50,1041,1084,2125,4585
-20,-10,80,1054,1072,2126,4761
140,-20,-130,1027,1099,2126,4622
10,-70,110,1049,1077,2126,4735
20,-50,110,1062,1064,2126,4796
20,30,-10,1036,1090,2126,4766
-60,40,160,1012,1115,2127,4668
-40,-10,100,1053,1074,2127,4938
150,50,-120,1034,1093,2127,4607
170,-10,-40,1042,1085,2127,4870
140,-40,-150,1046,1081,2127,4843
-50,-40,60,1050,1077,2127,4861
140,-50,-160,1052,1075,2127,4622
0,-70,110,1048,1079,2127,4759
-140,40,-100,1052,1076,2128,4664
0,70,130,1041,1087,2128,4732
-140,10,-100,1035,1094,2129,4576
-40,20,70,1056,1073,2129,4736
110,-60,-150,1038,1091,2129,4732
-80,50,140,1046,1083,2129,4824
60,30,0,1017,1112,2129,4582
-40,60,80,1062,1067,2129,4793
120,-60,170,1027,1102,2129,4737
-50,20,130,1040,1089,2129,5061
40,10,40,1007,1122,2129,4679
30,60,-10,1029,1100,2129,4669
130,30,-40,1045,1084,2129,4755
-150,40,-90,1048,1082,2130,4694
-90,-60,40,1042,1088,2130,4685
-180,70,-60,1025,1105,2130,4790
-150,80,-170,1043,1087,2130,4536
30,-80,140,1053,1077,2130,4668
-40,40,150,1028,1102,2130,4779
40,-20,60,1030,1100,2130,4783
180,70,-60,1025,1105,2130,4790
80,30,-50,1014,1116,2130,4694
50,20,30,1023,1107,2130,4647
0,0,100,1060,1070,2130,4555
90,-80,-150,1045,1086,2131,4814
-100,-80,30,1039,1092,2131,4721
140,-30,-70,1032,1099,2131,4876
80,50,-50,1026,1105,2131,4758
-170,-30,-160,1035,1096,2131,4673
-40,20,60,1054,1077,2131,4799
80,-60,100,1008,1124,2132,4839
20,-80,130,1047,1085,2132,4641
-170,70,-150,1043,1089,2132,4541
120,0,-80,1022,1111,2133,4847
130,-10,-70,1027,1106,2133,4762
-150,-30,-20,1043,1090,2133,4827
40,-30,80,1044,1089,2133,4667
-160,-30,-30,1071,1062,2133,4806
-40,20,110,1071,1062,2133,4935
140,-30,-140,1034,1100,2134,4816
170,-70,180,1019,1115,2134,4764
170,-70,-180,1019,1115,2134,4764
160,10,-40,1041,1093,2134,4783
50,30,10,1042,1092,2134,4464
90,70,-60,1035,1099,2134,4691
-20,10,120,1043,1091,2134,5018
50,50,80,1037,1097,2134,4798
130,0,-100,998,1136,2134,4524
-170,60,-70,1041,1094,2135,4644
-40,10,100,1063,1072,2135,4926
-100,60,-140,1019,1116,2135,4611
-40,0,60,1070,1066,2136,4848
-40,20,80,1077,1060,2137,4770
130,-40,-90,1019,1118,2137,4593
-130,-40,-110,1042,1095,2137,4732
-120,-60,-100,1065,1072,2137,4633
-170,70,-70,1038,1099,2137,4683
0,-80,120,1062,1075,2137,4947
-20,40,30,1034,1103,2137,4816
10,50,10,1058,1080,2138,4695
60,-80,170,1049,1089,2138,4702
-130,50,-110,1037,1101,2138,4771
-10,-10,90,1075,1063,2138,4806
-50,80,90,1050,1088,2138,4557
20,50,0,1031,1108,2139,4778
10,-20,20,1045,1094,2139,4585
-60,60,180,1052,1087,2139,4914
120,-60,-170,1039,1100,2139,4754
-100,50,170,1046,1093,2139,4910
-40,-60,70,1054,1085,2139,4610
0,10,110,1047,1092,2139,4850
70,-60,110,1047,1092,2139,4936
-160,0,-160,1011,1128,2139,4865
140,60,-30,1045,1094,2139,4698
-60,60,-180,1052,1087,2139,4914
30,80,0,1013,1126,2139,4564
-90,-70,40,1062,1078,2140,4663
90,30,-30,1049,1091,2140,4678
-90,50,160,1063,1077,2140,4944
10,70,120,1047,1093,2140,4779
90,60,-60,1039,1101,2140,4717
70,50,-40,1031,1110,2141,4933
-110,-80,-90,1061,1080,2141,4686
-120,-40,10,1038,1103,2141,4742
160,-40,-160,1038,1103,2141,4725
160,-50,-60,1034,1107,2141,4791
-20,-80,100,1070,1071,2141,4875
90,50,-60,1046,1095,2141,4901
140,40,-40,1060,1081,2141,4688
-160,80,-160,1060,1082,2142,4542
80,40,0,1050,1092,2142,4527
-40,0,90,1060,1082,2142,4783
-160,30,-80,1053,1089,2142,4799
80,40,-30,1059,1083,2142,4835
10,-30,30,1030,1112,2142,4783
-150,0,-160,1045,1097,2142,4935
130,-60,170,1035,1107,2142,4688
160,-80,-70,1062,1081,2143,4790
100,30,-30,1045,1098,2143,4572
-20,-10,110,1072,1071,2143,5065
100,-70,-160,1028,1115,2143,4742
30,-50,110,1064,1079,2143,4859
100,40,-70,1042,1101,2143,4909
-90,-30,10,1048,1095,2143,4705
20,60,0,1042,1101,2143,4740
-40,-10,90,1048,1095,2143,4924
-30,-80,90,1066,1077,2143,4875
20,30,110,1045,1098,2143,4812
110,-70,-160,1023,1121,2144,4600
10,-20,90,1052,1092,2144,4497
70,40,-30,1058,1086,2144,4974
170,-80,-60,1071,1073,2144,4716
-150,50,-160,1032,1112,2144,4579
-40,50,70,1063,1082,2145,4692
-40,30,60,1033,1112,2145,4840
10,-60,110,1053,1092,2145,4830
-20,-20,90,1064,1081,2145,4764
-150,10,-160,1050,1095,2145,4885
-40,-70,80,1078,1067,2145,4861
-30,-10,110,1048,1097,2145,4816
-130,-10,-80,1065,1080,2145,4722
90,40,-10,1061,1084,2145,4586
50,0,60,1032,1113,2145,4885
90,30,-40,1043,1102,2145,4871
-60,-40,50,1065,1081,2146,4817
0,40,0,1042,1104,2146,4935
-140,-20,-20,1056,1090,2146,4954
30,70,100,1050,1096,2146,4743
180,-60,-170,1036,1111,2147,4791
-180,-60,-170,1036,1111,2147,4791
140,-60,170,1039,1108,2147,4823
120,-60,-140,1044,1103,2147,4587
30,-30,50,1043,1104,2147,4585
30,-50,50,1040,1107,2147,4719
-160,-60,-20,1057,1090,2147,4801
130,50,-30,1044,1103,2147,4681
-30,60,70,1065,1083,2148,4703
-10,-30,90,1050,1098,2148,4750
180,-50,-170,1039,1109,2148,4736
-180,-50,-170,1039,1109,2148,4736
-10,40,10,1037,1111,2148,4930
-20,60,50,1042,1106,2148,4691
20,-60,110,1040,1108,2148,4696
20,-40,40,1030,1118,2148,4786
-10,-80,110,1074,1075,2149,4914
160,50,-130,1042,1107,2149,4603
-60,-20,40,1046,1103,2149,4907
-120,-30,0,1047,1102,2149,4835
-40,-40,-20,1038,1111,2149,4963
-30,-10,100,1055,1094,2149,4908
-110,-30,-70,1059,1091,2150,4745
20,20,100,1046,1104,2150,4782
-40,20,40,1071,1079,2150,4954
-180,0,-40,1045,1106,2151,4809
-180,-10,-40,1051,1100,2151,4762
180,0,-40,1045,1106,2151,4809
90,40,-20,1061,1090,2151,4653
-20,-50,0,1036,1115,2151,4680
180,-10,-40,1051,1100,2151,4762
70,40,-20,1068,1084,2152,4737
180,40,-140,1041,1111,2152,4582
-40,10,90,1074,1078,2152,4721
20,10,10,1040,1112,2152,4751
-180,40,-140,1041,1111,2152,4582
-30,-10,70,1056,1096,2152,4911
160,30,-130,1046,1106,2152,4710
160,40,-130,1046,1106,2152,4550
-70,-40,40,1048,1104,2152,4785
-70,50,120,1070,1082,2152,4879
-130,-70,-110,1062,1091,2153,4598
-10,40,20,1032,1121,2153,4744
-70,60,-170,1045,1108,2153,4853
-20,30,10,1040,1113,2153,4778
30,20,90,1070,1083,2153,4546
-50,30,140,1053,1101,2154,4819
70,-80,180,1059,1095,2154,4740
120,0,-70,1043,1111,2154,4930
70,-80,-180,1059,1095,2154,4740
-30,-20,80,1086,1069,2155,4964
-40,80,80,1056,1099,2155,4563
-30,80,70,1056,1099,2155,4598
-110,40,-170,1072,1083,2155,4896
-30,40,50,1031,1124,2155,4822
-150,40,-160,1042,1113,2155,4871
120,30,-90,1046,1109,2155,4776
-160,70,-80,1044,1111,2155,4691
20,40,-10,1056,1099,2155,4891
-10,0,100,1060,1095,2155,4952
-60,40,140,1060,1096,2156,4932
40,-70,130,1069,1087,2156,4763
-20,50,40,1051,1105,2156,4744
-120,50,-120,1056,1100,2156,4957
10,-80,120,1062,1095,2157,4652
30,50,-10,1048,1109,2157,4847
-40,20,50,1054,1103,2157,4873
160,40,-50,1065,1092,2157,4700
-10,10,110,1040,1117,2157,4721
-40,-80,80,1074,1083,2157,4921
170,0,-140,1057,1100,2157,4753
50,30,20,1045,1113,2158,4569
0,40,10,1037,1121,2158,4822
-70,-20,0,1039,1119,2158,4912
-180,-80,-50,1074,1084,2158,4714
100,40,-50,1063,1095,2158,4774
180,-80,-50,1074,1084,2158,4714
-60,40,150,1053,1105,2158,4781
120,10,-50,1048,1111,2159,4755
-150,60,-90,1039,1120,2159,4724
160,50,-50,1061,1098,2159,4699
-80,50,150,1060,1099,2159,5028
-40,20,30,1054,1105,2159,5116
-110,-80,20,1059,1100,2159,4727
130,-70,-100,1060,1100,2160,4722
-40,10,110,1081,1079,2160,5078
-30,30,30,1050,1110,2160,4928
30,-10,60,1054,1106,2160,4745
90,50,-50,1070,1090,2160,4812
10,-80,30,1053,1108,2161,4891
-20,10,110,1075,1086,2161,4946
160,-30,-150,1053,1108,2161,4849
40,20,80,1077,1084,2161,4774
50,-60,120,1061,1100,2161,4644
40,0,50,1044,1117,2161,4792
90,40,-40,1062,1099,2161,4768
0,-80,20,1046,1115,2161,4821
-40,20,130,1055,1106,2161,5062
20,70,110,1046,1115,2161,4860
50,-40,70,1054,1107,2161,5004
130,-50,-120,1045,1117,2162,4824
-130,-20,-100,1064,1098,2162,4792
110,10,-70,1035,1127,2162,4880
-30,10,120,1081,1081,2162,5161
70,40,-40,1042,1120,2162,4918
-60,50,170,1059,1103,2162,4796
180,50,-140,1038,1124,2162,4691
120,30,-40,1067,1095,2162,4778
10,10,90,1058,1104,2162,4673
-180,50,-140,1038,1124,2162,4691
-30,20,130,1056,1106,2162,4983
-60,40,110,1081,1081,2162,4932
80,70,-50,1045,1118,2163,4785
90,80,-60,1026,1137,2163,4534
-40,20,90,1094,1069,2163,4771
-80,60,130,1071,1093,2164,4807
-120,-80,-100,1072,1092,2164,4839
130,-20,-90,1040,1124,2164,4581
-40,70,80,1063,1101,2164,4664
0,-20,90,1086,1078,2164,4721
50,40,-20,1057,1107,2164,4929
-150,30,-160,1042,1123,2165,4984
-160,10,-160,1031,1134,2165,4930
-40,30,140,1048,1117,2165,4825
-150,20,-90,1047,1118,2165,4892
-30,-20,-10,1046,1119,2165,4943
-10,-40,10,1045,1120,2165,4697
-160,-80,-30,1080,1085,2165,4706
0,-70,100,1065,1101,2166,4791
-130,30,-120,1083,1083,2166,4878
-20,0,0,1075,1091,2166,4708
150,-60,170,1051,1115,2166,4884
60,-60,110,1073,1093,2166,4770
-10,-20,90,1088,1078,2166,4819
-160,60,-80,1036,1130,2166,4840
-20,30,30,1055,1112,2167,4687
-150,70,-90,1056,1111,2167,4752
90,-70,170,1062,1105,2167,4732
-40,-30,60,1057,1110,2167,4755
-40,50,80,1076,1091,2167,4941
-90,50,-170,1075,1092,2167,4795
80,50,-40,1082,1086,2168,4860
150,-50,-70,1043,1125,2168,4850
-10,40,30,1064,1104,2168,4727
30,-20,50,1050,1118,2168,4760
80,40,-40,1067,1101,2168,4976
-140,60,-100,1060,1108,2168,4753
40,-50,100,1077,1091,2168,4698
-120,-20,-70,1080,1088,2168,4831
-80,50,-180,1077,1092,2169,4751
-40,0,100,1079,1090,2169,5000
-80,50,180,1077,1092,2169,4751
40,-30,60,1051,1118,2169,4936
30,-60,50,1042,1127,2169,4876
80,40,-20,1065,1104,2169,4646
-30,50,150,1057,1113,2170,4983
20,20,10,1047,1123,2170,4815
-20,-30,80,1076,1094,2170,4837
150,-20,-140,1066,1104,2170,4866
30,-20,60,1054,1116,2170,4679
-10,-70,90,1069,1101,2170,4723
100,70,20,1046,1125,2171,4828
40,80,-10,1030,1141,2171,4676
-130,-60,-110,1081,1090,2171,4601
-30,-40,-10,1041,1130,2171,4993
-30,-20,70,1084,1087,2171,4815
100,30,-60,1059,1112,2171,4885
130,-30,-90,1049,1122,2171,4601
50,20,40,1056,1115,2171,4802
-120,-20,-20,1072,1100,2172,4830
-30,0,70,1077,1095,2172,4738
-40,-10,60,1086,1086,2172,4821
20,10,80,1060,1112,2172,4806
-150,-80,-20,1075,1097,2172,4725
-40,30,80,1104,1068,2172,4910
-60,-10,30,1055,1118,2173,5135
-100,-70,30,1063,1110,2173,4660
-120,-80,10,1062,1111,2173,4770
-40,-10,0,1060,1113,2173,4832
0,-40,20,1050,1123,2173,4754
-100,-60,30,1059,1114,2173,4818
160,-50,-170,1050,1123,2173,5009
170,-20,-150,1056,1117,2173,4827
180,20,-140,1067,1107,2174,4927
110,30,-70,1052,1122,2174,4932
120,-60,-150,1054,1120,2174,4735
-180,20,-140,1067,1107,2174,4927
60,-50,80,1048,1126,2174,5000
-10,-40,90,1068,1106,2174,4801
30,10,30,1056,1118,2174,4736
40,-60,120,1061,1114,2175,4693
-120,70,170,1063,1112,2175,4838
70,40,-10,1053,1122,2175,4769
130,-40,-140,1060,1116,2176,4756
10,30,10,1078,1098,2176,4895
-20,40,40,1076,1100,2176,4727
-170,-80,-40,1087,1090,2177,4725
-50,30,110,1088,1089,2177,5075
80,-80,-170,1077,1100,2177,4810
-20,-10,100,1075,1102,2177,5169
-140,-80,-10,1081,1096,2177,4767
-140,60,-170,1053,1124,2177,4550
90,50,10,1076,1101,2177,4964
-170,-60,-160,1047,1130,2177,4996
-40,10,120,1086,1092,2178,5170
20,-30,40,1064,1114,2178,4861
160,0,-40,1055,1123,2178,4839
20,-10,40,1062,1116,2178,4792
-10,20,120,1047,1131,2178,4930
30,10,80,1057,1121,2178,4816
140,-20,-110,1060,1118,2178,4648
-30,50,60,1076,1102,2178,4810
150,10,-40,1048,1130,2178,4963
-120,40,-170,1076,1103,2179,4912
30,0,40,1051,1128,2179,4772
10,20,0,1049,1130,2179,4885
20,-80,40,1063,1116,2179,4945
-140,-30,-130,1039,1140,2179,4940
10,-50,100,1075,1104,2179,4679
-40,40,80,1094,1085,2179,4943
-130,-80,0,1073,1107,2180,4808
50,10,50,1044,1136,2180,4894
0,10,0,1052,1128,2180,4797
-150,-20,-30,1092,1089,2181,4870
30,0,70,1085,1096,2181,4767
120,-70,-120,1075,1106,2181,4792
-180,-30,-160,1035,1146,2181,4812
-170,-50,-160,1060,1121,2181,4978
140,-10,-110,1071,1110,2181,4664
-100,70,150,1073,1108,2181,4929
0,-10,0,1053,1128,2181,4968
-40,-20,60,1095,1086,2181,4824
130,-40,-130,1037,1144,2181,4845
80,80,-50,1031,1150,2181,4615
130,-40,-100,1064,1117,2181,4730
180,-30,-160,1035,1146,2181,4812
-30,30,40,1074,1108,2182,5023
-150,20,-160,1062,1120,2182,4961
90,40,-30,1073,1109,2182,4728
110,-70,-150,1062,1120,2182,4663
-10,-70,100,1082,1100,2182,4890
-30,70,70,1086,1096,2182,4674
-90,-30,-40,1085,1098,2183,4938
130,-20,-80,1062,1121,2183,5015
110,30,-40,1083,1100,2183,4776
160,-20,-140,1075,1109,2184,4931
100,40,-20,1060,1124,2184,4768
50,40,-10,1071,1113,2184,4765
-170,-20,-160,1051,1133,2184,4987
20,-40,100,1091,1093,2184,4828
0,-60,100,1085,1099,2184,5012
110,-80,-130,1075,1110,2185,4937
-130,-20,-20,1075,1110,2185,4994
-180,30,-140,1060,1125,2185,4792
180,30,-140,1060,1125,2185,4792
0,-80,110,1079,1106,2185,4732
30,20,10,1057,1128,2185,4743
-140,70,-100,1060,1125,2185,4850
170,-40,-50,1059,1127,2186,4976
-20,-20,80,1087,1099,2186,4872
-130,-50,-110,1074,1112,2186,4736
-30,20,110,1084,1102,2186,5119
-110,70,160,1082,1104,2186,4840
20,0,70,1069,1117,2186,4816
50,10,60,1050,1136,2186,5044
-60,-60,60,1081,1105,2186,4924
60,40,-10,1082,1104,2186,4811
-50,-30,-20,1068,1118,2186,5005
-120,50,180,1081,1106,2187,4928
-120,50,-180,1081,1106,2187,4928
10,0,0,1049,1138,2187,4920
130,-60,-180,1065,1122,2187,4963
-80,-30,20,1096,1091,2187,4956
130,-60,180,1065,1122,2187,4963
60,50,-30,1055,1132,2187,5030
100,40,-30,1080,1107,2187,4713
80,-80,-180,1084,1103,2187,4693
80,-80,180,1084,1103,2187,4693
-10,10,0,1057,1131,2188,4924
20,-10,70,1071,1117,2188,5064
-130,40,-170,1082,1106,2188,5019
-50,60,170,1063,1125,2188,4957
10,10,10,1036,1152,2188,4693
-10,30,20,1065,1124,2189,4797
30,-10,70,1069,1120,2189,4628
-170,-10,-150,1064,1125,2189,4880
-10,20,0,1065,1124,2189,5026
-90,70,140,1073,1117,2190,4924
100,30,-40,1069,1121,2190,4879
-110,-50,20,1054,1137,2191,4917
-40,30,70,1087,1104,2191,4957
-150,50,-90,1040,1151,2191,4896
60,40,-30,1060,1131,2191,4973
70,80,-40,1041,1150,2191,4671
20,-20,40,1076,1115,2191,4779
140,-10,-120,1073,1119,2192,4696
120,-70,-150,1065,1127,2192,4715
40,0,60,1062,1130,2192,4935
-110,-70,20,1064,1128,2192,4781
-40,60,90,1077,1115,2192,4911
110,-70,-140,1092,1101,2193,4764
50,80,-20,1045,1148,2193,4704
-20,-70,90,1093,1100,2193,4920
80,-70,160,1067,1126,2193,4787
50,60,80,1075,1118,2193,4945
40,-50,60,1042,1152,2194,4991
80,40,-10,1070,1124,2194,4735
100,-80,-160,1082,1112,2194,4652
-50,0,40,1078,1116,2194,4996
-90,-50,-60,1085,1109,2194,4977
30,40,-10,1059,1135,2194,4838
150,-10,-130,1069,1126,2195,4918
0,20,0,1070,1125,2195,5129
-20,50,50,1059,1136,2195,4776
-170,10,-50,1085,1110,2195,5057
170,-50,-170,1050,1145,2195,4837
150,-50,-160,1069,1127,2196,4928
100,20,-60,1045,1151,2196,5015
-80,70,130,1071,1125,2196,4958
90,-80,-170,1089,1107,2196,4651
60,-80,160,1084,1113,2197,4727
-20,-40,0,1056,1141,2197,4935
-50,-10,50,1101,1096,2197,4925
-50,40,150,1080,1117,2197,4964
-20,0,80,1111,1086,2197,4830
60,30,30,1038,1159,2197,4767
110,10,-60,1053,1144,2197,5030
-60,-50,50,1093,1104,2197,5013
-40,20,120,1096,1102,2198,5126
-170,80,-150,1070,1128,2198,4690
-20,80,60,1074,1124,2198,4630
-40,60,160,1079,1119,2198,5050
0,30,0,1051,1148,2199,4980
-170,0,-150,1066,1133,2199,4992
-110,-30,-10,1080,1119,2199,4960
-100,-30,-10,1083,1116,2199,4838
-30,0,100,1099,1101,2200,5027
20,60,110,1048,1152,2200,4935
-100,-30,0,1076,1124,2200,4919
-80,-40,30,1085,1116,2201,5037
-120,40,-130,1092,1109,2201,5099
-130,70,180,1080,1121,2201,4859
20,30,0,1064,1137,2201,4941
70,-80,170,1087,1114,2201,4742
30,-70,50,1055,1146,2201,4936
160,30,-50,1062,1139,2201,4862
-130,70,-180,1080,1121,2201,4859
120,20,-80,1084,1118,2202,4947
10,-20,50,1083,1119,2202,4815
20,-20,80,1067,1135,2202,4999
70,70,-40,1071,1131,2202,4935
10,10,100,1069,1133,2202,5002
50,20,50,1051,1151,2202,5095
130,40,-40,1085,1117,2202,4675
160,10,-130,1061,1141,2202,4898
-30,30,50,1078,1124,2202,5075
30,30,0,1089,1113,2202,4935
-60,30,130,1110,1092,2202,5238
-20,0,110,1095,1107,2202,5122
180,60,-140,1066,1137,2203,4801
130,10,-50,1081,1122,2203,4837
50,-40,80,1071,1132,2203,5197
30,40,100,1074,1129,2203,4793
100,50,-60,1077,1126,2203,4900
-180,60,-140,1066,1137,2203,4801
30,10,40,1073,1130,2203,4830
120,-70,-130,1085,1118,2203,4833
-30,-30,-10,1075,1128,2203,5024
0,70,30,1060,1143,2203,4843
170,0,-40,1086,1118,2204,4931
-160,10,-60,1104,1100,2204,4813
100,-70,-180,1086,1118,2204,4770
-40,40,70,1091,1113,2204,5056
120,-70,-140,1070,1134,2204,4485
90,-80,-160,1095,1109,2204,4854
100,-70,180,1086,1118,2204,4770
20,0,30,1063,1141,2204,4589
-110,-20,-40,1105,1099,2204,4927
60,80,-30,1048,1156,2204,4713
40,10,50,1065,1139,2204,4951
70,40,10,1082,1123,2205,4792
100,40,-40,1064,1141,2205,4757
50,-80,150,1089,1116,2205,4757
-60,-20,-10,1097,1108,2205,5036
160,20,-130,1063,1142,2205,4812
60,-50,90,1071,1134,2205,5221
40,40,90,1074,1132,2206,5016
30,-20,70,1094,1112,2206,4807
30,-70,120,1103,1103,2206,4957
10,40,0,1046,1160,2206,5055
-90,-30,0,1102,1105,2207,4982
170,20,-50,1083,1124,2207,4891
110,40,-30,1080,1127,2207,4846
100,50,-10,1098,1109,2207,4973
140,-20,-120,1063,1144,2207,4876
10,30,0,1068,1139,2207,4909
0,-30,20,1058,1149,2207,4771
60,40,0,1070,1137,2207,4802
30,0,50,1097,1110,2207,4875
-30,-10,80,1120,1087,2207,5018
-30,50,70,1090,1118,2208,4966
170,40,-60,1071,1137,2208,4722
130,-10,-90,1059,1149,2208,4698
20,-30,90,1092,1116,2208,4890
-20,-40,80,1103,1105,2208,4899
150,40,-120,1062,1147,2209,4706
-150,60,-160,1066,1143,2209,4663
160,0,-130,1060,1149,2209,4821
-160,50,-150,1047,1162,2209,4765
10,20,10,1068,1141,2209,4915
-30,10,70,1102,1107,2209,4932
-40,20,100,1118,1091,2209,4950
0,-10,80,1097,1112,2209,4780
-20,-10,70,1098,1111,2209,4899
30,-30,60,1091,1118,2209,4858
40,-30,70,1064,1146,2210,4754
-80,50,160,1093,1117,2210,5157
-130,30,-140,1082,1128,2210,4774
-50,-80,70,1105,1106,2211,4973
30,0,60,1085,1126,2211,4873
-30,-40,70,1112,1100,2212,4838
0,-40,90,1113,1099,2212,4856
30,-80,50,1068,1144,2212,4950
-160,40,-150,1062,1150,2212,4932
-60,40,130,1088,1124,2212,5145
-30,0,110,1118,1094,2212,5143
-130,-80,-110,1083,1130,2213,5046
-110,60,-130,1096,1117,2213,4851
20,40,0,1055,1158,2213,4948
20,-10,50,1089,1124,2213,4826
-10,-60,90,1112,1101,2213,4952
20,-20,50,1099,1114,2213,4890
-30,-70,80,1082,1131,2213,4803
30,-40,90,1083,1130,2213,4941
150,30,-120,1090,1123,2213,4697
-30,-30,70,1127,1086,2213,4846
150,60,-40,1084,1130,2214,4997
-130,60,-110,1085,1129,2214,4859
-130,70,-110,1071,1143,2214,4976
40,-80,140,1097,1117,2214,4747
110,40,-40,1087,1127,2214,4787
-30,40,70,1106,1108,2214,4912
150,-40,-150,1077,1137,2214,5031
0,10,100,1091,1123,2214,4938
110,-80,-150,1085,1130,2215,4686
180,-40,-160,1059,1156,2215,4891
120,30,-70,1066,1149,2215,4931
-180,-40,-160,1059,1156,2215,4891
-20,30,40,1088,1127,2215,4858
-30,40,60,1077,1138,2215,4932
130,-50,-130,1053,1163,2216,4875
140,-50,-80,1064,1152,2216,4797
40,0,70,1058,1158,2216,4996
40,20,30,1054,1162,2216,4874
-140,0,-100,1079,1137,2216,4711
0,0,0,1068,1148,2216,4933
160,-60,-180,1067,1150,2217,5028
-50,-50,60,1089,1128,2217,5002
-180,-10,-150,1062,1155,2217,4947
-140,0,-90,1091,1126,2217,4944
10,20,110,1081,1136,2217,4964
140,50,-100,1086,1131,2217,4921
-100,50,-160,1108,1109,2217,4878
160,-60,180,1067,1150,2217,5028
180,-10,-150,1062,1155,2217,4947
70,50,-30,1087,1130,2217,4986
130,-50,-100,1080,1137,2217,4963
10,-20,40,1075,1142,2217,4770
170,-40,-160,1056,1162,2218,4918
50,-50,70,1077,1141,2218,5042
-20,20,30,1079,1139,2218,4926
-110,-20,-30,1087,1131,2218,4805
160,-40,-150,1082,1136,2218,4853
130,-60,-140,1061,1158,2219,4803
-150,0,-50,1104,1115,2219,5139
140,50,-40,1076,1143,2219,4831
180,40,-70,1108,1111,2219,4876
130,-60,-110,1073,1146,2219,4783
-20,30,130,1084,1135,2219,4988
150,10,-120,1071,1148,2219,4799
-180,40,-70,1108,1111,2219,4876
30,-80,130,1095,1125,2220,4785
30,-10,50,1075,1145,2220,4809
-10,30,30,1090,1130,2220,5016
110,20,-70,1070,1150,2220,4970
130,-60,-150,1078,1142,2220,4974
70,-70,150,1093,1127,2220,4806
-120,40,-150,1110,1111,2221,5065
90,70,30,1056,1165,2221,4865
-40,-20,-10,1097,1124,2221,5074
140,-30,-100,1078,1143,2221,4700
-30,-50,70,1098,1123,2221,4898
40,-80,60,1062,1159,2221,4887
-70,-90,50,1113,1109,2222,4992
-40,-90,80,1113,1109,2222,4992
-80,-90,40,1113,1109,2222,4992
100,-80,-150,1105,1117,2222,4903
10,-90,130,1113,1109,2222,4992
-50,-90,70,1113,1109,2222,4992
-10,-90,110,1113,1109,2222,4992
30,-90,150,1113,1109,2222,4992
20,-90,140,1113,1109,2222,4992
30,10,50,1098,1124,2222,4903
-30,-90,90,1113,1109,2222,4992
-170,-90,-50,1113,1109,2222,4992
50,-90,170,1113,1109,2222,4992
-20,-90,100,1113,1109,2222,4992
140,-90,-100,1113,1109,2222,4992
40,-90,160,1113,1109,2222,4992
100,-90,-140,1113,1109,2222,4992
170,-90,-70,1113,1109,2222,4992
60,-90,-180,1113,1109,2222,4992
-140,-90,-20,1113,1109,2222,4992
0,-90,120,1113,1109,2222,4992
120,-90,-120,1113,1109,2222,4992
150,20,-120,1093,1129,2222,4723
-150,-90,-30,1113,1109,2222,4992
110,-90,-130,1113,1109,2222,4992
-100,-90,20,1113,1109,2222,4992
-60,-90,60,1113,1109,2222,4992
60,-90,180,1113,1109,2222,4992
-90,-90,30,1113,1109,2222,4992
130,-90,-110,1113,1109,2222,4992
180,-90,-60,1113,1109,2222,4992
160,-90,-80,1113,1109,2222,4992
90,-90,-150,1113,1109,2222,4992
-110,-90,10,1113,1109,2222,4992
80,-90,-160,1113,1109,2222,4992
70,-90,-170,1113,1109,2222,4992
-180,-90,-60,1113,1109,2222,4992
30,60,100,1072,1150,2222,4976
30,-50,100,1097,1125,2222,4876
120,-80,-120,1091,1131,2222,5116
-160,-90,-40,1113,1109,2222,4992
-130,-90,-10,1113,1109,2222,4992
-120,-90,0,1113,1109,2222,4992
-70,60,120,1104,1118,2222,4967
130,-70,-130,1089,1133,2222,4714
150,-90,-90,1113,1109,2222,4992
20,0,50,1097,1126,2223,4764
-120,40,-140,1112,1111,2223,4956
0,40,20,1080,1143,2223,4966
-160,-50,-150,1068,1155,2223,5059
-20,30,20,1071,1153,2224,5121
-130,-40,0,1086,1138,2224,5063
-30,20,120,1103,1121,2224,5138
50,-60,110,1093,1131,2224,4889
40,30,80,1099,1125,2224,5040
0,-30,90,1111,1113,2224,4965
130,-60,-120,1064,1160,2224,4879
140,40,-100,1097,1127,2224,4940
110,40,-60,1094,1130,2224,4993
-10,0,90,1103,1121,2224,4900
20,50,110,1081,1144,2225,4881
120,30,-50,1101,1124,2225,4801
100,20,-50,1073,1152,2225,5138
20,10,70,1083,1142,2225,4871
170,50,-60,1089,1136,2225,4837
60,-60,80,1075,1151,2226,5008
0,30,10,1081,1145,2226,4902
-30,30,70,1108,1118,2226,4931
60,60,-30,1108,1118,2226,4944
70,-60,90,1059,1167,2226,5052
90,-70,160,1094,1132,2226,4975
0,0,90,1127,1099,2226,4889
-20,0,70,1123,1103,2226,4850
-140,0,-70,1092,1134,2226,4866
80,-60,110,1079,1148,2227,4907
-50,-70,70,1114,1113,2227,4964
120,40,-80,1070,1157,2227,4996
-130,-30,-10,1087,1140,2227,5209
70,60,-40,1109,1118,2227,4974
70,40,30,1090,1137,2227,4864
-110,50,-180,1094,1134,2228,5086
30,-60,110,1084,1144,2228,4914
40,-40,80,1093,1135,2228,4969
20,-30,60,1107,1121,2228,4722
-130,30,-130,1091,1137,2228,5082
130,-60,-130,1067,1161,2228,4825
-30,0,90,1103,1125,2228,4986
-110,50,180,1094,1134,2228,5086
130,-70,-140,1081,1147,2228,4843
140,-50,-150,1096,1132,2228,5070
-60,90,100,1092,1137,2229,4866
-120,90,160,1092,1137,2229,4866
-170,90,-150,1092,1137,2229,4866
-20,-30,0,1074,1155,2229,4992
70,90,-30,1092,1137,2229,4866
20,90,20,1092,1137,2229,4866
-160,90,-160,1092,1137,2229,4866
120,10,-80,1069,1160,2229,5032
-150,90,-170,1092,1137,2229,4866
50,90,-10,1092,1137,2229,4866
80,90,-40,1092,1137,2229,4866
0,90,40,1092,1137,2229,4866
-140,90,-180,1092,1137,2229,4866
110,50,-20,1108,1121,2229,4935
-80,90,120,1092,1137,2229,4866
-130,90,170,1092,1137,2229,4866
-70,90,110,1092,1137,2229,4866
130,90,-90,1092,1137,2229,4866
-20,90,60,1092,1137,2229,4866
40,-40,60,1052,1177,2229,4997
-180,90,-140,1092,1137,2229,4866
90,90,-50,1092,1137,2229,4866
-10,40,130,1095,1134,2229,5057
-50,90,90,1092,1137,2229,4866
-10,90,50,1092,1137,2229,4866
30,90,10,1092,1137,2229,4866
40,10,60,1068,1161,2229,4912
-110,90,150,1092,1137,2229,4866
100,90,-60,1092,1137,2229,4866
40,90,0,1092,1137,2229,4866
-70,70,120,1097,1132,2229,4934
120,90,-80,1092,1137,2229,4866
60,90,-20,1092,1137,2229,4866
160,90,-120,1092,1137,2229,4866
-100,90,140,1092,1137,2229,4866
-20,20,120,1080,1149,2229,4999
120,30,-80,1083,1146,2229,4941
170,90,-130,1092,1137,2229,4866
180,90,-140,1092,1137,2229,4866
110,90,-70,1092,1137,2229,4866
-30,90,70,1092,1137,2229,4866
10,90,30,1092,1137,2229,4866
-40,90,80,1092,1137,2229,4866
150,90,-110,1092,1137,2229,4866
-90,90,130,1092,1137,2229,4866
140,90,-100,1092,1137,2229,4866
110,30,-50,1098,1131,2229,5022
-160,20,-80,1093,1136,2229,4928
-140,90,180,1092,1137,2229,4866
10,40,10,1082,1148,2230,5060
80,-70,150,1100,1130,2230,5011
-40,-40,60,1081,1149,2230,4872
60,-70,140,1099,1131,2230,4912
-30,-10,90,1088,1142,2230,5104
-30,20,70,1114,1116,2230,5090
-140,20,-160,1104,1126,2230,4989
-80,-30,-30,1107,1124,2231,5041
-100,60,160,1069,1162,2231,4872
110,30,-60,1077,1154,2231,5054
40,60,90,1082,1149,2231,4998
120,40,-40,1111,1120,2231,4812
-160,30,-150,1083,1148,2231,5033
-70,-60,50,1100,1131,2231,5008
140,0,-50,1064,1167,2231,4955
10,-20,30,1076,1156,2232,4871
-140,-20,-130,1088,1144,2232,4950
-90,50,170,1092,1140,2232,5035
110,50,-70,1067,1165,2232,5017
-30,0,80,1128,1105,2233,4929
-40,10,50,1093,1140,2233,5029
60,70,-30,1086,1147,2233,5067
140,-60,-180,1080,1153,2233,4901
80,30,-40,1074,1159,2233,5071
140,-60,180,1080,1153,2233,4901
-140,30,-160,1083,1150,2233,5103
130,30,-50,1095,1138,2233,4963
20,-50,50,1096,1138,2234,5063
-140,0,-60,1093,1141,2234,5044
-40,30,90,1111,1123,2234,5043
-80,-50,40,1099,1135,2234,4835
130,-60,-170,1088,1146,2234,5002
150,-60,180,1091,1143,2234,4958
-50,60,100,1111,1123,2234,5146
150,-60,-180,1091,1143,2234,4958
-160,-40,-150,1091,1143,2234,5072
-10,-20,0,1073,1162,2235,5047
0,-60,30,1070,1165,2235,4810
40,50,90,1083,1152,2235,4956
-100,-40,20,1097,1138,2235,5063
-20,-20,70,1115,1120,2235,4964
140,-30,-130,1079,1156,2235,4846
40,50,-10,1094,1142,2236,4960
-140,0,-80,1097,1139,2236,5056
80,60,-50,1106,1130,2236,4992
130,-60,-100,1079,1157,2236,4950
-160,20,-150,1077,1159,2236,5068
180,80,-140,1087,1150,2237,4810
110,-70,-170,1101,1136,2237,4981
-30,10,110,1117,1120,2237,5142
-180,80,-140,1087,1150,2237,4810
0,-50,30,1076,1162,2238,4754
10,-30,40,1072,1166,2238,4843
-130,-10,-70,1108,1130,2238,4908
-30,40,140,1082,1157,2239,5115
-160,-10,-160,1085,1154,2239,5154
10,0,10,1071,1168,2239,4923
30,30,90,1097,1142,2239,4999
-70,-50,40,1094,1145,2239,4862
170,-30,-150,1108,1132,2240,5097
110,40,-70,1074,1166,2240,5045
-70,50,130,1092,1148,2240,5115
170,-10,-140,1098,1142,2240,5126
50,20,60,1086,1154,2240,5028
0,-40,30,1088,1152,2240,4940
-20,0,100,1115,1125,2240,5319
-140,-70,-120,1094,1147,2241,4919
-20,50,140,1099,1142,2241,5186
-50,40,100,1123,1118,2241,5152
100,-70,170,1119,1122,2241,5034
-10,-80,100,1096,1145,2241,4827
-10,30,10,1083,1158,2241,5136
30,-30,70,1110,1131,2241,4983
-70,50,140,1102,1140,2242,5206
-60,70,110,1113,1129,2242,4984
20,30,90,1105,1137,2242,4870
-20,-70,80,1097,1145,2242,4811
-60,-10,20,1092,1151,2243,5361
-30,20,40,1100,1143,2243,5059
-10,-20,80,1127,1116,2243,4971
140,60,-100,1111,1132,2243,4993
-30,10,80,1115,1128,2243,4983
160,60,-120,1088,1155,2243,4894
10,-10,20,1097,1146,2243,4986
-10,80,50,1100,1143,2243,4792
-110,-30,0,1120,1123,2243,5027
-60,50,110,1128,1115,2243,5058
10,70,20,1072,1171,2243,5001
-50,30,130,1109,1135,2244,5195
-140,-80,-120,1102,1142,2244,5124
40,20,40,1075,1169,2244,4993
0,20,110,1107,1137,2244,5082
70,-70,140,1104,1140,2244,5001
-70,50,170,1104,1140,2244,5138
-10,60,40,1085,1159,2244,4909
140,-30,-110,1063,1181,2244,4857
-140,10,-150,1079,1165,2244,4963
40,-90,60,1094,1151,2245,5054
-40,-90,-20,1094,1151,2245,5054
170,-90,-170,1094,1151,2245,5054
-120,60,-120,1101,1144,2245,5003
140,-70,-90,1113,1132,2245,5066
50,40,70,1103,1142,2245,4954
100,-90,120,1094,1151,2245,5054
-10,-10,80,1130,1115,2245,5024
-80,-90,-60,1094,1151,2245,5054
20,-90,40,1094,1151,2245,5054
140,-90,160,1094,1151,2245,5054
160,-90,-180,1094,1151,2245,5054
-30,-90,-10,1094,1151,2245,5054
60,-90,80,1094,1151,2245,5054
150,-90,170,1094,1151,2245,5054
-140,-90,-120,1094,1151,2245,5054
70,-90,90,1094,1151,2245,5054
-150,-90,-130,1094,1151,2245,5054
180,-90,-160,1094,1151,2245,5054
-90,-90,-70,1094,1151,2245,5054
-10,-90,10,1094,1151,2245,5054
50,-90,70,1094,1151,2245,5054
-60,-90,-40,1094,1151,2245,5054
160,-90,180,1094,1151,2245,5054
-20,-90,0,1094,1151,2245,5054
-110,-90,-90,1094,1151,2245,5054
0,-90,20,1094,1151,2245,5054
110,-90,130,1094,1151,2245,5054
80,-90,100,1094,1151,2245,5054
-50,-90,-30,1094,1151,2245,5054
-120,-90,-100,1094,1151,2245,5054
30,-90,50,1094,1151,2245,5054
10,-90,30,1094,1151,2245,5054
90,-90,110,1094,1151,2245,5054
110,-80,-140,1119,1126,2245,5024
130,-90,150,1094,1151,2245,5054
-170,-90,-150,1094,1151,2245,5054
120,-90,140,1094,1151,2245,5054
-10,10,100,1101,1144,2245,5084
-130,-90,-110,1094,1151,2245,5054
-100,-90,-80,1094,1151,2245,5054
-160,-90,-140,1094,1151,2245,5054
-180,-90,-160,1094,1151,2245,5054
-70,-90,-50,1094,1151,2245,5054
150,-30,-140,1087,1158,2245,5044
-150,-10,-150,1065,1181,2246,5064
-60,40,120,1111,1135,2246,5239
30,50,100,1081,1165,2246,5057
-110,50,-150,1105,1141,2246,5131
20,-20,60,1116,1130,2246,4680
-110,70,-130,1079,1167,2246,5066
-120,70,-120,1095,1151,2246,5003
50,-50,90,1098,1149,2247,5111
120,50,-80,1085,1162,2247,4864
-140,-60,-120,1123,1124,2247,4773
180,20,-60,1106,1141,2247,4975
-180,20,-60,1106,1141,2247,4975
140,-40,-140,1083,1164,2247,5117
130,-50,-140,1075,1172,2247,4827
130,-70,-120,1106,1142,2248,4924
20,-80,120,1108,1140,2248,4778
20,0,40,1083,1165,2248,4809
-20,-50,80,1134,1114,2248,4900
120,40,-50,1099,1149,2248,4969
-50,50,160,1117,1131,2248,5115
60,40,50,1096,1152,2248,4985
40,30,20,1088,1160,2248,4866
-20,-10,90,1129,1119,2248,5037
-10,-50,90,1119,1130,2249,4993
-100,50,-150,1107,1142,2249,5123
0,10,10,1087,1162,2249,4971
-150,10,-80,1091,1158,2249,5118
-20,70,60,1116,1133,2249,4870
-70,-20,20,1096,1153,2249,5092
140,-20,-70,1091,1158,2249,5080
-30,20,50,1105,1144,2249,5100
-50,-20,50,1117,1132,2249,5193
-70,-20,10,1095,1155,2250,5206
10,-60,100,1100,1150,2250,5101
10,10,80,1097,1153,2250,5009
20,-50,100,1095,1155,2250,4935
50,-70,130,1088,1163,2251,4989
-80,-50,-50,1094,1157,2251,4991
-30,20,30,1097,1154,2251,5149
-20,-60,80,1101,1150,2251,4861
-10,-30,10,1087,1164,2251,5049
-40,-70,-10,1098,1154,2252,4859
140,30,-100,1108,1144,2252,4879
170,10,-130,1078,1174,2252,4826
-60,60,110,1098,1154,2252,5072
-100,-50,-70,1106,1146,2252,4940
40,40,-10,1091,1161,2252,5153
-30,10,100,1110,1142,2252,5228
-40,-70,70,1113,1140,2253,4933
50,60,-20,1110,1143,2253,5036
40,-70,60,1073,1180,2253,5114
120,30,-60,1083,1170,2253,4981
-110,50,-140,1084,1169,2253,5122
130,-60,-160,1122,1131,2253,5108
150,-10,-50,1086,1168,2254,5009
10,-80,110,1111,1143,2254,4796
40,10,70,1067,1187,2254,5045
-140,0,-140,1091,1164,2255,5028
20,-20,70,1092,1163,2255,5149
0,-50,90,1113,1142,2255,4880
-90,60,150,1083,1172,2255,4885
-140,70,-170,1100,1155,2255,4838
-10,-10,0,1097,1158,2255,5020
70,40,0,1097,1159,2256,4942
10,-30,90,1126,1130,2256,4944
-70,-50,-40,1093,1163,2256,4956
-20,20,110,1114,1142,2256,5133
160,50,-120,1114,1142,2256,4809
90,-80,180,1104,1153,2257,4795
130,0,-90,1077,1180,2257,5044
-30,30,60,1117,1140,2257,5039
90,-80,-180,1104,1153,2257,4795
50,50,-20,1101,1156,2257,5032
20,-40,60,1109,1148,2257,4940
-60,-30,40,1101,1156,2257,5124
30,-40,60,1102,1155,2257,4975
20,-40,50,1122,1135,2257,5072
10,-30,50,1125,1132,2257,4984
-120,-30,-10,1133,1125,2258,5074
50,30,30,1082,1176,2258,4983
-50,-70,-20,1104,1154,2258,4915
0,10,20,1109,1149,2258,5061
40,-60,60,1071,1187,2258,5157
120,20,-50,1095,1163,2258,5053
180,10,-140,1102,1157,2259,4972
150,30,-50,1115,1144,2259,5029
-180,-20,-150,1106,1153,2259,5179
180,-20,-150,1106,1153,2259,5179
0,-30,30,1082,1177,2259,5005
20,0,60,1108,1151,2259,5061
140,-30,-120,1100,1159,2259,4913
130,20,-50,1120,1139,2259,4996
-180,10,-140,1102,1157,2259,4972
-30,0,60,1109,1150,2259,5045
-20,60,60,1117,1143,2260,4839
20,-30,50,1120,1140,2260,5113
150,-50,-150,1106,1154,2260,5083
-150,-40,-140,1072,1188,2260,5063
160,50,-60,1100,1160,2260,4932
130,50,-90,1084,1176,2260,5024
-20,-80,90,1098,1162,2260,4938
150,50,-50,1101,1160,2261,4875
140,-20,-100,1108,1153,2261,4805
20,10,20,1111,1150,2261,5088
0,30,120,1123,1138,2261,5239
10,-70,40,1099,1162,2261,4980
150,80,-110,1114,1147,2261,4974
160,-50,-160,1081,1180,2261,4963
80,60,30,1107,1155,2262,4898
0,80,40,1111,1151,2262,4914
-20,-70,10,1095,1167,2262,4824
50,-80,70,1068,1194,2262,5067
10,-40,40,1118,1144,2262,4921
80,-80,170,1105,1158,2263,4832
-30,-60,70,1091,1172,2263,4880
-110,70,170,1120,1143,2263,4768
-180,70,-140,1100,1164,2264,4842
130,80,-10,1100,1164,2264,4957
110,40,-50,1105,1159,2264,4912
-70,-30,30,1110,1154,2264,5107
20,-30,70,1110,1154,2264,5051
180,70,-140,1100,1164,2264,4842
-30,-70,0,1102,1163,2265,4818
0,-80,100,1127,1138,2265,4829
-60,-80,60,1140,1125,2265,5087
-50,50,100,1125,1140,2265,5170
-110,60,170,1085,1180,2265,4977
-160,-80,-140,1100,1165,2265,5125
20,20,90,1121,1144,2265,5040
70,40,20,1100,1166,2266,4856
-140,-10,-130,1113,1153,2266,5017
150,60,-110,1127,1139,2266,4947
-170,20,-70,1119,1147,2266,5028
-10,-70,20,1096,1170,2266,4757
-110,-60,20,1107,1159,2266,4993
130,80,-90,1131,1136,2267,5045
-30,50,80,1123,1144,2267,5084
130,-10,-80,1095,1172,2267,5084
120,50,-30,1123,1144,2267,5033
-10,-60,20,1099,1168,2267,4671
140,-60,-120,1096,1171,2267,4853
-120,-70,10,1099,1168,2267,4938
10,-60,40,1095,1172,2267,4954
-20,10,80,1144,1124,2268,5017
-30,-10,60,1128,1140,2268,5018
-100,-30,-50,1113,1155,2268,5213
50,40,20,1110,1158,2268,4823
30,20,20,1099,1170,2269,4931
170,50,-130,1079,1190,2269,4985
20,30,10,1109,1160,2269,5284
130,10,-90,1086,1183,2269,4989
170,80,-130,1097,1172,2269,4947
140,80,-20,1098,1171,2269,4972
20,-10,60,1121,1149,2270,4885
0,20,10,1113,1157,2270,5044
0,-70,30,1095,1175,2270,4837
40,30,10,1089,1182,2271,5038
130,50,-40,1116,1155,2271,5028
50,40,10,1109,1162,2271,4859
70,-80,160,1111,1160,2271,4876
-30,-30,60,1144,1127,2271,5047
140,-60,-170,1109,1162,2271,5092
-100,70,-140,1096,1175,2271,5053
70,-80,90,1089,1183,2272,5158
140,20,-50,1135,1137,2272,5126
0,-40,40,1105,1167,2272,4897
150,40,-50,1127,1145,2272,5049
30,10,70,1102,1171,2273,4973
30,40,0,1106,1167,2273,5184
120,-80,-140,1118,1155,2273,4807
-40,10,40,1140,1133,2273,5189
160,-20,-50,1084,1189,2273,5085
90,30,-50,1096,1178,2274,5156
130,-70,-110,1125,1149,2274,5079
-180,-50,-160,1104,1170,2274,5139
120,-80,-130,1134,1140,2274,5139
30,-40,80,1123,1151,2274,5182
180,-50,-160,1104,1170,2274,5139
-60,-40,-30,1117,1157,2274,5191
-50,-60,60,1121,1154,2275,5054
10,-10,40,1132,1143,2275,4892
-30,10,90,1136,1139,2275,5035
-120,60,-180,1105,1170,2275,4956
-150,-80,-130,1105,1170,2275,5176
-120,60,180,1105,1170,2275,4956
-60,-70,60,1133,1142,2275,5176
20,20,80,1120,1155,2275,5037
-150,70,-160,1123,1152,2275,4866
-10,0,0,1101,1175,2276,4999
140,-10,-60,1103,1173,2276,5111
-60,-70,-30,1102,1174,2276,4975
120,-70,140,1092,1184,2276,5231
-120,70,-180,1113,1163,2276,4860
60,40,10,1097,1179,2276,4858
130,-80,-110,1112,1164,2276,5314
-120,70,180,1113,1163,2276,4860
160,80,-120,1100,1177,2277,5000
-10,-30,80,1124,1153,2277,4989
-20,10,100,1123,1154,2277,5310
120,70,-10,1141,1136,2277,5095
-50,30,120,1140,1137,2277,5329
-170,-10,-40,1121,1157,2278,5134
160,-10,-130,1100,1178,2278,4963
20,40,10,1108,1170,2278,5235
-70,50,150,1115,1163,2278,5280
120,60,-20,1111,1167,2278,5029
20,30,100,1108,1170,2278,5030
110,70,0,1124,1155,2279,5080
50,70,-20,1101,1178,2279,5140
130,60,-90,1125,1154,2279,4956
100,60,0,1121,1158,2279,5178
-10,-80,90,1122,1157,2279,4899
140,80,-100,1128,1151,2279,5029
30,70,0,1101,1178,2279,5177
-160,10,-150,1085,1194,2279,5279
0,0,10,1094,1185,2279,5010
-30,30,80,1118,1161,2279,5282
170,60,-130,1100,1179,2279,4959
-170,-20,-150,1086,1193,2279,4967
-60,-20,0,1128,1151,2279,5051
-30,10,60,1126,1153,2279,5132
30,20,80,1120,1160,2280,4945
-30,60,150,1115,1165,2280,5194
20,-70,50,1102,1178,2280,5119
80,-80,100,1103,1177,2280,5163
-40,50,90,1130,1150,2280,5163
-30,-20,60,1125,1155,2280,5111
30,20,30,1084,1196,2280,4886
140,30,-50,1126,1154,2280,5124
-30,10,10,1120,1160,2280,5179
-150,-10,-40,1135,1145,2280,5096
60,-60,100,1114,1166,2280,5302
-20,20,100,1127,1153,2280,5185
0,0,80,1114,1167,2281,5010
0,-20,80,1129,1152,2281,5020
-30,20,60,1120,1161,2281,5203
-30,-80,80,1117,1164,2281,5031
10,20,20,1104,1177,2281,5182
120,-70,-160,1125,1156,2281,5108
40,-60,110,1120,1162,2282,5012
170,20,-130,1105,1177,2282,4855
160,60,-50,1113,1169,2282,5263
-20,-50,10,1097,1185,2282,5095
60,-70,130,1134,1148,2282,5095
130,40,-90,1106,1176,2282,4995
-50,70,100,1111,1171,2282,4989
-50,-20,-10,1129,1153,2282,5205
150,70,-110,1111,1172,2283,5049
140,-40,-80,1092,1191,2283,5029
-160,60,-150,1102,1181,2283,4766
20,-70,110,1129,1154,2283,5174
-170,-80,-150,1105,1178,2283,4971
-90,80,140,1126,1157,2283,4951
150,50,-110,1132,1151,2283,5061
0,20,20,1111,1172,2283,5163
20,10,50,1131,1152,2283,4899
170,0,-130,1105,1179,2284,5043
-50,40,140,1121,1163,2284,5236
130,60,-30,1124,1160,2284,5087
100,-80,-170,1120,1164,2284,4837
20,-30,80,1126,1158,2284,5219
-40,40,90,1111,1173,2284,5131
-90,-40,20,1123,1161,2284,5186
10,30,110,1113,1172,2285,5089
-130,30,-160,1139,1146,2285,5179
-90,70,150,1115,1170,2285,4849
-130,-10,-40,1130,1155,2285,5331
-140,10,-110,1103,1182,2285,5121
-80,70,140,1111,1174,2285,4911
-30,20,80,1120,1166,2286,5146
0,-10,10,1095,1191,2286,5233
50,40,0,1109,1177,2286,5014
-50,0,20,1105,1181,2286,5216
130,30,-60,1136,1150,2286,4977
180,-80,-160,1114,1173,2287,4987
60,-80,80,1086,1201,2287,5098
-180,-80,-160,1114,1173,2287,4987
-90,-30,-10,1126,1161,2287,5097
140,70,-100,1114,1173,2287,4911
130,40,-50,1129,1158,2287,5097
140,-40,-130,1087,1201,2288,4934
-130,50,-170,1115,1173,2288,5276
90,50,-10,1132,1156,2288,4897
-120,-30,-80,1132,1156,2288,5163
140,-80,-100,1130,1158,2288,5376
-10,0,80,1124,1164,2288,5013
120,70,-80,1128,1160,2288,5019
-160,-30,-150,1099,1189,2288,5252
110,60,-70,1116,1172,2288,5030
-100,50,180,1131,1157,2288,5239
-100,50,-180,1131,1157,2288,5239
-170,-20,-40,1129,1159,2288,5117
10,-50,50,1133,1155,2288,5045
-80,50,170,1119,1169,2288,5226
-30,40,80,1125,1163,2288,5184
-120,-20,-60,1129,1159,2288,5146
100,30,-50,1112,1176,2288,5210
130,-80,-130,1110,1179,2289,4870
-10,20,20,1116,1173,2289,5077
20,-40,90,1108,1181,2289,5195
10,-10,80,1098,1191,2289,5140
120,80,0,1118,1171,2289,5006
40,60,-10,1118,1171,2289,5109
0,0,20,1131,1159,2290,5028
0,-80,30,1125,1165,2290,5011
10,-50,40,1125,1165,2290,4938
-140,-50,-120,1142,1148,2290,4972
70,60,50,1103,1187,2290,5089
-20,50,60,1117,1173,2290,4986
40,-50,90,1134,1156,2290,5091
20,70,10,1101,1189,2290,5143
90,80,30,1105,1185,2290,5136
30,-50,90,1117,1173,2290,5129
80,70,40,1085,1205,2290,4993
-140,20,-110,1127,1163,2290,5114
50,-80,140,1119,1172,2291,5019
10,-80,40,1115,1176,2291,5057
40,30,30,1097,1194,2291,4981
30,30,10,1103,1188,2291,5088
-10,-40,20,1120,1171,2291,5066
40,70,-10,1114,1177,2291,5224
0,-20,20,1111,1180,2291,5248
150,50,-60,1129,1162,2291,4961
-40,0,50,1136,1155,2291,5065
120,10,-70,1103,1189,2292,5166
0,-30,50,1143,1149,2292,5084
90,50,0,1133,1159,2292,4974
-140,-40,-10,1123,1169,2292,5334
110,60,-10,1126,1167,2293,5022
10,-20,80,1121,1172,2293,5053
140,-50,-120,1088,1205,2293,4872
-100,70,160,1124,1169,2293,4779
170,30,-60,1136,1157,2293,5164
110,20,-50,1116,1177,2293,5199
-40,30,130,1117,1176,2293,5417
-40,30,120,1150,1143,2293,5361
170,40,-130,1112,1181,2293,5045
-20,0,90,1133,1160,2293,5160
-120,-40,-90,1134,1159,2293,4936
-30,-50,0,1096,1198,2294,5049
20,-60,100,1123,1171,2294,5083
130,20,-90,1120,1174,2294,5087
100,60,-60,1104,1190,2294,5008
150,80,-30,1099,1195,2294,4962
130,0,-70,1120,1174,2294,5173
10,-30,60,1125,1169,2294,5026
-130,30,-150,1116,1179,2295,5139
10,0,80,1115,1180,2295,5121
150,0,-120,1130,1165,2295,5011
130,0,-60,1122,1174,2296,5196
50,30,60,1102,1194,2296,5095
-160,-40,-30,1128,1168,2296,5208
140,-60,-90,1129,1167,2296,5184
-20,40,70,1133,1163,2296,5148
-110,80,160,1127,1169,2296,4989
-70,-70,-40,1115,1181,2296,4990
180,-30,-150,1108,1188,2296,5151
-180,-30,-150,1108,1188,2296,5151
70,-60,100,1124,1172,2296,5304
180,50,-70,1115,1182,2297,5062
-120,-50,10,1117,1180,2297,5083
-180,50,-70,1115,1182,2297,5062
150,20,-50,1126,1172,2298,5230
100,70,10,1122,1176,2298,5061
-120,40,-160,1143,1156,2299,5141
110,-70,150,1126,1173,2299,5159
40,-40,70,1107,1192,2299,5032
20,-40,70,1116,1183,2299,5223
100,50,-20,1134,1165,2299,4922
70,70,50,1102,1197,2299,5107
80,50,20,1119,1180,2299,5211
100,-70,120,1097,1202,2299,5167
100,-70,140,1121,1178,2299,5228
-20,-60,10,1113,1187,2300,5002
0,30,20,1110,1190,2300,5185
20,10,60,1127,1173,2300,5133
-20,10,30,1123,1177,2300,5200
40,20,70,1094,1206,2300,5109
-20,-30,70,1137,1163,2300,5052
-20,0,30,1125,1175,2300,5202
170,-40,-150,1121,1179,2300,5205
140,40,-50,1124,1176,2300,5143
130,40,-60,1147,1153,2300,5089
110,80,10,1117,1183,2300,5007
130,-70,150,1089,1211,2300,5304
10,-60,50,1137,1163,2300,5047
-70,80,120,1129,1171,2300,4909
60,-80,150,1121,1179,2300,4966
40,-90,140,1137,1164,2301,5030
-170,-90,-70,1137,1164,2301,5030
-120,-90,-20,1137,1164,2301,5030
-20,-90,80,1137,1164,2301,5030
-80,-90,20,1137,1164,2301,5030
90,60,-50,1124,1177,2301,5145
80,-90,180,1137,1164,2301,5030
170,-90,-90,1137,1164,2301,5030
80,-90,-180,1137,1164,2301,5030
140,-90,-120,1137,1164,2301,5030
-160,-90,-60,1137,1164,2301,5030
130,-90,-130,1137,1164,2301,5030
60,-90,160,1137,1164,2301,5030
-70,-90,30,1137,1164,2301,5030
0,-90,100,1137,1164,2301,5030
-150,-90,-50,1137,1164,2301,5030
20,-90,120,1137,1164,2301,5030
90,-90,-170,1137,1164,2301,5030
-90,-90,10,1137,1164,2301,5030
-60,-90,40,1137,1164,2301,5030
-40,-90,60,1137,1164,2301,5030
-140,-90,-40,1137,1164,2301,5030
140,50,-50,1135,1166,2301,5018
110,-90,-150,1137,1164,2301,5030
-40,-50,60,1114,1187,2301,5038
-100,-90,0,1137,1164,2301,5030
170,-20,-140,1132,1169,2301,5130
100,-90,-160,1137,1164,2301,5030
-120,50,-130,1097,1204,2301,5276
120,-90,-140,1137,1164,2301,5030
160,-40,-60,1116,1185,2301,5265
-30,-90,70,1137,1164,2301,5030
30,-90,130,1137,1164,2301,5030
150,-90,-110,1137,1164,2301,5030
-10,-90,90,1137,1164,2301,5030
180,-90,-80,1137,1164,2301,5030
-50,-90,50,1137,1164,2301,5030
50,-90,150,1137,1164,2301,5030
160,-90,-100,1137,1164,2301,5030
10,-90,110,1137,1164,2301,5030
70,-90,170,1137,1164,2301,5030
-180,-90,-80,1137,1164,2301,5030
130,-80,150,1106,1195,2301,5258
-110,-90,-10,1137,1164,2301,5030
160,50,-70,1134,1167,2301,4992
10,20,100,1133,1168,2301,5246
-130,-90,-30,1137,1164,2301,5030
120,80,-80,1136,1166,2302,5086
-60,80,110,1128,1174,2302,4981
30,50,0,1129,1173,2302,5147
-140,0,-110,1104,1198,2302,5053
-30,-70,70,1121,1181,2302,4942
90,-80,110,1104,1198,2302,5191
-40,70,90,1125,1177,2302,5047
-80,80,130,1127,1176,2303,4956
10,10,20,1115,1188,2303,5088
110,-80,-160,1133,1170,2303,4953
60,40,20,1114,1190,2304,5114
-10,50,130,1131,1173,2304,5273
120,40,-70,1131,1173,2304,5083
10,0,20,1113,1191,2304,5094
90,-70,150,1152,1152,2304,5028
30,10,60,1122,1182,2304,5123
-20,20,10,1120,1184,2304,5148
120,-80,140,1100,1205,2305,5245
-20,40,50,1123,1182,2305,5004
130,70,-20,1146,1159,2305,5116
50,-60,100,1125,1180,2305,5147
90,-70,110,1094,1211,2305,5261
-100,50,-170,1140,1165,2305,5194
-110,-40,10,1118,1187,2305,5243
140,-50,-100,1102,1203,2305,5029
80,-70,140,1143,1162,2305,5081
20,40,100,1119,1186,2305,5008
90,50,-40,1129,1177,2306,5021
-40,30,110,1149,1157,2306,5411
10,-10,50,1146,1160,2306,5083
30,20,50,1126,1180,2306,5046
-50,0,30,1117,1189,2306,5425
-30,-60,0,1095,1212,2307,5144
20,10,30,1113,1194,2307,5068
140,-40,-110,1111,1196,2307,5011
-30,30,130,1110,1197,2307,5304
-80,60,140,1105,1202,2307,5088
170,70,-130,1107,1201,2308,5026
-30,10,50,1128,1180,2308,4992
-120,-20,-30,1140,1168,2308,5172
10,80,30,1123,1185,2308,5096
50,30,50,1108,1200,2308,5269
30,-50,60,1110,1198,2308,5172
-140,-40,-120,1112,1196,2308,5131
-40,-80,70,1151,1157,2308,5147
-160,-10,-40,1147,1161,2308,5367
100,-80,120,1107,1201,2308,5256
130,30,-70,1130,1178,2308,5096
130,70,-90,1130,1179,2309,4969
-20,30,50,1136,1173,2309,5106
180,10,-50,1145,1164,2309,5300
-60,-60,-30,1139,1170,2309,5076
-100,80,150,1133,1176,2309,4978
40,-70,120,1139,1170,2309,5250
-20,40,80,1123,1186,2309,5120
30,-40,70,1131,1178,2309,5254
-180,10,-50,1145,1164,2309,5300
10,30,100,1120,1189,2309,5152
20,-80,50,1110,1199,2309,5113
140,70,-30,1146,1163,2309,5145
150,-40,-140,1123,1187,2310,5195
60,40,40,1110,1200,2310,5085
100,80,20,1112,1198,2310,5104
-10,-40,80,1148,1162,2310,5044
-40,70,160,1133,1177,2310,5189
-120,80,170,1140,1170,2310,4907
150,-60,-170,1116,1194,2310,5193
40,20,50,1120,1191,2311,5189
50,-60,70,1108,1203,2311,5161
-20,20,60,1140,1171,2311,5223
170,-60,-170,1095,1216,2311,5169
110,-70,180,1142,1169,2311,5220
-30,30,110,1153,1158,2311,5214
-40,-50,-10,1093,1218,2311,5090
-40,30,100,1147,1164,2311,5366
110,-70,-180,1142,1169,2311,5220
130,-80,-120,1155,1157,2312,5270
-10,10,80,1135,1177,2312,5123
-70,-70,50,1144,1168,2312,5238
-20,60,140,1128,1184,2312,5198
-80,-60,40,1130,1182,2312,5163
-140,40,-160,1128,1184,2312,5295
110,-70,130,1104,1208,2312,5197
120,60,-80,1123,1190,2313,5026
160,-80,180,1106,1207,2313,5140
160,-80,-180,1106,1207,2313,5140
-160,10,-70,1150,1163,2313,5095
-180,80,-60,1125,1188,2313,5063
-30,-10,0,1125,1188,2313,5249
160,40,-120,1131,1182,2313,5094
20,-50,60,1130,1183,2313,5059
140,-50,-140,1114,1199,2313,5343
180,80,-60,1125,1188,2313,5063
110,-80,130,1105,1208,2313,5264
120,40,-60,1129,1185,2314,5053
140,-70,160,1101,1213,2314,5346
-50,-30,50,1137,1177,2314,5283
140,50,-90,1139,1175,2314,5094
-150,20,-100,1139,1175,2314,5201
160,-70,-70,1152,1162,2314,5139
-20,-80,80,1130,1184,2314,5018
160,20,-50,1141,1173,2314,5100
90,-70,140,1141,1173,2314,5204
170,80,-50,1116,1199,2315,5016
-110,50,-160,1154,1161,2315,5301
140,-40,-120,1096,1219,2315,5026
-70,-60,-40,1134,1181,2315,5146
20,-60,50,1116,1199,2315,5171
170,-80,-170,1109,1206,2315,5063
0,10,90,1147,1168,2315,5236
-130,-20,-90,1147,1169,2316,5136
-180,30,-70,1148,1168,2316,5179
-10,30,120,1115,1201,2316,5160
-130,70,-170,1136,1180,2316,5047
-140,-20,-30,1148,1168,2316,5222
-60,50,130,1134,1182,2316,5282
60,50,-20,1137,1179,2316,5196
180,30,-70,1148,1168,2316,5179
-160,40,-90,1143,1173,2316,5209
120,-70,160,1131,1186,2317,5209
140,-80,160,1109,1208,2317,5285
70,50,-20,1136,1181,2317,5029
-40,0,10,1137,1180,2317,5407
-30,-80,70,1134,1183,2317,5061
-140,-10,-40,1155,1163,2318,5324
-130,80,180,1137,1181,2318,4976
-10,-80,20,1122,1196,2318,5047
40,-80,130,1135,1183,2318,5134
-130,80,-180,1137,1181,2318,4976
-170,40,-80,1135,1183,2318,5290
-30,60,80,1136,1182,2318,5164
-160,30,-90,1156,1162,2318,5324
140,-40,-100,1130,1188,2318,4876
70,50,40,1128,1191,2319,5120
-70,60,180,1142,1177,2319,5365
-40,-60,-10,1118,1201,2319,5094
-70,60,-180,1142,1177,2319,5365
100,70,-60,1144,1175,2319,5149
-60,-50,-30,1110,1209,2319,5199
150,40,-110,1139,1180,2319,5194
10,-10,30,1122,1198,2320,5162
-80,-70,-50,1122,1198,2320,5037
160,80,-40,1112,1208,2320,4986
150,30,-110,1155,1165,2320,5215
-90,50,180,1137,1183,2320,5194
150,-60,-160,1135,1185,2320,5169
-60,60,170,1143,1177,2320,5382
120,-70,150,1131,1189,2320,5215
-10,20,110,1155,1165,2320,5244
170,30,-130,1117,1203,2320,5085
-90,50,-180,1137,1183,2320,5194
-60,-30,-20,1146,1174,2320,5213
80,-70,100,1106,1215,2321,5290
0,40,120,1130,1191,2321,5258
80,50,-30,1130,1191,2321,5098
-20,30,60,1140,1181,2321,5277
30,20,40,1123,1198,2321,5143
0,0,30,1132,1190,2322,5213
160,-60,-170,1117,1205,2322,5144
0,-50,40,1138,1184,2322,5019
10,0,60,1140,1182,2322,5126
-20,10,70,1144,1178,2322,5194
160,10,-120,1143,1179,2322,5123
100,50,-50,1134,1188,2322,5041
160,-30,-140,1136,1186,2322,5323
140,20,-100,1134,1188,2322,5112
-80,70,-160,1145,1178,2323,5307
-50,80,100,1142,1181,2323,4967
-90,70,-150,1128,1195,2323,5136
70,80,50,1122,1201,2323,5090
-40,10,30,1144,1179,2323,5480
-150,-70,-130,1134,1189,2323,5274
-10,20,30,1139,1184,2323,5113
-130,-70,0,1116,1207,2323,5134
150,-80,170,1106,1217,2323,5218
-10,30,70,1150,1173,2323,5122
110,80,-70,1143,1181,2324,5143
-20,20,80,1159,1165,2324,5202
-10,-40,30,1129,1195,2324,5095
60,-70,80,1105,1219,2324,5168
-10,10,90,1153,1171,2324,5204
0,60,30,1160,1164,2324,5186
140,-60,-160,1122,1202,2324,5151
160,40,-60,1151,1173,2324,5265
-40,50,150,1160,1164,2324,5495
80,80,40,1121,1204,2325,5150
140,-70,-110,1125,1200,2325,5081
40,-50,70,1113,1212,2325,5166
-150,-30,-140,1126,1199,2325,5141
160,70,-120,1130,1195,2325,5175
20,-60,60,1142,1183,2325,5096
-170,30,-140,1117,1208,2325,5072
10,-40,60,1137,1188,2325,5149
100,-70,150,1140,1185,2325,5178
-140,20,-150,1126,1199,2325,5190
130,30,-80,1134,1191,2325,5111
-40,-60,60,1141,1185,2326,5120
-160,80,-80,1128,1198,2326,5170
-40,-10,50,1163,1163,2326,5247
-160,70,-150,1137,1189,2326,5055
-70,70,130,1137,1189,2326,4936
-10,10,30,1137,1189,2326,5258
100,80,-60,1135,1191,2326,5189
100,50,-30,1154,1172,2326,5059
-170,80,-70,1130,1196,2326,5141
-60,70,120,1144,1182,2326,4959
-50,-10,40,1151,1176,2327,5303
10,-10,60,1147,1180,2327,5124
0,30,110,1143,1185,2328,5325
170,-50,-160,1117,1211,2328,5191
0,-10,20,1138,1190,2328,5244
20,20,20,1122,1206,2328,5271
40,40,0,1110,1218,2328,5223
-10,-30,20,1122,1206,2328,5239
40,20,60,1100,1228,2328,5110
-70,50,160,1142,1187,2329,5327
110,50,-60,1122,1207,2329,5080
10,-20,60,1144,1185,2329,5138
110,-70,140,1146,1183,2329,5218
180,-40,-150,1134,1195,2329,5282
-180,-40,-150,1134,1195,2329,5282
70,-70,90,1109,1220,2329,5257
-30,20,100,1165,1164,2329,5432
-180,0,-140,1126,1203,2329,5175
10,-40,90,1152,1177,2329,5190
170,-70,-60,1159,1170,2329,5091
180,0,-140,1126,1203,2329,5175
-170,20,-140,1148,1182,2330,5011
-10,50,40,1151,1179,2330,5019
100,-70,160,1164,1166,2330,5150
-60,70,180,1148,1182,2330,5331
-60,70,-180,1148,1182,2330,5331
160,-50,-150,1128,1202,2330,5235
130,50,-80,1130,1201,2331,4969
50,-50,80,1114,1217,2331,5434
150,-20,-130,1131,1200,2331,5085
0,-40,50,1154,1177,2331,5184
40,40,80,1156,1175,2331,5159
130,20,-80,1132,1199,2331,5104
-150,80,-90,1132,1200,2332,5204
90,70,20,1125,1207,2332,5192
50,-70,120,1163,1169,2332,5237
110,50,-40,1159,1174,2333,5121
140,10,-50,1133,1200,2333,5238
150,-80,-90,1161,1172,2333,5425
60,70,60,1116,1217,2333,5223
140,-50,-110,1105,1228,2333,5066
140,-30,-90,1142,1191,2333,4947
160,0,-120,1140,1194,2334,5092
-80,-30,10,1148,1186,2334,5296
150,-30,-130,1135,1199,2334,5088
0,-30,40,1143,1191,2334,5136
140,50,-60,1166,1168,2334,4978
-120,80,-120,1149,1186,2335,5264
150,-40,-70,1136,1199,2335,5377
170,40,-70,1134,1201,2335,5147
110,50,-30,1140,1195,2335,5159
-20,20,90,1166,1169,2335,5265
130,-70,160,1135,1200,2335,5245
40,-60,100,1153,1182,2335,5150
30,20,70,1142,1193,2335,5126
-20,20,20,1113,1222,2335,5287
-20,20,40,1135,1200,2335,5212
90,-70,130,1137,1198,2335,5296
-90,60,160,1153,1182,2335,5173
-140,80,-170,1155,1180,2335,5034
-150,-90,-40,1157,1179,2336,5279
120,-90,-130,1157,1179,2336,5279
50,-90,160,1157,1179,2336,5279
140,10,-100,1148,1188,2336,5134
60,-90,170,1157,1179,2336,5279
80,50,-20,1144,1192,2336,5143
-170,-90,-60,1157,1179,2336,5279
-40,-90,70,1157,1179,2336,5279
-70,-90,40,1157,1179,2336,5279
-140,-30,-20,1143,1193,2336,5361
0,-90,110,1157,1179,2336,5279
130,-90,-120,1157,1179,2336,5279
-120,-90,-10,1157,1179,2336,5279
20,-90,130,1157,1179,2336,5279
-110,-90,0,1157,1179,2336,5279
140,-90,-110,1157,1179,2336,5279
40,-90,150,1157,1179,2336,5279
110,-90,-140,1157,1179,2336,5279
-140,-90,-30,1157,1179,2336,5279
-50,-90,60,1157,1179,2336,5279
170,-90,-80,1157,1179,2336,5279
80,-90,-170,1157,1179,2336,5279
-180,-90,-70,1157,1179,2336,5279
70,-90,-180,1157,1179,2336,5279
-160,-90,-50,1157,1179,2336,5279
-160,20,-90,1184,1152,2336,5253
-100,-90,10,1157,1179,2336,5279
-10,-90,100,1157,1179,2336,5279
-140,-30,-120,1145,1191,2336,5232
90,-90,-160,1157,1179,2336,5279
30,-90,140,1157,1179,2336,5279
100,-90,-150,1157,1179,2336,5279
30,60,0,1149,1187,2336,5160
180,-90,-70,1157,1179,2336,5279
10,-90,120,1157,1179,2336,5279
-80,-90,30,1157,1179,2336,5279
-130,-90,-20,1157,1179,2336,5279
180,-50,-50,1149,1187,2336,5240
-60,-90,50,1157,1179,2336,5279
150,-90,-100,1157,1179,2336,5279
-110,-50,-80,1135,1201,2336,5161
-180,-50,-50,1149,1187,2336,5240
-20,-90,90,1157,1179,2336,5279
-90,-90,20,1157,1179,2336,5279
70,-90,180,1157,1179,2336,5279
-30,-90,80,1157,1179,2336,5279
160,-90,-90,1157,1179,2336,5279
20,10,40,1135,1202,2337,5058
-20,50,70,1139,1198,2337,5174
-170,-30,-150,1115,1222,2337,5156
90,70,-50,1155,1182,2337,5200
50,30,40,1137,1200,2337,5153
110,-70,160,1141,1196,2337,5237
140,-60,-110,1129,1209,2338,5091
130,0,-80,1139,1199,2338,5210
50,-70,70,1103,1235,2338,5229
120,-80,-150,1154,1184,2338,5016
10,-50,90,1143,1195,2338,5111
140,-60,-100,1123,1215,2338,4972
-10,10,20,1112,1226,2338,5249
-70,70,-170,1157,1181,2338,5353
-20,-10,60,1149,1189,2338,5174
-120,-60,10,1136,1202,2338,5223
90,50,-30,1132,1206,2338,5247
-20,-40,20,1141,1197,2338,5221
90,60,10,1149,1189,2338,5314
40,40,10,1140,1198,2338,5188
-30,20,90,1158,1181,2339,5162
-110,80,-130,1139,1200,2339,5252
-20,-10,0,1133,1206,2339,5344
120,20,-70,1141,1198,2339,5363
-130,40,-140,1133,1206,2339,5087
-20,-40,10,1103,1236,2339,5180
-50,-10,10,1138,1201,2339,5561
-140,30,-110,1146,1193,2339,5252
-160,-70,-30,1156,1183,2339,5113
-130,80,-110,1141,1198,2339,5263
-60,-60,50,1168,1171,2339,5446
140,-60,-140,1139,1200,2339,5300
130,30,-90,1141,1199,2340,5214
-40,80,90,1135,1205,2340,5127
140,60,-50,1153,1187,2340,5198
-170,-40,-150,1131,1209,2340,5314
-140,10,-140,1141,1200,2341,5237
-70,-80,50,1169,1172,2341,5239
-170,10,-60,1145,1196,2341,5094
-150,0,-60,1162,1179,2341,5374
30,-50,70,1149,1192,2341,5293
-80,60,-170,1134,1207,2341,5326
-170,-30,-40,1141,1201,2342,5290
-40,-80,60,1146,1196,2342,5176
150,-70,-80,1164,1178,2342,5150
-30,70,150,1161,1181,2342,5159
140,-50,-130,1121,1221,2342,5082
40,-50,80,1121,1221,2342,5340
130,40,-80,1150,1192,2342,5105
0,-60,90,1150,1192,2342,5164
-50,-60,-20,1132,1210,2342,5132
140,0,-100,1128,1214,2342,5197
10,-70,50,1162,1180,2342,5169
-60,50,160,1152,1190,2342,5383
140,-10,-100,1120,1222,2342,5196
-20,30,70,1156,1186,2342,5229
140,40,-60,1142,1201,2343,5095
0,-20,30,1135,1208,2343,5343
-50,70,170,1145,1198,2343,5164
-170,50,-80,1143,1200,2343,5203
140,-20,-80,1146,1198,2344,5210
-140,0,-130,1140,1204,2344,5180
-130,60,-170,1132,1212,2344,5140
20,30,80,1155,1189,2344,5031
-150,-70,-20,1158,1186,2344,5112
20,80,20,1142,1202,2344,5235
70,-70,130,1164,1180,2344,5171
-150,-60,-130,1163,1181,2344,5213
10,-40,50,1152,1192,2344,5133
-150,-40,-20,1144,1200,2344,5508
10,-70,100,1146,1199,2345,5315
-130,-30,-100,1135,1210,2345,5247
10,10,70,1146,1199,2345,5335
-140,50,-160,1141,1204,2345,5262
140,-60,-150,1164,1181,2345,5325
80,70,-40,1160,1185,2345,5260
-10,10,10,1127,1218,2345,5255
90,80,-50,1141,1205,2346,5283
-50,-80,-20,1136,1210,2346,5268
30,-80,60,1110,1236,2346,5304
-10,-50,20,1138,1208,2346,5105
-130,-50,0,1132,1214,2346,5386
-80,60,150,1157,1189,2346,5268
80,60,-40,1146,1200,2346,5263
110,70,-70,1156,1190,2346,5133
150,50,-70,1172,1175,2347,5039
-160,0,-150,1119,1228,2347,5311
-170,30,-80,1145,1202,2347,5147
10,40,110,1139,1208,2347,5132
30,-60,60,1124,1223,2347,5344
20,50,10,1151,1196,2347,5315
60,80,60,1140,1207,2347,5165
-20,40,60,1168,1179,2347,5196
20,-70,60,1152,1195,2347,5149
-20,20,70,1152,1195,2347,5313
-20,30,80,1146,1201,2347,5253
50,-60,90,1140,1207,2347,5461
-170,10,-140,1168,1180,2348,5287
-20,-30,30,1177,1171,2348,5077
-10,-10,30,1138,1210,2348,5178
-40,40,140,1156,1192,2348,5265
-90,-50,30,1158,1190,2348,5228
-180,-70,-50,1160,1188,2348,5059
180,-70,-50,1160,1188,2348,5059
120,50,-70,1134,1214,2348,5122
60,50,60,1137,1212,2349,5440
-40,-70,60,1161,1188,2349,5242
130,60,-40,1153,1196,2349,5122
70,50,-10,1139,1210,2349,5111
-150,20,-150,1133,1216,2349,5327
-140,60,-160,1131,1219,2350,5107
-60,50,120,1159,1191,2350,5408
-140,-70,-10,1138,1212,2350,5132
60,50,-10,1144,1206,2350,5107
-110,-30,-20,1164,1186,2350,5262
-100,-30,-20,1166,1184,2350,5311
-20,50,80,1138,1213,2351,5241
100,-70,130,1162,1189,2351,5294
-110,50,-170,1155,1196,2351,5219
50,80,70,1154,1197,2351,5210
-140,70,-160,1141,1210,2351,5238
140,40,-70,1169,1182,2351,5044
120,10,-60,1135,1216,2351,5378
60,-60,90,1128,1224,2352,5370
160,20,-120,1139,1214,2353,5241
180,-40,-140,1154,1199,2353,5304
140,90,-20,1150,1203,2353,5189
-130,-30,-20,1157,1196,2353,5277
-110,90,-130,1150,1203,2353,5189
-150,90,-90,1150,1203,2353,5189
-10,0,10,1116,1237,2353,5318
100,90,20,1150,1203,2353,5189
30,80,10,1139,1214,2353,5263
180,90,-60,1150,1203,2353,5189
170,90,-50,1150,1203,2353,5189
-140,80,-100,1143,1210,2353,5271
-100,90,-140,1150,1203,2353,5189
-170,90,-70,1150,1203,2353,5189
-30,90,150,1150,1203,2353,5189
-10,90,130,1150,1203,2353,5189
-130,90,-110,1150,1203,2353,5189
110,90,10,1150,1203,2353,5189
-160,90,-80,1150,1203,2353,5189
-180,-40,-140,1154,1199,2353,5304
-150,40,-150,1169,1184,2353,5267
10,90,110,1150,1203,2353,5189
-180,90,-60,1150,1203,2353,5189
-20,90,140,1150,1203,2353,5189
30,90,90,1150,1203,2353,5189
60,90,60,1150,1203,2353,5189
90,90,30,1150,1203,2353,5189
130,90,-10,1150,1203,2353,5189
-170,60,-140,1139,1214,2353,5201
-120,90,-120,1150,1203,2353,5189
-20,10,60,1193,1160,2353,5170
20,90,100,1150,1203,2353,5189
160,90,-40,1150,1203,2353,5189
140,-10,-70,1166,1187,2353,5264
40,-60,90,1159,1194,2353,5337
150,90,-30,1150,1203,2353,5189
40,90,80,1150,1203,2353,5189
-60,90,-180,1150,1203,2353,5189
120,90,0,1150,1203,2353,5189
-70,90,-170,1150,1203,2353,5189
50,90,70,1150,1203,2353,5189
70,90,50,1150,1203,2353,5189
-140,90,-100,1150,1203,2353,5189
80,90,40,1150,1203,2353,5189
-60,90,180,1150,1203,2353,5189
0,90,120,1150,1203,2353,5189
-40,90,160,1150,1203,2353,5189
-50,90,170,1150,1203,2353,5189
-90,90,-150,1150,1203,2353,5189
-80,90,-160,1150,1203,2353,5189
-20,10,90,1183,1171,2354,5384
10,20,90,1158,1196,2354,5226
10,10,60,1158,1196,2354,5317
170,60,-60,1146,1208,2354,5382
90,50,-20,1160,1194,2354,5226
140,-70,-120,1150,1204,2354,4974
-10,20,90,1170,1184,2354,5246
140,-60,-130,1128,1226,2354,5123
-130,40,-120,1158,1196,2354,5296
-100,-60,-70,1158,1197,2355,5352
130,-70,170,1151,1204,2355,5301
-10,70,50,1157,1198,2355,5085
-20,70,140,1161,1194,2355,5212
-150,30,-100,1154,1201,2355,5366
-40,-80,-10,1132,1223,2355,5271
-20,-20,30,1160,1195,2355,5078
-10,-10,10,1130,1226,2356,5229
-10,-30,30,1163,1193,2356,5164
-10,0,20,1140,1216,2356,5148
-10,-30,40,1166,1190,2356,5285
0,20,100,1174,1182,2356,5422
-70,-60,40,1148,1208,2356,5187
-170,-70,-40,1169,1187,2356,5122
30,-80,120,1160,1197,2357,5118
70,70,-30,1163,1194,2357,5297
-160,0,-50,1170,1187,2357,5408
-30,50,90,1161,1196,2357,5260
150,-40,-130,1144,1213,2357,5389
-170,40,-140,1124,1233,2357,5151
-10,0,30,1145,1212,2357,5246
-150,80,-160,1160,1197,2357,5184
120,-70,-170,1170,1187,2357,5303
-80,-60,-50,1149,1208,2357,5267
-50,40,120,1175,1182,2357,5508
0,-50,80,1166,1191,2357,5281
150,60,-50,1169,1188,2357,5281
-80,-30,0,1166,1191,2357,5413
-120,50,-140,1134,1224,2358,5288
-30,-80,0,1139,1219,2358,5238
-100,60,170,1154,1204,2358,5247
10,30,20,1139,1219,2358,5341
40,80,0,1154,1204,2358,5285
-90,-40,-50,1158,1200,2358,5424
150,-10,-120,1145,1213,2358,5093
-10,-20,10,1152,1207,2359,5381
140,40,-90,1129,1230,2359,5084
140,-80,-120,1149,1210,2359,5134
140,-70,-130,1144,1215,2359,5282
-90,60,-160,1158,1201,2359,5326
130,-70,-150,1168,1191,2359,5203
-30,80,80,1146,1213,2359,5282
-150,50,-150,1146,1213,2359,5100
30,-70,60,1141,1218,2359,5345
-100,80,-140,1143,1216,2359,5305
-60,50,140,1172,1188,2360,5470
80,80,-40,1150,1210,2360,5295
-20,-20,0,1134,1226,2360,5330
20,20,70,1142,1218,2360,5265
-20,-20,60,1174,1186,2360,5282
10,40,20,1147,1213,2360,5362
-50,40,130,1152,1209,2361,5403
-10,-50,80,1178,1183,2361,5182
-80,-70,40,1169,1192,2361,5347
-150,10,-90,1150,1211,2361,5240
-20,30,90,1169,1192,2361,5288
-160,-20,-150,1116,1246,2362,5319
140,-30,-80,1135,1227,2362,5292
120,-70,170,1165,1197,2362,5267
-30,10,30,1170,1192,2362,5297
150,-70,170,1120,1242,2362,5412
150,40,-100,1148,1214,2362,5195
170,-30,-140,1149,1213,2362,5194
120,50,-40,1162,1200,2362,5181
140,-20,-90,1137,1225,2362,5143
-20,-10,30,1165,1198,2363,5317
30,30,20,1165,1198,2363,5277
-150,60,-150,1143,1220,2363,5079
130,40,-70,1156,1207,2363,5116
-10,20,100,1145,1218,2363,5387
-20,20,50,1180,1183,2363,5168
-40,-30,-10,1147,1217,2364,5508
-50,70,110,1150,1214,2364,5071
0,40,30,1173,1191,2364,5342
-70,60,130,1121,1243,2364,5263
140,60,-40,1167,1197,2364,5128
20,-50,70,1157,1207,2364,5364
-50,-50,-20,1128,1236,2364,5424
-30,70,80,1163,1201,2364,5146
-10,60,130,1154,1210,2364,5248
160,30,-120,1137,1227,2364,5254
-120,-90,-90,1130,1235,2365,5231
150,-90,-180,1130,1235,2365,5231
160,-90,-170,1130,1235,2365,5231
-50,-40,50,1175,1190,2365,5436
80,-90,110,1130,1235,2365,5231
-170,70,-140,1169,1196,2365,5224
-180,-90,-150,1130,1235,2365,5231
-150,0,-150,1143,1222,2365,5427
10,-90,40,1130,1235,2365,5231
-50,-90,-20,1130,1235,2365,5231
130,-90,160,1130,1235,2365,5231
70,-90,100,1130,1235,2365,5231
-40,-90,-10,1130,1235,2365,5231
-130,-90,-100,1130,1235,2365,5231
-60,-90,-30,1130,1235,2365,5231
180,-90,-150,1130,1235,2365,5231
120,-90,150,1130,1235,2365,5231
60,-90,90,1130,1235,2365,5231
-110,-90,-80,1130,1235,2365,5231
-100,-90,-70,1130,1235,2365,5231
-40,0,40,1170,1195,2365,5291
-90,-90,-60,1130,1235,2365,5231
30,-90,60,1130,1235,2365,5231
-20,-90,10,1130,1235,2365,5231
110,-90,140,1130,1235,2365,5231
170,-90,-160,1130,1235,2365,5231
40,-90,70,1130,1235,2365,5231
-170,-90,-140,1130,1235,2365,5231
140,-90,170,1130,1235,2365,5231
-140,-90,-110,1130,1235,2365,5231
0,-90,30,1130,1235,2365,5231
-170,-50,-40,1163,1202,2365,5209
-70,-90,-40,1130,1235,2365,5231
-80,-90,-50,1130,1235,2365,5231
100,-90,130,1130,1235,2365,5231
50,-90,80,1130,1235,2365,5231
-160,-90,-130,1130,1235,2365,5231
100,50,-40,1163,1202,2365,5256
90,-90,120,1130,1235,2365,5231
-150,-90,-120,1130,1235,2365,5231
-30,-90,0,1130,1235,2365,5231
150,-90,180,1130,1235,2365,5231
170,50,-70,1174,1191,2365,5305
170,-50,-150,1145,1220,2365,5220
20,-90,50,1130,1235,2365,5231
-10,-90,20,1130,1235,2365,5231
-10,-20,30,1164,1202,2366,5328
30,-70,110,1158,1208,2366,5280
-140,-10,-100,1153,1213,2366,5201
-50,40,110,1177,1189,2366,5485
-160,50,-90,1168,1198,2366,5353
30,40,90,1157,1209,2366,5205
0,-10,30,1152,1214,2366,5292
-10,-80,30,1158,1209,2367,5181
160,40,-70,1172,1195,2367,5170
60,40,30,1139,1228,2367,5301
150,-20,-60,1162,1205,2367,5305
20,20,60,1146,1221,2367,5364
-50,-70,60,1187,1180,2367,5293
-10,20,70,1170,1197,2367,5298
-30,30,120,1162,1205,2367,5529
-20,-80,10,1136,1232,2368,5160
-30,-40,30,1171,1197,2368,5172
-130,-10,-60,1183,1185,2368,5366
-90,-70,-60,1152,1216,2368,5108
-10,-60,80,1171,1197,2368,5289
-90,-60,-60,1146,1222,2368,5273
150,0,-50,1157,1211,2368,5173
140,-80,-110,1187,1181,2368,5379
0,-20,50,1175,1193,2368,5236
170,10,-120,1153,1216,2369,5130
-10,20,10,1137,1232,2369,5247
110,50,-50,1166,1203,2369,5236
150,60,-60,1167,1202,2369,5333
30,-60,100,1161,1208,2369,5276
-120,50,-170,1177,1192,2369,5348
-20,30,120,1157,1212,2369,5540
10,-50,60,1172,1197,2369,5317
130,50,-50,1172,1197,2369,5083
0,50,120,1145,1224,2369,5189
50,80,-10,1162,1207,2369,5340
-30,20,20,1154,1216,2370,5508
110,20,-60,1146,1224,2370,5484
80,50,10,1170,1200,2370,5263
150,70,-40,1166,1204,2370,5369
-140,-20,-120,1155,1215,2370,5286
80,-70,130,1169,1202,2371,5319
10,-60,90,1180,1191,2371,5339
20,60,10,1158,1213,2371,5286
-40,10,20,1162,1209,2371,5540
160,-20,-130,1142,1229,2371,5287
-180,-10,-140,1145,1226,2371,5266
150,20,-110,1162,1209,2371,5170
-10,-10,70,1194,1177,2371,5382
-20,-40,70,1162,1209,2371,5174
180,-10,-140,1145,1226,2371,5266
20,-40,80,1152,1220,2372,5309
10,20,80,1140,1232,2372,5229
150,-60,-80,1156,1216,2372,5270
-140,20,-120,1178,1194,2372,5439
150,-60,-110,1152,1220,2372,5156
-140,10,-130,1159,1213,2372,5299
10,-30,80,1176,1197,2373,5157
-140,0,-120,1164,1209,2373,5314
50,50,-10,1169,1205,2374,5452
90,-70,120,1167,1207,2374,5358
-30,-40,60,1199,1175,2374,5355
-60,-20,30,1163,1211,2374,5562
-50,-20,0,1175,1199,2374,5364
110,-70,170,1184,1191,2375,5267
140,-70,-180,1166,1209,2375,5421
10,50,20,1148,1227,2375,5349
180,30,-130,1162,1213,2375,5273
-180,-20,-140,1149,1226,2375,5411
100,60,-10,1172,1203,2375,5427
180,-20,-140,1149,1226,2375,5411
160,-80,-80,1176,1199,2375,5477
-80,-80,40,1178,1197,2375,5284
-180,30,-130,1162,1213,2375,5273
140,-70,180,1166,1209,2375,5421
10,60,20,1148,1228,2376,5381
180,40,-130,1144,1232,2376,5204
140,30,-80,1159,1217,2376,5210
-180,40,-130,1144,1232,2376,5204
150,-30,-70,1135,1241,2376,5401
-10,40,40,1160,1216,2376,5182
0,10,80,1163,1213,2376,5375
-120,-30,-20,1147,1229,2376,5261
70,50,0,1151,1225,2376,5262
40,80,80,1173,1203,2376,5345
-60,-80,-30,1159,1217,2376,5339
80,-70,120,1153,1223,2376,5424
-110,-30,-60,1188,1189,2377,5491
-140,-10,-90,1155,1222,2377,5279
-140,-10,-110,1154,1223,2377,5264
170,0,-120,1144,1233,2377,5036
-10,-10,20,1154,1223,2377,5116
160,-30,-60,1139,1238,2377,5358
-120,-20,-50,1179,1198,2377,5158
130,10,-80,1144,1233,2377,5434
120,50,-60,1157,1221,2378,5113
20,-50,90,1163,1215,2378,5215
150,-50,-110,1146,1232,2378,5259
130,-70,180,1183,1195,2378,5383
130,-70,-180,1183,1195,2378,5383
-160,-10,-150,1137,1241,2378,5345
-70,-40,30,1169,1209,2378,5513
120,50,-50,1168,1210,2378,5155
-10,-50,30,1152,1226,2378,5137
-30,10,40,1168,1211,2379,5240
160,-70,-180,1142,1237,2379,5379
160,-70,180,1142,1237,2379,5379
-20,-80,20,1167,1212,2379,5137
-140,10,-120,1176,1203,2379,5314
-10,-40,40,1175,1204,2379,5192
170,-10,-130,1153,1226,2379,5272
-20,-30,40,1176,1203,2379,5139
0,-80,40,1163,1216,2379,5244
0,50,30,1167,1212,2379,5293
150,-50,-140,1161,1219,2380,5318
-20,-40,30,1179,1201,2380,5228
130,20,-70,1155,1226,2381,5431
0,-80,90,1169,1212,2381,5339
-60,-40,40,1182,1199,2381,5335
170,-50,-60,1157,1224,2381,5294
-130,-60,0,1167,1214,2381,5405
-150,30,-150,1150,1231,2381,5428
160,30,-60,1161,1220,2381,5417
-30,50,140,1186,1195,2381,5498
130,-80,-140,1159,1223,2382,5074
-50,-80,60,1201,1181,2382,5421
160,-60,-150,1168,1214,2382,5434
180,60,-70,1153,1229,2382,5466
-180,60,-70,1153,1229,2382,5466
-70,-80,-40,1163,1219,2382,5373
10,-80,100,1172,1210,2382,5251
-80,-30,-10,1177,1205,2382,5396
170,-30,-50,1149,1233,2382,5435
150,40,-60,1162,1221,2383,5328
0,-70,40,1154,1229,2383,5119
150,40,-70,1187,1196,2383,5046
-140,-10,-120,1171,1212,2383,5339
-50,-80,50,1179,1204,2383,5327
0,10,30,1172,1211,2383,5188
80,50,0,1174,1209,2383,5037
-150,-30,-30,1175,1208,2383,5371
0,-20,60,1189,1194,2383,5297
-30,40,90,1162,1222,2384,5524
-120,-40,0,1172,1212,2384,5446
140,-70,170,1157,1227,2384,5375
140,-50,-90,1171,1213,2384,5405
-20,-70,20,1146,1239,2385,5219
130,20,-60,1162,1223,2385,5441
30,20,60,1152,1233,2385,5270
70,80,-30,1164,1221,2385,5350
-20,-10,20,1158,1227,2385,5279
-30,60,90,1164,1221,2385,5374
70,50,30,1159,1227,2386,5374
10,50,110,1165,1221,2386,5098
170,30,-80,1195,1192,2387,5213
0,-20,40,1187,1200,2387,5400
40,-80,70,1137,1250,2387,5378
-160,-70,-140,1153,1234,2387,5330
30,-50,80,1173,1214,2387,5346
-140,40,-110,1166,1221,2387,5364
170,10,-50,1193,1194,2387,5497
150,10,-110,1147,1240,2387,5255
-20,10,40,1192,1195,2387,5259
-100,-40,10,1182,1205,2387,5478
10,30,90,1173,1214,2387,5213
80,70,30,1143,1244,2387,5371
140,30,-60,1189,1198,2387,5271
60,50,0,1152,1236,2388,5127
40,30,50,1159,1229,2388,5270
-30,0,50,1180,1208,2388,5277
-80,-40,20,1173,1215,2388,5469
-130,-10,-50,1191,1197,2388,5533
40,30,60,1159,1229,2388,5266
30,-70,70,1176,1213,2389,5398
-10,0,40,1185,1204,2389,5263
-130,40,-160,1191,1198,2389,5458
-90,-30,-20,1174,1215,2389,5354
-160,80,-150,1188,1201,2389,5268
20,-80,110,1179,1210,2389,5246
10,0,40,1176,1214,2390,5330
-140,-60,-10,1176,1214,2390,5347
-160,-50,-30,1192,1198,2390,5375
-90,-40,10,1209,1181,2390,5369
-80,-80,-50,1164,1227,2391,5422
160,70,-50,1176,1215,2391,5479
0,20,80,1166,1225,2391,5458
-80,-50,30,1164,1227,2391,5311
-60,50,150,1178,1213,2391,5624
170,40,-80,1171,1220,2391,5321
30,-60,70,1172,1219,2391,5336
80,50,-10,1164,1227,2391,5419
-170,60,-80,1172,1219,2391,5423
10,-10,70,1143,1248,2391,5535
40,40,30,1157,1234,2391,5184
-50,-20,40,1197,1194,2391,5404
50,-60,80,1147,1245,2392,5324
10,0,70,1140,1252,2392,5532
150,-50,-130,1159,1233,2392,5539
10,0,30,1150,1242,2392,5430
-20,10,50,1200,1192,2392,5341
80,60,20,1182,1210,2392,5421
-150,-80,-110,1168,1224,2392,5281
-140,30,-150,1161,1231,2392,5431
-160,-80,-130,1147,1245,2392,5362
0,20,90,1162,1230,2392,5333
-140,50,-110,1153,1239,2392,5409
70,60,-30,1177,1215,2392,5432
180,-60,-160,1135,1258,2393,5388
40,-70,110,1194,1199,2393,5264
170,-80,-70,1187,1206,2393,5508
0,20,30,1160,1233,2393,5331
-30,-40,0,1140,1253,2393,5282
-90,-80,-60,1166,1227,2393,5454
-180,-60,-160,1135,1258,2393,5388
160,-60,-160,1149,1244,2393,5326
50,50,0,1164,1230,2394,5230
-130,-20,-30,1173,1221,2394,5399
60,80,-20,1164,1230,2394,5380
-130,40,-130,1169,1225,2394,5429
160,-40,-140,1169,1225,2394,5473
150,-80,-110,1171,1223,2394,5353
-170,50,-140,1141,1253,2394,5136
-100,-70,-70,1167,1227,2394,5145
-20,0,40,1171,1223,2394,5341
150,-60,-150,1179,1216,2395,5416
0,0,70,1153,1242,2395,5331
-140,20,-140,1165,1230,2395,5287
70,-70,120,1178,1217,2395,5441
10,20,60,1174,1221,2395,5307
-10,70,130,1171,1224,2395,5303
40,30,40,1166,1229,2395,5416
140,-70,-100,1170,1225,2395,5331
140,30,-70,1187,1208,2395,5310
0,20,60,1178,1218,2396,5266
-20,0,60,1182,1214,2396,5270
0,-50,50,1172,1224,2396,5320
150,30,-100,1160,1236,2396,5260
-30,-80,10,1166,1230,2396,5161
-20,0,20,1181,1215,2396,5567
-90,80,-150,1161,1235,2396,5390
-180,40,-80,1185,1212,2397,5363
-170,-40,-40,1180,1217,2397,5431
-90,-30,-30,1173,1224,2397,5475
180,40,-80,1185,1212,2397,5363
-50,-40,-20,1169,1228,2397,5687
-150,10,-150,1151,1246,2397,5312
160,40,-80,1177,1220,2397,5112
150,50,-100,1174,1224,2398,5337
0,60,120,1169,1229,2398,5344
180,-80,-60,1181,1217,2398,5511
-10,-80,80,1185,1213,2398,5449
-120,50,-160,1189,1209,2398,5586
10,20,70,1171,1227,2398,5321
-180,-80,-60,1181,1217,2398,5511
140,-10,-80,1178,1220,2398,5349
-20,80,70,1171,1228,2399,5462
140,30,-90,1175,1224,2399,5273
-20,60,70,1176,1223,2399,5438
-20,40,130,1168,1231,2399,5635
30,30,50,1158,1241,2399,5221
-10,10,40,1176,1224,2400,5306
-10,30,40,1183,1217,2400,5436
150,-20,-120,1159,1241,2400,5288
-180,50,-130,1152,1248,2400,5352
-170,-80,-140,1157,1243,2400,5395
180,50,-130,1152,1248,2400,5352
-10,-50,40,1172,1228,2400,5358
-10,60,50,1178,1222,2400,5356
-130,40,-150,1182,1218,2400,5465
-180,-70,-160,1151,1250,2401,5450
150,40,-90,1178,1223,2401,5282
180,-70,-160,1151,1250,2401,5450
-20,30,100,1186,1215,2401,5526
-120,-70,-90,1168,1233,2401,5347
30,-70,100,1202,1199,2401,5324
-30,30,100,1179,1222,2401,5581
-20,-50,70,1189,1213,2402,5360
10,0,50,1182,1220,2402,5333
-120,-80,0,1176,1226,2402,5491
40,-60,70,1149,1253,2402,5286
-100,-80,20,1188,1214,2402,5477
160,60,-60,1179,1223,2402,5490
0,-60,40,1179,1223,2402,5246
-110,-60,-80,1182,1221,2403,5394
110,60,-60,1153,1250,2403,5301
120,60,-30,1170,1233,2403,5188
60,-70,120,1192,1211,2403,5345
-30,30,90,1177,1226,2403,5643
130,50,-60,1171,1233,2404,5262
-50,60,160,1163,1241,2404,5517
50,70,70,1165,1239,2404,5377
0,-30,80,1163,1241,2404,5474
-20,-20,40,1193,1211,2404,5258
-10,-20,70,1195,1209,2404,5295
170,-70,-170,1156,1249,2405,5444
150,0,-110,1176,1229,2405,5299
-30,-20,20,1183,1222,2405,5415
170,-40,-140,1189,1216,2405,5322
-40,-80,0,1172,1233,2405,5155
-160,-60,-30,1180,1225,2405,5367
-150,-80,-120,1155,1250,2405,5287
150,-70,-110,1187,1219,2406,5209
140,-40,-90,1164,1242,2406,5308
0,70,40,1176,1230,2406,5329
-140,-50,-10,1173,1233,2406,5596
-10,-60,30,1158,1248,2406,5237
-10,-30,60,1196,1211,2407,5308
-70,60,140,1184,1223,2407,5355
140,40,-80,1173,1234,2407,5223
-150,-50,-130,1183,1224,2407,5297
-110,-70,-80,1164,1243,2407,5236
10,-80,50,1172,1235,2407,5352
-20,-40,40,1194,1213,2407,5281
-90,-80,30,1195,1212,2407,5391
150,-80,-100,1192,1215,2407,5405
90,-80,170,1176,1231,2407,5334
0,-20,70,1189,1219,2408,5354
80,-70,110,1167,1241,2408,5404
0,30,100,1201,1207,2408,5453
-10,20,40,1189,1219,2408,5436
50,40,60,1167,1241,2408,5295
30,30,80,1192,1216,2408,5364
-20,0,10,1176,1233,2409,5536
-110,-80,10,1183,1226,2409,5499
180,20,-130,1174,1235,2409,5320
-50,-80,-10,1170,1239,2409,5180
40,40,20,1176,1233,2409,5308
-150,10,-100,1194,1215,2409,5311
-180,20,-130,1174,1235,2409,5320
170,-60,-160,1154,1256,2410,5398
-20,-50,20,1166,1244,2410,5483
0,-10,70,1191,1219,2410,5233
120,-70,180,1187,1223,2410,5431
160,-10,-120,1161,1249,2410,5351
-170,-80,-50,1183,1227,2410,5506
-20,-50,40,1194,1216,2410,5355
120,-70,-180,1187,1223,2410,5431
0,70,120,1162,1248,2410,5401
40,-60,80,1181,1230,2411,5424
-30,-20,30,1190,1221,2411,5377
10,-40,80,1171,1240,2411,5274
30,30,60,1160,1251,2411,5281
140,-70,-170,1194,1217,2411,5499
-100,-80,-70,1164,1247,2411,5478
160,-60,-70,1179,1232,2411,5390
-160,-20,-40,1184,1228,2412,5407
-180,-30,-140,1184,1228,2412,5325
-10,-20,50,1181,1231,2412,5428
-150,-80,-30,1183,1229,2412,5510
180,-30,-140,1184,1228,2412,5325
-80,-30,-20,1183,1230,2413,5585
-100,-50,20,1189,1224,2413,5523
30,40,10,1162,1251,2413,5481
-50,-70,50,1183,1230,2413,5410
-10,20,80,1195,1219,2414,5447
180,60,-130,1183,1231,2414,5411
-10,-10,40,1174,1240,2414,5365
-140,-80,-100,1175,1239,2414,5298
10,-20,70,1172,1242,2414,5480
100,-80,-180,1174,1240,2414,5385
50,50,70,1176,1238,2414,5351
-10,-20,20,1171,1243,2414,5382
110,60,-20,1180,1234,2414,5302
-180,60,-130,1183,1231,2414,5411
100,-80,180,1174,1240,2414,5385
-140,-20,-110,1171,1244,2415,5361
-180,20,-70,1213,1202,2415,5424
-180,30,-80,1192,1223,2415,5277
0,-60,50,1185,1230,2415,5392
-170,0,-140,1189,1226,2415,5485
0,-10,40,1173,1242,2415,5467
-10,30,110,1183,1232,2415,5509
180,20,-70,1213,1202,2415,5424
-150,0,-70,1196,1219,2415,5436
20,30,20,1168,1247,2415,5549
-50,-60,50,1203,1212,2415,5402
-150,-60,-20,1192,1223,2415,5302
180,30,-80,1192,1223,2415,5277
30,-60,80,1199,1217,2416,5456
0,-70,90,1199,1217,2416,5383
-120,50,-150,1191,1225,2416,5492
20,50,100,1181,1235,2416,5356
-170,-60,-40,1190,1226,2416,5381
160,-50,-140,1198,1218,2416,5510
150,30,-60,1202,1214,2416,5297
0,90,50,1195,1222,2417,5465
110,90,-60,1195,1222,2417,5465
170,90,-120,1195,1222,2417,5465
-80,90,130,1195,1222,2417,5465
130,90,-80,1195,1222,2417,5465
70,-70,110,1175,1242,2417,5568
120,90,-70,1195,1222,2417,5465
-180,90,-130,1195,1222,2417,5465
160,90,-110,1195,1222,2417,5465
60,-70,110,1182,1235,2417,5549
100,90,-50,1195,1222,2417,5465
-60,90,110,1195,1222,2417,5465
40,90,10,1195,1222,2417,5465
-160,90,-150,1195,1222,2417,5465
-140,90,-170,1195,1222,2417,5465
-50,90,100,1195,1222,2417,5465
-30,90,80,1195,1222,2417,5465
-10,90,60,1195,1222,2417,5465
100,60,-50,1169,1248,2417,5336
70,90,-20,1195,1222,2417,5465
-20,90,70,1195,1222,2417,5465
-50,50,120,1170,1247,2417,5520
-120,90,170,1195,1222,2417,5465
-130,-80,-10,1189,1228,2417,5488
0,-60,80,1191,1226,2417,5346
-130,90,-180,1195,1222,2417,5465
-40,90,90,1195,1222,2417,5465
-90,90,140,1195,1222,2417,5465
-20,-20,20,1174,1243,2417,5125
180,90,-130,1195,1222,2417,5465
-130,90,180,1195,1222,2417,5465
-170,90,-140,1195,1222,2417,5465
80,90,-30,1195,1222,2417,5465
150,90,-100,1195,1222,2417,5465
60,90,-10,1195,1222,2417,5465
20,90,30,1195,1222,2417,5465
-30,-30,30,1182,1235,2417,5120
50,90,0,1195,1222,2417,5465
-100,90,150,1195,1222,2417,5465
140,90,-90,1195,1222,2417,5465
0,30,30,1194,1223,2417,5384
-110,90,160,1195,1222,2417,5465
90,90,-40,1195,1222,2417,5465
-70,90,120,1195,1222,2417,5465
10,90,40,1195,1222,2417,5465
-150,90,-160,1195,1222,2417,5465
30,90,20,1195,1222,2417,5465
120,20,-60,1184,1234,2418,5499
150,-70,180,1175,1243,2418,5419
-40,-40,-10,1166,1252,2418,5486
40,-70,70,1159,1259,2418,5482
-30,-50,40,1224,1194,2418,5253
150,-70,-180,1175,1243,2418,5419
-180,70,-130,1202,1216,2418,5408
-110,-80,-80,1177,1241,2418,5498
-20,-10,50,1180,1238,2418,5458
-40,-10,40,1193,1225,2418,5438
-30,0,40,1188,1230,2418,5340
120,60,-70,1166,1252,2418,5269
30,-60,90,1198,1220,2418,5379
180,70,-130,1202,1216,2418,5408
-10,-70,30,1167,1251,2418,5146
80,-80,160,1186,1233,2419,5341
10,-60,60,1176,1243,2419,5420
-90,-70,30,1174,1245,2419,5377
-20,-30,60,1185,1235,2420,5254
-140,20,-130,1185,1235,2420,5441
60,-80,140,1193,1227,2420,5321
170,30,-90,1189,1231,2420,5161
50,-70,100,1197,1224,2421,5518
-100,60,-160,1190,1231,2421,5777
-10,-20,60,1207,1214,2421,5295
-160,-80,-40,1191,1230,2421,5525
-90,70,160,1203,1218,2421,5352
-170,-50,-150,1166,1255,2421,5340
-10,80,60,1189,1233,2422,5464
-10,0,70,1208,1214,2422,5494
20,20,50,1193,1229,2422,5330
150,-70,-90,1180,1242,2422,5480
170,70,-60,1187,1235,2422,5572
60,70,-20,1175,1247,2422,5437
-100,60,-150,1178,1244,2422,5479
30,80,90,1193,1229,2422,5344
-20,-10,40,1196,1227,2423,5338
170,-50,-140,1189,1234,2423,5417
160,40,-110,1185,1238,2423,5421
-40,-10,10,1174,1249,2423,5398
-50,-50,50,1206,1217,2423,5549
-10,-30,50,1198,1225,2423,5413
150,10,-50,1183,1240,2423,5593
0,30,80,1187,1236,2423,5545
-10,10,70,1213,1210,2423,5302
50,-80,130,1199,1225,2424,5369
-30,0,10,1168,1256,2424,5644
-90,60,-170,1200,1224,2424,5658
160,30,-100,1166,1259,2425,5229
0,-40,80,1194,1231,2425,5425
20,-60,70,1192,1233,2425,5447
70,-80,150,1194,1231,2425,5316
-150,40,-100,1192,1233,2425,5529
20,80,100,1192,1234,2426,5445
-60,-80,50,1223,1203,2426,5599
-80,70,150,1190,1236,2426,5384
-40,70,100,1191,1235,2426,5318
130,50,-70,1193,1233,2426,5282
-130,-80,-100,1186,1240,2426,5452
30,30,30,1167,1259,2426,5210
-140,-80,-20,1190,1237,2427,5482
-20,-50,30,1191,1236,2427,5351
-20,10,10,1175,1252,2427,5449
130,60,-80,1180,1247,2427,5292
-60,-80,40,1208,1219,2427,5398
-10,-30,70,1191,1236,2427,5401
-30,-10,10,1202,1225,2427,5605
-30,-10,30,1185,1242,2427,5386
20,20,30,1181,1246,2427,5292
-40,-20,50,1217,1210,2427,5454
-80,80,-160,1172,1255,2427,5482
-10,40,70,1201,1226,2427,5223
40,30,70,1169,1259,2428,5345
-30,-30,10,1195,1233,2428,5460
-30,-30,0,1188,1240,2428,5435
-10,-40,50,1193,1235,2428,5439
20,-80,60,1176,1252,2428,5467
50,-70,90,1188,1240,2428,5541
-10,-20,40,1196,1233,2429,5321
-150,-20,-140,1164,1265,2429,5606
-10,30,60,1186,1243,2429,5356
170,20,-60,1201,1228,2429,5411
140,20,-60,1186,1244,2430,5486
160,40,-90,1188,1242,2430,5414
180,-50,-150,1177,1253,2430,5432
-40,60,150,1192,1238,2430,5575
-180,-50,-150,1177,1253,2430,5432
-180,-80,-150,1175,1256,2431,5534
-40,-20,0,1191,1240,2431,5441
20,70,20,1171,1260,2431,5600
-100,-40,-60,1179,1252,2431,5489
-20,-20,10,1169,1262,2431,5483
160,-80,-100,1201,1230,2431,5446
-30,-50,60,1186,1245,2431,5456
180,-80,-150,1175,1256,2431,5534
140,50,-80,1188,1243,2431,5204
-10,-40,70,1191,1240,2431,5374
20,-60,90,1201,1230,2431,5478
60,60,60,1184,1247,2431,5498
10,80,110,1185,1247,2432,5476
30,70,90,1190,1242,2432,5358
0,-10,60,1199,1233,2432,5388
-170,0,-50,1200,1232,2432,5544
-80,60,180,1205,1227,2432,5607
140,-10,-90,1168,1264,2432,5450
40,50,0,1183,1249,2432,5632
-80,60,-180,1205,1227,2432,5607
170,40,-90,1191,1241,2432,5341
130,10,-70,1171,1261,2432,5623
-120,-80,-90,1190,1242,2432,5497
-110,-80,-70,1200,1232,2432,5314
20,20,40,1198,1235,2433,5441
-30,0,30,1183,1250,2433,5364
30,30,70,1185,1248,2433,5354
-180,10,-130,1190,1243,2433,5316
-80,-40,-40,1204,1229,2433,5561
60,-70,100,1175,1258,2433,5668
-40,40,100,1187,1246,2433,5727
180,10,-130,1190,1243,2433,5316
10,70,110,1180,1254,2434,5473
10,10,30,1184,1250,2434,5464
0,30,90,1182,1252,2434,5420
-130,-80,-90,1185,1249,2434,5333
-20,-60,40,1209,1225,2434,5497
50,-80,80,1151,1283,2434,5481
60,60,-20,1194,1240,2434,5557
130,-70,-160,1211,1223,2434,5510
-40,40,110,1195,1239,2434,5745
-80,80,140,1211,1224,2435,5338
-130,50,-120,1160,1275,2435,5546
-160,-70,-130,1172,1263,2435,5468
110,-80,-170,1177,1258,2435,5519
20,-70,90,1205,1231,2436,5302
20,70,100,1187,1249,2436,5410
-150,-40,-130,1199,1237,2436,5395
160,-30,-130,1164,1273,2437,5476
0,80,120,1192,1245,2437,5524
20,-50,80,1182,1255,2437,5498
160,-80,-90,1213,1224,2437,5461
20,30,60,1201,1236,2437,5570
150,-70,-160,1211,1226,2437,5583
-60,-30,30,1205,1232,2437,5617
-60,-80,-20,1184,1253,2437,5211
-100,-30,-40,1226,1212,2438,5527
150,-10,-110,1177,1261,2438,5286
-160,40,-140,1176,1262,2438,5357
150,-30,-120,1179,1259,2438,5443
-130,-40,-100,1205,1233,2438,5469
10,30,60,1203,1235,2438,5409
-10,40,60,1177,1261,2438,5532
150,30,-90,1199,1239,2438,5346
150,-20,-70,1188,1250,2438,5524
170,30,-100,1191,1247,2438,5334
10,10,50,1206,1233,2439,5346
-70,80,130,1200,1239,2439,5383
-10,-10,60,1215,1224,2439,5337
-20,-30,10,1185,1254,2439,5490
-10,-50,50,1206,1233,2439,5448
160,20,-100,1186,1254,2440,5441
180,-90,-140,1192,1248,2440,5535
0,20,70,1195,1245,2440,5536
-80,-90,-40,1192,1248,2440,5535
-10,-90,30,1192,1248,2440,5535
-170,-90,-130,1192,1248,2440,5535
20,-90,60,1192,1248,2440,5535
50,-90,90,1192,1248,2440,5535
110,-90,150,1192,1248,2440,5535
0,30,70,1178,1262,2440,5377
0,-90,40,1192,1248,2440,5535
-70,-90,-30,1192,1248,2440,5535
-130,-90,-90,1192,1248,2440,5535
-180,-90,-140,1192,1248,2440,5535
150,-90,-170,1192,1248,2440,5535
-60,-90,-20,1192,1248,2440,5535
10,-90,50,1192,1248,2440,5535
-120,-90,-80,1192,1248,2440,5535
70,-90,110,1192,1248,2440,5535
140,-90,180,1192,1248,2440,5535
120,-90,160,1192,1248,2440,5535
140,-90,-180,1192,1248,2440,5535
-150,-90,-110,1192,1248,2440,5535
100,-90,140,1192,1248,2440,5535
-140,-90,-100,1192,1248,2440,5535
40,-90,80,1192,1248,2440,5535
-90,-90,-50,1192,1248,2440,5535
170,-90,-150,1192,1248,2440,5535
-30,-90,10,1192,1248,2440,5535
-100,-80,-60,1206,1234,2440,5287
90,-90,130,1192,1248,2440,5535
30,-90,70,1192,1248,2440,5535
-160,-90,-120,1192,1248,2440,5535
160,-90,-160,1192,1248,2440,5535
50,50,20,1183,1257,2440,5261
60,-90,100,1192,1248,2440,5535
-20,-70,70,1205,1235,2440,5450
-40,-90,0,1192,1248,2440,5535
140,-70,-140,1177,1263,2440,5373
-100,-90,-60,1192,1248,2440,5535
80,-90,120,1192,1248,2440,5535
-50,-90,-10,1192,1248,2440,5535
130,-90,170,1192,1248,2440,5535
-20,-90,20,1192,1248,2440,5535
-110,-90,-70,1192,1248,2440,5535
-130,60,-160,1203,1238,2441,5432
-170,-70,-150,1175,1266,2441,5367
-40,60,100,1191,1250,2441,5351
-30,40,100,1191,1250,2441,5709
-160,30,-140,1186,1255,2441,5436
-50,60,110,1187,1254,2441,5394
10,80,40,1205,1236,2441,5424
-50,-70,-10,1175,1266,2441,5350
-40,50,100,1209,1232,2441,5491
-90,-80,-50,1206,1235,2441,5276
-30,-50,20,1170,1271,2441,5445
0,80,50,1204,1238,2442,5436
10,-30,70,1195,1247,2442,5481
-100,70,170,1215,1227,2442,5311
70,50,10,1192,1250,2442,5245
-20,-30,50,1215,1227,2442,5397
-70,-80,-30,1186,1256,2442,5231
-60,80,120,1209,1233,2442,5382
60,50,10,1174,1268,2442,5176
-140,-80,-110,1182,1260,2442,5346
10,70,30,1190,1253,2443,5502
70,70,40,1166,1277,2443,5529
-20,-80,70,1205,1238,2443,5514
-150,-50,-20,1209,1234,2443,5652
-110,-50,10,1212,1231,2443,5663
30,40,20,1183,1260,2443,5363
-30,-10,20,1203,1241,2444,5604
-100,80,160,1214,1230,2444,5378
-90,-60,30,1200,1244,2444,5602
-70,-30,-20,1205,1239,2444,5527
-20,-20,50,1204,1240,2444,5478
-120,60,-170,1197,1247,2444,5410
-50,50,110,1192,1252,2444,5693
-120,-80,-80,1200,1244,2444,5352
-130,-70,-100,1195,1250,2445,5493
160,20,-110,1194,1251,2445,5307
20,-70,100,1205,1240,2445,5524
-50,50,150,1204,1241,2445,5616
50,40,50,1194,1251,2445,5376
-160,-80,-120,1190,1255,2445,5397
-20,-60,70,1207,1238,2445,5345
10,20,50,1217,1229,2446,5466
-70,-30,20,1222,1224,2446,5732
40,70,80,1191,1255,2446,5425
0,10,70,1166,1280,2446,5474
-30,-20,0,1190,1256,2446,5726
140,-80,-130,1182,1264,2446,5321
60,-80,90,1159,1287,2446,5560
-70,80,-170,1178,1269,2447,5508
50,40,40,1198,1249,2447,5349
-20,80,140,1193,1254,2447,5637
10,-70,80,1216,1231,2447,5332
-10,80,130,1193,1254,2447,5561
40,-70,80,1195,1252,2447,5447
-160,-40,-140,1195,1253,2448,5612
0,0,40,1179,1269,2448,5465
50,50,10,1174,1274,2448,5302
-110,60,180,1202,1247,2449,5463
-110,60,-180,1202,1247,2449,5463
70,-70,100,1186,1263,2449,5550
-40,40,120,1212,1237,2449,5723
-20,30,110,1212,1237,2449,5663
-120,-50,-90,1202,1248,2450,5501
-170,80,-140,1221,1229,2450,5424
-10,-70,80,1214,1236,2450,5508
-90,80,150,1216,1235,2451,5363
-110,-40,0,1210,1241,2451,5550
-70,-80,30,1225,1226,2451,5516
-30,-70,10,1180,1271,2451,5278
40,-80,120,1206,1245,2451,5456
-70,60,170,1200,1251,2451,5610
-30,-50,10,1180,1271,2451,5438
150,-30,-80,1174,1278,2452,5471
-180,-60,-50,1229,1223,2452,5416
-100,-30,-30,1213,1239,2452,5601
-10,30,90,1204,1248,2452,5446
180,-60,-50,1229,1223,2452,5416
-40,0,30,1185,1267,2452,5666
-80,-80,-40,1199,1253,2452,5240
160,-70,-170,1196,1256,2452,5532
-20,0,50,1202,1251,2453,5470
0,-70,70,1226,1227,2453,5411
150,50,-80,1207,1246,2453,5375
-20,-30,20,1188,1265,2453,5452
-170,-70,-140,1180,1273,2453,5550
-120,-60,-90,1229,1225,2454,5311
160,30,-110,1194,1260,2454,5409
-60,60,130,1202,1252,2454,5555
-160,60,-90,1186,1268,2454,5571
150,-60,-90,1201,1253,2454,5331
20,40,90,1225,1229,2454,5377
150,-70,-100,1218,1236,2454,5293
0,-10,50,1197,1257,2454,5537
90,60,-40,1190,1265,2455,5338
-30,-10,50,1212,1243,2455,5676
50,-70,110,1209,1246,2455,5508
-170,30,-90,1225,1231,2456,5454
150,-20,-110,1186,1270,2456,5419
150,-50,-100,1190,1266,2456,5505
-10,-50,70,1215,1241,2456,5489
-60,60,120,1166,1290,2456,5470
-60,-70,50,1229,1228,2457,5669
-110,60,-140,1185,1272,2457,5571
170,-60,-60,1218,1239,2457,5538
-30,-30,50,1197,1260,2457,5616
10,-70,90,1206,1251,2457,5489
170,10,-110,1183,1275,2458,5226
150,-30,-110,1218,1240,2458,5406
-30,-70,60,1217,1242,2459,5494
-30,-40,10,1181,1278,2459,5341
-30,-40,40,1213,1246,2459,5352
30,30,40,1198,1261,2459,5449
140,50,-70,1199,1260,2459,5352
-20,40,90,1203,1257,2460,5509
30,70,10,1191,1269,2460,5648
-70,70,140,1200,1260,2460,5382
40,-80,80,1205,1255,2460,5631
150,-60,-100,1218,1243,2461,5340
60,-70,90,1185,1276,2461,5591
-50,80,110,1213,1248,2461,5549
-170,20,-80,1206,1255,2461,5408
-30,10,20,1199,1262,2461,5733
-110,-40,-70,1197,1265,2462,5382
0,-30,60,1212,1250,2462,5425
-30,-40,20,1190,1272,2462,5526
-130,-60,-100,1214,1248,2462,5378
20,30,70,1187,1275,2462,5633
-170,-10,-140,1204,1259,2463,5439
160,10,-50,1208,1255,2463,5762
-20,50,130,1200,1263,2463,5701
150,-70,-120,1185,1278,2463,5500
-30,-20,10,1199,1264,2463,5522
-130,-20,-80,1200,1263,2463,5551
-10,30,80,1206,1257,2463,5560
40,50,80,1197,1266,2463,5517
-20,-40,60,1211,1252,2463,5444
160,30,-70,1218,1245,2463,5368
160,-10,-50,1203,1260,2463,5673
170,-20,-130,1200,1263,2463,5565
110,70,-10,1226,1237,2463,5654
-20,-40,50,1219,1244,2463,5473
-20,-60,20,1195,1268,2463,5404
40,-70,90,1227,1237,2464,5600
140,60,-90,1216,1248,2464,5517
120,-80,-160,1181,1283,2464,5585
150,-70,-170,1207,1257,2464,5717
160,50,-110,1200,1264,2464,5429
50,-80,90,1208,1256,2464,5600
-60,-50,40,1232,1232,2464,5520
170,20,-120,1200,1264,2464,5395
-170,-30,-140,1187,1277,2464,5506
-20,-10,10,1202,1263,2465,5570
0,10,60,1194,1271,2465,5481
-20,-50,50,1235,1230,2465,5593
10,-60,80,1220,1245,2465,5384
-110,70,-180,1218,1247,2465,5294
-40,-30,50,1260,1205,2465,5535
-110,70,180,1218,1247,2465,5294
30,-80,70,1211,1255,2466,5606
170,-60,-150,1201,1265,2466,5505
90,70,10,1212,1254,2466,5458
-160,-50,-140,1196,1270,2466,5546
-30,40,130,1211,1255,2466,5744
-60,70,130,1198,1269,2467,5485
180,-50,-140,1193,1274,2467,5587
20,80,30,1222,1245,2467,5434
150,-50,-80,1203,1264,2467,5639
-180,-50,-140,1193,1274,2467,5587
170,30,-70,1211,1256,2467,5545
180,80,-130,1225,1242,2467,5502
70,50,20,1211,1256,2467,5561
-180,80,-130,1225,1242,2467,5502
150,20,-100,1199,1268,2467,5550
-30,70,90,1214,1253,2467,5505
150,-40,-110,1215,1252,2467,5422
0,30,60,1196,1272,2468,5381
-150,50,-100,1197,1271,2468,5539
-150,70,-150,1208,1260,2468,5480
60,50,50,1186,1282,2468,5464
160,0,-50,1218,1250,2468,5574
-10,0,60,1228,1240,2468,5475
-30,60,140,1213,1255,2468,5641
-150,-70,-120,1199,1269,2468,5565
-30,-60,60,1212,1256,2468,5455
50,70,-10,1200,1268,2468,5481
10,60,110,1182,1286,2468,5628
170,70,-120,1218,1251,2469,5643
40,-70,100,1232,1237,2469,5606
-10,-60,70,1209,1260,2469,5646
10,-50,80,1200,1269,2469,5544
160,50,-80,1229,1240,2469,5381
-50,-30,-10,1213,1256,2469,5738
70,60,40,1197,1273,2470,5463
-30,-50,30,1214,1256,2470,5512
10,30,70,1201,1269,2470,5501
-20,70,70,1205,1265,2470,5471
-60,80,-180,1193,1277,2470,5576
150,40,-80,1212,1258,2470,5152
-60,80,180,1193,1277,2470,5576
70,-80,100,1181,1289,2470,5634
170,-80,-160,1193,1277,2470,5610
0,40,60,1202,1269,2471,5593
10,-70,60,1206,1265,2471,5710
-140,30,-140,1205,1266,2471,5382
40,70,0,1188,1283,2471,5624
170,50,-120,1204,1267,2471,5653
-180,-20,-130,1195,1276,2471,5499
180,-20,-130,1195,1276,2471,5499
170,-80,-80,1238,1233,2471,5537
160,-20,-120,1205,1266,2471,5572
-140,-10,-80,1191,1280,2471,5492
-10,-10,50,1215,1256,2471,5452
-150,-10,-140,1192,1279,2471,5667
-70,-80,40,1244,1228,2472,5642
110,60,-30,1206,1266,2472,5475
-170,-80,-130,1197,1275,2472,5576
-30,-40,50,1225,1247,2472,5629
100,70,0,1221,1251,2472,5566
140,20,-90,1203,1269,2472,5514
-120,-20,-40,1225,1247,2472,5553
-110,80,170,1241,1231,2472,5481
-10,10,50,1220,1252,2472,5500
0,40,70,1210,1262,2472,5400
-20,60,80,1214,1258,2472,5459
-130,50,-160,1243,1230,2473,5548
-140,30,-120,1200,1273,2473,5615
170,-20,-50,1179,1294,2473,5501
160,60,-70,1217,1256,2473,5486
20,40,80,1218,1255,2473,5470
10,-40,70,1190,1283,2473,5588
140,20,-70,1226,1247,2473,5529
150,50,-90,1192,1282,2474,5544
-40,40,130,1210,1264,2474,5781
-20,10,20,1188,1286,2474,5670
70,60,30,1223,1251,2474,5582
-120,70,-170,1222,1252,2474,5456
-40,80,160,1198,1276,2474,5591
130,-70,-170,1213,1261,2474,5577
150,-60,-120,1186,1288,2474,5601
-40,-70,0,1183,1291,2474,5323
0,-40,60,1241,1233,2474,5411
40,40,40,1197,1278,2475,5465
-20,-60,30,1229,1246,2475,5531
50,-70,80,1180,1295,2475,5558
50,60,-10,1195,1280,2475,5579
-30,-60,10,1207,1268,2475,5594
-10,0,50,1220,1255,2475,5425
-10,30,100,1238,1237,2475,5644
-160,10,-140,1220,1256,2476,5650
-10,30,50,1208,1268,2476,5568
120,60,-60,1192,1284,2476,5458
170,60,-120,1221,1255,2476,5676
120,70,-20,1225,1251,2476,5712
10,40,100,1221,1255,2476,5446
-10,40,120,1228,1249,2477,5771
-160,-60,-140,1198,1279,2477,5598
-60,-70,-20,1197,1280,2477,5374
0,-70,50,1215,1262,2477,5637
30,80,20,1225,1252,2477,5414
-130,-40,-10,1227,1250,2477,5689
-180,-70,-140,1188,1290,2478,5794
-170,-20,-140,1208,1270,2478,5421
40,40,50,1203,1275,2478,5352
-140,-70,-110,1211,1267,2478,5584
-140,50,-150,1237,1241,2478,5630
-10,40,50,1198,1280,2478,5641
180,-70,-140,1188,1290,2478,5794
150,-50,-90,1199,1279,2478,5371
-30,-60,30,1221,1258,2479,5538
-10,50,80,1230,1249,2479,5499
-50,80,170,1202,1277,2479,5594
-10,40,80,1215,1264,2479,5380
30,-80,110,1215,1264,2479,5443
110,60,-50,1195,1285,2480,5472
-30,-10,40,1225,1255,2480,5571
170,60,-70,1204,1276,2480,5642
-60,-20,10,1214,1266,2480,5808
150,-20,-80,1211,1269,2480,5533
-10,-60,60,1231,1249,2480,5583
170,50,-80,1213,1267,2480,5506
30,40,50,1216,1265,2481,5506
-140,40,-150,1222,1259,2481,5620
-160,60,-140,1215,1266,2481,5443
130,10,-60,1226,1255,2481,5685
-180,-80,-140,1208,1273,2481,5675
180,-80,-140,1208,1273,2481,5675
0,60,40,1205,1276,2481,5601
-60,60,160,1204,1277,2481,5690
-60,-70,40,1219,1262,2481,5589
60,-80,130,1231,1251,2482,5459
160,-80,-160,1209,1273,2482,5797
-30,80,150,1207,1275,2482,5606
30,40,60,1234,1248,2482,5492
140,0,-90,1203,1279,2482,5548
150,30,-80,1187,1295,2482,5354
10,30,30,1212,1270,2482,5788
150,30,-70,1220,1263,2483,5358
120,60,-40,1213,1270,2483,5463
70,-80,110,1214,1269,2483,5676
-140,-60,-110,1212,1271,2483,5533
170,-80,-90,1231,1252,2483,5526
-70,60,150,1214,1270,2484,5591
-90,60,180,1223,1261,2484,5802
-90,60,-180,1223,1261,2484,5802
-10,-60,40,1227,1257,2484,5660
-170,-60,-150,1193,1291,2484,5579
170,-70,-160,1204,1280,2484,5662
-160,10,-80,1218,1266,2484,5697
170,-60,-140,1221,1263,2484,5660
-100,-70,-60,1199,1286,2485,5407
160,-40,-130,1201,1284,2485,5742
130,60,-50,1220,1265,2485,5391
160,-70,-80,1223,1262,2485,5543
-30,-20,50,1217,1268,2485,5749
-180,0,-130,1209,1277,2486,5591
30,50,90,1229,1257,2486,5685
180,0,-130,1209,1277,2486,5591
150,-40,-100,1220,1266,2486,5515
-50,-30,40,1237,1249,2486,5664
150,-40,-90,1205,1281,2486,5493
-40,80,100,1226,1260,2486,5605
130,70,-30,1234,1252,2486,5739
-70,-30,0,1220,1267,2487,5812
160,30,-90,1210,1277,2487,5426
-170,-70,-130,1194,1293,2487,5716
160,-80,-170,1199,1288,2487,5685
-80,-80,30,1249,1238,2487,5637
10,-50,70,1206,1281,2487,5589
-10,20,50,1236,1251,2487,5579
180,-60,-150,1194,1294,2488,5614
-150,0,-140,1193,1295,2488,5726
180,-70,-150,1193,1295,2488,5577
180,-30,-130,1219,1269,2488,5577
-40,-20,40,1231,1257,2488,5651
-180,-30,-130,1219,1269,2488,5577
60,-80,100,1220,1268,2488,5716
-180,-70,-150,1193,1295,2488,5577
160,-70,-150,1220,1268,2488,5801
-50,-10,30,1203,1285,2488,5757
-80,-60,30,1215,1273,2488,5462
-180,-60,-150,1194,1294,2488,5614
90,60,0,1224,1265,2489,5704
70,-80,140,1236,1253,2489,5488
20,30,50,1217,1272,2489,5592
-160,20,-140,1206,1283,2489,5591
-20,-50,60,1227,1263,2490,5602
-10,50,50,1202,1288,2490,5524
-10,-70,60,1233,1257,2490,5502
-180,-70,-130,1235,1255,2490,5777
180,-70,-130,1235,1255,2490,5777
20,-80,100,1219,1271,2490,5462
-50,50,130,1238,1252,2490,5689
0,-70,80,1224,1266,2490,5443
-100,-70,20,1209,1282,2491,5468
170,-80,-150,1205,1286,2491,5753
-160,20,-100,1238,1253,2491,5473
80,-80,110,1197,1294,2491,5689
150,-60,-130,1192,1299,2491,5652
150,-60,-140,1217,1274,2491,5601
-10,50,60,1232,1260,2492,5679
150,-80,-120,1219,1273,2492,5502
-140,-10,-70,1221,1271,2492,5666
10,40,90,1209,1283,2492,5474
-100,-40,0,1228,1264,2492,5638
20,40,20,1226,1266,2492,5780
150,-40,-120,1216,1276,2492,5626
180,-40,-50,1216,1276,2492,5568
-180,-40,-50,1216,1276,2492,5568
0,-50,60,1227,1265,2492,5597
180,50,-80,1228,1265,2493,5619
160,40,-100,1209,1284,2493,5425
0,-60,70,1239,1254,2493,5392
-180,50,-80,1228,1265,2493,5619
140,0,-60,1209,1284,2493,5637
110,-80,150,1206,1287,2493,5863
50,40,30,1221,1272,2493,5615
-170,10,-70,1234,1259,2493,5355
40,80,10,1238,1256,2494,5565
100,60,-20,1211,1283,2494,5526
-30,-80,60,1224,1270,2494,5596
-40,-50,0,1167,1328,2495,5444
20,-60,80,1224,1271,2495,5601
-120,60,-130,1206,1289,2495,5746
-70,-70,-30,1216,1279,2495,5414
-150,-70,-110,1215,1281,2496,5437
20,-70,70,1236,1260,2496,5741
50,-80,120,1249,1247,2496,5489
40,50,10,1211,1285,2496,5505
80,-80,120,1215,1281,2496,5714
-60,-60,40,1231,1266,2497,5613
-180,-60,-140,1224,1273,2497,5748
-140,-30,-110,1220,1277,2497,5482
-160,-70,-120,1207,1290,2497,5538
80,-80,150,1230,1267,2497,5536
180,-60,-140,1224,1273,2497,5748
100,60,-40,1204,1293,2497,5519
-150,60,-100,1202,1295,2497,5561
0,40,80,1209,1288,2497,5687
-80,-80,20,1232,1265,2497,5645
180,30,-90,1232,1266,2498,5492
-90,-80,20,1247,1251,2498,5648
-180,30,-90,1232,1266,2498,5492
10,70,40,1232,1266,2498,5616
-70,-50,30,1229,1270,2499,5609
-30,-60,20,1243,1256,2499,5375
-20,40,120,1235,1264,2499,5883
170,80,-120,1236,1263,2499,5621
150,20,-60,1244,1255,2499,5773
-30,-50,50,1247,1252,2499,5600
-10,-60,50,1255,1245,2500,5624
30,-80,100,1248,1252,2500,5554
170,-70,-140,1234,1266,2500,5820
170,-10,-120,1221,1279,2500,5460
140,20,-80,1207,1293,2500,5638
-160,30,-100,1246,1254,2500,5521
40,50,20,1216,1284,2500,5627
160,-60,-140,1248,1253,2501,5701
150,-80,180,1198,1303,2501,5703
-180,-60,-130,1243,1258,2501,5800
180,-60,-130,1243,1258,2501,5800
170,-50,-130,1258,1243,2501,5534
150,-80,-180,1198,1303,2501,5703
-110,60,-150,1222,1279,2501,5834
-140,60,-150,1214,1287,2501,5440
-170,-60,-140,1203,1298,2501,5561
0,-50,70,1241,1261,2502,5590
-40,50,110,1215,1287,2502,5775
-140,30,-130,1237,1265,2502,5606
0,0,50,1215,1287,2502,5687
140,0,-70,1235,1267,2502,5754
180,-10,-130,1223,1279,2502,5655
40,-80,110,1247,1255,2502,5465
80,70,20,1225,1277,2502,5471
140,60,-60,1208,1294,2502,5420
-180,-10,-130,1223,1279,2502,5655
90,-80,130,1217,1285,2502,5808
80,60,-30,1215,1288,2503,5523
140,-80,-180,1230,1273,2503,5859
140,-70,-150,1230,1273,2503,5669
-40,-20,10,1226,1277,2503,5665
-80,-70,-40,1212,1291,2503,5412
0,-60,60,1231,1272,2503,5718
140,-80,180,1230,1273,2503,5859
-90,60,170,1247,1257,2504,5488
160,30,-80,1225,1279,2504,5260
-30,-30,20,1216,1288,2504,5494
0,40,110,1230,1274,2504,5637
-40,-60,0,1206,1298,2504,5622
-20,60,130,1220,1284,2504,5701
-170,40,-90,1234,1270,2504,5583
80,60,-20,1195,1310,2505,5520
100,-80,140,1210,1295,2505,5828
-160,-10,-140,1215,1291,2506,5697
-40,-50,30,1230,1276,2506,5633
-170,-60,-130,1202,1304,2506,5747
-40,50,140,1239,1267,2506,5770
30,-70,80,1260,1247,2507,5689
0,70,50,1232,1275,2507,5597
-10,20,60,1232,1275,2507,5588
170,20,-100,1221,1286,2507,5536
0,0,60,1221,1286,2507,5614
120,-80,160,1212,1296,2508,5941
10,-80,90,1228,1280,2508,5586
170,40,-120,1213,1295,2508,5555
-130,50,-130,1227,1281,2508,5734
10,20,30,1214,1294,2508,5721
80,60,-10,1230,1278,2508,5571
-50,50,140,1245,1263,2508,5960
60,-90,150,1224,1285,2509,5652
120,-90,-150,1224,1285,2509,5652
-170,-90,-80,1224,1285,2509,5652
180,-90,-90,1224,1285,2509,5652
160,-90,-110,1224,1285,2509,5652
-120,-90,-30,1224,1285,2509,5652
90,60,-30,1212,1297,2509,5552
70,-90,160,1224,1285,2509,5652
130,-90,-140,1224,1285,2509,5652
180,70,-70,1213,1296,2509,5774
170,-90,-100,1224,1285,2509,5652
-20,-90,70,1224,1285,2509,5652
-140,-90,-50,1224,1285,2509,5652
-160,-90,-70,1224,1285,2509,5652
100,-90,-170,1224,1285,2509,5652
-60,-90,30,1224,1285,2509,5652
150,-90,-120,1224,1285,2509,5652
20,-90,110,1224,1285,2509,5652
-180,70,-70,1213,1296,2509,5774
-100,-90,-10,1224,1285,2509,5652
150,-80,-160,1228,1281,2509,5827
30,-90,120,1224,1285,2509,5652
-70,-90,20,1224,1285,2509,5652
-30,-90,60,1224,1285,2509,5652
50,60,70,1214,1295,2509,5678
110,-90,-160,1224,1285,2509,5652
-80,-90,10,1224,1285,2509,5652
140,-90,-130,1224,1285,2509,5652
90,-90,180,1224,1285,2509,5652
-180,-90,-90,1224,1285,2509,5652
-10,-70,70,1232,1277,2509,5622
-150,-90,-60,1224,1285,2509,5652
-80,60,170,1250,1259,2509,5761
-130,-90,-40,1224,1285,2509,5652
10,-90,100,1224,1285,2509,5652
-110,-90,-20,1224,1285,2509,5652
50,-90,140,1224,1285,2509,5652
150,-40,-80,1216,1293,2509,5607
80,-90,170,1224,1285,2509,5652
0,-90,90,1224,1285,2509,5652
-90,-90,0,1224,1285,2509,5652
90,-90,-180,1224,1285,2509,5652
-10,-90,80,1224,1285,2509,5652
-40,-90,50,1224,1285,2509,5652
-50,-90,40,1224,1285,2509,5652
40,-90,130,1224,1285,2509,5652
-160,-60,-130,1204,1306,2510,5556
-10,-40,60,1241,1269,2510,5543
130,-80,170,1225,1285,2510,5905
90,80,20,1204,1306,2510,5650
160,-70,-160,1226,1284,2510,5804
140,-80,-170,1221,1289,2510,5848
20,-80,70,1235,1275,2510,5883
-10,60,70,1254,1256,2510,5611
-30,-60,50,1239,1272,2511,5634
-20,70,80,1225,1286,2511,5566
-130,-50,-100,1242,1269,2511,5555
-30,-60,40,1260,1251,2511,5671
130,-80,-150,1208,1303,2511,5681
160,-30,-120,1214,1297,2511,5627
-30,50,100,1234,1277,2511,5569
160,0,-110,1210,1301,2511,5793
20,60,100,1204,1307,2511,5800
150,10,-100,1224,1288,2512,5625
0,40,100,1243,1269,2512,5715
-150,-60,-120,1231,1281,2512,5514
-160,50,-140,1216,1296,2512,5506
-110,-30,-50,1250,1262,2512,5665
170,-80,-140,1236,1276,2512,5805
160,60,-110,1239,1274,2513,5616
-50,70,120,1209,1304,2513,5596
170,-40,-130,1245,1269,2514,5617
150,60,-100,1240,1274,2514,5490
180,20,-90,1236,1278,2514,5452
0,10,50,1225,1289,2514,5659
-10,-50,60,1239,1275,2514,5662
-100,60,-180,1244,1270,2514,5703
-170,-70,-120,1226,1288,2514,5713
-100,60,180,1244,1270,2514,5703
-180,20,-90,1236,1278,2514,5452
40,40,70,1232,1282,2514,5500
10,40,60,1244,1270,2514,5449
20,30,30,1211,1303,2514,5602
-90,-70,-50,1205,1309,2514,5412
-10,-70,40,1236,1278,2514,5762
-40,-40,50,1267,1248,2515,5543
-140,-10,-60,1243,1272,2515,5822
10,10,40,1219,1296,2515,5531
140,-80,170,1212,1303,2515,5727
-10,50,70,1228,1287,2515,5509
-10,10,60,1245,1270,2515,5574
40,40,60,1210,1305,2515,5572
180,20,-80,1245,1270,2515,5600
-70,-30,-10,1229,1286,2515,5696
-180,20,-80,1245,1270,2515,5600
130,-80,-180,1220,1296,2516,5873
170,-40,-60,1220,1296,2516,5682
130,-80,180,1220,1296,2516,5873
0,-30,70,1222,1295,2517,5471
50,80,0,1242,1275,2517,5648
160,-70,-100,1242,1275,2517,5418
140,70,-40,1244,1273,2517,5740
60,50,40,1218,1299,2517,5579
160,70,-110,1240,1277,2517,5716
160,-50,-70,1220,1298,2518,5649
-40,-60,50,1241,1277,2518,5573
-30,-30,40,1260,1258,2518,5652
120,70,-70,1229,1289,2518,5624
90,-80,120,1210,1308,2518,5771
-70,60,160,1242,1276,2518,5732
-150,-30,-130,1236,1283,2519,5689
-170,20,-90,1238,1281,2519,5710
-40,-70,50,1242,1277,2519,5536
10,-80,60,1224,1295,2519,5822
-80,60,160,1246,1273,2519,5533
-120,80,180,1242,1278,2520,5622
-130,50,-150,1245,1275,2520,5663
-10,70,60,1236,1284,2520,5607
50,-80,100,1258,1262,2520,5867
160,80,-50,1229,1291,2520,5609
-30,80,90,1233,1287,2520,5685
-130,70,-160,1247,1273,2520,5557
20,30,40,1245,1275,2520,5539
150,-80,-170,1224,1296,2520,5826
-120,80,-180,1242,1278,2520,5622
50,50,50,1234,1287,2521,5598
180,-80,-70,1258,1263,2521,5642
-40,-50,10,1219,1302,2521,5706
130,70,-40,1246,1275,2521,5797
-10,50,120,1228,1293,2521,5785
-180,-80,-70,1258,1263,2521,5642
160,-80,-150,1237,1284,2521,5844
150,-30,-100,1229,1292,2521,5721
30,-70,90,1248,1273,2521,5761
170,30,-120,1221,1300,2521,5508
180,10,-60,1243,1279,2522,5665
-140,-70,-100,1236,1286,2522,5558
-90,-50,20,1232,1290,2522,5742
-40,-30,10,1242,1280,2522,5554
-180,10,-60,1243,1279,2522,5665
-70,-40,-30,1246,1276,2522,5933
150,-20,-100,1220,1303,2523,5665
90,-80,160,1242,1281,2523,5596
0,20,50,1220,1303,2523,5596
80,-80,130,1228,1295,2523,5828
130,-80,160,1215,1308,2523,5743
180,-40,-130,1242,1282,2524,5759
150,20,-90,1205,1319,2524,5660
100,-80,150,1230,1294,2524,5884
-180,-40,-130,1242,1282,2524,5759
-20,-60,60,1236,1288,2524,5736
-140,60,-110,1213,1312,2525,5737
-110,-70,-70,1233,1292,2525,5509
160,10,-110,1226,1299,2525,5573
-20,-60,50,1258,1267,2525,5728
10,-60,70,1240,1285,2525,5693
120,-80,170,1223,1303,2526,5867
-30,0,20,1238,1288,2526,5867
140,-70,-160,1241,1285,2526,5685
160,-40,-70,1230,1296,2526,5748
-60,60,140,1242,1284,2526,5563
-140,-30,-30,1249,1277,2526,5682
130,60,-70,1212,1315,2527,5555
140,10,-90,1226,1301,2527,5563
120,80,-10,1225,1302,2527,5653
-100,60,-170,1245,1282,2527,5826
180,30,-100,1242,1285,2527,5429
-180,30,-100,1242,1285,2527,5429
20,70,30,1245,1282,2527,5805
110,-80,160,1229,1298,2527,5838
130,70,-80,1254,1273,2527,5696
100,-80,130,1207,1321,2528,5799
180,60,-80,1228,1300,2528,5715
-130,-30,-90,1224,1304,2528,5658
-30,40,110,1232,1296,2528,5793
70,60,0,1217,1311,2528,5575
-180,60,-80,1228,1300,2528,5715
-20,40,110,1245,1284,2529,5887
70,60,-20,1231,1298,2529,5625
150,20,-80,1234,1295,2529,5600
100,60,-30,1251,1279,2530,5691
-140,-50,-110,1238,1292,2530,5731
150,-70,-130,1203,1327,2530,5727
-160,10,-90,1248,1282,2530,5617
60,-80,110,1244,1286,2530,5861
170,-30,-130,1235,1296,2531,5631
30,40,40,1232,1299,2531,5589
-160,-20,-140,1229,1302,2531,5744
-10,40,110,1251,1280,2531,5882
-160,40,-100,1250,1281,2531,5683
-110,-30,-30,1244,1287,2531,5737
160,20,-90,1223,1308,2531,5596
-70,-40,20,1248,1283,2531,5801
40,60,80,1229,1302,2531,5610
140,80,-30,1223,1309,2532,5657
-40,-60,30,1262,1270,2532,5723
-180,0,-50,1245,1287,2532,5900
-30,-20,40,1250,1282,2532,5696
180,0,-50,1245,1287,2532,5900
40,50,50,1256,1276,2532,5489
90,-80,140,1238,1294,2532,5884
-140,-20,-100,1218,1314,2532,5676
20,-70,80,1252,1280,2532,5800
0,50,40,1234,1298,2532,5772
70,-80,120,1237,1296,2533,5848
-150,0,-100,1246,1287,2533,5579
-120,-50,0,1236,1297,2533,5684
30,40,30,1206,1327,2533,5454
120,-80,150,1213,1320,2533,5787
-150,-50,-120,1240,1293,2533,5728
-140,40,-120,1234,1299,2533,5715
-40,-50,50,1239,1294,2533,5566
-130,60,-120,1220,1313,2533,5768
-90,-80,10,1239,1294,2533,5746
0,10,40,1231,1303,2534,5623
-20,50,90,1250,1284,2534,5559
-180,20,-100,1249,1285,2534,5522
160,-50,-130,1237,1297,2534,5722
-170,-50,-130,1228,1306,2534,5814
170,-70,-150,1222,1312,2534,5869
0,40,90,1234,1300,2534,5451
180,20,-100,1249,1285,2534,5522
30,50,10,1229,1306,2535,5917
-180,-80,-80,1254,1281,2535,5695
180,-80,-80,1254,1281,2535,5695
160,80,-110,1241,1294,2535,5717
-160,0,-140,1236,1300,2536,5807
-40,-10,30,1239,1297,2536,5734
-100,-80,10,1265,1271,2536,5619
10,30,50,1248,1288,2536,5704
160,20,-80,1227,1309,2536,5569
90,60,-20,1235,1301,2536,5653
100,70,-50,1224,1312,2536,5553
-160,-30,-140,1212,1324,2536,5852
140,0,-80,1224,1312,2536,5749
-110,-80,0,1262,1274,2536,5646
30,60,90,1247,1289,2536,5751
80,80,30,1218,1319,2537,5714
30,40,80,1262,1275,2537,5860
40,60,0,1222,1315,2537,5762
100,80,10,1218,1319,2537,5664
-50,-20,10,1253,1284,2537,5786
-10,40,100,1254,1283,2537,5705
150,-50,-120,1228,1310,2538,5703
-50,-60,-10,1215,1323,2538,5681
-170,-60,-120,1247,1291,2538,5749
-30,-70,30,1245,1293,2538,5712
-50,-20,30,1243,1295,2538,5820
-150,-10,-50,1241,1297,2538,5985
-170,-80,-120,1232,1306,2538,5810
170,0,-110,1227,1311,2538,5465
130,80,-20,1230,1308,2538,5666
120,70,-30,1264,1275,2539,5754
30,-80,80,1255,1284,2539,5860
150,60,-70,1234,1305,2539,5587
110,-80,140,1216,1323,2539,5839
160,-60,-100,1234,1305,2539,5478
-180,-80,-130,1250,1289,2539,5859
140,10,-60,1239,1300,2539,5676
180,-80,-130,1250,1289,2539,5859
70,60,-10,1213,1326,2539,5670
170,80,-60,1247,1293,2540,5645
110,70,-20,1273,1267,2540,5835
110,70,-60,1228,1312,2540,5614
10,-80,80,1263,1277,2540,5664
-20,-70,50,1255,1285,2540,5723
-70,-70,40,1249,1291,2540,5961
150,80,-40,1233,1307,2540,5662
170,-70,-70,1248,1292,2540,5651
-50,-70,40,1246,1294,2540,5674
-130,-80,-80,1227,1313,2540,5625
140,10,-70,1222,1318,2540,5852
-20,-70,30,1248,1293,2541,5747
40,-80,90,1262,1279,2541,5878
-40,-40,30,1239,1302,2541,5615
-50,-50,-10,1198,1343,2541,5720
0,-40,70,1232,1309,2541,5557
-100,-80,-50,1239,1302,2541,5569
-110,60,-170,1256,1285,2541,5747
80,70,-30,1233,1308,2541,5628
160,-10,-110,1219,1322,2541,5731
10,60,30,1227,1314,2541,5635
-150,-60,-110,1238,1304,2542,5600
60,70,50,1208,1334,2542,5701
-160,-60,-120,1204,1338,2542,5703
-90,-40,0,1279,1263,2542,5743
-60,-40,30,1253,1289,2542,5754
-130,80,-170,1243,1299,2542,5691
20,40,60,1265,1277,2542,5829
-70,-70,30,1278,1264,2542,5713
-150,0,-80,1240,1303,2543,5762
-40,0,20,1227,1316,2543,5964
-170,50,-130,1239,1304,2543,5591
-10,-80,40,1232,1311,2543,5816
0,50,60,1249,1294,2543,5685
-130,50,-140,1223,1320,2543,5738
-40,-80,50,1256,1288,2544,5675
-80,-50,20,1227,1317,2544,5691
-140,-40,-20,1256,1288,2544,5813
-130,-80,-20,1262,1282,2544,5726
90,70,-40,1228,1316,2544,5549
90,80,10,1261,1283,2544,5645
-40,-40,20,1253,1291,2544,5655
-170,-40,-140,1244,1301,2545,5849
-140,-70,-90,1243,1302,2545,5691
-150,-70,-100,1241,1304,2545,5594
-60,-20,20,1225,1320,2545,6114
-20,40,100,1260,1285,2545,5858
150,0,-100,1247,1298,2545,5631
-120,-80,-70,1236,1309,2545,5615
-110,-80,-60,1233,1313,2546,5607
-170,-20,-130,1232,1314,2546,5832
-50,-40,40,1263,1283,2546,5830
110,80,0,1233,1313,2546,5709
140,10,-80,1218,1329,2547,5765
160,-40,-120,1227,1320,2547,5666
-180,-50,-130,1246,1301,2547,5805
-40,-30,20,1251,1296,2547,5910
180,-50,-130,1246,1301,2547,5805
170,0,-50,1254,1293,2547,5925
-160,-30,-40,1281,1266,2547,5622
-10,60,60,1243,1304,2547,5808
-50,60,120,1251,1296,2547,5695
-120,-40,-10,1280,1268,2548,5788
-100,-90,-50,1250,1298,2548,5833
70,-90,120,1250,1298,2548,5833
80,-90,130,1250,1298,2548,5833
-140,-90,-90,1250,1298,2548,5833
180,-90,-130,1250,1298,2548,5833
-170,-90,-120,1250,1298,2548,5833
-180,-90,-130,1250,1298,2548,5833
90,-90,140,1250,1298,2548,5833
160,-80,-110,1251,1297,2548,5670
-90,-90,-40,1250,1298,2548,5833
-150,-90,-100,1250,1298,2548,5833
0,-90,50,1250,1298,2548,5833
-80,-90,-30,1250,1298,2548,5833
-80,-70,30,1246,1302,2548,5876
100,-90,150,1250,1298,2548,5833
-10,-90,40,1250,1298,2548,5833
120,-90,170,1250,1298,2548,5833
-60,-90,-10,1250,1298,2548,5833
130,-90,180,1250,1298,2548,5833
-150,-20,-40,1249,1299,2548,5785
140,-90,-170,1250,1298,2548,5833
20,-90,70,1250,1298,2548,5833
50,-90,100,1250,1298,2548,5833
60,-90,110,1250,1298,2548,5833
60,80,-10,1267,1281,2548,5764
-160,-90,-110,1250,1298,2548,5833
170,-90,-140,1250,1298,2548,5833
110,-90,160,1250,1298,2548,5833
20,-80,90,1262,1286,2548,5630
160,-90,-150,1250,1298,2548,5833
30,-90,80,1250,1298,2548,5833
-30,-90,20,1250,1298,2548,5833
-20,-90,30,1250,1298,2548,5833
-70,-90,-20,1250,1298,2548,5833
-160,-80,-110,1238,1310,2548,5774
150,-90,-160,1250,1298,2548,5833
40,50,30,1247,1301,2548,5646
150,20,-70,1269,1279,2548,5870
0,-80,50,1234,1314,2548,5846
-120,-90,-70,1250,1298,2548,5833
-80,-50,-40,1251,1297,2548,5890
10,-90,60,1250,1298,2548,5833
130,-90,-180,1250,1298,2548,5833
140,-80,-140,1223,1325,2548,5757
-40,-90,10,1250,1298,2548,5833
-50,-90,0,1250,1298,2548,5833
-110,-90,-60,1250,1298,2548,5833
-130,-90,-80,1250,1298,2548,5833
140,80,-90,1238,1310,2548,5861
40,-90,90,1250,1298,2548,5833
-50,60,130,1245,1304,2549,5660
-170,-80,-60,1289,1260,2549,5721
80,80,20,1249,1300,2549,5688
-170,50,-90,1239,1310,2549,5776
170,20,-90,1235,1314,2549,5531
-40,-60,10,1250,1299,2549,5615
-120,-30,-30,1246,1304,2550,5691
160,-30,-70,1231,1319,2550,5702
150,70,-100,1251,1299,2550,5770
0,-80,80,1231,1319,2550,5679
170,40,-100,1248,1302,2550,5664
100,70,-10,1279,1272,2551,5857
0,20,40,1237,1314,2551,5716
90,70,0,1282,1269,2551,5914
-140,-80,-90,1233,1318,2551,5659
160,20,-60,1253,1298,2551,5535
-120,-30,-70,1256,1296,2552,5730
-120,-70,-80,1247,1305,2552,5567
-50,-40,10,1261,1291,2552,5689
-180,80,-70,1252,1300,2552,5756
-30,-80,20,1236,1316,2552,5809
180,80,-70,1252,1300,2552,5756
-60,-30,-10,1261,1292,2553,5846
-110,60,-160,1275,1278,2553,5865
-40,-40,0,1235,1318,2553,5732
0,30,50,1247,1306,2553,5753
-60,60,150,1249,1304,2553,5807
160,-70,-110,1241,1313,2554,5726
-120,-80,-10,1272,1282,2554,5712
-30,40,120,1250,1304,2554,6120
10,50,100,1251,1304,2555,5765
-170,70,-80,1231,1324,2555,5729
60,60,-10,1238,1317,2555,5641
-20,-70,40,1251,1304,2555,5832
-40,-50,40,1259,1296,2555,5804
140,70,-50,1268,1287,2555,5801
40,50,40,1258,1298,2556,5662
120,60,-50,1253,1303,2556,5646
-160,70,-140,1250,1307,2557,5704
-20,80,80,1252,1305,2557,5786
20,50,20,1252,1305,2557,5953
130,80,-80,1232,1325,2557,5845
140,60,-80,1246,1311,2557,5774
170,20,-80,1270,1288,2558,5501
150,70,-50,1267,1291,2558,5759
150,-30,-90,1206,1353,2559,5628
90,60,-10,1257,1302,2559,5704
-120,-40,-80,1266,1293,2559,5764
-40,-40,10,1259,1300,2559,5718
10,40,50,1256,1303,2559,5909
90,80,-40,1254,1305,2559,5856
-110,-70,10,1255,1304,2559,5689
160,-60,-120,1230,1329,2559,5800
150,80,-100,1248,1312,2560,5833
-140,40,-140,1258,1302,2560,5671
-130,-20,-70,1242,1318,2560,5722
-10,40,90,1247,1313,2560,5781
100,-80,170,1265,1295,2560,5646
-100,-60,20,1255,1305,2560,5826
-30,-70,50,1243,1318,2561,5727
10,40,70,1244,1317,2561,5723
0,50,110,1264,1297,2561,5820
170,-10,-50,1247,1314,2561,5849
160,-60,-80,1283,1278,2561,5614
-150,-70,-30,1275,1286,2561,5719
-150,30,-140,1231,1330,2561,5872
70,70,-20,1251,1311,2562,5713
-50,-80,40,1261,1301,2562,5766
-30,60,100,1261,1301,2562,5673
110,80,-60,1249,1313,2562,5880
70,80,-20,1260,1302,2562,5816
-20,-70,60,1241,1321,2562,5672
-40,-60,40,1268,1294,2562,5758
-40,-60,20,1273,1289,2562,5652
160,50,-90,1244,1318,2562,5686
-40,-40,40,1269,1294,2563,5873
-20,60,90,1258,1305,2563,5659
10,50,50,1245,1318,2563,5816
60,70,40,1263,1300,2563,5668
0,50,70,1240,1323,2563,5669
180,40,-90,1246,1317,2563,5702
-180,40,-90,1246,1317,2563,5702
10,40,80,1230,1334,2564,5803
160,10,-100,1224,1340,2564,5745
-70,70,180,1238,1326,2564,5967
-40,-70,20,1271,1293,2564,5726
-20,-80,40,1256,1308,2564,5854
-70,70,-180,1238,1326,2564,5967
-50,70,160,1241,1323,2564,5961
-150,-80,-100,1235,1329,2564,5688
20,40,50,1244,1321,2565,5806
-20,-80,30,1235,1330,2565,5811
0,-80,60,1262,1303,2565,5787
10,30,80,1230,1335,2565,5715
-60,70,170,1252,1314,2566,5984
120,80,-70,1246,1320,2566,5842
-50,-60,40,1266,1300,2566,5819
-160,50,-100,1267,1299,2566,5708
110,60,-40,1243,1323,2566,5671
100,80,0,1261,1305,2566,5648
-170,-50,-140,1235,1331,2566,5736
-60,-60,-20,1231,1335,2566,5692
140,70,-90,1261,1306,2567,5751
130,60,-60,1249,1318,2567,5691
-160,-70,-40,1277,1291,2568,5656
60,60,40,1265,1303,2568,5648
-70,-60,-30,1245,1323,2568,5713
-130,-70,-90,1243,1325,2568,5649
-40,-30,0,1260,1308,2568,5799
100,80,-50,1250,1318,2568,5873
130,80,-30,1249,1320,2569,5655
160,-70,-90,1301,1268,2569,5712
-170,-70,-50,1280,1289,2569,5763
0,-80,70,1271,1298,2569,5767
-40,-80,10,1253,1316,2569,5831
70,80,40,1233,1336,2569,5761
-150,0,-90,1259,1310,2569,5795
-120,60,-150,1261,1309,2570,5861
-150,20,-140,1222,1348,2570,5860
-180,-50,-120,1265,1305,2570,5550
160,-50,-90,1256,1314,2570,5578
140,80,-40,1256,1314,2570,5620
-170,10,-80,1268,1302,2570,5805
110,80,-10,1257,1313,2570,5675
-90,-50,10,1250,1320,2570,5752
-140,40,-130,1269,1301,2570,5825
180,-50,-120,1265,1305,2570,5550
150,-70,-140,1256,1314,2570,5758
-140,-70,-20,1273,1298,2571,5706
150,-70,-150,1257,1314,2571,5832
-170,40,-130,1233,1338,2571,5623
-40,-30,40,1282,1290,2572,5909
70,80,30,1269,1303,2572,5691
50,60,40,1278,1294,2572,5650
-170,-80,-70,1265,1307,2572,5760
-40,60,110,1273,1299,2572,5790
-100,-80,0,1252,1320,2572,5823
160,-50,-80,1227,1345,2572,5602
-170,30,-100,1247,1325,2572,5675
120,-80,-170,1248,1324,2572,5720
170,20,-70,1248,1324,2572,5556
-50,-60,0,1248,1325,2573,5787
130,-80,-160,1269,1304,2573,5761
-50,-80,0,1253,1320,2573,5736
50,60,0,1232,1341,2573,5725
140,60,-70,1253,1320,2573,5783
-130,-50,-10,1255,1318,2573,5809
-140,-80,-30,1278,1295,2573,5738
0,40,50,1246,1327,2573,5704
-130,-20,-40,1252,1321,2573,5940
-40,-20,30,1265,1308,2573,5948
170,-60,-130,1271,1302,2573,5791
-160,0,-60,1284,1289,2573,5764
-40,-30,30,1265,1309,2574,5841
160,70,-60,1264,1310,2574,5795
40,60,10,1236,1338,2574,5862
-50,-70,10,1271,1303,2574,5820
-10,-70,50,1277,1297,2574,5853
30,50,20,1245,1329,2574,5816
0,40,40,1261,1313,2574,5617
60,60,0,1244,1330,2574,5730
80,80,-30,1268,1307,2575,5858
-10,60,80,1274,1301,2575,5712
-160,-50,-130,1238,1337,2575,5779
150,80,-50,1258,1317,2575,5718
-140,-40,-110,1273,1302,2575,5811
-50,-10,20,1241,1334,2575,5984
10,50,60,1266,1309,2575,5612
-170,60,-90,1254,1321,2575,5721
120,80,-20,1260,1315,2575,5630
-110,-60,10,1254,1322,2576,5797
-130,-20,-60,1275,1301,2576,5629
30,70,20,1263,1313,2576,5885
-150,-40,-30,1280,1296,2576,5906
10,-70,70,1282,1294,2576,5833
-160,-80,-50,1297,1279,2576,5746
10,20,40,1263,1314,2577,5689
-10,-80,50,1274,1303,2577,5822
-140,-10,-50,1256,1321,2577,5940
-30,-70,20,1264,1313,2577,5799
-150,-80,-40,1285,1292,2577,5753
-40,-50,20,1276,1301,2577,5719
-80,-40,10,1281,1296,2577,5994
-130,-60,-10,1260,1317,2577,5780
110,-80,180,1266,1312,2578,5691
-150,10,-140,1229,1349,2578,5989
110,-80,-180,1266,1312,2578,5691
-90,-70,20,1257,1322,2579,5869
20,40,70,1248,1331,2579,5829
-160,70,-90,1253,1326,2579,5803
30,60,10,1255,1324,2579,5890
60,70,-10,1258,1321,2579,5813
40,70,10,1260,1319,2579,5971
-10,-80,60,1271,1308,2579,5864
-40,-20,20,1255,1324,2579,6127
-120,60,-160,1263,1316,2579,5853
-90,-50,-50,1270,1310,2580,5776
-50,-50,40,1280,1300,2580,5813
-10,-80,70,1236,1344,2580,5816
170,20,-110,1252,1329,2581,5575
150,10,-60,1263,1318,2581,5851
70,70,30,1267,1314,2581,5551
-170,-30,-130,1257,1324,2581,5779
60,60,10,1245,1336,2581,5664
20,40,30,1237,1344,2581,5836
-120,-70,0,1273,1308,2581,5769
-60,-30,0,1276,1305,2581,5969
-10,80,70,1260,1322,2582,5815
-10,60,120,1275,1307,2582,5841
-60,-80,-10,1259,1323,2582,5726
30,40,70,1276,1306,2582,5738
170,-70,-100,1259,1323,2582,5638
-60,-80,30,1273,1309,2582,5837
0,60,50,1249,1333,2582,5734
30,50,30,1252,1330,2582,5793
160,-50,-120,1234,1349,2583,5792
180,-70,-60,1282,1301,2583,5837
180,-20,-50,1251,1332,2583,5855
0,30,40,1253,1330,2583,5652
-180,-20,-50,1251,1332,2583,5855
-180,-70,-60,1282,1301,2583,5837
-140,70,-110,1257,1326,2583,5983
-170,-40,-130,1259,1324,2583,5841
30,50,50,1272,1311,2583,5767
-40,70,110,1258,1325,2583,5737
160,-20,-110,1252,1332,2584,5716
150,-10,-60,1266,1318,2584,5970
-160,-70,-110,1245,1339,2584,5707
-70,-60,30,1278,1306,2584,5938
10,50,30,1262,1322,2584,5805
-150,20,-110,1263,1321,2584,5886
-10,70,70,1266,1319,2585,5738
170,-80,-100,1266,1319,2585,5655
150,10,-90,1254,1331,2585,5791
-130,70,-120,1247,1338,2585,5879
-40,50,120,1294,1292,2586,5917
-130,-70,-10,1278,1308,2586,5781
80,60,10,1271,1315,2586,5932
-90,-80,-40,1256,1330,2586,5666
-130,-30,-30,1260,1326,2586,5857
0,60,60,1257,1329,2586,5768
60,60,50,1259,1327,2586,5826
-30,-80,30,1275,1311,2586,5892
20,50,90,1273,1314,2587,5750
-110,-80,-10,1275,1312,2587,5839
0,-70,60,1277,1310,2587,5775
10,40,30,1271,1317,2588,5844
180,10,-100,1260,1328,2588,5715
-180,10,-100,1260,1328,2588,5715
170,10,-60,1267,1321,2588,5976
-150,30,-110,1275,1313,2588,5831
-170,30,-130,1269,1319,2588,5711
150,-80,-130,1242,1347,2589,5824
100,-80,160,1283,1306,2589,5865
50,50,40,1277,1312,2589,5685
120,-80,180,1277,1312,2589,5857
120,-80,-180,1277,1312,2589,5857
20,40,40,1278,1312,2590,5683
90,-80,150,1289,1301,2590,5896
-150,70,-100,1275,1315,2590,5979
-50,-30,0,1276,1314,2590,5954
-120,-60,0,1272,1318,2590,5799
80,-80,140,1292,1298,2590,5921
10,60,40,1251,1340,2591,5886
-160,10,-100,1277,1314,2591,5747
-120,70,-130,1247,1344,2591,5836
-110,70,-140,1246,1345,2591,5900
-50,60,150,1240,1351,2591,5917
-70,-50,-30,1251,1341,2592,6089
170,10,-100,1249,1343,2592,5773
-160,-60,-110,1257,1335,2592,5673
160,10,-90,1244,1348,2592,5817
-70,70,150,1274,1318,2592,5837
160,-70,-140,1264,1329,2593,5869
-150,0,-110,1274,1319,2593,5940
110,-80,170,1284,1309,2593,5824
-170,80,-80,1263,1330,2593,5802
-140,80,-160,1265,1329,2594,5815
-150,-40,-120,1285,1309,2594,5940
160,50,-100,1256,1338,2594,5909
-50,-30,10,1276,1318,2594,5964
-180,10,-70,1271,1324,2595,5689
180,10,-70,1271,1324,2595,5689
-120,-70,-60,1277,1318,2595,5693
70,-80,130,1293,1302,2595,5933
50,70,0,1266,1329,2595,5935
170,-20,-120,1252,1344,2596,5812
160,-60,-110,1251,1345,2596,6016
-20,-80,60,1246,1351,2597,5830
-60,-40,-20,1276,1321,2597,6058
-160,80,-90,1272,1325,2597,5897
60,-80,120,1289,1308,2597,5934
-50,-50,10,1283,1314,2597,5824
150,-80,-150,1259,1338,2597,5905
-160,-80,-60,1272,1325,2597,5943
170,-10,-110,1261,1336,2597,5809
-40,70,150,1267,1331,2598,6125
150,-10,-100,1258,1340,2598,5749
-70,-80,-20,1264,1334,2598,5753
-60,70,140,1280,1318,2598,5736
-100,80,170,1278,1320,2598,5907
150,-10,-70,1269,1330,2599,5901
140,-80,-160,1267,1332,2599,5868
-50,-40,-10,1253,1346,2599,5983
0,50,50,1243,1356,2599,5818
-20,-80,50,1272,1328,2600,5894
-170,-50,-120,1262,1338,2600,5842
0,70,60,1268,1332,2600,5762
180,-60,-120,1276,1324,2600,5754
-180,-60,-120,1276,1324,2600,5754
-140,-20,-90,1256,1344,2600,5817
-160,0,-70,1280,1320,2600,5856
-150,40,-110,1267,1334,2601,5859
160,-60,-130,1255,1346,2601,5818
-150,10,-110,1270,1331,2601,5887
-150,80,-150,1270,1331,2601,5856
170,-40,-120,1283,1319,2602,5840
-170,20,-130,1293,1309,2602,5886
-130,-70,-70,1284,1318,2602,5651
150,60,-90,1267,1336,2603,6052
-40,-70,40,1285,1318,2603,5764
-130,-70,-80,1276,1327,2603,5764
170,70,-70,1267,1336,2603,5791
50,70,50,1284,1319,2603,5688
-150,20,-130,1277,1326,2603,5940
-120,60,-140,1247,1356,2603,5958
170,-60,-70,1286,1317,2603,5791
-100,-50,-60,1266,1338,2604,5835
-170,60,-130,1259,1345,2604,5823
-140,-60,-80,1272,1332,2604,5668
-50,-60,20,1286,1318,2604,5796
150,-20,-90,1257,1347,2604,5756
-150,-20,-130,1268,1337,2605,6044
180,-40,-120,1277,1328,2605,5806
-90,70,-170,1283,1322,2605,6056
-140,80,-110,1257,1348,2605,5909
-180,-40,-120,1277,1328,2605,5806
10,-80,70,1286,1319,2605,5851
-150,80,-100,1269,1336,2605,5873
-150,-50,-110,1293,1313,2606,5789
-180,-10,-50,1267,1339,2606,6114
-160,-50,-120,1244,1362,2606,5868
150,0,-60,1262,1344,2606,5805
60,80,40,1278,1328,2606,5731
180,-10,-50,1267,1339,2606,6114
-40,50,130,1288,1318,2606,6187
50,-80,110,1285,1321,2606,5899
60,80,50,1257,1350,2607,5798
-140,-20,-40,1264,1343,2607,6028
-80,-80,-30,1268,1339,2607,5702
140,-80,-150,1278,1330,2608,5778
160,-30,-110,1247,1361,2608,5888
160,0,-100,1255,1354,2609,6013
-100,-50,10,1288,1321,2609,6062
-180,-10,-120,1250,1359,2609,5799
-90,80,160,1278,1331,2609,5974
180,-10,-120,1250,1359,2609,5799
-70,70,170,1306,1303,2609,6115
-40,-10,20,1272,1338,2610,6034
-170,-50,-50,1293,1317,2610,5902
-180,-30,-50,1279,1331,2610,5904
-170,80,-130,1274,1336,2610,5871
-170,20,-100,1287,1323,2610,5897
180,-30,-50,1279,1331,2610,5904
-110,-40,-10,1298,1312,2610,6060
-150,40,-140,1280,1331,2611,5756
-140,-60,-100,1273,1338,2611,5800
-150,30,-130,1279,1332,2611,5920
60,50,20,1253,1359,2612,5633
0,60,110,1308,1304,2612,5962
0,80,60,1277,1335,2612,5833
-30,-80,40,1269,1343,2612,5852
180,-10,-110,1277,1335,2612,5751
160,10,-60,1291,1321,2612,6060
-50,60,140,1284,1328,2612,5861
160,-70,-120,1244,1368,2612,5861
-180,-10,-110,1277,1335,2612,5751
-80,70,-170,1262,1351,2613,6019
-80,70,180,1298,1315,2613,5943
-70,-30,10,1265,1348,2613,6002
-110,80,-180,1286,1327,2613,5934
-50,-40,20,1301,1312,2613,5887
-40,-70,10,1282,1331,2613,5789
-140,50,-120,1264,1349,2613,5943
150,60,-80,1270,1343,2613,5915
-80,70,-180,1298,1315,2613,5943
20,60,20,1262,1351,2613,5856
-110,80,180,1286,1327,2613,5934
80,70,10,1300,1314,2614,5917
60,50,30,1272,1342,2614,5907
-110,-70,-60,1293,1321,2614,5699
-160,-50,-110,1274,1340,2614,5850
180,0,-110,1258,1357,2615,5694
-50,-50,0,1263,1352,2615,5822
-180,0,-110,1258,1357,2615,5694
-40,60,140,1268,1347,2615,5964
-110,-70,-50,1284,1331,2615,5850
30,50,60,1288,1327,2615,5840
20,50,40,1273,1343,2616,5942
-180,-30,-120,1273,1343,2616,5820
-120,-70,-70,1277,1339,2616,5778
180,-30,-120,1273,1343,2616,5820
-170,-10,-130,1266,1350,2616,5952
-150,-60,-100,1286,1331,2617,5863
-180,-80,-90,1281,1336,2617,5682
-60,-60,-10,1273,1344,2617,5833
150,70,-60,1299,1318,2617,5923
180,-80,-90,1281,1336,2617,5682
10,50,90,1289,1329,2618,5877
10,60,50,1269,1349,2618,5826
-150,-80,-50,1280,1338,2618,5986
180,70,-80,1271,1348,2619,5801
-100,70,-150,1270,1349,2619,6019
160,-60,-90,1285,1334,2619,5642
-180,70,-80,1271,1348,2619,5801
-50,-90,30,1255,1365,2620,5915
30,-90,110,1255,1365,2620,5915
140,-90,-140,1255,1365,2620,5915
-150,-90,-70,1255,1365,2620,5915
100,-90,180,1255,1365,2620,5915
-160,-90,-80,1255,1365,2620,5915
-90,-90,-10,1255,1365,2620,5915
-140,-90,-60,1255,1365,2620,5915
-40,-90,40,1255,1365,2620,5915
100,-90,-180,1255,1365,2620,5915
-10,-90,70,1255,1365,2620,5915
40,-90,120,1255,1365,2620,5915
-180,-90,-100,1255,1365,2620,5915
150,-90,-130,1255,1365,2620,5915
20,-90,100,1255,1365,2620,5915
-20,-90,60,1255,1365,2620,5915
-130,-90,-50,1255,1365,2620,5915
-100,-90,-20,1255,1365,2620,5915
20,-80,80,1290,1330,2620,5920
-120,-90,-40,1255,1365,2620,5915
120,-90,-160,1255,1365,2620,5915
80,-90,160,1255,1365,2620,5915
130,-90,-150,1255,1365,2620,5915
60,-90,140,1255,1365,2620,5915
50,-90,130,1255,1365,2620,5915
-50,-60,30,1289,1331,2620,5896
10,-90,90,1255,1365,2620,5915
-170,-90,-90,1255,1365,2620,5915
-60,-90,20,1255,1365,2620,5915
-110,-90,-30,1255,1365,2620,5915
170,-90,-110,1255,1365,2620,5915
-80,-90,0,1255,1365,2620,5915
-30,-90,50,1255,1365,2620,5915
-120,-80,-20,1288,1332,2620,5923
90,-90,170,1255,1365,2620,5915
160,-90,-120,1255,1365,2620,5915
-70,-90,10,1255,1365,2620,5915
0,-90,80,1255,1365,2620,5915
70,-90,150,1255,1365,2620,5915
110,-90,-170,1255,1365,2620,5915
180,-90,-100,1255,1365,2620,5915
-180,0,-120,1260,1361,2621,5810
180,0,-120,1260,1361,2621,5810
50,70,60,1264,1357,2621,5890
-110,-30,-40,1308,1313,2621,5970
50,60,10,1266,1355,2621,5906
130,-80,-170,1279,1343,2622,5844
-100,-40,-10,1308,1314,2622,5993
-160,80,-140,1287,1335,2622,5884
170,-50,-70,1266,1356,2622,5805
20,60,40,1278,1344,2622,5939
-90,70,170,1292,1330,2622,5995
-80,-60,-40,1275,1347,2622,5817
160,-80,-140,1278,1345,2623,5928
-30,-80,50,1256,1367,2623,5869
-100,-70,-50,1297,1326,2623,5764
180,40,-100,1278,1345,2623,5981
-150,50,-140,1296,1327,2623,5776
160,-20,-60,1269,1354,2623,5963
10,70,50,1282,1341,2623,5884
-180,40,-100,1278,1345,2623,5981
-100,-70,10,1276,1348,2624,5834
-30,-70,40,1276,1348,2624,5980
160,80,-60,1275,1349,2624,5739
-140,70,-150,1293,1331,2624,5782
50,50,60,1264,1360,2624,5853
170,-70,-90,1299,1325,2624,5731
-60,70,160,1315,1309,2624,6171
170,60,-80,1307,1319,2626,5984
-180,0,-100,1276,1350,2626,5728
70,-90,140,1291,1335,2626,5741
-180,-60,-60,1285,1341,2626,5874
110,-90,180,1291,1335,2626,5741
-10,-90,60,1291,1335,2626,5741
180,-90,-110,1291,1335,2626,5741
-100,-90,-30,1291,1335,2626,5741
10,-90,80,1291,1335,2626,5741
-180,80,-120,1273,1353,2626,5957
110,-90,-180,1291,1335,2626,5741
30,-90,100,1291,1335,2626,5741
90,-90,160,1291,1335,2626,5741
-40,-80,20,1284,1342,2626,5932
120,-90,-170,1291,1335,2626,5741
-60,-90,10,1291,1335,2626,5741
-120,-90,-50,1291,1335,2626,5741
180,-60,-60,1285,1341,2626,5874
130,-90,-160,1291,1335,2626,5741
180,80,-120,1273,1353,2626,5957
80,-90,150,1291,1335,2626,5741
60,-90,130,1291,1335,2626,5741
-160,60,-100,1289,1337,2626,5811
-170,-90,-100,1291,1335,2626,5741
50,-90,120,1291,1335,2626,5741
-80,-90,-10,1291,1335,2626,5741
170,-90,-120,1291,1335,2626,5741
-110,-90,-40,1291,1335,2626,5741
160,-90,-130,1291,1335,2626,5741
0,-90,70,1291,1335,2626,5741
-20,-90,50,1291,1335,2626,5741
80,60,0,1279,1347,2626,5919
140,-90,-150,1291,1335,2626,5741
-140,-90,-70,1291,1335,2626,5741
100,-90,170,1291,1335,2626,5741
-160,-90,-90,1291,1335,2626,5741
-90,-90,-20,1291,1335,2626,5741
-30,-90,40,1291,1335,2626,5741
-50,-90,20,1291,1335,2626,5741
-180,-90,-110,1291,1335,2626,5741
-130,-90,-60,1291,1335,2626,5741
-150,-90,-80,1291,1335,2626,5741
40,-90,110,1291,1335,2626,5741
180,0,-100,1276,1350,2626,5728
20,-90,90,1291,1335,2626,5741
-70,-90,0,1291,1335,2626,5741
-140,-70,-80,1285,1341,2626,5724
150,-90,-140,1291,1335,2626,5741
-40,-90,30,1291,1335,2626,5741
-50,90,110,1276,1351,2627,5909
-130,90,-170,1276,1351,2627,5909
-140,90,-160,1276,1351,2627,5909
-180,90,-120,1276,1351,2627,5909
-70,90,130,1276,1351,2627,5909
120,90,-60,1276,1351,2627,5909
110,90,-50,1276,1351,2627,5909
170,80,-70,1284,1343,2627,5830
20,90,40,1276,1351,2627,5909
60,90,0,1276,1351,2627,5909
-150,90,-150,1276,1351,2627,5909
170,90,-110,1276,1351,2627,5909
-90,90,150,1276,1351,2627,5909
-80,70,160,1295,1332,2627,5933
50,90,10,1276,1351,2627,5909
70,90,-10,1276,1351,2627,5909
150,90,-90,1276,1351,2627,5909
180,90,-120,1276,1351,2627,5909
-120,90,180,1276,1351,2627,5909
-10,90,70,1276,1351,2627,5909
40,90,20,1276,1351,2627,5909
160,90,-100,1276,1351,2627,5909
-20,90,80,1276,1351,2627,5909
130,90,-70,1276,1351,2627,5909
10,90,50,1276,1351,2627,5909
90,90,-30,1276,1351,2627,5909
-40,90,100,1276,1351,2627,5909
30,90,30,1276,1351,2627,5909
-80,90,140,1276,1351,2627,5909
-40,-80,30,1283,1344,2627,5897
-160,90,-140,1276,1351,2627,5909
-60,90,120,1276,1351,2627,5909
100,90,-40,1276,1351,2627,5909
-120,90,-180,1276,1351,2627,5909
-100,90,160,1276,1351,2627,5909
-110,90,170,1276,1351,2627,5909
0,90,60,1276,1351,2627,5909
-170,90,-130,1276,1351,2627,5909
80,90,-20,1276,1351,2627,5909
-50,-30,30,1310,1317,2627,6082
140,90,-80,1276,1351,2627,5909
-30,90,90,1276,1351,2627,5909
30,60,20,1260,1368,2628,6041
-130,-20,-50,1308,1320,2628,5888
-80,-70,20,1328,1300,2628,6069
50,80,60,1282,1346,2628,5783
-20,70,130,1307,1321,2628,6125
-150,-50,-30,1311,1317,2628,6007
-30,70,140,1298,1330,2628,6132
-140,-60,-20,1287,1342,2629,5801
-170,70,-130,1293,1336,2629,5916
-130,60,-150,1301,1328,2629,5856
170,30,-110,1263,1367,2630,5782
-150,-70,-90,1287,1343,2630,5808
150,10,-70,1286,1344,2630,6072
120,-90,-180,1277,1354,2631,5976
-170,-90,-110,1277,1354,2631,5976
-60,-90,0,1277,1354,2631,5976
-120,-90,-60,1277,1354,2631,5976
130,-90,-170,1277,1354,2631,5976
60,-90,120,1277,1354,2631,5976
160,-90,-140,1277,1354,2631,5976
70,-90,130,1277,1354,2631,5976
-150,-90,-90,1277,1354,2631,5976
-20,-90,40,1277,1354,2631,5976
140,-90,-160,1277,1354,2631,5976
-140,-90,-80,1277,1354,2631,5976
20,-90,80,1277,1354,2631,5976
-160,-90,-100,1277,1354,2631,5976
30,-90,90,1277,1354,2631,5976
-70,-90,-10,1277,1354,2631,5976
-30,-90,30,1277,1354,2631,5976
40,-90,100,1277,1354,2631,5976
120,-90,180,1277,1354,2631,5976
-90,-90,-30,1277,1354,2631,5976
10,-90,70,1277,1354,2631,5976
100,-90,160,1277,1354,2631,5976
-40,-90,20,1277,1354,2631,5976
-50,-90,10,1277,1354,2631,5976
90,-90,150,1277,1354,2631,5976
-110,-90,-50,1277,1354,2631,5976
50,-90,110,1277,1354,2631,5976
80,-90,140,1277,1354,2631,5976
180,-90,-120,1277,1354,2631,5976
150,-90,-150,1277,1354,2631,5976
-50,-80,10,1284,1347,2631,5919
110,-90,170,1277,1354,2631,5976
170,-90,-130,1277,1354,2631,5976
-80,-90,-20,1277,1354,2631,5976
0,-90,60,1277,1354,2631,5976
-130,-90,-70,1277,1354,2631,5976
40,60,20,1287,1344,2631,5996
-10,-90,50,1277,1354,2631,5976
-100,-90,-40,1277,1354,2631,5976
-180,-90,-120,1277,1354,2631,5976
-130,80,-120,1277,1355,2632,5970
-40,60,120,1301,1331,2632,5687
-140,-80,-40,1285,1347,2632,6008
30,60,30,1291,1341,2632,6028
-50,-70,30,1297,1335,2632,5905
-130,-60,-90,1294,1338,2632,5808
-30,70,100,1276,1356,2632,5970
-80,80,150,1288,1345,2633,5943
-70,-80,20,1293,1340,2633,5932
-130,-80,-30,1291,1342,2633,5953
20,60,30,1260,1373,2633,6093
10,30,40,1282,1352,2634,6106
50,70,40,1300,1334,2634,5850
-10,50,90,1276,1358,2634,5854
60,60,30,1296,1339,2635,5959
-60,-70,0,1301,1334,2635,5923
170,50,-90,1296,1339,2635,5901
-170,-30,-120,1294,1341,2635,5930
-60,-50,-20,1255,1380,2635,6024
160,20,-70,1287,1348,2635,5778
180,-20,-120,1283,1353,2636,5843
-50,-50,20,1315,1321,2636,5960
-140,50,-140,1299,1337,2636,5938
30,50,40,1288,1348,2636,5966
-50,-40,0,1294,1342,2636,6010
-100,-60,-60,1290,1346,2636,5976
-180,-20,-120,1283,1353,2636,5843
-120,-50,-10,1315,1322,2637,6079
40,-80,100,1298,1339,2637,5949
40,80,70,1288,1350,2638,5813
150,-80,-140,1291,1347,2638,5841
-70,80,140,1286,1352,2638,5948
-50,70,130,1301,1337,2638,5829
-60,-70,30,1307,1331,2638,5948
10,80,50,1296,1342,2638,5917
-150,50,-110,1274,1364,2638,6011
180,10,-80,1303,1336,2639,5781
-30,50,130,1311,1328,2639,6210
10,40,40,1271,1368,2639,6176
-180,10,-80,1303,1336,2639,5781
-50,-70,0,1305,1334,2639,5807
-170,-40,-120,1280,1359,2639,6000
-170,10,-90,1318,1321,2639,6046
-50,-20,20,1280,1360,2640,5934
-40,-70,30,1287,1353,2640,6056
-170,-80,-80,1294,1346,2640,5710
30,50,80,1290,1350,2640,6070
-90,-40,-10,1316,1324,2640,6027
-60,-50,30,1299,1342,2641,6109
-60,-60,20,1316,1325,2641,5890
-160,-40,-130,1279,1362,2641,6036
-120,80,-170,1291,1350,2641,6002
170,-70,-120,1289,1353,2642,5859
110,70,-30,1279,1364,2643,5849
-150,-60,-90,1312,1331,2643,5735
-30,50,110,1303,1340,2643,5965
170,-70,-130,1289,1355,2644,5955
-150,40,-130,1298,1346,2644,5928
170,10,-90,1291,1353,2644,5823
-170,-60,-110,1295,1349,2644,5789
-160,-50,-40,1325,1319,2644,5975
-70,-70,-10,1311,1333,2644,5970
150,0,-70,1286,1359,2645,5980
60,70,30,1288,1357,2645,5921
160,-70,-130,1282,1363,2645,5967
-170,10,-130,1292,1353,2645,5958
40,60,50,1305,1340,2645,5836
30,-80,90,1304,1341,2645,5991
-180,20,-110,1294,1351,2645,5821
50,60,20,1304,1341,2645,6053
180,20,-110,1294,1351,2645,5821
-150,-10,-60,1309,1337,2646,6006
-180,10,-90,1287,1359,2646,5754
-160,-40,-40,1281,1365,2646,5879
160,-80,-120,1271,1375,2646,5904
180,10,-90,1287,1359,2646,5754
-150,30,-120,1297,1349,2646,6152
-150,10,-130,1308,1339,2647,6017
170,-30,-120,1279,1368,2647,5811
-150,-10,-130,1296,1351,2647,6165
-90,-60,-50,1294,1353,2647,5960
-50,70,150,1327,1321,2648,6183
50,80,50,1283,1365,2648,5767
-60,-60,30,1319,1330,2649,6088
170,-70,-110,1289,1360,2649,5896
-150,40,-120,1296,1353,2649,6027
-140,-50,-20,1285,1364,2649,6059
-30,60,130,1329,1320,2649,5985
-60,-30,20,1273,1377,2650,6133
-80,-80,10,1302,1348,2650,5958
20,50,30,1284,1366,2650,6085
50,60,50,1296,1354,2650,5733
-100,70,180,1300,1350,2650,5974
-30,80,100,1314,1336,2650,6071
-100,70,-180,1300,1350,2650,5974
160,-50,-110,1283,1368,2651,6066
-60,-80,0,1299,1352,2651,6018
-120,-30,-60,1306,1345,2651,6060
-50,-60,10,1303,1348,2651,5802
-60,80,130,1288,1363,2651,6035
160,-80,-130,1303,1349,2652,5847
-180,10,-110,1298,1354,2652,5787
180,10,-110,1298,1354,2652,5787
50,50,30,1286,1366,2652,5837
-140,-60,-90,1299,1353,2652,6006
-90,70,180,1326,1327,2653,6052
-90,70,-180,1326,1327,2653,6052
-180,-50,-60,1294,1359,2653,5878
10,50,40,1271,1382,2653,6095
180,-50,-60,1294,1359,2653,5878
-90,-60,20,1293,1360,2653,5972
-40,60,130,1309,1344,2653,6034
170,-50,-110,1289,1364,2653,5953
170,-80,-110,1280,1374,2654,5949
-160,-40,-120,1289,1365,2654,5939
-120,80,-130,1292,1362,2654,5918
-180,-60,-110,1297,1358,2655,5801
-80,-50,10,1317,1338,2655,5879
-90,70,-160,1269,1386,2655,6091
180,-60,-110,1297,1358,2655,5801
160,-40,-110,1291,1365,2656,5993
70,70,20,1287,1369,2656,6019
-50,-70,20,1304,1352,2656,5971
-60,-70,10,1308,1349,2657,5914
180,-80,-110,1324,1333,2657,5832
20,70,40,1322,1335,2657,6030
-160,-70,-100,1306,1351,2657,5898
-60,-70,-10,1306,1351,2657,5849
-180,-80,-110,1324,1333,2657,5832
-170,-70,-110,1309,1348,2657,6010
-170,0,-130,1286,1371,2657,6150
-130,60,-130,1272,1385,2657,6096
-130,-60,-70,1309,1349,2658,5947
-170,-60,-50,1302,1356,2658,5945
160,-50,-100,1296,1362,2658,5878
-20,90,130,1292,1367,2659,5932
170,90,-60,1292,1367,2659,5932
160,90,-50,1292,1367,2659,5932
130,90,-20,1292,1367,2659,5932
50,90,60,1292,1367,2659,5932
-10,90,120,1292,1367,2659,5932
-30,90,140,1292,1367,2659,5932
-180,90,-70,1292,1367,2659,5932
40,50,60,1284,1375,2659,5870
70,90,40,1292,1367,2659,5932
150,90,-40,1292,1367,2659,5932
120,90,-10,1292,1367,2659,5932
180,90,-70,1292,1367,2659,5932
-130,90,-120,1292,1367,2659,5932
-160,90,-90,1292,1367,2659,5932
-120,90,-130,1292,1367,2659,5932
-90,90,-160,1292,1367,2659,5932
20,90,90,1292,1367,2659,5932
-150,90,-100,1292,1367,2659,5932
80,90,30,1292,1367,2659,5932
-70,90,-180,1292,1367,2659,5932
30,90,80,1292,1367,2659,5932
-40,90,150,1292,1367,2659,5932
-50,90,160,1292,1367,2659,5932
-100,90,-150,1292,1367,2659,5932
-70,90,180,1292,1367,2659,5932
-170,90,-80,1292,1367,2659,5932
0,90,110,1292,1367,2659,5932
40,90,70,1292,1367,2659,5932
10,90,100,1292,1367,2659,5932
-80,90,-170,1292,1367,2659,5932
60,90,50,1292,1367,2659,5932
90,90,20,1292,1367,2659,5932
110,90,0,1292,1367,2659,5932
-180,-50,-110,1294,1365,2659,5711
140,90,-30,1292,1367,2659,5932
100,90,10,1292,1367,2659,5932
-110,90,-140,1292,1367,2659,5932
-110,-50,0,1312,1347,2659,6142
150,-10,-80,1280,1379,2659,5854
-140,90,-110,1292,1367,2659,5932
180,-50,-110,1294,1365,2659,5711
170,-30,-60,1270,1389,2659,5969
-60,90,170,1292,1367,2659,5932
180,-70,-120,1306,1354,2660,6004
-50,-30,20,1285,1375,2660,5941
-180,80,-80,1305,1355,2660,5910
160,60,-80,1308,1352,2660,6027
180,80,-80,1305,1355,2660,5910
-180,-70,-120,1306,1354,2660,6004
-10,70,120,1322,1338,2660,6075
170,80,-110,1290,1371,2661,6030
170,0,-100,1293,1368,2661,5937
-70,-80,0,1307,1354,2661,6039
-160,20,-110,1291,1370,2661,5952
170,-50,-120,1312,1349,2661,5913
170,-80,-120,1312,1349,2661,5828
170,-20,-110,1273,1388,2661,5873
70,60,20,1319,1343,2662,5922
170,40,-110,1281,1381,2662,6002
-160,-40,-110,1313,1349,2662,5938
-170,40,-100,1307,1355,2662,5929
-70,-80,-10,1304,1358,2662,6115
-40,80,110,1304,1358,2662,6017
-170,-80,-100,1322,1341,2663,5848
40,70,70,1279,1384,2663,6033
170,-70,-80,1332,1331,2663,6050
-140,60,-120,1275,1388,2663,6116
-20,50,100,1306,1357,2663,5967
-170,-10,-50,1323,1340,2663,6338
150,10,-80,1288,1375,2663,6091
-100,-80,-40,1298,1366,2664,6124
170,-60,-120,1301,1363,2664,5846
-100,-70,-40,1306,1358,2664,5912
-50,80,120,1295,1369,2664,6043
170,-80,-130,1304,1360,2664,6005
-50,70,140,1317,1347,2664,6079
-90,-70,-40,1304,1361,2665,5899
-50,-80,20,1303,1362,2665,5975
-40,-80,40,1277,1388,2665,5840
120,70,-40,1296,1369,2665,5939
-150,-30,-40,1318,1347,2665,6101
-150,-10,-100,1310,1356,2666,5915
-120,-60,-80,1311,1355,2666,5798
-40,70,120,1292,1374,2666,5987
-150,-10,-110,1308,1358,2666,6060
-90,-70,-30,1325,1342,2667,5974
-110,-80,-50,1301,1366,2667,6144
-100,-50,0,1331,1336,2667,6142
-110,-50,-70,1302,1365,2667,6025
-150,-30,-120,1305,1362,2667,6188
180,-20,-110,1305,1363,2668,5945
-150,-10,-70,1320,1348,2668,5951
-180,10,-120,1287,1381,2668,5914
-180,-20,-110,1305,1363,2668,5945
160,-40,-80,1298,1370,2668,6134
-50,-50,30,1329,1339,2668,5871
-160,-10,-50,1320,1348,2668,6106
180,10,-120,1287,1381,2668,5914
0,50,100,1289,1379,2668,6137
-70,-50,20,1307,1361,2668,6018
-170,-80,-110,1314,1354,2668,6082
-60,-70,20,1319,1350,2669,6078
-110,70,-170,1311,1358,2669,6022
-60,-40,20,1305,1364,2669,6102
-150,-50,-90,1321,1348,2669,5994
-170,70,-90,1314,1355,2669,5861
-150,-60,-30,1292,1378,2670,5832
-60,-50,-10,1296,1374,2670,6094
-110,-70,0,1320,1351,2671,5907
-150,60,-110,1298,1373,2671,6135
170,-60,-80,1312,1359,2671,5848
180,-80,-120,1315,1357,2672,6051
180,60,-120,1314,1358,2672,6050
-40,70,140,1336,1336,2672,6085
-180,60,-120,1314,1358,2672,6050
-180,-80,-120,1315,1357,2672,6051
-180,50,-120,1314,1359,2673,5924
110,70,-50,1282,1391,2673,6072
180,50,-120,1314,1359,2673,5924
-70,-60,-20,1305,1368,2673,5883
40,60,40,1322,1351,2673,6034
-80,-40,-10,1319,1354,2673,6140
180,-40,-60,1301,1373,2674,6054
-180,-40,-60,1301,1373,2674,6054
180,-80,-100,1285,1389,2674,5940
-180,-80,-100,1285,1389,2674,5940
-30,70,120,1314,1360,2674,6067
-80,-70,-20,1319,1355,2674,5887
-160,-60,-40,1303,1371,2674,5916
-80,70,170,1340,1335,2675,6020
30,80,80,1300,1375,2675,5975
-90,-80,-30,1309,1366,2675,6150
-170,-60,-100,1301,1374,2675,5882
0,50,90,1281,1395,2676,5887
-100,70,-160,1312,1364,2676,6082
-180,50,-90,1321,1355,2676,6112
120,70,-60,1282,1394,2676,6003
180,50,-90,1321,1355,2676,6112
-140,-80,-80,1296,1380,2676,6092
-20,70,90,1303,1374,2677,6149
170,-60,-110,1289,1388,2677,5839
170,50,-100,1302,1375,2677,6149
-60,70,150,1325,1352,2677,6049
-20,80,120,1309,1368,2677,6132
20,50,60,1318,1360,2678,6178
10,50,70,1325,1353,2678,6201
20,80,40,1311,1367,2678,5985
-130,-80,-70,1295,1383,2678,6098
100,70,-20,1288,1391,2679,5895
0,60,70,1298,1381,2679,6038
-80,-60,20,1312,1367,2679,6044
150,-10,-90,1277,1402,2679,5984
-180,30,-110,1306,1373,2679,6020
180,30,-110,1306,1373,2679,6020
-130,-60,-80,1312,1368,2680,6029
-110,80,-140,1294,1386,2680,6019
160,-30,-100,1299,1381,2680,6033
40,70,60,1320,1360,2680,5949
-110,-60,-70,1311,1369,2680,6014
160,-10,-100,1282,1398,2680,5936
-70,70,160,1341,1339,2680,6010
-160,-60,-100,1318,1363,2681,5877
-180,70,-120,1314,1367,2681,6038
-70,-70,-20,1305,1376,2681,5971
180,70,-120,1314,1367,2681,6038
-60,-80,10,1314,1367,2681,5997
-170,-20,-120,1312,1370,2682,6049
-80,-80,-20,1313,1369,2682,6172
10,50,80,1279,1403,2682,6013
-20,80,90,1326,1356,2682,6117
90,70,-10,1297,1386,2683,6097
100,70,-40,1278,1405,2683,6131
-20,60,120,1330,1353,2683,6100
-170,-40,-50,1325,1358,2683,5950
-160,-80,-70,1309,1374,2683,5885
20,50,50,1299,1384,2683,6032
-120,-80,-60,1305,1378,2683,6138
-40,70,130,1315,1368,2683,6047
-150,-40,-110,1309,1375,2684,6060
-160,-80,-90,1322,1362,2684,5894
-80,-70,-30,1304,1380,2684,6007
50,60,30,1303,1381,2684,5984
-60,-50,10,1319,1366,2685,6017
-100,70,-170,1344,1341,2685,6133
160,-40,-100,1312,1373,2685,6026
-60,-60,10,1340,1345,2685,5983
-60,-30,10,1328,1358,2686,6291
-170,80,-90,1320,1366,2686,6049
180,30,-120,1311,1375,2686,6037
-180,30,-120,1311,1375,2686,6037
-10,70,80,1319,1368,2687,6098
-160,40,-110,1321,1366,2687,6030
-100,80,-150,1297,1390,2687,5993
-130,80,-160,1310,1377,2687,6070
180,-70,-90,1297,1390,2687,6000
-10,50,110,1317,1370,2687,6184
-180,-70,-90,1297,1390,2687,6000
-60,-50,20,1343,1344,2687,6080
-170,-30,-110,1313,1375,2688,5918
-80,-80,-10,1324,1364,2688,6108
-10,60,110,1331,1357,2688,6175
-70,-70,0,1327,1361,2688,6019
160,80,-100,1299,1389,2688,6129
-150,-80,-80,1317,1371,2688,5990
-60,-40,0,1324,1364,2688,6116
-10,80,110,1316,1372,2688,6214
-160,-80,-100,1310,1378,2688,6123
-150,-80,-90,1310,1380,2690,6137
60,60,20,1292,1398,2690,6066
-90,-80,0,1321,1369,2690,6032
160,0,-60,1332,1358,2690,6084
-150,60,-140,1322,1369,2691,5941
-140,50,-130,1335,1356,2691,6061
-180,20,-120,1295,1396,2691,5902
180,20,-120,1295,1396,2691,5902
-90,-40,-40,1321,1371,2692,6096
-70,-80,10,1321,1371,2692,5893
-90,-80,-20,1331,1361,2692,6152
-60,-60,0,1313,1379,2692,6109
-70,-70,20,1322,1370,2692,6251
0,80,100,1317,1375,2692,6224
-180,-70,-110,1307,1386,2693,5875
180,-70,-110,1307,1386,2693,5875
-110,-80,-40,1333,1360,2693,6111
180,-30,-110,1316,1378,2694,5920
-180,-30,-110,1316,1378,2694,5920
40,50,70,1317,1377,2694,6025
40,80,60,1305,1389,2694,5863
10,60,100,1344,1351,2695,6169
20,80,80,1316,1379,2695,6138
170,-60,-100,1303,1392,2695,6004
170,-10,-100,1301,1394,2695,6101
-170,10,-100,1353,1343,2696,6115
-60,-80,20,1305,1391,2696,5896
160,-30,-80,1297,1399,2696,5960
20,80,90,1301,1395,2696,5992
180,-40,-110,1317,1379,2696,5757
-180,-40,-110,1317,1379,2696,5757
-140,60,-140,1328,1369,2697,6061
-20,70,110,1315,1382,2697,6238
-70,-40,-20,1327,1370,2697,6464
130,70,-50,1316,1381,2697,6019
-150,-80,-60,1321,1376,2697,5976
-150,-20,-110,1304,1393,2697,5978
-50,-40,30,1345,1353,2698,6213
-170,-20,-50,1332,1366,2698,6308
10,80,90,1304,1394,2698,6150
-50,-80,30,1299,1399,2698,5927
-170,-40,-110,1317,1382,2699,5943
-140,-80,-50,1324,1375,2699,6032
-40,80,140,1318,1381,2699,6148
170,10,-80,1333,1366,2699,5889
-150,-10,-90,1301,1398,2699,6178
-150,20,-120,1327,1373,2700,6248
-120,70,-160,1316,1384,2700,6034
-180,40,-120,1322,1378,2700,5998
180,40,-120,1322,1378,2700,5998
-130,-40,-20,1343,1357,2700,6208
-170,0,-60,1349,1351,2700,6167
-160,30,-110,1318,1383,2701,5998
-180,-70,-100,1317,1384,2701,5972
80,70,-20,1281,1420,2701,6081
-90,-70,10,1344,1357,2701,6208
10,80,100,1301,1400,2701,6060
160,60,-100,1312,1389,2701,6317
180,-70,-100,1317,1384,2701,5972
50,60,60,1318,1384,2702,6129
-90,-60,10,1325,1377,2702,6078
130,70,-70,1294,1408,2702,6104
100,70,-30,1304,1398,2702,6035
0,70,110,1345,1357,2702,6266
-30,80,130,1320,1383,2703,6173
0,50,80,1312,1391,2703,6123
-160,30,-130,1293,1410,2703,6070
-90,80,-160,1299,1404,2703,6129
170,-50,-80,1324,1380,2704,5884
170,70,-110,1313,1392,2705,6100
30,80,30,1322,1383,2705,6097
-170,-50,-110,1306,1399,2705,5895
-120,-50,-80,1321,1384,2705,6042
-140,-80,-70,1324,1381,2705,6058
-100,-80,-30,1338,1367,2705,6171
30,80,70,1310,1395,2705,5968
-80,80,160,1319,1387,2706,6124
0,80,110,1312,1394,2706,6133
170,50,-110,1310,1396,2706,6142
-160,-20,-130,1321,1385,2706,6213
80,70,-10,1293,1413,2706,6203
-170,-70,-100,1324,1383,2707,5926
-120,-60,-70,1322,1385,2707,5982
160,-20,-100,1296,1411,2707,6165
10,70,100,1328,1379,2707,6293
-150,-20,-120,1308,1399,2707,6275
140,90,-40,1320,1388,2708,6030
-150,-50,-100,1351,1357,2708,6035
160,90,-60,1320,1388,2708,6030
-30,90,130,1320,1388,2708,6030
-120,90,-140,1320,1388,2708,6030
160,10,-80,1327,1381,2708,6169
170,90,-70,1320,1388,2708,6030
-160,90,-100,1320,1388,2708,6030
-180,90,-80,1320,1388,2708,6030
-140,90,-120,1320,1388,2708,6030
70,90,30,1320,1388,2708,6030
-60,-50,0,1321,1387,2708,6256
180,90,-80,1320,1388,2708,6030
130,90,-30,1320,1388,2708,6030
-150,90,-110,1320,1388,2708,6030
-10,90,110,1320,1388,2708,6030
10,90,90,1320,1388,2708,6030
50,90,50,1320,1388,2708,6030
150,90,-50,1320,1388,2708,6030
80,90,20,1320,1388,2708,6030
-150,0,-130,1320,1388,2708,6168
-100,90,-160,1320,1388,2708,6030
-40,90,140,1320,1388,2708,6030
20,90,80,1320,1388,2708,6030
-150,-10,-80,1319,1389,2708,6205
-80,90,180,1320,1388,2708,6030
-50,90,150,1320,1388,2708,6030
-110,90,-150,1320,1388,2708,6030
110,90,-10,1320,1388,2708,6030
-130,90,-130,1320,1388,2708,6030
-80,90,-180,1320,1388,2708,6030
-60,90,160,1320,1388,2708,6030
40,90,60,1320,1388,2708,6030
30,90,70,1320,1388,2708,6030
100,90,0,1320,1388,2708,6030
90,90,10,1320,1388,2708,6030
60,90,40,1320,1388,2708,6030
0,90,100,1320,1388,2708,6030
-20,90,120,1320,1388,2708,6030
-90,90,-170,1320,1388,2708,6030
-70,90,170,1320,1388,2708,6030
-170,90,-90,1320,1388,2708,6030
170,-30,-110,1305,1403,2708,5964
120,90,-20,1320,1388,2708,6030
-130,-80,-60,1326,1383,2709,6080
-120,-80,-50,1336,1373,2709,6153
-90,80,170,1322,1387,2709,6149
-30,70,130,1350,1359,2709,6136
90,70,-30,1293,1416,2709,6153
-160,-50,-100,1331,1378,2709,5964
-60,80,160,1322,1388,2710,6220
-170,-80,-90,1305,1406,2711,6063
90,70,-20,1299,1412,2711,6137
-140,-30,-100,1329,1383,2712,5921
-70,80,150,1326,1386,2712,6142
-20,50,120,1338,1375,2713,6388
-130,-50,-90,1329,1384,2713,6102
-160,20,-130,1305,1408,2713,6202
150,0,-80,1287,1426,2713,6098
-70,-60,10,1342,1372,2714,6041
-60,-40,-10,1339,1375,2714,6377
-130,-50,-20,1345,1369,2714,6163
-80,-40,-30,1331,1384,2715,6265
-160,-30,-130,1322,1393,2715,6269
-130,60,-140,1321,1394,2715,6070
-120,-30,-50,1331,1384,2715,6130
150,0,-90,1292,1423,2715,6058
-50,80,150,1330,1386,2716,6216
160,10,-70,1336,1380,2716,6154
-150,70,-140,1338,1379,2717,6141
-30,60,110,1311,1406,2717,6029
70,60,10,1303,1414,2717,6120
160,70,-70,1321,1396,2717,6124
-150,-30,-110,1329,1388,2717,6182
-120,-40,-20,1332,1386,2718,6304
-30,60,120,1343,1375,2718,6080
10,60,60,1338,1381,2719,6090
-110,-60,-60,1339,1380,2719,6033
40,80,20,1329,1390,2719,6162
-80,-70,-10,1334,1385,2719,6111
-130,-30,-80,1295,1424,2719,6239
-130,-80,-40,1344,1376,2720,6048
150,80,-90,1315,1406,2721,6132
-130,-40,-90,1324,1397,2721,6047
150,70,-90,1320,1401,2721,6217
-160,10,-110,1354,1368,2722,6040
-140,80,-150,1331,1391,2722,6162
-10,50,100,1328,1394,2722,6071
-80,-60,-30,1312,1410,2722,6074
-110,-50,-10,1346,1377,2723,6284
-180,60,-90,1319,1404,2723,6227
-80,-40,0,1351,1372,2723,6335
180,60,-90,1319,1404,2723,6227
-140,-50,-100,1331,1392,2723,6048
40,60,60,1327,1396,2723,5946
70,70,-10,1288,1435,2723,6096
30,50,70,1335,1388,2723,6184
-160,-10,-130,1315,1409,2724,6268
-160,-80,-80,1316,1408,2724,6031
-120,-70,-10,1346,1378,2724,6030
-60,-40,10,1337,1387,2724,6283
-30,80,140,1314,1410,2724,6178
-170,-70,-90,1330,1394,2724,6027
-110,70,-160,1340,1384,2724,6244
-70,-40,-10,1347,1377,2724,6277
-160,-70,-90,1336,1388,2724,6075
140,70,-80,1323,1401,2724,6141
-20,50,110,1335,1390,2725,6210
-180,-60,-100,1319,1406,2725,5992
180,-60,-100,1319,1406,2725,5992
-130,-80,-50,1335,1390,2725,6136
30,70,80,1322,1403,2725,6060
-70,80,170,1336,1389,2725,6213
-60,80,140,1325,1400,2725,6209
80,70,0,1315,1410,2725,6225
70,70,10,1328,1397,2725,6266
-10,80,120,1317,1408,2725,6225
160,-10,-60,1342,1384,2726,6251
180,-10,-100,1322,1404,2726,6023
30,70,30,1335,1391,2726,6187
-180,-10,-100,1322,1404,2726,6023
-170,-30,-50,1336,1390,2726,6220
-80,-80,0,1330,1397,2727,5904
-160,0,-100,1334,1394,2728,6359
-180,-70,-80,1350,1378,2728,6059
-170,0,-100,1373,1355,2728,6077
-110,-60,0,1335,1393,2728,6000
170,-40,-110,1312,1416,2728,6157
160,-20,-70,1334,1394,2728,6194
180,-70,-80,1350,1378,2728,6059
170,60,-110,1339,1390,2729,6308
-10,80,80,1354,1375,2729,6135
-160,80,-100,1333,1396,2729,6124
-70,-60,-10,1334,1395,2729,6206
-160,0,-90,1333,1397,2730,6168
40,70,50,1337,1393,2730,6147
-160,40,-130,1316,1414,2730,6177
110,70,-40,1313,1417,2730,6125
0,70,70,1355,1375,2730,6139
140,70,-60,1331,1399,2730,6178
-70,-70,10,1332,1399,2731,6152
160,70,-100,1324,1407,2731,6315
-170,20,-110,1308,1423,2731,6235
-20,80,130,1324,1407,2731,6212
170,-60,-90,1315,1416,2731,6035
-70,-50,-20,1319,1412,2731,6428
160,-40,-90,1346,1386,2732,6091
160,-30,-90,1332,1400,2732,6153
40,60,30,1356,1376,2732,6219
-160,-30,-120,1336,1396,2732,6271
-120,-80,-30,1340,1393,2733,6092
170,-50,-90,1326,1407,2733,6077
20,70,90,1340,1393,2733,6235
-80,80,-170,1320,1413,2733,6155
-100,-40,-50,1337,1397,2734,6194
-100,-40,-20,1351,1383,2734,6182
-80,80,-180,1344,1390,2734,6255
-80,80,180,1344,1390,2734,6255
30,60,50,1345,1389,2734,6228
-120,-80,-40,1336,1400,2736,6171
-140,-80,-60,1330,1406,2736,6164
-170,-20,-110,1325,1411,2736,6125
-170,50,-100,1321,1415,2736,6271
-30,50,120,1355,1381,2736,6367
-110,-80,-20,1333,1403,2736,6099
70,70,0,1315,1422,2737,6264
170,10,-70,1355,1382,2737,6008
-70,-60,20,1354,1384,2738,6258
-160,-30,-110,1340,1398,2738,6130
20,50,80,1351,1387,2738,6127
-140,70,-120,1323,1416,2739,6292
30,60,40,1336,1403,2739,6263
-160,-40,-100,1344,1396,2740,6079
-90,80,-170,1340,1400,2740,6336
-90,-80,-10,1346,1394,2740,5985
-140,-40,-100,1338,1403,2741,6079
-140,-30,-40,1334,1407,2741,6315
-110,-40,-20,1346,1395,2741,6224
-100,-80,-10,1349,1393,2742,6102
-150,-80,-70,1333,1409,2742,6131
30,70,70,1341,1401,2742,6169
-90,-50,0,1365,1378,2743,6259
-140,-20,-80,1339,1405,2744,6180
-40,80,150,1314,1430,2744,6243
50,80,10,1339,1405,2744,6314
-130,70,-150,1323,1422,2745,6176
-150,-10,-120,1333,1412,2745,6345
-20,70,120,1361,1384,2745,6262
-120,-60,-10,1351,1395,2746,6028
-140,-50,-80,1343,1403,2746,6171
-10,70,110,1363,1384,2747,6343
160,0,-90,1322,1425,2747,6212
-80,-70,0,1342,1405,2747,6333
-80,-70,10,1349,1398,2747,6348
170,-20,-100,1328,1419,2747,6025
-90,-70,-20,1347,1400,2747,6249
-100,-60,0,1352,1395,2747,6047
180,-70,-70,1350,1398,2748,6224
170,-40,-70,1330,1418,2748,6223
-110,70,-150,1341,1407,2748,6336
-170,-10,-120,1354,1394,2748,6214
-180,-70,-70,1350,1398,2748,6224
-70,80,180,1332,1417,2749,6176
-160,-70,-80,1343,1406,2749,6187
-30,70,110,1332,1417,2749,6177
-70,80,-180,1332,1417,2749,6176
-100,-60,10,1335,1415,2750,6130
-50,80,130,1338,1413,2751,6249
-100,80,180,1349,1402,2751,6214
-160,-20,-110,1343,1408,2751,6092
-100,80,-180,1349,1402,2751,6214
20,50,70,1334,1417,2751,6274
-110,-80,-30,1346,1406,2752,6107
-70,-60,0,1361,1392,2753,6275
0,70,100,1359,1394,2753,6412
-160,0,-80,1357,1396,2753,6178
40,70,20,1346,1407,2753,6274
60,70,0,1318,1436,2754,6259
-150,80,-140,1342,1412,2754,6232
160,60,-90,1330,1424,2754,6363
20,60,50,1355,1400,2755,6201
-70,-50,10,1350,1405,2755,6166
-100,80,-160,1354,1402,2756,6313
-20,60,110,1355,1401,2756,6112
130,80,-70,1334,1422,2756,6246
140,80,-80,1334,1423,2757,6191
-100,-80,-20,1341,1416,2757,6044
-160,-20,-120,1340,1417,2757,6223
-40,80,120,1339,1419,2758,6306
-110,-40,-60,1356,1402,2758,6336
-90,-40,-30,1349,1410,2759,6445
-100,-70,-30,1344,1415,2759,6209
170,70,-80,1332,1427,2759,6251
-100,-60,-50,1353,1406,2759,6083
-170,-40,-100,1364,1396,2760,6065
-60,80,170,1334,1426,2760,6209
-150,0,-120,1358,1403,2761,6360
-160,-60,-90,1346,1415,2761,6307
70,80,-10,1348,1413,2761,6457
-50,80,160,1328,1433,2761,6260
-150,70,-110,1330,1432,2762,6416
20,60,90,1344,1418,2762,6484
60,80,0,1357,1406,2763,6403
170,-50,-100,1336,1427,2763,6157
-160,10,-130,1336,1427,2763,6382
50,70,10,1351,1412,2763,6301
-90,-40,-20,1366,1398,2764,6314
-100,-70,0,1368,1396,2764,6290
0,80,70,1360,1404,2764,6219
150,70,-70,1345,1420,2765,6308
-130,-70,-20,1357,1410,2767,6256
-180,50,-100,1345,1422,2767,6229
180,50,-100,1345,1422,2767,6229
-10,70,100,1353,1414,2767,6322
-160,60,-130,1348,1420,2768,6225
120,80,-60,1344,1425,2769,6341
-140,-30,-90,1347,1422,2769,6136
30,60,60,1358,1411,2769,6349
-170,-10,-100,1367,1402,2769,6125
-160,70,-130,1345,1424,2769,6319
180,-50,-70,1342,1428,2770,6017
130,70,-60,1337,1433,2770,6343
-180,-50,-70,1342,1428,2770,6017
-70,-50,-10,1363,1407,2770,6382
-140,-40,-30,1374,1398,2772,6471
-160,70,-100,1340,1432,2772,6146
-110,80,-150,1356,1416,2772,6288
170,0,-60,1364,1409,2773,6430
-170,-50,-100,1358,1415,2773,6057
-110,-70,-40,1350,1423,2773,6195
70,80,20,1362,1412,2774,6336
-70,-40,10,1363,1411,2774,6356
-170,-20,-100,1354,1421,2775,6216
-160,50,-110,1362,1413,2775,6227
-160,0,-110,1368,1407,2775,6021
-90,-70,0,1353,1422,2775,6354
120,70,-50,1343,1433,2776,6273
110,80,-20,1353,1423,2776,6273
-70,-40,0,1379,1397,2776,6376
0,60,100,1362,1415,2777,6216
-120,-30,-40,1373,1404,2777,6398
-90,-70,-10,1349,1428,2777,6444
-80,-60,-20,1357,1420,2777,6286
100,80,-10,1359,1419,2778,6255
30,60,70,1355,1423,2778,6371
40,80,50,1362,1416,2778,6441
0,60,90,1351,1427,2778,6237
10,70,90,1372,1406,2778,6392
-120,-70,-50,1363,1416,2779,6228
-90,-60,-40,1338,1441,2779,6214
-150,50,-130,1371,1408,2779,6214
-110,80,-170,1355,1424,2779,6297
-160,0,-130,1355,1424,2779,6373
10,70,60,1370,1410,2780,6207
170,60,-90,1360,1420,2780,6357
-50,80,140,1356,1424,2780,6478
-150,-70,-80,1359,1421,2780,6266
-180,-60,-70,1377,1404,2781,6138
-160,80,-130,1351,1430,2781,6305
-160,-30,-100,1372,1409,2781,6255
180,-60,-70,1377,1404,2781,6138
-150,50,-120,1364,1418,2782,6390
-130,70,-130,1345,1437,2782,6450
170,0,-90,1336,1446,2782,6337
-140,-70,-70,1354,1428,2782,6409
160,-20,-80,1342,1441,2783,6275
-120,-60,-60,1361,1423,2784,6166
-160,-10,-110,1351,1433,2784,6231
-140,80,-120,1345,1439,2784,6204
-150,80,-110,1347,1437,2784,6189
60,70,20,1360,1424,2784,6307
-140,-70,-30,1359,1426,2785,6336
-150,10,-120,1357,1428,2785,6418
-30,80,110,1349,1436,2785,6422
-170,60,-100,1342,1443,2785,6230
-80,-60,10,1375,1411,2786,6241
-40,80,130,1349,1437,2786,6433
110,80,-50,1351,1435,2786,6394
-60,80,150,1365,1421,2786,6434
30,70,40,1368,1419,2787,6404
-140,70,-140,1361,1426,2787,6304
90,80,0,1363,1424,2787,6326
-170,30,-110,1335,1452,2787,6311
-160,-10,-100,1370,1418,2788,6436
-170,0,-120,1353,1435,2788,6305
-20,60,100,1354,1436,2790,6469
100,80,-40,1359,1431,2790,6411
-130,80,-130,1354,1437,2791,6313
-80,-40,-20,1364,1427,2791,6375
30,80,60,1356,1435,2791,6520
-180,70,-90,1349,1442,2791,6245
180,70,-90,1349,1442,2791,6245
-140,60,-130,1348,1443,2791,6339
180,-20,-100,1367,1425,2792,6343
-170,-10,-110,1365,1427,2792,6266
-80,-50,0,1380,1412,2792,6372
60,70,10,1353,1439,2792,6461
-180,-20,-100,1367,1425,2792,6343
-170,-70,-60,1356,1437,2793,6308
-80,-50,-30,1351,1442,2793,6547
50,80,40,1383,1410,2793,6432
-150,-70,-70,1368,1425,2793,6388
40,70,40,1382,1411,2793,6309
-150,60,-130,1369,1424,2793,6314
-120,80,-160,1357,1437,2794,6412
-70,80,160,1371,1423,2794,6427
-180,40,-110,1362,1432,2794,6279
180,40,-110,1362,1432,2794,6279
160,-20,-90,1349,1445,2794,6234
-110,-60,-10,1378,1417,2795,6187
-30,80,120,1362,1433,2795,6463
120,80,-30,1362,1433,2795,6284
-170,10,-110,1343,1452,2795,6423
-120,70,-150,1363,1432,2795,6344
60,80,30,1375,1420,2795,6410
20,70,50,1384,1411,2795,6212
20,70,80,1368,1427,2795,6324
80,80,-20,1370,1426,2796,6489
-70,-50,0,1377,1419,2796,6313
130,80,-40,1357,1439,2796,6364
-160,50,-130,1370,1426,2796,6227
140,80,-50,1354,1443,2797,6398
-110,-40,-30,1387,1411,2798,6347
140,70,-70,1343,1456,2799,6359
-150,-20,-100,1366,1433,2799,6298
170,-30,-70,1358,1441,2799,6405
160,0,-70,1364,1435,2799,6380
50,70,30,1376,1423,2799,6320
-130,80,-150,1367,1433,2800,6471
-170,0,-90,1394,1406,2800,6354
-110,-70,-10,1399,1401,2800,6374
40,70,30,1362,1438,2800,6415
90,80,-30,1371,1429,2800,6466
80,80,10,1375,1426,2801,6335
-80,90,150,1374,1428,2802,6396
40,90,30,1374,1428,2802,6396
10,90,60,1374,1428,2802,6396
100,90,-30,1374,1428,2802,6396
0,90,70,1374,1428,2802,6396
180,90,-110,1374,1428,2802,6396
-180,90,-110,1374,1428,2802,6396
-180,-50,-100,1345,1457,2802,6349
-140,90,-150,1374,1428,2802,6396
-20,70,100,1350,1452,2802,6342
120,90,-50,1374,1428,2802,6396
-170,-50,-60,1368,1434,2802,6261
170,90,-100,1374,1428,2802,6396
-110,90,-180,1374,1428,2802,6396
-160,90,-130,1374,1428,2802,6396
-170,-70,-80,1362,1440,2802,6182
160,90,-90,1374,1428,2802,6396
90,90,-20,1374,1428,2802,6396
30,90,40,1374,1428,2802,6396
-20,90,90,1374,1428,2802,6396
130,90,-60,1374,1428,2802,6396
-150,90,-140,1374,1428,2802,6396
50,90,20,1374,1428,2802,6396
110,90,-40,1374,1428,2802,6396
20,90,50,1374,1428,2802,6396
-90,90,160,1374,1428,2802,6396
-120,90,-170,1374,1428,2802,6396
-110,90,180,1374,1428,2802,6396
-10,90,80,1374,1428,2802,6396
-170,90,-120,1374,1428,2802,6396
80,90,-10,1374,1428,2802,6396
60,90,10,1374,1428,2802,6396
-50,90,120,1374,1428,2802,6396
-70,90,140,1374,1428,2802,6396
-60,90,130,1374,1428,2802,6396
-100,90,170,1374,1428,2802,6396
-40,90,110,1374,1428,2802,6396
140,90,-70,1374,1428,2802,6396
-130,90,-160,1374,1428,2802,6396
70,90,0,1374,1428,2802,6396
150,90,-80,1374,1428,2802,6396
-30,90,100,1374,1428,2802,6396
180,-50,-100,1345,1457,2802,6349
180,0,-90,1357,1446,2803,6184
170,-20,-60,1353,1450,2803,6405
-180,0,-90,1357,1446,2803,6184
-10,60,100,1367,1436,2803,6120
-160,0,-120,1367,1436,2803,6378
-160,-70,-50,1365,1439,2804,6318
-130,-70,-60,1380,1424,2804,6298
-120,-70,-40,1386,1418,2804,6597
-150,-50,-40,1368,1438,2806,6376
180,0,-60,1378,1428,2806,6619
-180,0,-60,1378,1428,2806,6619
30,70,50,1387,1420,2807,6391
40,60,70,1355,1452,2807,6304
-170,-30,-100,1377,1430,2807,6314
-160,-20,-100,1374,1433,2807,6311
-140,-50,-30,1385,1422,2807,6305
-100,-50,-10,1402,1406,2808,6397
-100,-70,-20,1382,1427,2809,6520
-120,80,-140,1352,1457,2809,6331
-170,0,-70,1390,1420,2810,6150
170,-10,-60,1371,1439,2810,6435
170,-40,-100,1357,1454,2811,6237
160,70,-80,1365,1446,2811,6432
160,-10,-90,1355,1456,2811,6409
30,80,50,1388,1424,2812,6492
0,60,80,1364,1448,2812,6453
-110,-70,-30,1389,1424,2813,6588
-10,70,90,1347,1466,2813,6571
-130,-30,-70,1373,1440,2813,6489
-140,-20,-70,1390,1424,2814,6318
-130,-50,-80,1375,1439,2814,6226
-130,-30,-40,1372,1442,2814,6415
-120,70,-140,1369,1445,2814,6557
-170,10,-120,1354,1460,2814,6271
-130,-60,-20,1379,1436,2815,6265
-120,-40,-70,1367,1448,2815,6363
10,80,70,1370,1445,2815,6490
10,60,90,1374,1441,2815,6376
-20,80,100,1359,1457,2816,6540
-130,-70,-50,1381,1435,2816,6541
-160,-10,-120,1367,1450,2817,6386
20,60,60,1378,1439,2817,6427
-140,-70,-60,1378,1439,2817,6545
-140,-50,-90,1384,1433,2817,6350
-100,-70,-10,1372,1445,2817,6432
-10,80,100,1362,1456,2818,6560
-150,-40,-100,1391,1427,2818,6366
-140,-20,-60,1398,1420,2818,6351
-180,-60,-90,1357,1461,2818,6198
10,60,70,1390,1428,2818,6536
170,-30,-100,1351,1467,2818,6330
-150,-60,-80,1388,1430,2818,6379
180,-60,-90,1357,1461,2818,6198
50,70,20,1373,1446,2819,6510
-170,50,-120,1365,1455,2820,6338
10,80,60,1391,1429,2820,6408
20,80,60,1377,1443,2820,6507
-10,60,90,1353,1468,2821,6481
-80,-60,-10,1388,1433,2821,6405
0,70,90,1386,1435,2821,6384
-160,60,-110,1379,1443,2822,6525
-170,-70,-70,1400,1422,2822,6294
-150,-70,-40,1376,1447,2823,6368
-80,80,170,1384,1440,2824,6434
-150,-40,-90,1395,1429,2824,6347
30,60,80,1386,1438,2824,6540
0,80,90,1362,1463,2825,6491
-170,-60,-90,1392,1433,2825,6331
170,60,-100,1374,1452,2826,6511
-90,-50,-40,1376,1450,2826,6650
-170,80,-120,1366,1461,2827,6353
-130,70,-140,1374,1454,2828,6485
-100,-40,-30,1388,1440,2828,6615
-150,-30,-100,1379,1449,2828,6265
-160,-20,-50,1391,1437,2828,6518
180,50,-110,1355,1474,2829,6465
-180,50,-110,1355,1474,2829,6465
-80,-50,-20,1401,1428,2829,6468
-120,-50,-70,1389,1441,2830,6369
160,0,-80,1374,1457,2831,6433
170,-20,-90,1387,1444,2831,6349
-100,80,-170,1392,1439,2831,6485
20,80,70,1367,1464,2831,6513
-160,30,-120,1380,1453,2833,6323
10,70,70,1378,1455,2833,6588
-170,20,-120,1375,1459,2834,6381
-150,-40,-40,1405,1430,2835,6553
-120,-70,-20,1413,1422,2835,6412
-170,0,-110,1375,1461,2836,6634
0,80,80,1369,1467,2836,6639
-160,-50,-50,1404,1433,2837,6413
30,70,60,1396,1442,2838,6540
160,-10,-70,1378,1460,2838,6495
-90,-60,-30,1386,1452,2838,6393
40,80,40,1399,1439,2838,6547
180,-30,-100,1380,1459,2839,6324
-180,-30,-100,1380,1459,2839,6324
-100,-40,-40,1411,1428,2839,6522
-170,0,-80,1387,1452,2839,6238
-20,80,110,1375,1464,2839,6509
-120,-50,-20,1410,1430,2840,6550
10,80,80,1360,1480,2840,6460
-140,80,-140,1382,1458,2840,6512
-90,-60,0,1401,1439,2840,6368
-150,70,-130,1381,1460,2841,6461
150,70,-80,1364,1477,2841,6505
-80,-50,-10,1405,1437,2842,6506
-100,-50,-50,1401,1441,2842,6613
-130,-40,-80,1366,1476,2842,6335
170,-10,-90,1378,1464,2842,6465
180,-40,-100,1378,1465,2843,6392
150,80,-60,1371,1472,2843,6447
-120,-40,-30,1397,1446,2843,6525
-180,-40,-100,1378,1465,2843,6392
-110,-50,-60,1388,1456,2844,6422
10,70,80,1394,1451,2845,6467
-150,60,-120,1371,1474,2845,6496
-10,80,90,1373,1473,2846,6601
-170,60,-120,1367,1479,2846,6442
-110,80,-160,1387,1460,2847,6661
0,70,80,1384,1463,2847,6625
-160,-50,-90,1393,1455,2848,6231
-130,-40,-30,1397,1451,2848,6620
160,80,-70,1383,1466,2849,6458
-110,-60,-50,1380,1469,2849,6396
170,80,-80,1396,1454,2850,6492
20,80,50,1407,1444,2851,6519
-90,80,180,1403,1448,2851,6500
-140,-20,-50,1404,1447,2851,6706
100,80,-20,1383,1468,2851,6649
-90,80,-180,1403,1448,2851,6500
180,-60,-80,1400,1451,2851,6429
-150,-50,-80,1410,1441,2851,6393
-180,-60,-80,1400,1451,2851,6429
20,70,60,1391,1461,2852,6485
-140,-60,-70,1390,1462,2852,6516
80,80,0,1400,1453,2853,6562
-170,-60,-60,1409,1444,2853,6400
-170,70,-120,1370,1483,2853,6503
50,80,30,1397,1457,2854,6584
-170,40,-110,1359,1495,2854,6467
-170,30,-120,1378,1476,2854,6640
-80,-60,0,1393,1461,2854,6393
90,80,-10,1396,1459,2855,6590
-140,-40,-90,1389,1466,2855,6419
20,60,80,1414,1442,2856,6494
20,90,60,1386,1471,2857,6556
60,90,20,1386,1471,2857,6556
-170,90,-110,1386,1471,2857,6556
-150,90,-130,1386,1471,2857,6556
-110,90,-170,1386,1471,2857,6556
30,90,50,1386,1471,2857,6556
170,90,-90,1386,1471,2857,6556
50,90,30,1386,1471,2857,6556
-80,90,160,1386,1471,2857,6556
160,-10,-80,1369,1488,2857,6504
120,90,-40,1386,1471,2857,6556
110,90,-30,1386,1471,2857,6556
0,90,80,1386,1471,2857,6556
-40,90,120,1386,1471,2857,6556
80,90,0,1386,1471,2857,6556
-60,90,140,1386,1471,2857,6556
-180,90,-100,1386,1471,2857,6556
-120,90,-160,1386,1471,2857,6556
130,90,-50,1386,1471,2857,6556
160,90,-80,1386,1471,2857,6556
-160,90,-120,1386,1471,2857,6556
-20,90,100,1386,1471,2857,6556
40,90,40,1386,1471,2857,6556
60,80,20,1398,1459,2857,6598
-130,90,-150,1386,1471,2857,6556
140,90,-60,1386,1471,2857,6556
-10,90,90,1386,1471,2857,6556
70,90,10,1386,1471,2857,6556
-70,90,150,1386,1471,2857,6556
150,90,-70,1386,1471,2857,6556
90,90,-10,1386,1471,2857,6556
10,90,70,1386,1471,2857,6556
-30,90,110,1386,1471,2857,6556
-90,90,170,1386,1471,2857,6556
-100,90,180,1386,1471,2857,6556
100,90,-20,1386,1471,2857,6556
-50,90,130,1386,1471,2857,6556
180,90,-100,1386,1471,2857,6556
-140,90,-140,1386,1471,2857,6556
-100,90,-180,1386,1471,2857,6556
10,60,80,1404,1454,2858,6529
30,80,40,1404,1455,2859,6614
-140,70,-130,1390,1469,2859,6580
-140,-60,-30,1392,1467,2859,6355
-160,-40,-90,1381,1479,2860,6397
-150,-20,-90,1393,1467,2860,6407
110,80,-30,1382,1479,2861,6629
-160,20,-120,1395,1467,2862,6415
-130,-70,-30,1425,1437,2862,6516
-120,80,-150,1392,1470,2862,6791
-160,-10,-90,1384,1479,2863,6480
-180,80,-90,1411,1452,2863,6605
180,80,-90,1411,1452,2863,6605
120,80,-40,1385,1478,2863,6628
-110,-70,-20,1393,1471,2864,6613
-160,10,-120,1408,1458,2866,6506
-160,40,-120,1408,1459,2867,6514
-100,-60,-40,1410,1457,2867,6422
-180,80,-110,1384,1483,2867,6461
170,70,-90,1394,1473,2867,6520
-160,-30,-50,1404,1463,2867,6747
180,80,-110,1384,1483,2867,6461
-180,-30,-60,1394,1475,2869,6650
-150,80,-130,1392,1477,2869,6495
-130,-50,-70,1404,1465,2869,6388
-110,-50,-20,1441,1428,2869,6414
-90,-50,-10,1421,1448,2869,6451
180,-30,-60,1394,1475,2869,6650
60,80,10,1410,1459,2869,6620
-180,60,-110,1396,1477,2873,6497
-140,-70,-40,1430,1443,2873,6546
180,60,-110,1396,1477,2873,6497
-170,70,-100,1392,1482,2874,6453
70,80,10,1410,1464,2874,6560
160,70,-90,1393,1482,2875,6639
-180,-10,-90,1395,1481,2876,6640
-120,-60,-20,1419,1457,2876,6433
20,70,70,1409,1467,2876,6609
180,-10,-90,1395,1481,2876,6640
-90,-60,-20,1414,1463,2877,6490
180,60,-100,1405,1473,2878,6590
-180,60,-100,1405,1473,2878,6590
-180,-50,-90,1403,1476,2879,6441
170,80,-100,1391,1488,2879,6554
180,-50,-90,1403,1476,2879,6441
-160,-10,-60,1416,1463,2879,6642
170,-40,-80,1402,1478,2880,6545
-130,80,-140,1401,1479,2880,6806
-160,-70,-60,1410,1470,2880,6491
-160,80,-120,1392,1488,2880,6537
20,60,70,1413,1469,2882,6485
160,80,-90,1393,1490,2883,6613
-170,-40,-60,1406,1478,2884,6824
170,-40,-90,1402,1484,2886,6615
120,80,-50,1389,1497,2886,6798
-100,-50,-20,1420,1466,2886,6497
-150,80,-120,1405,1482,2887,6741
-170,-60,-80,1404,1483,2887,6552
-160,50,-120,1416,1471,2887,6450
-90,-50,-20,1428,1460,2888,6641
160,80,-80,1417,1471,2888,6705
70,80,0,1415,1474,2889,6674
180,90,-90,1412,1478,2890,6701
-60,90,150,1412,1478,2890,6701
30,90,60,1412,1478,2890,6701
-90,90,-180,1412,1478,2890,6701
90,90,0,1412,1478,2890,6701
-20,90,110,1412,1478,2890,6701
-150,90,-120,1412,1478,2890,6701
50,90,40,1412,1478,2890,6701
20,90,70,1412,1478,2890,6701
160,90,-70,1412,1478,2890,6701
40,90,50,1412,1478,2890,6701
-160,90,-110,1412,1478,2890,6701
-150,70,-120,1411,1479,2890,6701
-130,-60,-60,1406,1484,2890,6575
-120,90,-150,1412,1478,2890,6701
170,90,-80,1412,1478,2890,6701
-80,90,170,1412,1478,2890,6701
70,90,20,1412,1478,2890,6701
-40,90,130,1412,1478,2890,6701
100,90,-10,1412,1478,2890,6701
50,80,20,1421,1469,2890,6682
60,90,30,1412,1478,2890,6701
-170,90,-100,1412,1478,2890,6701
150,90,-60,1412,1478,2890,6701
-50,90,140,1412,1478,2890,6701
10,90,80,1412,1478,2890,6701
-130,90,-140,1412,1478,2890,6701
-10,90,100,1412,1478,2890,6701
-100,90,-170,1412,1478,2890,6701
-140,90,-130,1412,1478,2890,6701
140,90,-50,1412,1478,2890,6701
-180,90,-90,1412,1478,2890,6701
110,90,-20,1412,1478,2890,6701
120,90,-30,1412,1478,2890,6701
-70,90,160,1412,1478,2890,6701
-90,90,180,1412,1478,2890,6701
-30,90,120,1412,1478,2890,6701
80,90,10,1412,1478,2890,6701
0,90,90,1412,1478,2890,6701
130,90,-40,1412,1478,2890,6701
-110,90,-160,1412,1478,2890,6701
130,80,-50,1406,1485,2891,6732
-100,-60,-10,1438,1453,2891,6624
-160,-70,-70,1390,1501,2891,6468
-160,70,-110,1404,1487,2891,6713
150,80,-70,1412,1480,2892,6733
100,80,-30,1389,1504,2893,6738
140,80,-70,1386,1508,2894,6734
-180,80,-100,1412,1484,2896,6602
180,80,-100,1412,1484,2896,6602
-150,-60,-40,1417,1479,2896,6478
180,-20,-90,1411,1485,2896,6652
-180,-20,-90,1411,1485,2896,6652
-180,-50,-80,1402,1495,2897,6485
180,-50,-80,1402,1495,2897,6485
130,80,-60,1392,1506,2898,6772
-110,-40,-50,1445,1453,2898,6737
-160,-60,-80,1418,1481,2899,6673
40,80,30,1413,1486,2899,6652
-140,80,-130,1411,1488,2899,6764
170,-30,-80,1404,1496,2900,6539
-170,80,-110,1402,1498,2900,6527
180,0,-80,1421,1479,2900,6460
-180,0,-80,1421,1479,2900,6460
180,0,-70,1432,1469,2901,6638
-180,0,-70,1432,1469,2901,6638
-170,40,-120,1394,1507,2901,6728
170,-30,-90,1402,1499,2901,6539
-90,-60,-10,1414,1487,2901,6559
140,80,-60,1413,1491,2904,6717
110,80,-40,1397,1508,2905,6758
170,0,-80,1421,1484,2905,6631
-160,80,-110,1416,1489,2905,6752
-160,-30,-90,1417,1489,2906,6444
-130,-30,-60,1443,1464,2907,6589
180,-40,-70,1418,1489,2907,6582
-180,-40,-70,1418,1489,2907,6582
-170,80,-100,1419,1488,2907,6705
-110,-60,-20,1447,1461,2908,6674
-130,-30,-50,1442,1466,2908,6819
90,80,-20,1392,1516,2908,6656
80,80,-10,1404,1505,2909,6659
-160,-20,-90,1413,1496,2909,6624
-170,50,-110,1412,1499,2911,6645
-150,-40,-80,1409,1502,2911,6728
-160,-10,-80,1415,1496,2911,6486
170,80,-90,1431,1480,2911,6654
-160,-40,-50,1429,1483,2912,6713
-170,-50,-90,1411,1503,2914,6623
180,70,-110,1401,1513,2914,6693
-180,70,-110,1401,1513,2914,6693
170,-20,-70,1420,1494,2914,6775
-150,-70,-50,1425,1491,2916,6608
-100,-60,-30,1423,1493,2916,6635
150,80,-80,1401,1515,2916,6676
-170,-10,-90,1423,1495,2918,6491
-160,70,-120,1434,1484,2918,6643
170,-20,-80,1406,1513,2919,6648
-120,-60,-50,1428,1492,2920,6713
-160,-10,-70,1429,1491,2920,6538
-100,-60,-20,1427,1495,2922,6795
-110,-40,-40,1440,1484,2924,6807
-120,-70,-30,1415,1511,2926,6692
170,70,-100,1423,1503,2926,6677
-160,60,-120,1409,1517,2926,6450
-150,-30,-90,1428,1499,2927,6567
-180,-10,-60,1444,1485,2929,6740
-140,-40,-80,1421,1508,2929,6599
180,-10,-60,1444,1485,2929,6740
-130,-70,-40,1417,1512,2929,6784
-110,-60,-40,1424,1505,2929,6773
170,0,-70,1430,1500,2930,6842
-150,-20,-80,1435,1496,2931,6643
-180,-30,-90,1437,1496,2933,6698
180,-30,-90,1437,1496,2933,6698
-140,-30,-80,1401,1533,2934,6699
-100,-50,-40,1435,1501,2936,6959
-120,-40,-40,1444,1493,2937,6792
-160,-60,-50,1453,1484,2937,6557
-170,-40,-90,1445,1492,2937,6592
-120,-40,-60,1451,1488,2939,6739
-180,-20,-60,1436,1507,2943,6971
-140,-70,-50,1418,1525,2943,6796
180,-20,-60,1436,1507,2943,6971
-90,-50,-30,1442,1503,2945,6692
-150,-20,-50,1425,1523,2948,7037
-120,-50,-60,1441,1508,2949,6624
-170,-60,-70,1455,1495,2950,6683
-130,-50,-30,1454,1498,2952,6795
-110,-50,-50,1452,1500,2952,6833
-170,70,-110,1440,1513,2953,6752
-150,-70,-60,1430,1524,2954,6746
-160,-50,-80,1447,1509,2956,6764
-170,-20,-90,1428,1529,2957,6691
-170,-50,-70,1449,1509,2958,6674
-140,-50,-70,1444,1516,2960,6643
-170,-30,-90,1439,1522,2961,6801
180,-40,-90,1420,1541,2961,6760
-180,-40,-90,1420,1541,2961,6760
-180,70,-100,1439,1525,2964,6716
180,70,-100,1439,1525,2964,6716
-110,-50,-30,1464,1501,2965,6756
-120,-60,-30,1463,1503,2966,6681
-170,-50,-80,1430,1538,2968,6768
-130,-40,-70,1434,1536,2970,6740
-150,-20,-70,1469,1507,2976,6836
-160,-40,-60,1463,1513,2976,6884
-120,-50,-30,1495,1482,2977,6671
-170,60,-110,1434,1545,2979,6804
-130,-60,-30,1467,1514,2981,6691
-140,-30,-70,1458,1524,2982,6812
-170,-10,-60,1478,1505,2983,6976
-170,-40,-80,1451,1533,2984,6890
-150,-30,-50,1459,1525,2984,7033
170,-10,-80,1454,1532,2986,6876
180,-40,-80,1446,1540,2986,6720
-180,-40,-80,1446,1540,2986,6720
180,-30,-70,1444,1543,2987,7033
-180,-30,-70,1444,1543,2987,7033
-110,-60,-30,1454,1540,2994,6890
-140,-60,-40,1450,1546,2996,6774
-140,-30,-50,1458,1544,3002,7040
-100,-50,-30,1472,1532,3004,6915
-150,-50,-70,1460,1545,3005,6902
-140,-40,-70,1466,1543,3009,6787
-150,-60,-70,1459,1553,3012,6817
-120,-60,-40,1444,1569,3013,6890
-130,-40,-40,1486,1528,3014,6888
-170,-30,-60,1485,1529,3014,7069
-120,-40,-50,1489,1525,3014,6994
-130,-60,-40,1476,1542,3018,6819
-150,-60,-50,1476,1546,3022,6902
-170,-10,-80,1455,1567,3022,6840
-140,-40,-40,1478,1545,3023,7017
-160,-60,-60,1479,1545,3024,6954
-150,-30,-80,1462,1562,3024,6802
-140,-60,-60,1450,1574,3024,6878
-170,-40,-70,1453,1571,3024,6816
-160,-50,-60,1490,1537,3027,6926
170,-10,-70,1466,1562,3028,6997
-130,-50,-60,1459,1569,3028,6904
-180,-20,-70,1471,1560,3031,7060
-160,-60,-70,1459,1572,3031,6910
180,-20,-70,1471,1560,3031,7060
-130,-60,-50,1470,1563,3033,6914
-130,-50,-40,1504,1529,3033,6787
-160,-50,-70,1466,1568,3034,6970
-120,-50,-40,1501,1538,3039,7067
-160,-30,-80,1480,1561,3041,6896
-140,-50,-40,1481,1563,3044,7061
-150,-60,-60,1477,1569,3046,7058
-120,-50,-50,1513,1533,3046,7052
180,-10,-80,1461,1586,3047,7083
-180,-10,-80,1461,1586,3047,7083
-140,-60,-50,1473,1576,3049,6941
-160,-40,-70,1487,1565,3052,6942
-160,-20,-80,1478,1576,3054,6957
-160,-40,-80,1475,1579,3054,6986
-150,-40,-50,1503,1553,3056,7111
-130,-40,-60,1503,1554,3057,6970
180,-30,-80,1481,1586,3067,7017
-180,-30,-80,1481,1586,3067,7017
180,-20,-80,1472,1599,3071,7142
-180,-20,-80,1472,1599,3071,7142
-130,-40,-50,1503,1568,3071,7103
-170,-30,-70,1507,1565,3072,7115
-170,-20,-60,1505,1569,3074,7231
-170,-10,-70,1524,1555,3079,7005
-150,-40,-60,1500,1582,3082,7153
-150,-50,-50,1514,1569,3083,7212
-110,-50,-40,1504,1585,3089,7074
-170,-30,-80,1510,1580,3090,7299
-150,-40,-70,1496,1595,3091,7260
-150,-20,-60,1530,1561,3091,7168
-160,-30,-60,1508,1584,3092,7272
-140,-30,-60,1523,1573,3096,7154
-160,-20,-70,1526,1587,3113,7184
-160,-20,-60,1510,1603,3113,7287
180,-10,-70,1533,1587,3120,7185
-180,-10,-70,1533,1587,3120,7185
-140,-40,-50,1516,1607,3123,7249
-150,-30,-70,1519,1606,3125,7084
-140,-50,-50,1542,1585,3127,7189
-130,-50,-50,1523,1606,3129,7287
-170,-20,-80,1504,1626,3130,7330
-150,-50,-60,1530,1601,3131,7192
-170,-20,-70,1541,1599,3140,7436
-160,-30,-70,1525,1616,3141,7423
-150,-30,-60,1516,1627,3143,7167
-140,-50,-60,1539,1616,3155,7383
-140,-40,-60,1533,1642,3175,7444
