alpha,beta,gamma,ENZ_CA,SUB_CA,TOT_CA,clashes
-10,-40,-40,116,95,211,325
0,-40,-30,117,101,218,335
-10,-50,-40,123,97,220,340
0,-50,-30,121,99,220,313
-20,-50,-50,120,109,229,425
-10,-30,-30,121,111,232,394
-20,-30,-40,119,117,236,378
-20,-40,-50,119,118,237,366
-20,-60,-50,126,116,242,419
-10,-60,-50,129,113,242,389
10,-50,-20,128,116,244,364
-10,-60,-40,131,117,248,395
40,-60,10,125,124,249,395
-20,-60,-60,122,128,250,410
0,-50,-40,125,126,251,446
-10,-40,-30,137,114,251,428
10,-60,-20,131,121,252,434
-20,-40,-40,132,120,252,416
0,-60,-30,134,120,254,434
40,-60,0,129,125,254,393
-30,-60,-70,128,126,254,442
-10,-30,-40,131,124,255,389
30,-60,0,133,122,255,406
-30,-30,-50,124,131,255,437
30,-70,-10,129,128,257,379
-30,-50,-60,135,122,257,482
-30,-40,-50,132,128,260,456
-20,-70,-60,128,133,261,475
0,-30,-30,130,131,261,438
50,-60,20,138,123,261,437
50,-50,20,137,125,262,484
0,-60,-40,139,123,262,408
40,-70,0,129,133,262,394
60,-60,30,135,129,264,474
-10,-50,-50,134,131,265,480
40,-70,10,129,136,265,486
10,-50,-30,136,129,265,469
30,-60,-10,133,133,266,405
40,-50,10,133,133,266,442
-10,-70,-50,139,129,268,472
10,-70,-30,138,130,268,412
50,-60,10,135,133,268,409
10,-40,-20,144,125,269,411
20,-60,-10,141,129,270,431
60,-50,30,140,130,270,506
10,-60,-30,141,130,271,435
0,-70,-40,136,135,271,445
-20,-20,-40,139,133,272,476
0,-70,-30,145,128,273,549
-20,-50,-60,133,140,273,494
10,-70,-20,138,135,273,530
30,-70,0,141,132,273,490
-10,-70,-40,143,131,274,569
-160,50,90,132,142,274,492
50,-70,10,138,137,275,428
20,-60,-20,139,136,275,435
20,-70,-10,141,134,275,508
-170,40,90,134,141,275,433
20,-70,-20,145,130,275,408
-150,60,80,136,140,276,472
30,-50,0,142,136,278,448
20,-50,-10,143,137,280,450
0,-40,-20,152,128,280,488
-130,50,60,131,152,283,464
-170,20,100,136,147,283,441
-20,-50,-40,150,133,283,517
-30,-60,-60,145,140,285,484
-140,50,70,142,143,285,449
-150,50,80,140,148,288,471
-20,-70,-50,147,143,290,596
0,-40,-40,148,142,290,542
-30,-70,-70,147,143,290,512
10,-40,-30,147,144,291,553
60,-40,30,153,139,292,533
20,-50,-20,147,145,292,523
0,-30,-20,153,139,292,538
-10,-20,-30,146,147,293,551
-170,50,100,150,143,293,539
-40,-60,-80,148,146,294,517
60,-60,20,150,145,295,482
-120,50,50,141,154,295,511
60,-70,20,149,146,295,479
-30,-40,-60,152,144,296,521
-140,60,70,144,152,296,501
10,-30,-20,148,148,296,517
50,-70,20,145,151,296,497
-130,40,60,154,143,297,477
-150,40,80,148,149,297,495
-160,40,90,149,148,297,511
-160,60,90,143,155,298,506
-160,40,80,150,148,298,463
70,-60,40,155,143,298,542
-130,60,60,141,159,300,493
180,40,100,157,144,301,538
-180,40,100,157,144,301,538
-10,-50,-30,163,139,302,524
20,-80,-20,154,148,302,555
50,-40,20,158,144,302,528
-150,30,80,161,142,303,502
-40,-40,-60,155,149,304,558
-140,40,70,151,153,304,480
60,-70,30,147,158,305,537
30,-50,-10,158,147,305,559
-150,50,70,152,154,306,515
-30,-70,-60,148,158,306,631
20,-40,-10,160,146,306,511
40,-50,0,161,148,309,554
10,-80,-30,153,156,309,569
30,-40,0,159,150,309,524
-20,-30,-50,150,160,310,487
70,-50,40,164,146,310,578
-30,-50,-70,155,155,310,530
30,-80,-10,156,155,311,562
50,-50,10,150,161,311,524
-30,-50,-50,167,144,311,562
-30,-20,-40,158,154,312,540
-40,-70,-80,156,156,312,555
-130,40,50,155,157,312,473
-170,30,100,156,157,313,590
-180,50,110,164,150,314,609
180,50,110,164,150,314,609
-150,40,70,155,159,314,486
-10,-40,-50,161,154,315,576
-40,-50,-70,162,153,315,602
170,40,110,163,152,315,622
-120,60,50,150,166,316,511
40,-40,10,162,154,316,554
-170,50,90,154,163,317,562
40,-40,20,163,155,318,555
-160,30,90,158,162,320,572
0,-80,-40,155,165,320,569
40,-80,0,162,160,322,558
-170,40,100,166,156,322,627
-40,-60,-70,165,157,322,563
-40,-30,-50,164,158,322,620
-30,-30,-40,158,165,323,540
70,-70,30,163,160,323,545
50,-40,30,170,153,323,636
-30,-20,-50,163,161,324,550
-140,40,60,165,159,324,523
20,-40,-20,165,159,324,640
-40,-70,-70,159,166,325,645
-120,40,50,163,162,325,574
180,50,100,156,170,326,551
-140,30,70,168,158,326,539
40,-50,20,164,162,326,568
-180,50,100,156,170,326,551
-140,50,60,158,169,327,570
20,-30,-10,166,161,327,612
70,-70,40,156,172,328,592
-40,-30,-60,162,168,330,596
-170,60,100,161,170,331,573
30,-30,0,164,168,332,572
-10,-80,-50,168,166,334,592
0,-50,-20,174,160,334,575
60,-50,20,168,167,335,534
-40,-20,-50,165,170,335,617
40,-30,20,174,163,337,597
50,-80,10,166,171,337,574
50,-50,30,177,162,339,606
180,40,110,174,165,339,717
-10,-20,-40,168,171,339,602
-40,-40,-70,171,168,339,624
-180,40,110,174,165,339,717
60,-50,40,176,164,340,668
0,-20,-30,173,167,340,618
30,-60,10,172,168,340,663
30,-40,10,175,165,340,575
-50,-70,-90,164,176,340,629
0,-60,-20,179,162,341,691
70,-60,30,176,165,341,546
40,-60,20,168,173,341,635
-40,-50,-60,174,167,341,630
20,-30,-20,171,171,342,623
60,-80,20,169,173,342,597
-180,10,110,174,170,344,708
180,10,110,174,170,344,708
-20,-80,-60,174,170,344,632
50,-30,20,170,176,346,616
0,-20,-20,177,170,347,655
-20,-30,-30,181,166,347,633
40,-80,10,175,172,347,665
-10,-60,-30,182,165,347,661
-50,-60,-90,171,176,347,575
-20,-10,-40,177,171,348,682
50,-30,30,181,167,348,669
20,-60,0,182,167,349,739
-30,-80,-70,172,177,349,651
-50,-40,-70,172,177,349,716
-180,20,110,175,175,350,644
30,-80,0,175,175,350,648
180,60,110,173,177,350,623
50,-60,30,176,174,350,650
-180,60,110,173,177,350,623
70,-40,40,178,172,350,631
10,-80,-20,175,175,350,680
180,20,110,175,175,350,644
-110,50,40,179,172,351,614
60,-40,40,190,161,351,718
-20,-60,-40,184,167,351,689
60,-30,30,178,173,351,659
30,-40,-10,176,175,351,690
-20,-40,-60,174,177,351,654
10,-60,-10,182,169,351,730
20,-80,-10,174,178,352,660
10,-40,-10,180,172,352,643
-180,30,110,173,180,353,658
50,-80,20,172,181,353,667
-160,20,100,184,169,353,593
60,-60,40,178,175,353,646
180,30,110,173,180,353,658
-40,-80,-80,175,178,353,668
80,-70,40,180,173,353,627
80,-70,50,167,186,353,610
-170,10,100,176,178,354,588
10,-30,-10,181,173,354,658
30,-30,-10,175,180,355,678
-160,50,80,177,178,355,618
20,-50,0,185,171,356,682
80,-80,40,173,183,356,638
70,-80,30,175,181,356,611
40,-30,10,177,180,357,601
60,-30,40,187,170,357,706
-30,-10,-40,186,171,357,704
170,50,120,176,181,357,694
30,-50,10,186,171,357,628
-150,20,90,182,175,357,601
-50,-50,-80,187,171,358,698
-50,-70,-80,175,184,359,702
10,-50,-10,182,177,359,663
170,20,110,177,183,360,619
60,-80,30,175,185,360,687
-160,70,90,179,181,360,600
-120,40,40,180,181,361,592
-30,-60,-50,184,178,362,719
-20,-20,-30,186,176,362,663
0,-80,-30,186,176,362,727
40,-20,10,182,181,363,623
30,-30,10,189,175,364,592
50,-70,30,180,184,364,736
-110,60,40,178,187,365,601
70,-80,40,178,187,365,711
-10,-10,-30,182,183,365,739
-10,-80,-40,190,175,365,752
160,50,120,181,184,365,670
10,-20,-20,186,179,365,670
-130,50,50,172,193,365,593
30,-70,10,183,182,365,754
-50,-60,-80,191,174,365,685
20,-40,0,184,181,365,663
180,30,100,191,175,366,642
-180,30,100,191,175,366,642
40,-70,20,184,182,366,733
-120,50,40,176,190,366,598
-20,-40,-30,192,174,366,698
20,-20,-20,181,185,366,683
10,-30,-30,176,191,367,644
-40,-40,-50,189,178,367,707
-20,-80,-50,189,179,368,780
90,-70,50,192,176,368,717
160,40,120,189,179,368,721
-60,-70,-100,178,191,369,719
30,-20,0,190,179,369,642
-50,-80,-90,183,186,369,725
-170,70,100,182,188,370,620
-50,-30,-60,186,184,370,729
-160,10,100,188,182,370,652
80,-60,50,189,181,370,678
-130,30,60,187,183,370,667
170,50,110,192,179,371,663
20,-70,0,194,178,372,800
-150,70,80,185,187,372,631
-160,20,90,184,189,373,583
-30,-40,-40,191,182,373,705
90,-80,50,185,189,374,685
70,-50,30,191,183,374,570
40,-40,0,188,186,374,747
10,-70,-10,196,179,375,805
-150,30,90,192,184,376,714
-20,-10,-30,196,180,376,789
180,20,100,186,190,376,603
70,-50,50,200,176,376,724
-180,20,100,186,190,376,603
-180,0,110,186,191,377,691
180,0,110,186,191,377,691
-40,-50,-80,191,186,377,658
170,30,110,188,189,377,701
-30,-80,-60,192,185,377,803
30,-20,10,192,186,378,657
30,-20,-10,184,194,378,696
-160,30,80,190,189,379,641
-150,50,90,187,192,379,670
-50,-50,-70,189,190,379,744
-160,30,100,196,183,379,735
-50,-40,-80,184,196,380,742
90,-70,60,187,193,380,706
170,60,120,189,191,380,710
100,-80,60,192,188,380,719
0,-70,-20,192,188,380,836
-60,-80,-100,188,192,380,750
-10,-70,-30,199,181,380,847
-60,-70,-90,185,195,380,755
20,-20,-10,191,190,381,714
-10,-30,-20,196,186,382,729
110,-80,70,197,186,383,729
-110,40,40,192,191,383,716
-160,50,100,182,201,383,729
170,40,120,197,186,383,825
-20,-20,-50,192,192,384,687
80,-80,50,188,196,384,728
-170,0,110,186,199,385,714
-140,30,80,185,200,385,671
70,-60,50,194,192,386,703
-40,-20,-40,200,186,386,700
60,-70,40,189,198,387,767
0,-60,-50,199,188,387,738
90,-90,50,194,194,388,727
-70,-90,-110,194,194,388,727
70,-90,30,194,194,388,727
110,-90,70,194,194,388,727
80,-90,40,194,194,388,727
120,-90,80,194,194,388,727
-180,-90,140,194,194,388,727
-110,-90,-150,194,194,388,727
-130,-90,-170,194,194,388,727
-40,-90,-80,194,194,388,727
40,-90,0,194,194,388,727
-80,-90,-120,194,194,388,727
-90,-90,-130,194,194,388,727
50,-90,10,194,194,388,727
-120,-90,-160,194,194,388,727
130,-90,90,194,194,388,727
-150,-90,170,194,194,388,727
10,-90,-30,194,194,388,727
0,-90,-40,194,194,388,727
180,-90,140,194,194,388,727
100,-90,60,194,194,388,727
-50,-90,-90,194,194,388,727
-160,-90,160,194,194,388,727
-140,-90,-180,194,194,388,727
-170,50,110,193,195,388,784
140,-90,100,194,194,388,727
-170,-90,150,194,194,388,727
160,-90,120,194,194,388,727
-130,40,70,187,201,388,696
-180,-10,110,197,191,388,733
-10,-90,-50,194,194,388,727
30,-90,-10,194,194,388,727
180,-10,110,197,191,388,733
20,-90,-20,194,194,388,727
-20,-90,-60,194,194,388,727
170,-90,130,194,194,388,727
60,-90,20,194,194,388,727
150,-90,110,194,194,388,727
-60,-90,-100,194,194,388,727
-30,-90,-70,194,194,388,727
-140,-90,180,194,194,388,727
-100,-90,-140,194,194,388,727
-150,60,90,191,198,389,688
-140,60,80,196,193,389,664
-70,-80,-110,192,197,389,781
-10,-20,-20,201,188,389,752
-40,-60,-60,193,196,389,820
10,-70,-40,186,204,390,649
0,-70,-50,196,195,391,630
-30,-30,-60,189,202,391,693
-140,50,80,197,194,391,672
20,-30,0,193,199,392,729
-140,20,80,193,199,392,652
-10,-70,-60,201,191,392,679
90,-80,60,195,198,393,750
-130,60,70,192,201,393,642
160,50,130,198,196,394,756
-70,-70,-110,198,196,394,786
80,-60,40,215,180,395,640
-40,-80,-70,205,190,395,847
120,-80,80,198,197,395,742
-130,50,70,193,203,396,696
-10,-80,-60,195,201,396,686
-30,-40,-70,192,204,396,756
-160,60,100,193,204,397,729
70,-40,50,210,187,397,806
-140,40,80,207,191,398,709
-20,-70,-70,196,202,398,702
-170,30,90,205,193,398,666
-150,40,90,206,192,398,796
70,-30,40,206,192,398,697
30,-70,-20,188,210,398,615
-20,-70,-40,205,193,398,833
-50,-80,-80,205,193,398,874
-130,30,50,199,200,399,662
-140,70,70,198,201,399,696
0,-80,-50,195,204,399,669
-80,-80,-120,193,206,399,816
0,-10,-20,207,192,399,771
50,-20,20,203,197,400,676
-180,70,110,204,196,400,684
180,70,110,204,196,400,684
40,-30,0,205,195,400,773
-10,-40,-20,206,194,400,759
-30,-70,-80,200,201,401,706
40,-70,-10,193,208,401,628
40,-20,0,205,196,401,680
150,50,130,206,195,401,748
140,-80,100,208,193,401,803
10,-20,-30,202,199,401,756
10,-60,-40,200,202,402,760
100,-80,70,199,203,402,793
-90,-80,-130,197,205,402,818
-130,70,60,204,199,403,727
-10,-10,-40,207,196,403,786
-40,-70,-90,199,205,404,702
150,50,140,210,194,404,859
-10,-60,-60,205,199,404,746
-140,70,80,203,201,404,706
-130,70,70,199,205,404,707
0,-30,-40,195,209,404,751
10,-80,-40,191,213,404,669
-50,-40,-60,207,197,404,828
160,60,130,208,197,405,773
80,-50,50,216,189,405,727
100,-70,70,207,199,406,757
20,-70,-30,196,210,406,645
20,-80,-30,191,215,406,657
-150,20,80,202,204,406,673
100,-70,60,209,198,407,771
-20,-80,-70,198,209,407,718
-170,-10,110,206,201,407,829
-160,70,100,207,200,407,705
-20,-60,-70,210,198,408,758
50,-40,10,210,198,408,795
-120,60,60,193,215,408,691
130,-80,90,204,204,408,781
-30,-10,-30,216,192,408,808
-150,70,90,208,201,409,693
40,-20,20,213,196,409,766
-170,60,110,204,205,409,797
70,-70,50,200,210,410,814
70,-30,50,218,193,411,819
-120,50,60,205,206,411,754
-170,10,110,201,210,411,819
150,-80,110,213,199,412,816
-60,-80,-90,209,203,412,893
10,-20,-10,213,199,412,734
-120,70,60,205,208,413,741
0,-10,-30,203,210,413,815
60,-40,20,200,215,415,748
-30,-60,-80,211,204,415,806
30,-80,-20,200,215,415,670
-60,-60,-100,208,207,415,727
-40,-80,-90,201,214,415,727
-60,-50,-90,209,206,415,785
-100,-80,-140,204,212,416,869
160,40,130,209,207,416,906
-50,-30,-70,218,198,416,766
-80,-70,-120,213,204,417,862
150,60,140,207,210,417,831
110,-70,70,212,205,417,791
110,-80,80,214,203,417,816
170,0,110,216,202,418,805
50,-70,0,204,214,418,646
90,-60,60,215,203,418,806
-30,-70,-50,213,205,418,856
10,-10,-20,220,198,418,832
-180,60,100,194,225,419,763
-50,-30,-50,203,216,419,812
60,-20,30,213,206,419,758
-60,-40,-80,210,209,419,843
50,-20,30,210,209,419,778
-170,20,110,216,203,419,790
150,40,130,213,206,419,849
180,60,100,194,225,419,763
-30,-80,-80,202,218,420,738
-50,-50,-90,219,201,420,804
-110,-80,-150,205,215,420,888
-70,-70,-100,206,215,421,831
-160,40,100,210,211,421,846
-40,-60,-90,211,210,421,800
-50,-70,-100,209,212,421,732
20,-20,0,212,210,422,783
-100,50,30,215,207,422,759
-50,-20,-50,202,220,422,779
40,-80,20,212,210,422,917
-50,-80,-100,207,216,423,742
-170,30,110,210,213,423,828
-60,-60,-90,214,209,423,840
-40,-10,-40,217,207,424,800
160,-80,120,227,197,424,831
-50,-60,-70,213,211,424,895
140,50,150,215,209,424,875
-30,-50,-40,216,209,425,832
-30,-20,-30,215,210,425,858
-20,-50,-30,216,209,425,846
30,-10,0,216,209,425,812
-110,60,50,210,216,426,724
-120,30,50,217,209,426,731
20,-60,-30,212,214,426,805
30,-40,20,219,207,426,828
-40,-30,-40,215,212,427,855
120,-80,90,219,208,427,828
50,-40,40,215,212,427,825
30,-60,-20,214,213,427,810
-120,70,50,214,214,428,764
-170,40,110,212,216,428,898
-110,-80,-160,210,218,428,806
-90,50,20,218,210,428,812
-170,70,110,219,209,428,733
170,30,120,207,221,428,864
30,-80,10,215,213,428,908
40,-80,-10,209,220,429,689
120,-70,80,216,213,429,821
-120,-80,-160,209,220,429,910
-70,-80,-100,218,211,429,945
-100,60,30,213,216,429,773
130,-70,90,214,215,429,843
-60,-80,-110,207,222,429,762
60,-40,50,230,200,430,913
60,-20,40,221,209,430,841
50,-30,10,216,214,430,828
50,-20,10,215,216,431,816
20,-10,-10,219,212,431,778
-40,-50,-50,222,209,431,869
-150,60,70,212,220,432,803
170,-80,130,231,201,432,856
-20,0,-30,219,213,432,903
-10,-10,-20,224,208,432,847
40,-10,10,214,219,433,740
40,-40,30,228,205,433,821
-130,30,70,205,228,433,823
-80,-80,-130,217,216,433,782
180,60,120,222,212,434,877
170,70,120,211,223,434,771
-180,60,120,222,212,434,877
-60,-50,-80,217,217,434,873
-100,-80,-150,214,220,434,784
50,-80,30,218,217,435,916
170,10,110,224,212,436,809
-180,70,120,220,216,436,787
-120,-80,-170,213,223,436,806
-90,-80,-140,216,220,436,783
180,70,120,220,216,436,787
20,-80,0,220,217,437,924
-130,-80,-170,215,222,437,917
-150,-90,-180,216,222,438,904
20,-90,-10,216,222,438,904
-70,-90,-100,216,222,438,904
30,-90,0,216,222,438,904
100,-90,70,216,222,438,904
80,-90,50,216,222,438,904
-80,-90,-110,216,222,438,904
140,-90,110,216,222,438,904
-170,-90,160,216,222,438,904
-130,-90,-160,216,222,438,904
-50,-90,-80,216,222,438,904
-20,-90,-50,216,222,438,904
110,-90,80,216,222,438,904
-150,-90,180,216,222,438,904
130,-90,100,216,222,438,904
90,-90,60,216,222,438,904
-60,-90,-90,216,222,438,904
-140,-90,-170,216,222,438,904
120,-90,90,216,222,438,904
-90,-90,-120,216,222,438,904
70,-90,40,216,222,438,904
60,-90,30,216,222,438,904
-120,-90,-150,216,222,438,904
-110,-90,-140,216,222,438,904
10,-90,-20,216,222,438,904
-180,-90,150,216,222,438,904
160,-90,130,216,222,438,904
180,-90,150,216,222,438,904
-160,-90,170,216,222,438,904
50,-90,20,216,222,438,904
170,-90,140,216,222,438,904
40,-90,10,216,222,438,904
150,-90,120,216,222,438,904
-30,-90,-60,216,222,438,904
-110,70,50,211,227,438,806
-40,-90,-70,216,222,438,904
40,-60,-10,224,214,438,839
-10,-90,-40,216,222,438,904
0,-90,-30,216,222,438,904
-100,-90,-130,216,222,438,904
180,-80,140,228,211,439,869
-180,-80,140,228,211,439,869
-10,-30,-50,212,227,439,880
-70,-60,-110,219,220,439,844
50,-80,0,222,217,439,723
40,-50,30,225,214,439,849
110,-70,80,222,218,440,817
-40,-70,-60,225,215,440,868
50,-50,40,224,216,440,843
130,-80,100,224,216,440,871
170,-10,110,218,222,440,797
-140,-80,-180,215,226,441,933
-80,-80,-110,221,220,441,963
-140,-80,180,215,226,441,933
-170,-80,150,222,219,441,885
-60,-40,-90,224,218,442,849
-90,70,30,216,226,442,892
60,-80,40,224,218,442,915
0,-20,-40,219,223,442,862
-90,-70,-130,223,219,442,950
-130,-80,180,216,227,443,824
0,-50,-50,228,215,443,845
-130,-80,-180,216,227,443,824
-110,50,50,222,221,443,864
-40,-40,-80,215,228,443,899
30,-10,-10,222,221,443,882
-40,-30,-70,218,225,443,817
-60,-70,-110,215,229,444,815
80,-60,60,218,226,444,837
-10,-50,-60,221,223,444,841
-170,60,90,214,231,445,870
-160,-80,150,226,219,445,855
-100,70,40,214,231,445,859
0,-80,-20,221,224,445,954
50,-10,20,222,223,445,777
0,-30,-10,229,216,445,868
-70,-80,-120,221,224,445,791
170,0,120,227,219,446,853
40,-30,30,234,212,446,877
30,-30,20,230,216,446,840
-100,40,30,218,228,446,924
130,50,160,224,222,446,872
10,-80,-10,224,222,446,926
140,40,150,220,226,446,1013
-150,-90,160,220,227,447,845
120,-90,70,220,227,447,845
-40,-90,-90,220,227,447,845
-30,-10,-50,227,220,447,884
30,-90,-20,220,227,447,845
-10,-80,-30,219,228,447,960
-100,-90,-150,220,227,447,845
100,-90,50,220,227,447,845
-80,-90,-130,220,227,447,845
-60,-90,-110,220,227,447,845
90,-90,40,220,227,447,845
40,-90,-10,220,227,447,845
-20,-90,-70,220,227,447,845
20,-90,-30,220,227,447,845
-110,-90,-160,220,227,447,845
60,-90,10,220,227,447,845
0,-90,-50,220,227,447,845
-30,-90,-80,220,227,447,845
-120,-90,-170,220,227,447,845
180,-90,130,220,227,447,845
160,-90,110,220,227,447,845
-170,-90,140,220,227,447,845
130,-90,80,220,227,447,845
170,-90,120,220,227,447,845
-130,-90,-180,220,227,447,845
-130,-90,180,220,227,447,845
110,-90,60,220,227,447,845
50,-90,0,220,227,447,845
140,-90,90,220,227,447,845
-70,-90,-120,220,227,447,845
-160,-90,150,220,227,447,845
-90,-90,-140,220,227,447,845
-180,-90,130,220,227,447,845
70,-90,20,220,227,447,845
80,-90,30,220,227,447,845
-10,-90,-60,220,227,447,845
10,-90,-40,220,227,447,845
140,40,140,233,214,447,949
150,-90,100,220,227,447,845
-50,-90,-100,220,227,447,845
-140,-90,170,220,227,447,845
150,40,140,224,224,448,984
-150,-80,170,221,227,448,906
170,10,120,227,221,448,968
170,60,110,219,229,448,815
60,-70,10,226,223,449,678
-30,0,-30,237,212,449,887
-180,-80,130,229,221,450,863
130,40,160,227,223,450,876
-160,-80,160,229,221,450,892
-140,-80,170,219,231,450,858
180,-80,130,229,221,450,863
-110,70,40,218,233,451,827
-140,60,60,230,221,451,886
-170,-80,140,231,220,451,836
60,-30,20,235,216,451,929
50,-10,10,229,223,452,818
140,50,140,234,218,452,870
160,20,120,231,221,452,833
-120,40,60,230,223,453,792
40,-10,0,227,226,453,812
140,-80,110,227,226,453,908
170,60,130,230,223,453,930
10,-50,-40,226,228,454,881
-150,80,90,227,227,454,861
170,-80,120,232,222,454,894
70,-40,30,216,238,454,785
160,30,120,231,223,454,903
-160,60,80,225,230,455,871
-150,-80,160,227,228,455,863
-60,-50,-100,224,231,455,916
180,50,120,229,226,455,901
-100,60,40,224,231,455,802
-110,40,30,220,235,455,866
-10,0,-30,232,223,455,907
-180,50,120,229,226,455,901
50,-60,0,226,230,456,822
-50,-70,-70,234,222,456,908
70,-80,50,232,225,457,935
20,-30,10,234,223,457,923
-20,-80,-40,226,231,457,990
20,-10,0,238,219,457,893
-170,0,100,226,231,457,794
-140,80,80,228,230,458,877
170,20,120,223,235,458,922
-120,30,40,240,218,458,748
20,-50,-30,238,220,458,943
140,-70,100,231,227,458,895
60,-80,10,232,226,458,755
-80,50,10,232,227,459,843
60,-30,50,238,222,460,986
-90,60,30,221,239,460,888
-10,-50,-20,238,222,460,898
-30,0,-40,227,234,461,851
50,-30,40,241,220,461,911
100,-60,70,237,224,461,884
-70,40,0,230,231,461,845
-50,50,-10,220,241,461,863
80,-70,60,225,236,461,911
140,60,150,228,233,461,886
160,-80,110,238,223,461,925
-60,40,-10,229,232,461,857
0,-40,-10,237,225,462,885
-80,-70,-110,230,232,462,944
-50,-60,-100,228,234,462,822
60,-20,50,244,218,462,1023
-160,0,110,229,233,462,983
-90,-80,-120,230,233,463,997
-180,10,100,229,234,463,713
180,10,100,229,234,463,713
-20,0,-40,233,230,463,908
-130,20,70,229,234,463,837
0,-20,-10,236,228,464,895
160,70,140,233,231,464,826
-140,30,60,230,235,465,859
30,-50,20,242,223,465,908
180,40,120,227,239,466,952
-60,-40,-70,245,221,466,982
-180,40,120,227,239,466,952
70,-80,20,238,228,466,821
-30,-80,-50,232,234,466,1023
-120,80,60,227,240,467,892
20,-10,-20,230,237,467,906
-40,-20,-60,235,232,467,901
170,70,130,234,233,467,839
160,10,120,237,231,468,978
-70,-70,-120,233,235,468,867
90,-60,50,240,228,468,836
30,-10,10,241,227,468,887
140,-80,90,243,225,468,950
150,-80,120,232,237,469,945
-160,80,100,233,236,469,861
-150,30,70,245,224,469,784
-70,-60,-100,239,231,470,961
150,-80,100,246,224,470,945
-100,-70,-150,228,242,470,938
-50,30,-20,235,235,470,923
-40,-10,-30,245,225,470,990
-170,80,110,239,231,470,843
-40,-10,-50,238,232,470,916
-130,80,70,232,238,470,880
-90,-70,-140,235,235,470,895
150,70,150,235,235,470,841
140,70,160,243,228,471,831
-80,70,20,233,238,471,967
20,-20,10,238,233,471,911
30,-50,-20,237,235,472,1018
-50,-20,-40,242,230,472,931
-180,-20,110,240,232,472,960
10,-10,-10,241,231,472,899
120,-70,90,232,240,472,882
180,-20,110,240,232,472,960
170,-10,120,242,231,473,945
-60,-30,-70,247,226,473,899
-50,-50,-60,236,237,473,958
120,40,170,227,246,473,930
-20,-10,-20,245,228,473,973
80,-80,60,247,227,474,951
40,-20,30,245,229,474,972
-90,60,20,225,249,474,945
-60,50,0,229,245,474,891
-80,-70,-130,231,243,474,905
-160,-10,110,237,237,474,925
-130,60,50,240,235,475,907
-140,20,70,245,230,475,805
160,60,140,240,235,475,962
50,-10,30,236,240,476,889
80,-50,60,252,224,476,894
30,-40,-20,232,244,476,985
150,60,150,238,238,476,988
-100,-70,-140,239,237,476,1044
-30,-30,-30,240,236,476,948
40,-10,20,248,229,477,887
-20,-50,-70,230,247,477,961
160,70,130,240,238,478,855
60,-50,50,243,235,478,953
180,80,120,242,236,478,844
-180,80,120,242,236,478,844
130,40,150,254,225,479,989
120,40,160,247,232,479,930
50,-60,40,238,241,479,979
20,-50,10,245,234,479,1035
20,-40,10,250,229,479,979
150,-70,110,242,237,479,941
160,30,130,240,240,480,1044
140,60,160,240,240,480,984
80,-80,30,247,233,480,876
-90,40,20,240,240,480,935
170,80,130,246,234,480,835
-40,0,-30,249,231,480,935
10,-40,0,245,236,481,1013
-110,50,30,234,247,481,857
-150,20,100,247,234,481,933
-60,-70,-80,248,233,481,957
90,-80,70,248,233,481,976
-20,-20,-20,241,240,481,981
-40,-80,-60,236,246,482,1051
130,-80,80,249,233,482,939
-80,40,10,242,240,482,925
160,80,140,248,234,482,866
130,40,170,244,238,482,958
60,-10,30,246,237,483,880
-110,30,30,252,231,483,851
160,0,120,240,243,483,957
10,0,-20,238,245,483,962
-60,-60,-80,240,243,483,1028
-60,30,-10,237,247,484,929
-20,-10,-50,238,246,484,950
80,-50,40,247,237,484,791
-80,60,10,231,253,484,949
50,-20,40,257,227,484,1002
-50,40,-10,244,241,485,943
-100,80,40,231,254,485,950
-70,60,10,234,251,485,918
-100,50,40,243,242,485,963
150,80,150,248,237,485,880
60,-20,20,246,239,485,1044
160,-80,130,242,243,485,972
-40,50,-20,237,249,486,884
30,-20,20,253,233,486,949
-90,80,30,240,246,486,945
-110,80,50,229,257,486,946
80,-40,50,249,237,486,853
-100,-80,-130,239,247,486,1039
120,40,180,249,237,486,973
120,40,-180,249,237,486,973
70,-70,20,244,242,486,783
80,-40,60,265,222,487,981
130,50,150,243,244,487,996
60,-10,40,241,246,487,920
160,-70,120,246,241,487,951
40,-50,-10,247,240,487,1065
40,-60,30,246,241,487,985
10,-10,-30,244,243,487,1001
110,40,-170,251,237,488,946
-10,0,-20,252,236,488,974
-80,60,20,236,252,488,955
-110,30,40,252,236,488,879
10,-30,0,250,239,489,999
180,0,120,249,240,489,924
-180,0,120,249,240,489,924
-50,-20,-60,247,242,489,926
-70,-50,-100,245,244,489,960
-50,0,-30,257,233,490,966
30,-60,20,250,240,490,1022
-40,40,-20,238,252,490,981
140,50,160,249,241,490,1039
40,-20,-10,251,240,491,968
130,50,170,252,240,492,1051
110,60,-160,255,237,492,898
130,60,170,250,242,492,950
-150,10,100,252,240,492,935
-30,-60,-40,249,243,492,1044
110,50,-160,256,237,493,881
-60,60,0,237,256,493,933
150,50,150,248,245,493,1093
180,-10,120,245,248,493,1026
-110,40,50,247,246,493,985
0,0,-30,253,240,493,1029
-80,-60,-120,248,245,493,939
-180,-10,120,245,248,493,1026
50,0,10,242,251,493,925
-50,-80,-70,242,252,494,1052
60,-60,10,244,250,494,847
130,70,170,259,235,494,861
170,50,130,252,242,494,1069
-110,-70,-160,241,254,495,972
20,-40,-30,240,255,495,1009
-140,20,90,250,245,495,955
10,-50,0,255,241,496,1093
30,-30,-20,242,254,496,1052
-70,70,10,249,247,496,986
10,-40,-40,237,259,496,1065
-40,0,-40,249,247,496,903
-60,-60,-110,242,254,496,842
0,0,-20,254,243,497,973
160,50,140,251,246,497,1102
-100,70,30,235,262,497,940
-60,40,0,246,251,497,957
150,30,130,254,243,497,1081
-80,80,20,252,246,498,940
70,-20,40,256,242,498,896
100,-80,80,259,239,498,1013
-30,10,-30,257,241,498,985
-70,-40,-90,257,241,498,986
-170,-20,120,247,252,499,1081
40,0,10,250,249,499,981
90,-70,70,248,251,499,975
70,-40,60,258,241,499,1073
-120,-70,-170,251,248,499,1004
140,80,160,253,246,499,911
0,-50,-10,259,240,499,1039
-40,60,-20,246,253,499,959
60,-60,50,246,253,499,1020
-50,-10,-40,258,242,500,912
-110,-80,-140,250,250,500,1040
110,30,-170,262,238,500,955
160,60,120,246,254,500,944
-60,-50,-70,255,245,500,1045
50,-20,0,253,247,500,1030
-20,-30,-60,244,256,500,990
-60,-30,-80,253,247,500,984
20,-60,10,249,251,500,1071
-20,-60,-30,260,241,501,1065
120,30,170,250,252,502,947
-60,-30,-60,270,232,502,1006
170,-80,140,255,247,502,1020
10,-20,0,253,250,503,984
50,0,20,257,246,503,916
120,70,-170,255,248,503,922
180,10,120,255,248,503,1051
-20,-30,-20,262,241,503,1047
0,-10,-10,253,250,503,973
180,-80,150,258,245,503,1063
-180,10,120,255,248,503,1051
-180,-80,150,258,245,503,1063
-30,70,-20,255,249,504,993
70,-20,50,267,237,504,944
110,-60,80,255,249,504,971
-70,50,0,254,250,504,898
30,-20,-20,247,257,504,972
120,60,-180,259,245,504,920
120,60,180,259,245,504,920
-110,-70,-150,248,256,504,1091
-20,10,-30,263,241,504,1037
-40,-20,-30,254,251,505,1067
110,40,180,248,257,505,978
-20,0,-20,267,238,505,1063
170,-20,110,258,247,505,990
110,40,-180,248,257,505,978
120,-80,70,257,248,505,978
90,-50,60,265,241,506,913
-40,30,-20,254,252,506,1054
-40,10,-30,260,246,506,966
-50,40,-20,247,259,506,962
-140,30,90,257,249,506,1002
-30,-50,-80,255,251,506,1015
120,50,180,263,243,506,1028
120,50,-180,263,243,506,1028
-130,-70,-180,252,254,506,1006
-130,-70,180,252,254,506,1006
110,30,180,261,246,507,938
-120,60,40,252,255,507,916
-50,60,-10,244,263,507,947
-100,40,20,252,255,507,952
110,30,-180,261,246,507,938
-50,-40,-90,255,253,508,1053
-30,-20,-60,254,254,508,1071
120,50,170,255,253,508,983
-70,-50,-90,257,251,508,1036
-120,30,60,249,260,509,1022
130,60,160,243,266,509,954
40,-30,-10,248,262,510,1037
-40,80,-10,255,255,510,1002
-70,50,10,254,256,510,931
50,-10,40,260,250,510,1079
-160,-70,150,267,243,510,1036
-40,-60,-50,253,257,510,1079
-90,50,30,253,257,510,1004
0,80,-50,265,245,510,977
-160,10,110,253,258,511,1091
20,-30,-30,251,260,511,1089
130,-70,100,252,259,511,960
50,-10,0,256,256,512,988
-70,80,10,254,258,512,959
-100,30,30,254,258,512,1121
120,70,180,261,251,512,904
130,80,170,258,254,512,924
120,70,-180,261,251,512,904
0,-10,-40,258,254,512,1054
-150,30,100,264,248,512,979
180,-20,120,259,254,513,1146
40,-40,-10,257,256,513,1038
60,-10,20,259,254,513,1029
170,-70,130,261,252,513,1000
90,-80,40,262,251,513,935
-40,-50,-90,265,248,513,1038
90,-60,70,251,262,513,963
-170,20,90,255,258,513,859
-180,-20,120,259,254,513,1146
150,70,140,261,253,514,942
-180,-70,130,267,247,514,1064
180,-70,130,267,247,514,1064
-30,60,-20,258,256,514,976
0,-60,-10,268,247,515,1130
-20,70,-30,257,258,515,1004
40,0,0,258,257,515,994
-50,80,0,261,254,515,1001
170,-70,120,267,249,516,1078
70,-30,30,260,256,516,1020
-40,70,-10,261,255,516,1029
-50,-40,-50,261,255,516,1071
-10,-60,-20,271,246,517,1102
-120,-80,-150,261,256,517,1056
-60,70,0,259,258,517,1003
60,-10,50,270,247,517,1084
-70,-60,-120,263,254,517,933
-130,-80,-160,262,255,517,1061
40,-10,-10,257,260,517,999
-170,-20,110,262,256,518,953
-100,70,50,256,262,518,1051
110,70,-160,269,249,518,928
-60,-80,-80,254,264,518,1093
-60,50,-10,261,257,518,934
160,-10,120,257,262,519,998
-80,50,20,259,260,519,1013
-180,30,120,260,259,519,1070
-40,-40,-40,276,243,519,1050
180,30,120,260,259,519,1070
-150,-70,160,271,248,519,1059
60,0,30,268,251,519,947
-120,-70,-160,255,264,519,1128
70,-50,60,276,243,519,1064
100,-80,50,268,251,519,978
70,-30,60,274,245,519,1092
-140,90,80,262,258,520,989
80,90,-140,262,258,520,989
170,90,130,262,258,520,989
120,90,180,262,258,520,989
120,90,-180,262,258,520,989
-130,90,70,262,258,520,989
150,90,150,262,258,520,989
-90,90,30,262,258,520,989
-10,90,-50,262,258,520,989
110,90,-170,262,258,520,989
-180,90,120,262,258,520,989
-120,90,60,262,258,520,989
10,90,-70,262,258,520,989
-160,90,100,262,258,520,989
100,90,-160,262,258,520,989
-70,90,10,262,258,520,989
-150,90,90,262,258,520,989
160,90,140,262,258,520,989
20,90,-80,262,258,520,989
50,90,-110,262,258,520,989
-30,90,-30,262,258,520,989
30,90,-90,262,258,520,989
90,90,-150,262,258,520,989
130,90,170,262,258,520,989
0,90,-60,262,258,520,989
-80,90,20,262,258,520,989
-100,90,40,262,258,520,989
-60,90,0,262,258,520,989
40,90,-100,262,258,520,989
-20,90,-40,262,258,520,989
70,90,-130,262,258,520,989
180,90,120,262,258,520,989
140,90,160,262,258,520,989
60,90,-120,262,258,520,989
-40,90,-20,262,258,520,989
-170,90,110,262,258,520,989
-110,90,50,262,258,520,989
-50,10,-30,274,246,520,946
-50,90,-10,262,258,520,989
10,-60,0,268,253,521,1130
100,50,-140,266,255,521,986
10,80,-60,268,253,521,984
-170,-80,160,263,258,521,1083
-20,80,-30,267,254,521,965
120,50,-170,262,259,521,1085
-160,10,90,263,258,521,918
-50,70,-10,259,263,522,995
40,-70,30,260,262,522,1108
-180,20,120,255,267,522,1090
-170,0,120,253,269,522,1094
-80,-60,-110,262,260,522,1078
-30,80,-20,264,258,522,984
-160,0,100,252,270,522,982
180,20,120,255,267,522,1090
30,0,0,269,254,523,1033
-170,-70,140,267,256,523,1062
-20,60,-30,270,253,523,991
120,30,180,267,256,523,955
120,30,-180,267,256,523,955
180,-70,140,264,259,523,1022
-10,80,-40,272,251,523,948
-40,70,-20,257,266,523,948
-180,-70,140,264,259,523,1022
160,-70,110,271,252,523,1032
100,40,-150,262,262,524,923
-70,60,0,254,270,524,948
-150,-80,-180,267,257,524,1075
20,0,-10,272,252,524,1060
-50,30,-10,264,260,524,1042
100,-70,80,265,259,524,1065
-70,30,0,253,271,524,1024
-30,40,-30,264,260,524,998
-150,-80,180,267,257,524,1075
-90,80,40,262,263,525,1066
-130,-70,-170,264,261,525,1133
-30,-40,-30,274,251,525,1075
-110,80,60,262,263,525,1069
-140,-70,170,267,258,525,1058
50,-50,0,265,260,525,1099
-70,-70,-90,270,256,526,1108
140,-60,100,271,255,526,1050
-60,80,0,262,264,526,985
-70,-40,-100,269,257,526,1036
30,-10,20,266,260,526,1065
40,0,20,269,257,526,1055
-140,-80,-170,265,261,526,1079
-130,80,80,263,263,526,1069
140,-90,120,268,259,527,1085
120,-90,100,268,259,527,1085
-50,-90,-70,268,259,527,1085
-70,-90,-90,268,259,527,1085
40,-90,20,268,259,527,1085
70,-90,50,268,259,527,1085
-50,20,-20,265,262,527,1030
180,-90,160,268,259,527,1085
0,-90,-20,268,259,527,1085
20,-90,0,268,259,527,1085
-80,-90,-100,268,259,527,1085
-100,-90,-120,268,259,527,1085
-130,-90,-150,268,259,527,1085
-10,-90,-30,268,259,527,1085
150,-90,130,268,259,527,1085
-120,-90,-140,268,259,527,1085
-90,-90,-110,268,259,527,1085
-60,-90,-80,268,259,527,1085
30,-90,10,268,259,527,1085
-160,-90,180,268,259,527,1085
-170,-90,170,268,259,527,1085
-20,-90,-40,268,259,527,1085
-160,-90,-180,268,259,527,1085
-30,-90,-50,268,259,527,1085
100,60,-150,282,245,527,967
100,-90,80,268,259,527,1085
-180,-90,160,268,259,527,1085
-150,-90,-170,268,259,527,1085
30,0,10,265,262,527,1102
80,-90,60,268,259,527,1085
10,-90,-10,268,259,527,1085
90,-90,70,268,259,527,1085
160,-90,140,268,259,527,1085
130,-90,110,268,259,527,1085
60,-90,40,268,259,527,1085
-140,-90,-160,268,259,527,1085
-110,-90,-130,268,259,527,1085
110,-90,90,268,259,527,1085
170,-90,150,268,259,527,1085
50,-90,30,268,259,527,1085
-40,-90,-60,268,259,527,1085
-120,80,70,263,264,527,1093
110,50,-170,269,259,528,957
-10,70,-40,269,259,528,1012
-10,-20,-50,263,265,528,1086
-100,80,50,262,266,528,1066
-60,80,10,271,257,528,1028
-160,-80,170,270,258,528,1077
-150,40,100,264,265,529,1095
-50,-10,-30,275,254,529,1083
-70,70,20,262,267,529,1107
140,-70,110,265,264,529,1027
-70,80,20,270,259,529,1036
0,70,-50,271,258,529,1017
-90,70,40,255,275,530,1083
10,-70,0,265,265,530,1117
110,-80,60,269,261,530,1003
110,-80,90,272,258,530,1051
150,-60,110,268,262,530,1056
20,0,-20,272,258,530,1048
100,70,-150,281,249,530,962
-10,60,-40,264,266,530,1021
-90,-70,-120,264,267,531,1093
40,-10,30,269,262,531,1122
160,-10,110,269,262,531,975
-100,30,20,264,267,531,1049
50,-70,40,268,263,531,1097
-10,0,-40,258,274,532,1028
-170,-10,120,259,273,532,1169
-140,40,90,276,256,532,1049
120,80,-180,272,260,532,949
110,30,170,275,257,532,1002
-40,20,-30,272,260,532,1056
120,80,180,272,260,532,949
140,80,170,270,262,532,978
0,-40,-50,258,274,532,1098
150,20,130,273,259,532,1110
-130,20,60,265,267,532,967
-60,70,10,273,260,533,1047
-170,-70,150,272,261,533,1048
-80,70,30,265,268,533,1096
-50,70,0,269,264,533,1042
-110,70,60,269,265,534,1019
-50,-50,-100,268,266,534,1054
-30,0,-20,274,260,534,1097
-30,70,-30,256,278,534,1003
10,0,-10,280,254,534,1100
30,0,-10,270,264,534,1045
110,40,-160,274,261,535,1031
30,-70,20,272,263,535,1140
-140,-70,180,268,267,535,1112
-140,-70,-180,268,267,535,1112
-70,-50,-110,272,263,535,1076
-140,80,90,266,269,535,1080
20,-70,10,273,262,535,1153
-150,10,90,272,263,535,961
-90,30,20,261,274,535,1174
-160,80,90,262,274,536,1054
-120,70,70,270,266,536,1014
-130,40,80,266,270,536,1017
-150,80,100,265,271,536,1071
100,-60,60,276,260,536,1027
-50,-20,-70,271,265,536,1018
0,-70,-10,274,262,536,1142
-70,30,-10,266,271,537,1036
110,50,-150,275,262,537,990
50,-20,50,279,258,537,1202
150,30,140,269,268,537,1179
-160,50,110,266,272,538,1073
130,80,-180,275,263,538,972
130,80,180,275,263,538,972
160,-20,110,275,263,538,1039
-40,20,-20,274,264,538,1109
-70,-60,-90,264,274,538,1182
-70,-80,-90,267,272,539,1136
150,80,160,268,271,539,988
110,40,170,281,258,539,971
-80,80,30,274,265,539,1069
-160,40,110,269,270,539,1063
20,80,-70,276,263,539,1012
-60,-20,-50,268,271,539,1037
50,-40,0,279,261,540,1168
130,-60,90,282,258,540,1072
60,0,20,268,272,540,1020
-30,60,-30,268,272,540,1022
-60,60,10,267,274,541,1113
-90,70,20,267,274,541,1035
170,-20,120,278,264,542,1179
-160,80,110,264,278,542,1075
70,-60,60,274,268,542,1100
130,70,-180,264,278,542,986
130,70,180,264,278,542,986
120,40,-170,280,262,542,1129
120,60,-170,271,271,542,990
60,0,40,276,267,543,1054
-60,-40,-100,274,269,543,1132
-40,50,-10,273,270,543,1084
160,80,150,268,275,543,1021
-150,70,100,272,271,543,1044
20,-20,-30,270,273,543,1062
-20,40,-30,275,269,544,1094
-20,50,-30,268,276,544,1081
100,30,-170,266,278,544,1015
-130,80,60,271,273,544,1105
-140,50,90,271,273,544,1020
70,80,-120,277,267,544,995
120,30,160,271,273,544,1081
50,-30,50,286,258,544,1200
-50,-60,-60,269,275,544,1156
140,40,160,269,275,544,1143
-40,60,-10,273,271,544,1026
-150,90,100,272,273,545,1024
-30,90,-20,272,273,545,1024
-60,90,10,272,273,545,1024
150,90,160,272,273,545,1024
10,90,-60,272,273,545,1024
70,90,-120,272,273,545,1024
-10,90,-40,272,273,545,1024
40,90,-90,272,273,545,1024
140,90,170,272,273,545,1024
-160,90,110,272,273,545,1024
100,90,-150,272,273,545,1024
60,90,-110,272,273,545,1024
-120,90,70,272,273,545,1024
110,80,-160,283,262,545,953
-90,90,40,272,273,545,1024
-140,90,90,272,273,545,1024
-100,90,50,272,273,545,1024
170,90,140,272,273,545,1024
80,90,-130,272,273,545,1024
-180,90,130,272,273,545,1024
180,90,130,272,273,545,1024
150,60,130,268,277,545,1104
90,90,-140,272,273,545,1024
-170,90,120,272,273,545,1024
-150,-70,170,277,268,545,1111
30,90,-80,272,273,545,1024
100,80,-150,284,261,545,951
-160,20,110,269,276,545,1113
-130,90,80,272,273,545,1024
130,90,-180,272,273,545,1024
20,90,-70,272,273,545,1024
120,90,-170,272,273,545,1024
0,90,-50,272,273,545,1024
50,90,-100,272,273,545,1024
-40,90,-10,272,273,545,1024
160,90,150,272,273,545,1024
50,-40,50,277,268,545,1167
-80,90,30,272,273,545,1024
-50,90,0,272,273,545,1024
110,90,-160,272,273,545,1024
-20,90,-30,272,273,545,1024
-70,90,20,272,273,545,1024
-110,90,60,272,273,545,1024
130,90,180,272,273,545,1024
-150,50,100,268,277,545,1047
-30,20,-30,280,265,545,1106
170,40,130,262,284,546,1134
120,-60,90,280,266,546,1012
110,60,-150,276,270,546,1031
20,-10,10,287,259,546,1053
-160,-70,160,277,270,547,1097
-90,-60,-130,272,275,547,1118
-170,80,100,272,275,547,1040
60,80,-110,273,274,547,1017
100,60,-140,286,261,547,1043
170,80,140,272,276,548,1038
10,70,-60,274,274,548,1048
-40,0,-20,279,269,548,1152
-60,20,-10,272,276,548,1129
-30,40,-20,274,275,549,1090
50,-30,0,271,278,549,1132
130,40,-180,279,270,549,1086
-90,-60,-140,278,271,549,1108
120,80,-170,284,265,549,961
80,80,-130,281,268,549,978
130,40,180,279,270,549,1086
180,80,130,268,282,550,1067
-180,80,130,268,282,550,1067
-20,-70,-30,277,273,550,1149
-80,-60,-130,282,268,550,1043
-150,60,100,263,287,550,1064
-30,50,-20,279,271,550,1096
-50,-10,-50,279,271,550,1049
80,-70,30,275,275,550,908
50,0,0,270,280,550,1058
-140,60,90,268,282,550,1040
90,-50,70,279,271,550,1058
-50,-30,-80,270,281,551,1076
100,40,-140,286,265,551,950
130,50,180,280,271,551,1166
130,50,-180,280,271,551,1166
-50,10,-20,276,275,551,1062
140,40,130,289,262,551,1151
-170,80,120,263,288,551,1080
160,40,140,265,286,551,1182
110,-70,90,280,272,552,1161
-50,60,0,270,282,552,1093
-70,40,10,276,276,552,1049
160,-60,110,273,279,552,1074
30,-10,-20,266,286,552,1090
-10,-70,-20,285,268,553,1168
-110,60,60,281,272,553,1025
-30,-30,-70,272,281,553,1147
-40,10,-20,278,275,553,1127
160,20,130,279,274,553,1212
-50,0,-40,281,272,553,997
-80,30,10,275,278,553,1175
-120,60,70,277,276,553,1008
-60,20,-20,280,274,554,1067
120,-80,100,278,276,554,1082
160,-60,120,278,276,554,1087
-60,10,-20,277,277,554,1045
50,0,30,290,264,554,1031
-50,80,-10,281,273,554,1014
40,10,10,281,273,554,1083
-130,30,80,275,280,555,1101
60,-70,50,281,274,555,1128
-10,10,-30,284,271,555,1152
60,-10,60,280,275,555,1267
-60,0,-30,272,283,555,1068
-130,50,80,270,285,555,1008
180,-30,120,272,283,555,1062
-180,-30,120,272,283,555,1062
30,80,-80,283,273,556,1037
-120,20,50,286,270,556,1066
110,80,-170,284,272,556,1005
-30,10,-20,282,274,556,1233
70,-60,20,266,290,556,931
10,-10,0,290,266,556,1156
50,80,-100,275,281,556,1038
-180,80,110,277,279,556,1028
-30,50,-30,274,282,556,1008
40,10,0,280,276,556,1149
180,80,110,277,279,556,1028
140,30,140,289,268,557,1130
-140,70,90,276,281,557,1010
-170,50,120,281,276,557,1156
100,50,-150,293,265,558,1008
-160,30,110,270,288,558,1106
-50,50,0,283,275,558,1117
40,80,-90,278,280,558,1053
140,70,150,283,275,558,1032
-30,-10,-20,281,278,559,1142
-80,-80,-100,277,282,559,1175
-130,60,80,267,292,559,1010
-10,10,-20,292,267,559,1172
-140,10,90,279,280,559,1052
-40,40,-10,284,275,559,1115
-150,80,80,273,286,559,1096
-130,70,80,275,284,559,1026
130,30,160,284,275,559,1185
-30,20,-20,288,272,560,1146
140,70,170,277,283,560,1047
120,-60,80,286,274,560,1092
-60,-40,-60,282,278,560,1194
130,30,150,287,273,560,1189
90,80,-140,287,273,560,966
-50,20,-10,282,279,561,1196
-160,60,110,265,296,561,1111
-100,-70,-130,275,286,561,1191
150,-50,110,281,280,561,1203
-170,60,120,278,283,561,1114
50,10,10,284,277,561,1099
130,-60,100,284,277,561,1098
60,-50,10,282,279,561,1083
100,80,-160,284,278,562,1076
130,60,180,278,284,562,1101
-70,-40,-80,297,265,562,1186
-170,-30,120,275,287,562,1102
130,60,-180,278,284,562,1101
-150,0,100,278,284,562,1146
100,30,180,287,276,563,1032
100,30,-180,287,276,563,1032
-20,10,-20,294,269,563,1190
-120,50,70,272,291,563,1083
-20,70,-40,274,289,563,1103
150,40,150,283,280,563,1250
-10,-40,-60,271,292,563,1139
-160,-20,120,271,293,564,1137
120,50,-160,290,274,564,1121
40,-40,40,287,277,564,1203
-10,-20,-10,286,278,564,1088
170,-60,120,289,275,564,1078
-100,60,50,279,285,564,1094
10,-30,-40,266,299,565,1185
140,30,150,292,273,565,1245
-140,80,70,277,288,565,1122
150,10,130,283,282,565,1229
150,-70,100,296,270,566,1106
-70,-50,-80,285,281,566,1223
80,70,-120,288,278,566,1042
110,-60,70,297,269,566,1114
60,-20,60,289,277,566,1314
10,70,-50,290,276,566,1114
-30,10,-40,290,276,566,1103
10,0,-30,284,282,566,1194
70,-20,60,304,263,567,1152
-180,-60,130,290,277,567,1097
-50,-30,-40,289,278,567,1159
180,-60,130,290,277,567,1097
150,30,120,289,279,568,1096
-160,-10,120,274,294,568,1296
170,-30,120,289,279,568,1186
-100,-60,-140,280,288,568,1204
110,70,-170,283,285,568,1033
140,-70,90,294,274,568,1117
150,-70,120,284,285,569,1119
-100,40,40,285,284,569,1206
-80,40,20,283,286,569,1200
-60,-30,-50,290,279,569,1170
-130,20,80,287,282,569,1090
-180,60,130,287,283,570,1182
160,30,110,293,277,570,1012
-70,60,20,285,285,570,1166
60,-10,10,276,294,570,1153
100,30,-150,282,288,570,1080
110,60,-170,288,282,570,1069
-10,-30,-10,286,284,570,1161
150,-10,120,287,283,570,1171
180,60,130,287,283,570,1182
100,-60,80,286,285,571,1085
40,-30,40,296,275,571,1212
-160,70,110,285,286,571,1065
70,-70,60,290,282,572,1201
20,-10,-30,274,298,572,1212
-70,-30,-80,294,278,572,1173
-60,30,0,293,279,572,1193
-120,20,60,288,284,572,1156
120,50,160,274,298,572,1130
-170,-60,140,280,292,572,1156
-40,30,-30,286,287,573,1142
-40,-20,-70,277,296,573,1168
60,-20,10,283,290,573,1213
-170,70,120,285,288,573,1112
70,70,-110,287,286,573,1069
90,70,-130,291,282,573,1064
0,0,-10,286,288,574,1180
160,70,150,284,290,574,1138
-80,-70,-100,288,286,574,1236
-90,30,10,279,295,574,1167
110,40,-150,285,289,574,1098
-80,60,30,289,285,574,1226
-20,-40,-20,288,286,574,1228
-110,30,50,293,282,575,1150
-90,40,30,282,293,575,1269
100,30,-160,289,286,575,1063
-90,-80,-110,287,288,575,1209
0,60,-40,289,286,575,1203
90,70,-140,308,268,576,1050
-30,-70,-40,292,284,576,1181
50,-50,50,293,283,576,1255
130,40,140,315,261,576,1190
170,30,130,287,289,576,1264
10,-20,-40,286,290,576,1226
120,30,-170,297,280,577,1143
-30,30,-20,291,286,577,1190
110,30,-160,292,285,577,1130
-60,-20,-70,293,284,577,1068
150,70,160,285,292,577,1128
50,80,-90,288,289,577,1139
50,-10,50,289,288,577,1271
20,70,-60,298,280,578,1134
20,80,-60,303,276,579,1137
-80,70,10,295,284,579,1148
-10,-10,-10,293,286,579,1172
-90,-60,-120,288,291,579,1198
-120,80,50,298,281,579,1149
160,-20,120,294,285,579,1212
100,70,-140,299,280,579,1073
130,-80,110,291,288,579,1131
30,0,20,290,290,580,1187
140,60,170,290,290,580,1211
50,-80,40,286,294,580,1207
150,-60,100,292,288,580,1130
60,0,50,292,288,580,1193
130,30,170,282,298,580,1154
160,10,130,298,283,581,1232
-60,-20,-60,284,297,581,1153
180,50,130,290,291,581,1276
170,-40,120,287,294,581,1218
180,70,130,295,286,581,1145
-170,10,120,288,293,581,1229
30,-80,20,298,283,581,1227
140,-60,110,292,289,581,1184
-180,50,130,290,291,581,1276
-180,70,130,295,286,581,1145
140,50,170,299,282,581,1254
120,60,170,288,294,582,1046
-70,-30,-90,290,292,582,1152
-80,30,0,288,294,582,1161
-40,10,-40,291,291,582,1109
100,70,-160,300,283,583,1136
-40,-70,-50,300,283,583,1214
0,60,-50,295,288,583,1133
-90,40,10,281,302,583,1128
50,10,20,299,284,583,1101
20,0,0,298,285,583,1187
0,10,-20,290,293,583,1220
-90,60,40,288,295,583,1172
120,60,-160,299,284,583,1096
10,60,-50,279,304,583,1169
30,-40,30,304,279,583,1163
100,40,-160,283,300,583,1046
0,70,-40,302,282,584,1135
-170,-40,130,289,295,584,1194
40,-80,30,292,292,584,1228
110,50,-140,291,293,584,1150
-110,50,60,284,300,584,1199
160,-70,130,294,290,584,1178
150,40,120,313,271,584,1126
-20,-40,-70,276,308,584,1202
-20,10,-40,297,287,584,1235
-60,-60,-70,299,285,584,1299
-110,-70,-140,293,292,585,1230
-40,30,-10,297,288,585,1222
80,-40,70,302,283,585,1258
60,-40,60,311,274,585,1273
-80,-50,-110,289,296,585,1231
40,80,-80,299,287,586,1148
60,10,10,295,291,586,1079
60,80,-100,297,289,586,1136
-10,60,-30,299,287,586,1184
-40,80,-20,299,287,586,1069
-50,50,-20,289,297,586,1046
40,10,20,304,282,586,1216
40,0,-10,285,301,586,1228
170,-60,130,290,296,586,1123
80,-60,70,298,289,587,1281
60,0,10,285,302,587,1132
-20,30,-30,296,291,587,1222
30,80,-70,299,288,587,1163
160,20,110,295,292,587,1021
110,70,-150,303,284,587,1081
-50,0,-20,301,287,588,1160
-40,-50,-40,303,285,588,1268
50,10,0,289,299,588,1221
40,0,30,303,285,588,1294
60,-80,50,296,292,588,1218
160,-30,110,286,302,588,1187
-30,-20,-20,295,293,588,1198
170,70,140,291,297,588,1172
140,-80,120,295,293,588,1172
-70,-40,-110,289,299,588,1203
120,-70,100,295,294,589,1274
80,-40,40,297,292,589,1098
60,-30,60,305,284,589,1301
170,60,140,297,292,589,1207
170,80,120,294,295,589,1072
170,-30,110,288,301,589,1123
160,0,110,294,295,589,1128
100,50,-130,301,288,589,1177
150,60,160,300,289,589,1247
80,-50,70,300,289,589,1245
-100,-80,-120,297,293,590,1224
-20,20,-20,301,289,590,1269
150,0,120,299,291,590,1171
30,-30,30,310,280,590,1193
-10,-10,-50,291,299,590,1230
-20,30,-20,299,292,591,1171
-20,20,-30,304,287,591,1246
100,50,-160,287,304,591,1069
10,80,-50,312,280,592,1158
120,-50,90,310,282,592,1179
-10,70,-30,305,287,592,1155
20,-80,10,300,292,592,1239
80,80,-120,298,294,592,1119
-20,70,-20,307,285,592,1114
90,80,-150,299,293,592,1174
50,0,40,301,291,592,1197
170,50,140,298,294,592,1317
-170,40,120,291,302,593,1232
-30,70,-10,308,285,593,1132
140,60,140,288,305,593,1238
-20,60,-20,311,282,593,1186
30,-20,30,309,285,594,1260
-20,60,-40,297,297,594,1147
100,-50,80,310,284,594,1192
-50,20,-30,303,291,594,1216
120,70,-160,303,291,594,1140
-60,-10,-40,303,291,594,1149
0,10,-30,307,287,594,1271
-80,-50,-120,297,297,594,1231
-20,40,-20,304,290,594,1217
180,-40,120,283,311,594,1240
-180,-40,120,283,311,594,1240
110,80,-150,307,287,594,1145
100,40,-170,295,299,594,1109
140,30,130,303,292,595,1194
-80,40,0,291,304,595,1133
-110,60,30,290,306,596,1130
-60,-20,-40,311,285,596,1211
-60,-10,-30,305,291,596,1206
170,-70,140,299,297,596,1230
60,10,20,290,306,596,1093
90,80,-130,308,289,597,1119
-10,50,-40,286,311,597,1157
100,-50,70,303,294,597,1125
-50,40,0,301,297,598,1220
160,-40,110,300,298,598,1193
-60,60,-10,300,298,598,1101
180,-60,140,302,296,598,1199
90,-40,70,310,288,598,1181
-10,80,-30,308,290,598,1143
-180,-60,140,302,296,598,1199
20,60,-60,303,296,599,1206
90,60,-130,311,288,599,1096
70,-80,60,301,298,599,1236
150,50,160,300,299,599,1309
-150,-10,110,303,296,599,1149
170,30,100,322,278,600,1018
-30,30,-30,304,296,600,1114
10,-80,0,297,303,600,1236
-150,0,110,304,296,600,1232
20,-30,20,312,288,600,1257
30,70,-70,304,296,600,1185
150,-30,110,303,297,600,1263
-40,20,-10,300,301,601,1237
70,80,-110,302,299,601,1135
80,-30,60,314,287,601,1160
-100,50,20,300,301,601,1072
-100,-60,-150,298,303,601,1270
40,-20,40,309,292,601,1302
-30,-50,-30,304,297,601,1310
-30,0,-50,297,304,601,1291
140,20,140,304,297,601,1306
-20,80,-20,307,294,601,1137
30,-10,30,296,306,602,1311
110,-60,90,305,297,602,1233
-70,-30,-70,312,290,602,1237
100,80,-140,313,289,602,1133
0,-20,0,301,301,602,1281
130,-70,80,311,291,602,1188
160,-50,120,302,300,602,1264
90,-70,40,313,289,602,1080
150,-40,110,305,297,602,1220
100,60,-130,300,302,602,1185
180,-30,110,300,303,603,1123
-50,-70,-60,309,294,603,1284
0,80,-40,313,290,603,1161
-160,-60,150,315,288,603,1226
160,-80,140,309,294,603,1246
-180,-30,110,300,303,603,1123
90,60,-140,312,291,603,1087
60,-40,10,298,305,603,1253
160,80,130,300,304,604,1100
160,60,150,309,295,604,1296
-80,-50,-100,309,295,604,1288
150,-20,110,308,296,604,1174
20,-40,20,317,287,604,1325
-50,-50,-50,310,294,604,1262
40,-50,40,309,296,605,1270
-60,-50,-110,301,304,605,1172
-30,80,-10,308,297,605,1136
-80,-40,-100,301,304,605,1259
-80,-60,-100,306,299,605,1331
90,50,-130,304,302,606,1121
-120,40,70,300,306,606,1093
140,40,170,296,310,606,1203
130,-50,100,311,296,607,1205
10,10,-20,308,299,607,1217
-120,-70,-150,310,297,607,1272
-180,0,100,307,301,608,1067
-160,-20,110,300,308,608,1102
180,0,100,307,301,608,1067
-30,80,-30,312,296,608,1115
0,-30,0,305,303,608,1230
-10,-40,-10,305,303,608,1247
10,-30,10,310,298,608,1262
-160,-30,130,291,318,609,1357
120,80,-160,312,297,609,1175
60,0,60,310,299,609,1266
-180,40,90,307,302,609,1117
130,30,140,313,296,609,1205
-120,30,70,300,309,609,1250
-110,-80,-130,309,300,609,1293
60,-30,10,305,304,609,1319
170,-50,120,311,298,609,1268
180,40,90,307,302,609,1117
80,-30,50,315,294,609,1152
-110,80,40,302,308,610,1185
140,20,130,313,297,610,1199
30,0,-20,294,316,610,1295
150,-60,120,304,306,610,1257
40,10,-10,307,303,610,1242
-120,20,40,318,292,610,1111
150,-80,130,306,304,610,1212
-50,-20,-30,326,284,610,1295
30,10,10,307,303,610,1266
180,-80,160,317,294,611,1319
-180,-80,160,317,294,611,1319
60,70,-100,304,307,611,1155
20,70,-70,307,304,611,1199
40,-10,40,316,295,611,1345
0,-80,-10,302,309,611,1270
170,-80,150,317,295,612,1296
-160,-70,170,315,297,612,1311
-140,10,80,299,313,612,1092
160,50,150,309,303,612,1367
100,40,-130,315,297,612,1179
30,10,0,317,295,612,1265
-70,20,0,304,308,612,1322
-110,-60,-150,312,300,612,1303
140,-50,100,306,306,612,1244
-110,-60,-160,305,307,612,1312
-40,40,-30,305,308,613,1089
60,-50,60,321,292,613,1358
-10,-80,-20,299,314,613,1300
-40,80,0,318,295,613,1175
50,70,-90,308,306,614,1158
100,30,-140,310,304,614,1115
-140,10,100,308,306,614,1269
-10,40,-30,311,303,614,1237
150,20,120,319,295,614,1096
-10,50,-30,314,301,615,1283
-50,30,0,313,302,615,1314
20,-20,20,314,301,615,1252
80,70,-130,316,299,615,1174
-70,70,0,305,310,615,1225
-60,0,-20,305,310,615,1273
-130,-70,-160,314,301,615,1333
-110,20,40,313,303,616,1235
160,40,110,321,295,616,1100
90,60,-120,312,304,616,1242
180,-70,150,306,310,616,1288
-120,-60,-170,307,309,616,1323
-180,-70,150,306,310,616,1288
-60,50,10,306,310,616,1205
80,-80,70,312,305,617,1276
110,20,170,291,326,617,1167
130,70,-170,315,302,617,1233
-20,50,-20,320,297,617,1230
10,-20,10,314,303,617,1282
170,10,130,301,316,617,1306
-40,-30,-30,307,310,617,1291
-50,90,10,318,300,618,1240
-50,80,10,317,301,618,1191
140,90,-180,318,300,618,1240
140,-50,110,322,296,618,1255
-80,90,40,318,300,618,1240
-180,90,140,318,300,618,1240
-170,90,130,318,300,618,1240
110,-50,80,325,293,618,1190
140,90,180,318,300,618,1240
-10,20,-20,316,302,618,1256
180,90,140,318,300,618,1240
90,90,-130,318,300,618,1240
100,90,-140,318,300,618,1240
-140,90,100,318,300,618,1240
80,90,-120,318,300,618,1240
60,90,-100,318,300,618,1240
-20,90,-20,318,300,618,1240
130,20,150,317,301,618,1403
-30,90,-10,318,300,618,1240
-60,90,20,318,300,618,1240
-130,90,90,318,300,618,1240
160,90,160,318,300,618,1240
-70,90,30,318,300,618,1240
130,90,-170,318,300,618,1240
20,90,-60,318,300,618,1240
10,90,-50,318,300,618,1240
40,90,-80,318,300,618,1240
-110,90,70,318,300,618,1240
110,90,-150,318,300,618,1240
-90,90,50,318,300,618,1240
-150,90,110,318,300,618,1240
-160,90,120,318,300,618,1240
150,90,170,318,300,618,1240
70,90,-110,318,300,618,1240
170,90,150,318,300,618,1240
120,90,-160,318,300,618,1240
50,90,-90,318,300,618,1240
30,90,-70,318,300,618,1240
-10,90,-30,318,300,618,1240
0,90,-40,318,300,618,1240
-40,90,0,318,300,618,1240
-100,90,60,318,300,618,1240
-120,90,80,318,300,618,1240
-70,-30,-60,318,301,619,1300
-70,20,-10,312,307,619,1188
50,0,-10,308,311,619,1258
30,10,-10,315,304,619,1283
20,0,-30,312,307,619,1382
-60,-30,-90,315,304,619,1236
0,0,-40,295,325,620,1278
-30,30,-10,315,305,620,1247
-130,20,50,321,299,620,1138
180,-50,130,314,306,620,1224
-180,-50,130,314,306,620,1224
100,20,-170,318,302,620,1271
-170,-30,130,302,318,620,1371
130,70,160,315,305,620,1211
120,-60,100,318,303,621,1291
-60,10,-30,309,312,621,1218
170,40,100,321,300,621,1170
-180,-40,130,309,313,622,1326
70,-10,50,318,304,622,1209
40,70,-80,316,306,622,1194
180,-40,130,309,313,622,1326
-170,-80,170,323,299,622,1321
160,-50,110,305,317,622,1294
60,-10,70,318,305,623,1347
-70,-60,-80,324,299,623,1398
-140,-70,-170,322,301,623,1322
50,-10,-10,301,322,623,1343
-160,-80,-180,322,301,623,1336
-120,-80,-140,317,306,623,1314
-120,-70,-180,306,317,623,1286
-160,-80,180,322,301,623,1336
-120,-70,180,306,317,623,1286
150,20,140,302,321,623,1420
-20,-80,-30,308,315,623,1330
-110,-70,-170,310,313,623,1252
80,-70,70,317,306,623,1318
-10,30,-30,304,319,623,1261
140,-40,110,314,310,624,1310
-130,-80,-150,314,310,624,1328
130,50,-170,321,303,624,1279
70,-50,20,303,321,624,1193
-170,30,120,313,312,625,1306
110,20,180,316,309,625,1145
130,60,-170,311,314,625,1302
110,20,-180,316,309,625,1145
-20,-50,-20,315,310,625,1372
110,-50,90,326,299,625,1267
160,0,130,310,316,626,1317
-150,10,110,309,317,626,1314
-170,-70,160,317,309,626,1322
120,20,160,320,306,626,1346
120,40,-160,326,300,626,1283
110,60,-140,311,315,626,1199
110,50,170,309,317,626,1188
10,10,-30,315,311,626,1420
130,-50,90,319,308,627,1295
170,20,130,310,317,627,1401
150,80,140,313,314,627,1149
-40,70,0,326,302,628,1181
160,-40,120,316,312,628,1299
150,0,130,317,311,628,1350
110,50,-180,302,326,628,1198
-180,40,130,302,326,628,1356
110,50,180,302,326,628,1198
-150,-80,-170,323,305,628,1333
-60,80,20,318,310,628,1238
180,40,130,302,326,628,1356
130,30,-180,312,317,629,1212
130,30,180,312,317,629,1212
170,-50,130,313,316,629,1287
-100,30,40,318,311,629,1326
-70,40,-10,304,325,629,1194
130,-70,110,308,321,629,1371
70,-10,40,324,305,629,1181
-90,-50,-130,319,310,629,1319
-160,0,120,310,319,629,1334
120,30,150,331,299,630,1226
70,-20,30,316,314,630,1231
160,50,110,301,329,630,1245
-170,20,120,315,315,630,1312
120,40,150,336,294,630,1268
-70,30,10,313,318,631,1327
0,-40,0,317,314,631,1347
-60,30,-20,317,314,631,1250
-150,-60,160,329,302,631,1329
140,-60,90,324,307,631,1285
30,-50,30,324,307,631,1310
10,0,0,319,312,631,1342
-50,70,10,322,309,631,1210
80,80,-140,317,314,631,1230
100,40,180,325,307,632,1123
-60,-50,-60,322,310,632,1337
-100,20,20,312,320,632,1275
-100,50,50,311,321,632,1325
100,40,-180,325,307,632,1123
140,10,140,319,313,632,1503
160,10,110,331,301,632,1214
-170,-50,140,314,318,632,1244
-90,-70,-110,322,310,632,1331
140,-20,110,325,308,633,1283
150,10,120,319,314,633,1290
100,70,-130,327,306,633,1256
-30,-80,-40,315,318,633,1356
20,0,10,321,312,633,1299
170,40,140,306,327,633,1424
-40,0,-50,307,326,633,1363
20,10,-20,324,309,633,1346
90,50,-120,316,318,634,1268
-30,60,-10,333,301,634,1227
-20,-20,-60,321,313,634,1375
-60,-70,-70,319,315,634,1366
130,80,-170,320,314,634,1231
90,-70,80,323,312,635,1431
-130,-60,-180,323,312,635,1343
90,70,-120,326,309,635,1251
160,-30,120,329,306,635,1399
-10,20,-30,324,311,635,1344
10,-40,10,321,314,635,1399
-130,-60,180,323,312,635,1343
80,-30,70,334,302,636,1321
-150,-70,180,326,310,636,1338
170,0,130,322,314,636,1277
120,-70,70,327,309,636,1265
100,-70,50,323,313,636,1249
10,-10,-40,315,321,636,1364
-160,70,80,310,326,636,1333
-150,-70,-180,326,310,636,1338
0,50,-40,325,311,636,1351
90,-80,80,321,316,637,1335
-150,70,70,315,322,637,1298
-30,20,-40,327,310,637,1251
-40,-10,-20,322,315,637,1296
0,-10,0,324,313,637,1373
-20,80,-40,324,313,637,1173
120,20,170,310,327,637,1293
-120,20,70,325,312,637,1264
10,60,-60,321,317,638,1250
30,0,30,320,318,638,1398
-10,40,-20,330,308,638,1363
-30,40,-10,324,315,639,1321
-130,-70,170,317,322,639,1322
140,30,160,314,325,639,1427
-140,-80,-160,325,314,639,1339
80,70,-110,330,310,640,1268
30,60,-70,324,316,640,1251
-10,30,-20,323,317,640,1294
-70,80,30,321,319,640,1254
140,50,180,328,312,640,1376
0,-50,0,324,316,640,1451
160,30,140,316,324,640,1436
180,-50,140,326,314,640,1349
-180,-50,140,326,314,640,1349
90,-60,80,329,311,640,1393
140,50,-180,328,312,640,1376
-180,-30,130,319,322,641,1397
80,60,-120,332,309,641,1161
140,-10,120,320,321,641,1371
170,-40,110,313,328,641,1265
50,-10,60,327,314,641,1500
180,-30,130,319,322,641,1397
70,-30,70,332,309,641,1330
-70,50,20,329,313,642,1308
10,-50,10,326,316,642,1430
-180,70,100,317,325,642,1296
-20,40,-40,314,328,642,1222
140,80,-180,325,317,642,1277
140,80,180,325,317,642,1277
-10,0,-10,324,318,642,1329
0,-30,-50,312,330,642,1345
-150,10,80,321,321,642,1146
180,70,100,317,325,642,1296
40,20,0,322,320,642,1312
20,-10,20,329,314,643,1356
150,-20,120,338,306,644,1406
-80,50,30,323,321,644,1349
-100,20,30,326,318,644,1333
-140,-60,170,331,313,644,1369
-170,-20,130,317,328,645,1419
-170,-50,130,309,336,645,1265
-170,70,90,317,328,645,1368
-30,20,-10,330,315,645,1286
-110,40,60,325,320,645,1310
160,-60,130,320,325,645,1348
-60,70,20,319,326,645,1302
-60,70,-10,321,324,645,1302
-10,40,-40,322,324,646,1287
-80,80,40,325,321,646,1299
110,70,-140,332,314,646,1302
20,-50,20,336,311,647,1411
-170,-60,150,340,307,647,1323
0,30,-30,337,310,647,1321
0,20,-30,326,321,647,1355
110,-70,60,333,314,647,1272
-110,20,30,336,311,647,1214
-120,-60,-160,331,317,648,1393
-80,20,0,322,326,648,1286
-20,0,-50,318,330,648,1401
150,-50,120,334,314,648,1381
150,50,120,322,326,648,1324
-40,-80,-50,327,321,648,1362
70,70,-100,319,329,648,1312
-70,70,30,326,322,648,1320
110,30,-150,328,320,648,1303
-140,0,100,330,318,648,1373
20,10,-10,331,318,649,1274
140,-40,100,336,313,649,1277
-150,-70,150,326,323,649,1269
10,10,-10,328,321,649,1385
-20,20,-40,328,321,649,1330
-30,50,-10,330,319,649,1302
60,0,0,317,332,649,1307
-90,50,40,322,328,650,1372
-60,10,-10,314,336,650,1378
70,70,-120,323,327,650,1204
-70,-50,-120,330,320,650,1333
80,60,-110,326,325,651,1299
-100,80,60,327,324,651,1340
-50,-40,-100,327,324,651,1401
180,-50,120,329,323,652,1327
-160,20,80,328,324,652,1157
130,-40,100,331,321,652,1310
150,80,170,326,326,652,1311
-10,80,-50,331,321,652,1215
110,20,-170,333,319,652,1292
0,20,-20,326,326,652,1311
-180,-50,120,329,323,652,1327
-80,70,40,326,326,652,1388
-60,-10,-50,331,321,652,1238
40,-10,-20,315,337,652,1392
150,40,160,317,335,652,1394
130,40,-170,339,314,653,1317
-40,60,0,337,316,653,1337
160,40,150,320,333,653,1462
50,0,50,337,316,653,1432
70,-10,60,341,312,653,1318
130,20,160,331,322,653,1408
70,-40,70,332,321,653,1425
-50,-80,-60,330,324,654,1374
-100,80,30,321,333,654,1285
30,70,-80,330,324,654,1313
-70,-40,-70,336,318,654,1388
0,40,-30,336,318,654,1354
150,30,150,326,328,654,1449
-140,-70,160,331,323,654,1295
100,20,180,327,328,655,1229
-10,70,-50,312,343,655,1255
110,10,170,333,322,655,1351
-90,80,50,329,326,655,1315
-10,-50,-10,332,323,655,1473
50,10,30,340,315,655,1319
100,20,-180,327,328,655,1229
-160,-50,140,328,327,655,1267
-140,20,100,313,342,655,1275
30,10,-20,334,321,655,1445
-150,-20,120,319,336,655,1390
70,80,-130,334,321,655,1266
-50,10,-10,326,329,655,1356
-100,-70,-160,327,328,655,1227
110,40,-140,333,323,656,1317
60,-20,70,340,316,656,1467
70,-20,70,337,319,656,1446
-90,50,10,316,340,656,1255
180,0,130,326,331,657,1352
90,-50,50,319,338,657,1236
90,-50,80,331,326,657,1351
-170,-60,130,337,320,657,1260
-20,50,-40,319,338,657,1216
-180,0,130,326,331,657,1352
100,-80,90,329,328,657,1407
170,50,100,316,341,657,1232
130,-60,110,328,329,657,1401
40,60,-70,339,318,657,1377
-160,-70,140,331,326,657,1254
-70,-70,-80,327,331,658,1399
150,-40,100,333,325,658,1299
120,-50,100,336,322,658,1368
60,10,30,335,324,659,1227
10,-10,10,336,323,659,1377
140,60,-180,332,328,660,1421
-100,-60,-130,334,326,660,1422
-40,-30,-80,327,333,660,1349
140,60,180,332,328,660,1421
130,20,140,335,325,660,1336
20,60,-50,335,325,660,1430
-30,-40,-80,315,345,660,1361
140,10,130,333,327,660,1450
140,20,150,339,322,661,1516
140,70,180,328,333,661,1362
140,70,-180,328,333,661,1362
-140,-60,-180,341,320,661,1474
-90,20,10,330,331,661,1325
-140,-60,180,341,320,661,1474
-80,30,20,331,331,662,1456
160,-10,130,336,326,662,1406
-160,-20,130,318,344,662,1487
-10,60,-50,324,338,662,1243
120,70,170,330,332,662,1342
-60,-80,-70,331,332,663,1375
-140,70,60,316,347,663,1376
120,50,-150,329,334,663,1309
-80,-50,-90,340,323,663,1434
170,70,110,327,336,663,1290
-40,10,-10,339,324,663,1301
50,-60,50,341,322,663,1448
20,-90,10,336,328,664,1390
-30,-90,-40,336,328,664,1390
-20,-10,-10,336,328,664,1360
-170,-90,-180,336,328,664,1390
120,-90,110,336,328,664,1390
50,-90,40,336,328,664,1390
-170,-90,180,336,328,664,1390
180,-90,170,336,328,664,1390
-130,-90,-140,336,328,664,1390
-70,-90,-80,336,328,664,1390
-80,-90,-90,336,328,664,1390
130,-90,120,336,328,664,1390
-180,-90,170,336,328,664,1390
150,-90,140,336,328,664,1390
110,-90,100,336,328,664,1390
-110,-90,-120,336,328,664,1390
100,-90,90,336,328,664,1390
-120,-90,-130,336,328,664,1390
-60,-90,-70,336,328,664,1390
30,-90,20,336,328,664,1390
70,-90,60,336,328,664,1390
0,10,-10,338,326,664,1395
90,-90,80,336,328,664,1390
10,-90,0,336,328,664,1390
-60,0,-40,317,347,664,1264
-140,-90,-150,336,328,664,1390
-160,-90,-170,336,328,664,1390
80,-90,70,336,328,664,1390
-10,-90,-20,336,328,664,1390
-50,-90,-60,336,328,664,1390
140,-90,130,336,328,664,1390
-160,-60,140,328,336,664,1297
160,-90,150,336,328,664,1390
170,-90,160,336,328,664,1390
40,-60,40,333,331,664,1414
0,-90,-10,336,328,664,1390
40,-90,30,336,328,664,1390
-150,-90,-160,336,328,664,1390
-160,-40,140,326,338,664,1373
60,-90,50,336,328,664,1390
-100,-90,-110,336,328,664,1390
140,50,130,333,331,664,1343
-20,-90,-30,336,328,664,1390
-90,-90,-100,336,328,664,1390
-40,-90,-50,336,328,664,1390
120,20,150,325,340,665,1448
40,0,-20,324,341,665,1496
140,80,150,342,323,665,1234
150,-50,100,339,326,665,1383
0,40,-40,327,338,665,1345
-170,-10,130,326,339,665,1521
0,30,-20,336,329,665,1381
0,-20,-50,336,329,665,1494
30,60,-60,336,329,665,1391
90,-40,80,332,333,665,1389
140,0,130,330,335,665,1468
140,-70,120,333,332,665,1426
50,20,0,339,327,666,1397
60,70,-110,323,343,666,1248
150,-10,110,326,341,667,1235
-60,-20,-80,331,336,667,1309
-130,10,80,334,333,667,1210
50,-20,60,342,325,667,1491
-80,-40,-110,333,334,667,1306
60,10,0,336,331,667,1328
-170,80,130,324,344,668,1436
140,-30,110,328,340,668,1370
100,20,-150,340,328,668,1350
-90,-70,-150,328,340,668,1316
-60,20,0,342,326,668,1374
-40,-60,-40,337,331,668,1494
130,60,150,327,342,669,1379
180,-10,130,329,340,669,1468
-180,-10,130,329,340,669,1468
-80,-40,-90,341,328,669,1419
-60,40,10,330,339,669,1374
-50,60,-20,331,338,669,1264
170,-10,130,331,339,670,1439
-90,70,50,342,328,670,1377
-40,-40,-90,345,325,670,1442
10,20,-20,343,327,670,1398
-30,-30,-20,343,327,670,1381
-30,-60,-30,335,335,670,1526
110,30,160,355,315,670,1269
170,80,150,330,341,671,1414
100,-70,90,341,330,671,1510
180,50,90,331,340,671,1282
-180,50,90,331,340,671,1282
-160,-30,120,330,341,671,1334
-110,80,70,336,335,671,1374
150,-40,120,331,341,672,1467
-180,80,140,324,348,672,1438
180,80,140,324,348,672,1438
20,10,-30,342,330,672,1534
-160,-40,130,329,344,673,1306
130,10,150,332,341,673,1519
160,70,160,334,339,673,1453
-20,0,-10,341,332,673,1417
-80,-30,-90,343,330,673,1397
110,60,-180,320,353,673,1338
-30,10,-10,342,331,673,1310
110,60,180,320,353,673,1338
0,80,-60,340,334,674,1296
-130,10,70,341,333,674,1246
60,-10,80,350,324,674,1468
-180,10,130,335,339,674,1441
70,60,-110,334,340,674,1263
180,10,130,335,339,674,1441
0,-60,0,343,331,674,1494
150,70,170,330,345,675,1436
180,-20,130,338,337,675,1545
10,-60,10,336,339,675,1490
-170,40,80,352,323,675,1160
-150,20,110,327,348,675,1411
20,10,0,348,327,675,1425
50,10,-10,330,345,675,1445
110,20,160,333,342,675,1295
20,-60,20,342,333,675,1479
150,10,140,330,345,675,1564
-10,10,-40,341,334,675,1484
-180,-20,130,338,337,675,1545
-100,70,60,338,337,675,1357
-50,60,10,346,329,675,1371
40,-20,50,353,322,675,1460
-70,-80,-80,339,337,676,1412
-130,-60,-170,351,325,676,1495
100,60,-160,348,328,676,1406
-10,10,-10,339,337,676,1472
170,-40,130,338,338,676,1500
0,60,-30,345,331,676,1427
-150,-60,150,338,338,676,1330
-160,10,120,337,339,676,1415
30,-60,30,349,327,676,1462
100,-60,90,341,335,676,1481
40,20,-10,341,335,676,1350
90,-40,60,344,332,676,1338
-20,30,-40,330,347,677,1356
50,70,-100,326,351,677,1305
10,60,-40,351,326,677,1452
30,10,20,347,330,677,1437
50,20,10,336,341,677,1410
-180,-60,120,345,332,677,1271
-120,80,80,339,338,677,1405
180,-60,120,345,332,677,1271
110,80,-140,343,334,677,1407
-70,-20,-50,344,334,678,1390
-90,30,30,330,348,678,1465
170,70,150,339,339,678,1475
160,80,160,334,345,679,1382
110,-80,100,345,334,679,1464
70,-50,70,359,320,679,1509
-150,-60,170,349,330,679,1456
150,60,170,351,328,679,1519
40,60,-80,329,350,679,1286
-90,80,20,334,345,679,1338
-160,-50,150,341,338,679,1424
60,-10,0,334,346,680,1471
-160,80,120,330,350,680,1441
-90,-50,-120,340,341,681,1456
100,80,-130,344,337,681,1392
30,-50,-30,341,340,681,1471
-120,-80,-180,342,339,681,1271
40,-20,-20,331,350,681,1446
-120,-80,180,342,339,681,1271
130,-50,110,344,338,682,1478
10,30,-30,342,340,682,1328
-150,30,110,349,333,682,1478
90,70,-150,347,335,682,1345
30,0,-30,333,349,682,1541
-170,-70,130,340,342,682,1260
-110,-80,-170,344,339,683,1306
30,70,-60,343,340,683,1440
160,-70,140,346,337,683,1503
-40,30,0,349,334,683,1446
50,60,-80,354,330,684,1351
-160,-60,160,353,331,684,1445
70,0,20,346,338,684,1415
100,50,-120,337,347,684,1480
120,60,-150,337,347,684,1309
-20,-60,-20,339,345,684,1590
120,20,180,342,342,684,1310
120,20,-180,342,342,684,1310
10,50,-50,349,336,685,1353
100,-40,80,341,344,685,1412
-100,-50,-140,341,344,685,1501
-110,70,70,340,345,685,1412
-10,-30,-60,342,343,685,1469
80,-60,30,332,354,686,1213
40,-30,-20,334,352,686,1466
120,10,160,342,344,686,1433
70,-10,30,345,341,686,1386
0,50,-30,349,337,686,1477
-10,30,-40,332,354,686,1419
30,-30,-30,326,360,686,1500
70,80,-100,345,341,686,1378
60,-60,60,350,337,687,1515
10,80,-70,338,349,687,1337
-60,60,20,347,340,687,1438
-40,50,0,355,332,687,1447
180,30,130,344,344,688,1575
170,-60,140,350,338,688,1457
-20,10,-10,351,337,688,1474
140,40,180,342,346,688,1413
60,80,-90,347,341,688,1384
110,40,160,369,319,688,1436
90,80,-120,352,336,688,1403
40,10,-20,346,342,688,1472
-150,80,110,336,352,688,1416
140,40,-180,342,346,688,1413
-180,30,130,344,344,688,1575
-130,80,90,343,345,688,1436
40,70,-90,338,350,688,1338
-50,-30,-90,349,340,689,1522
-10,60,-20,366,323,689,1431
120,-40,100,354,335,689,1482
-170,-40,140,350,339,689,1483
150,-70,130,348,341,689,1456
30,-10,-30,343,346,689,1554
60,80,-120,344,345,689,1334
70,60,-100,341,349,690,1340
-50,-10,-20,352,338,690,1425
-20,-20,-10,354,336,690,1447
-120,10,60,347,343,690,1352
160,70,120,341,349,690,1304
80,80,-110,353,337,690,1404
-70,-20,-70,355,335,690,1404
50,70,-80,337,353,690,1420
20,0,20,351,339,690,1463
-20,20,-10,359,331,690,1454
40,70,-70,337,353,690,1428
-130,-80,170,346,344,690,1296
70,-10,70,357,334,691,1510
-180,30,90,366,325,691,1301
-140,-60,160,352,339,691,1384
10,50,-40,353,338,691,1459
50,-20,-10,339,352,691,1462
-100,-70,-120,359,332,691,1427
180,30,90,366,325,691,1301
100,-50,90,350,341,691,1489
-160,-10,100,343,348,691,1310
30,20,-10,352,340,692,1475
-170,-10,100,344,348,692,1291
-80,20,10,350,342,692,1439
30,20,0,365,327,692,1427
170,-50,110,346,346,692,1433
-80,-50,-130,346,346,692,1414
-80,-70,-140,333,359,692,1348
-170,-50,150,339,353,692,1542
10,20,-30,357,335,692,1448
-140,80,100,338,354,692,1440
-110,20,50,350,342,692,1452
60,0,70,352,341,693,1375
-90,-80,-150,347,346,693,1325
40,0,40,355,338,693,1542
100,20,-160,344,349,693,1436
20,80,-80,345,348,693,1389
-140,-80,160,352,342,694,1313
10,40,-30,349,345,694,1422
170,-30,130,355,339,694,1512
30,-20,-30,346,348,694,1431
90,50,-140,339,356,695,1332
-70,10,-10,347,348,695,1434
0,40,-20,362,333,695,1525
-50,30,-30,351,345,696,1428
60,70,-90,344,352,696,1385
180,-10,100,344,352,696,1247
-180,-10,100,344,352,696,1247
-80,-60,-90,363,333,696,1587
-20,30,-10,352,344,696,1414
-100,-80,-160,349,347,696,1316
-140,30,100,353,343,696,1352
-90,20,20,350,346,696,1503
130,10,140,341,355,696,1555
80,-30,40,342,355,697,1380
-50,-60,-50,358,339,697,1515
180,60,140,358,339,697,1587
-180,60,140,358,339,697,1587
120,-80,110,352,345,697,1527
-180,-70,120,347,350,697,1321
-50,-20,-80,350,347,697,1506
180,-70,120,347,350,697,1321
-130,70,50,339,358,697,1469
-140,70,100,355,342,697,1498
-130,10,90,344,354,698,1401
40,-30,50,360,338,698,1502
40,20,10,358,340,698,1435
-70,0,-20,353,345,698,1427
-90,-60,-110,355,344,699,1579
50,-10,70,363,336,699,1539
120,30,-160,358,341,699,1508
-40,-10,-60,346,353,699,1519
-30,-20,-70,342,357,699,1453
40,10,30,358,342,700,1506
-60,-30,-40,355,345,700,1462
160,-50,130,358,342,700,1548
-70,0,-30,342,358,700,1398
-10,-60,-10,359,341,700,1608
50,20,-10,368,332,700,1450
160,60,160,366,334,700,1571
-70,60,30,351,349,700,1517
-180,70,140,353,347,700,1483
70,0,30,351,349,700,1366
180,70,140,353,347,700,1483
-50,-40,-40,351,349,700,1468
50,80,-110,352,348,700,1360
-50,20,0,357,343,700,1469
-60,-40,-50,352,349,701,1442
50,80,-80,353,348,701,1413
-130,70,90,358,343,701,1460
100,10,170,354,347,701,1327
120,70,-150,356,345,701,1363
130,50,140,351,351,702,1354
60,-30,70,360,342,702,1555
120,80,-150,358,344,702,1451
140,-20,120,366,336,702,1542
-30,30,-40,343,359,702,1349
100,30,-130,355,347,702,1358
120,-40,90,370,332,702,1426
-150,70,110,351,352,703,1500
-40,-40,-30,364,339,703,1494
-140,40,100,359,344,703,1464
-80,60,40,343,360,703,1518
-40,-20,-20,361,342,703,1465
150,50,170,349,355,704,1522
-10,20,-40,354,350,704,1533
50,-30,60,364,340,704,1553
-120,70,80,353,351,704,1431
20,-50,-40,350,354,704,1485
140,-60,120,347,357,704,1526
-40,40,0,351,353,704,1506
-70,40,20,358,346,704,1509
170,60,150,372,333,705,1579
20,20,-20,357,348,705,1524
40,-50,-20,355,350,705,1496
-150,-50,150,367,338,705,1450
-80,-80,-90,350,355,705,1464
-50,0,-50,341,364,705,1490
80,-30,80,364,341,705,1530
120,40,-150,355,350,705,1451
-170,70,130,354,352,706,1492
150,-10,130,356,350,706,1513
-130,20,90,352,354,706,1449
10,0,-40,336,370,706,1540
0,50,-50,351,355,706,1361
-10,50,-20,365,341,706,1524
0,-10,-50,349,357,706,1574
-150,-20,130,338,369,707,1547
110,-40,90,365,342,707,1462
10,20,-10,361,346,707,1525
100,20,170,341,366,707,1277
-70,-10,-40,360,347,707,1389
20,70,-50,360,347,707,1476
40,20,-20,358,349,707,1551
-100,40,50,351,357,708,1560
20,50,-50,351,357,708,1485
50,60,-90,359,349,708,1396
130,-80,120,363,345,708,1563
-50,10,-40,354,354,708,1400
-30,0,-10,367,341,708,1475
-50,70,-20,343,365,708,1394
-110,-70,-130,361,347,708,1497
110,-70,100,360,349,709,1563
-70,-20,-40,359,350,709,1460
-170,0,130,351,358,709,1534
20,10,10,362,347,709,1525
10,70,-40,366,343,709,1467
70,-20,80,379,330,709,1565
180,20,130,351,359,710,1527
-180,20,130,351,359,710,1527
-80,80,10,349,361,710,1434
-80,40,30,351,359,710,1578
20,60,-70,345,365,710,1352
0,70,-30,368,342,710,1405
10,30,-20,363,347,710,1493
-170,10,90,363,347,710,1335
70,-60,70,368,342,710,1619
40,-10,50,367,344,711,1576
-70,10,-20,354,357,711,1344
130,80,160,361,350,711,1361
160,20,140,353,358,711,1647
-160,50,120,354,357,711,1500
170,-70,150,360,351,711,1529
110,10,160,344,368,712,1486
30,80,-90,355,357,712,1418
-70,-20,-80,361,351,712,1460
40,80,-70,357,355,712,1410
20,20,-30,363,349,712,1514
-150,-30,130,345,367,712,1443
60,-20,0,351,361,712,1555
130,20,170,350,362,712,1493
-80,-80,-140,354,359,713,1394
-150,-80,150,357,356,713,1338
30,-10,40,365,348,713,1570
0,20,-10,359,354,713,1543
10,-50,-50,353,360,713,1497
-20,40,-10,367,346,713,1482
-160,60,120,362,351,713,1517
130,10,160,365,348,713,1566
10,40,-40,365,348,713,1476
130,-40,110,365,349,714,1533
-130,-60,170,355,359,714,1463
30,80,-60,360,354,714,1426
-10,-60,-70,351,364,715,1418
40,80,-100,364,351,715,1398
70,-40,20,354,361,715,1516
130,-20,110,369,346,715,1536
-110,30,60,351,364,715,1422
-110,-60,-170,360,355,715,1523
60,60,-100,366,349,715,1363
100,50,-170,355,360,715,1449
-70,-70,-130,346,369,715,1393
-120,-60,-180,363,352,715,1447
-120,-60,180,363,352,715,1447
-160,70,120,353,362,715,1500
-40,50,-30,344,372,716,1364
-70,-10,-30,363,353,716,1413
0,0,0,357,359,716,1603
-150,-10,120,336,380,716,1553
80,60,-100,368,348,716,1537
-10,20,-10,367,349,716,1529
130,50,-160,362,355,717,1503
90,50,-110,366,351,717,1518
180,-40,140,369,348,717,1588
-10,30,-10,364,353,717,1544
-180,-40,140,369,348,717,1588
70,-10,20,360,357,717,1515
-90,-50,-110,358,359,717,1581
170,10,100,362,355,717,1259
-50,-10,-60,365,352,717,1535
140,10,150,352,366,718,1662
10,80,-40,365,353,718,1430
-80,-40,-120,371,348,719,1396
100,40,-120,357,362,719,1412
80,50,-110,353,366,719,1453
130,0,130,364,355,719,1603
-100,60,20,351,368,719,1480
150,-30,120,358,362,720,1579
130,-30,110,366,354,720,1546
-70,-20,-60,361,359,720,1427
0,30,-40,368,352,720,1479
-170,60,130,362,358,720,1562
0,-60,-60,363,357,720,1424
30,10,-30,362,358,720,1600
30,-30,40,368,352,720,1555
-60,-20,-30,371,349,720,1581
140,30,170,351,369,720,1490
-40,0,-10,364,356,720,1437
10,40,-20,369,351,720,1590
70,0,50,369,352,721,1490
-60,-60,-60,376,345,721,1540
90,60,-110,362,359,721,1560
60,-20,80,368,353,721,1644
20,20,-10,370,352,722,1540
-80,-70,-90,364,358,722,1505
-120,10,70,354,368,722,1379
-150,-30,140,360,362,722,1478
40,-70,40,365,357,722,1586
80,-50,80,372,350,722,1615
-170,-40,120,369,353,722,1416
20,80,-50,361,361,722,1437
130,80,-160,365,357,722,1507
0,70,-60,356,367,723,1426
20,-70,20,372,351,723,1604
30,-20,40,368,355,723,1582
-120,10,50,365,358,723,1426
-20,-60,-80,355,368,723,1401
-90,-80,-100,359,364,723,1515
-160,20,120,351,372,723,1548
-20,-30,-10,361,362,723,1543
140,-80,130,369,355,724,1614
170,-20,130,375,349,724,1625
130,30,-170,368,356,724,1413
-10,-70,-10,368,356,724,1603
140,0,120,362,362,724,1459
10,10,0,360,364,724,1585
50,-70,50,375,349,724,1591
-130,60,90,366,358,724,1466
30,-70,30,363,361,724,1606
60,60,-90,367,357,724,1386
-150,20,70,366,359,725,1380
-80,50,0,352,373,725,1430
-70,-30,-100,368,357,725,1481
-70,-80,-130,357,368,725,1418
50,-30,-10,365,360,725,1580
140,20,160,368,357,725,1596
0,-70,0,363,362,725,1629
-10,80,-20,369,356,725,1377
20,-20,30,375,350,725,1599
170,20,100,366,360,726,1329
50,-40,60,378,348,726,1620
10,0,10,373,353,726,1540
-60,-70,-120,368,358,726,1390
-150,40,110,359,367,726,1497
30,20,-20,374,353,727,1553
130,0,140,365,362,727,1602
110,30,-140,367,361,728,1498
-20,60,-10,386,342,728,1464
-150,50,110,369,359,728,1443
150,70,130,350,378,728,1405
50,0,60,368,361,729,1560
-70,20,10,370,359,729,1612
-160,-30,140,367,362,729,1579
50,10,-20,355,374,729,1695
10,50,-30,376,353,729,1610
140,-50,120,367,362,729,1626
-110,-60,-140,367,362,729,1541
-150,60,110,371,358,729,1528
-10,70,-20,379,350,729,1401
110,-30,100,383,346,729,1638
60,20,10,367,363,730,1469
40,-40,50,373,357,730,1562
120,10,170,367,363,730,1527
180,-70,160,367,363,730,1576
60,0,-10,355,375,730,1510
-180,-70,160,367,363,730,1576
70,60,-90,376,354,730,1561
-90,-50,-140,366,365,731,1507
0,80,-30,370,361,731,1405
20,40,-40,376,355,731,1568
-60,30,10,365,366,731,1547
-140,60,100,363,368,731,1508
120,50,150,375,356,731,1421
80,50,-100,370,361,731,1596
50,0,-20,369,363,732,1573
110,50,-130,361,371,732,1536
140,-10,130,362,370,732,1680
130,-10,120,361,372,733,1578
-50,-30,-30,373,360,733,1512
60,-10,90,379,354,733,1521
10,-70,10,372,361,733,1604
-160,-80,140,377,356,733,1415
80,-40,80,367,366,733,1542
-150,-40,140,369,364,733,1461
30,30,-20,378,356,734,1549
-30,-10,-60,360,374,734,1628
20,-20,-40,369,365,734,1610
-70,-50,-70,376,358,734,1555
20,-70,-40,361,373,734,1479
70,-30,80,381,353,734,1594
110,-50,100,367,367,734,1595
-30,-40,-20,369,365,734,1606
100,-40,90,383,351,734,1534
-130,40,90,358,376,734,1537
-90,60,50,365,369,734,1514
60,10,40,372,362,734,1432
-140,50,100,365,369,734,1510
0,20,-40,372,363,735,1618
100,60,-120,373,362,735,1518
80,-60,80,383,352,735,1718
90,-20,100,373,362,735,1535
170,30,140,364,372,736,1757
-80,-30,-80,373,363,736,1521
0,10,-40,362,374,736,1666
110,-60,100,367,370,737,1647
160,10,140,363,374,737,1613
-50,0,-10,373,364,737,1539
150,-60,130,367,370,737,1655
90,40,-120,370,367,737,1417
-70,80,0,357,381,738,1499
-10,0,-50,354,384,738,1593
20,40,-20,366,372,738,1657
180,-60,150,377,362,739,1616
-160,30,120,377,362,739,1628
-180,-60,150,377,362,739,1616
90,40,-140,365,374,739,1452
10,-70,-50,370,369,739,1459
-40,20,-40,370,369,739,1410
-120,60,80,364,375,739,1499
100,30,170,387,352,739,1414
-170,50,130,363,377,740,1593
130,-60,80,389,351,740,1544
120,-50,80,385,355,740,1547
-80,-30,-70,362,378,740,1581
160,50,160,359,381,740,1632
-60,-40,-110,372,368,740,1523
-150,-50,160,389,351,740,1593
-100,60,60,367,374,741,1519
130,-20,120,390,351,741,1644
20,30,-20,377,364,741,1535
-70,-30,-50,381,360,741,1509
120,10,150,359,382,741,1581
-140,0,110,384,357,741,1511
170,-50,140,382,359,741,1627
150,20,150,370,371,741,1672
50,-40,-10,357,384,741,1617
140,0,140,370,372,742,1707
120,-30,100,387,355,742,1573
-100,-60,-160,368,374,742,1584
80,-20,90,389,353,742,1571
130,60,-160,378,364,742,1458
-60,-80,-120,368,374,742,1442
-80,-30,-100,375,367,742,1467
150,-80,140,377,366,743,1642
-60,0,-10,379,364,743,1628
-20,80,-10,375,368,743,1403
20,20,0,379,364,743,1548
-160,-10,130,362,381,743,1613
-60,40,-20,372,371,743,1391
170,-60,110,377,367,744,1416
120,80,170,377,367,744,1455
20,-40,-40,367,377,744,1643
-170,-60,160,378,366,744,1648
-60,-60,-120,375,369,744,1528
130,70,-160,372,373,745,1499
70,0,10,373,372,745,1582
170,50,150,372,373,745,1644
80,60,-130,372,373,745,1505
-30,-10,-10,381,364,745,1516
60,60,-80,376,369,745,1635
-170,10,130,369,376,745,1572
30,-60,-30,380,365,745,1511
-170,-70,170,380,365,745,1597
-170,-80,130,378,367,745,1427
90,30,-160,365,380,745,1367
10,30,-10,376,370,746,1636
-80,-40,-80,384,362,746,1602
-60,-30,-100,376,370,746,1583
0,30,-10,371,375,746,1639
-50,50,10,376,370,746,1560
130,-40,90,383,363,746,1497
-40,60,-30,361,385,746,1393
20,-30,-40,358,388,746,1655
80,70,-100,375,372,747,1599
40,-40,-20,360,387,747,1641
120,-70,110,380,367,747,1671
-20,70,-10,386,361,747,1459
-30,-50,-90,379,369,748,1519
80,-20,50,394,354,748,1452
-40,20,0,383,365,748,1569
160,-20,130,378,370,748,1705
90,-30,80,375,373,748,1598
110,40,-130,371,377,748,1554
-20,-70,-20,381,367,748,1663
30,-40,-30,360,389,749,1656
30,40,-20,389,360,749,1669
130,-30,100,374,375,749,1477
-110,60,70,373,377,750,1479
-120,70,40,367,383,750,1511
110,70,-180,372,378,750,1499
110,70,180,372,378,750,1499
-30,80,0,377,373,750,1432
70,-30,20,379,371,750,1617
20,40,-30,382,368,750,1542
-120,-70,-140,377,373,750,1538
-20,50,-10,390,360,750,1575
30,20,10,392,359,751,1517
20,-60,-40,375,376,751,1544
-70,-10,-50,369,382,751,1441
30,50,-60,381,370,751,1605
-30,-60,-90,371,381,752,1478
-30,70,0,394,358,752,1476
150,30,160,373,379,752,1737
20,50,-40,392,360,752,1649
-140,10,70,379,373,752,1359
70,0,40,375,378,753,1455
-160,40,120,373,380,753,1582
10,-60,-50,377,376,753,1485
150,40,170,361,392,753,1617
90,-50,90,383,370,753,1635
140,80,-170,379,374,753,1598
-50,-70,-110,380,373,753,1445
50,60,-70,381,372,753,1668
30,50,-50,385,368,753,1700
-150,-40,150,380,373,753,1651
-130,30,90,372,382,754,1541
-90,-70,-100,379,375,754,1602
50,0,70,387,367,754,1525
-110,-50,-150,371,383,754,1619
20,-30,30,393,361,754,1678
140,-30,100,371,383,754,1510
-40,70,-30,371,383,754,1539
70,90,-100,380,375,755,1527
150,90,-180,380,375,755,1527
140,90,-170,380,375,755,1527
160,90,170,380,375,755,1527
130,90,-160,380,375,755,1527
-100,90,70,380,375,755,1527
150,90,180,380,375,755,1527
-40,70,10,399,356,755,1564
100,-30,100,388,367,755,1642
100,90,-130,380,375,755,1527
40,90,-70,380,375,755,1527
-120,90,90,380,375,755,1527
110,20,-160,382,373,755,1674
50,90,-80,380,375,755,1527
-90,90,60,380,375,755,1527
60,-70,60,389,366,755,1627
0,90,-30,380,375,755,1527
-170,90,140,380,375,755,1527
180,90,150,380,375,755,1527
-100,-50,-150,379,376,755,1583
30,90,-60,380,375,755,1527
-80,90,50,380,375,755,1527
-50,90,20,380,375,755,1527
-70,90,40,380,375,755,1527
-40,90,10,380,375,755,1527
110,90,-140,380,375,755,1527
60,90,-90,380,375,755,1527
-180,90,150,380,375,755,1527
-20,90,-10,380,375,755,1527
120,90,-150,380,375,755,1527
90,90,-120,380,375,755,1527
-60,90,30,380,375,755,1527
-30,90,0,380,375,755,1527
170,90,160,380,375,755,1527
10,90,-40,380,375,755,1527
-150,90,120,380,375,755,1527
-140,90,110,380,375,755,1527
80,90,-110,380,375,755,1527
-130,90,100,380,375,755,1527
-160,90,130,380,375,755,1527
-10,90,-20,380,375,755,1527
-110,90,80,380,375,755,1527
20,90,-50,380,375,755,1527
-70,-40,-60,385,371,756,1596
20,-10,30,395,361,756,1635
0,-70,-60,372,384,756,1501
-140,-50,160,401,355,756,1616
100,-20,110,392,364,756,1613
160,-40,130,385,371,756,1675
-30,-70,-30,384,372,756,1687
90,-20,110,392,364,756,1621
30,-40,40,381,375,756,1670
50,20,-20,380,377,757,1611
-40,80,10,378,379,757,1496
40,-60,-20,375,382,757,1583
70,70,-90,386,371,757,1643
90,40,-130,380,377,757,1385
20,50,-60,382,375,757,1518
10,30,-40,377,380,757,1646
-10,40,-10,389,368,757,1642
70,-20,90,395,362,757,1613
-50,-80,-110,380,377,757,1434
50,90,-120,377,381,758,1612
-160,90,90,377,381,758,1612
-30,90,-40,377,381,758,1612
70,90,-140,377,381,758,1612
100,90,-170,377,381,758,1612
-150,90,80,377,381,758,1612
-100,90,30,377,381,758,1612
-40,90,-30,377,381,758,1612
130,90,160,377,381,758,1612
150,90,140,377,381,758,1612
40,90,-110,377,381,758,1612
20,90,-90,377,381,758,1612
-10,90,-60,377,381,758,1612
-100,-60,-120,384,374,758,1727
110,90,-180,377,381,758,1612
90,90,-160,377,381,758,1612
-130,90,60,377,381,758,1612
170,90,120,377,381,758,1612
0,90,-70,377,381,758,1612
-20,90,-50,377,381,758,1612
120,90,170,377,381,758,1612
-60,90,-10,377,381,758,1612
80,90,-150,377,381,758,1612
-120,90,50,377,381,758,1612
10,90,-80,377,381,758,1612
-50,90,-20,377,381,758,1612
-70,90,0,377,381,758,1612
110,90,180,377,381,758,1612
-20,-30,-70,384,374,758,1638
160,90,130,377,381,758,1612
60,90,-130,377,381,758,1612
-180,90,110,377,381,758,1612
60,-40,70,397,361,758,1717
140,90,150,377,381,758,1612
-80,90,10,377,381,758,1612
-90,90,20,377,381,758,1612
30,90,-100,377,381,758,1612
180,90,110,377,381,758,1612
-110,90,40,377,381,758,1612
-170,90,100,377,381,758,1612
-140,90,70,377,381,758,1612
-100,-80,-110,374,385,759,1561
170,-80,160,385,374,759,1686
70,-10,90,405,354,759,1563
-50,80,20,385,374,759,1565
90,70,-110,385,374,759,1584
-20,-40,-10,387,372,759,1709
50,20,20,389,370,759,1521
160,-80,150,386,373,759,1686
-150,-70,-170,394,366,760,1654
20,-10,-40,369,391,760,1727
-70,50,-10,375,385,760,1435
40,0,-30,369,391,760,1679
30,-70,-30,378,382,760,1508
40,10,-30,375,385,760,1675
90,-30,90,390,371,761,1652
-90,40,40,382,379,761,1627
110,-40,100,399,362,761,1628
-10,-20,0,393,368,761,1665
-160,-40,150,377,384,761,1720
-150,-10,100,372,389,761,1519
60,50,-80,373,388,761,1621
120,60,160,374,387,761,1571
-50,-70,-50,396,366,762,1684
0,50,-20,381,381,762,1655
160,30,150,377,385,762,1810
-10,-10,0,384,378,762,1719
120,-20,110,389,373,762,1634
-170,50,80,386,376,762,1440
-60,80,-10,373,389,762,1568
-70,-60,-130,382,380,762,1529
20,30,-30,387,376,763,1529
-130,50,90,375,388,763,1588
20,-40,30,392,371,763,1669
30,60,-80,379,385,764,1479
-80,-60,-140,385,379,764,1565
-60,-10,-20,397,367,764,1660
-40,-70,-40,395,370,765,1677
50,-20,70,394,371,765,1726
-100,-50,-130,381,384,765,1698
-50,40,10,387,378,765,1647
30,40,-30,390,375,765,1686
30,20,-30,381,384,765,1652
80,-10,110,390,376,766,1607
110,-20,110,393,373,766,1651
70,-70,70,390,376,766,1724
90,-40,90,387,379,766,1624
180,50,140,381,385,766,1667
-30,10,-50,387,379,766,1668
-40,-50,-30,392,374,766,1666
-180,50,140,381,385,766,1667
40,30,-20,391,375,766,1546
-40,-80,-100,385,382,767,1472
-50,80,-20,385,382,767,1597
110,10,-180,365,402,767,1637
170,-70,110,392,375,767,1463
-180,-80,170,385,382,767,1687
130,-70,120,394,373,767,1724
110,10,180,365,402,767,1637
-60,50,20,383,384,767,1647
180,-80,170,385,382,767,1687
-160,-70,180,387,381,768,1626
-160,-70,-180,387,381,768,1626
80,-20,100,398,370,768,1658
-170,-80,180,388,380,768,1681
120,-30,110,394,374,768,1670
-170,-80,-180,388,380,768,1681
-120,-60,-150,396,372,768,1601
100,20,-140,384,384,768,1436
-160,-50,130,386,382,768,1482
-140,20,60,395,374,769,1400
-170,-30,140,392,377,769,1735
80,-20,60,408,361,769,1533
10,-40,-50,379,390,769,1650
60,20,0,388,381,769,1658
-10,-30,0,393,376,769,1725
60,10,-10,386,384,770,1615
140,-30,120,389,381,770,1713
20,30,-10,397,373,770,1613
140,-40,120,388,382,770,1633
70,10,10,379,391,770,1516
180,-80,120,394,376,770,1469
120,0,140,380,390,770,1730
-180,-80,120,394,376,770,1469
0,-50,-60,383,388,771,1586
160,-30,130,394,377,771,1721
-10,-70,-70,381,390,771,1570
70,-20,20,390,381,771,1624
-140,-70,-160,394,377,771,1662
-70,20,-20,389,382,771,1505
-130,-70,-150,400,372,772,1615
150,0,140,393,379,772,1760
-60,80,30,387,385,772,1618
100,70,-120,394,378,772,1611
20,0,-40,375,397,772,1710
140,-50,90,396,376,772,1490
50,-50,-10,374,398,772,1598
-110,-80,-120,387,386,773,1601
-30,30,0,390,383,773,1638
120,20,-170,381,392,773,1480
-150,0,90,386,387,773,1540
140,30,-180,366,408,774,1691
30,60,-50,390,384,774,1718
140,30,180,366,408,774,1691
150,80,-180,381,393,774,1640
150,80,180,381,393,774,1640
-110,-50,-160,391,383,774,1638
40,60,-60,390,384,774,1722
80,-30,90,401,373,774,1723
-170,40,130,384,390,774,1730
60,10,50,390,385,775,1589
-80,50,40,388,387,775,1663
-50,-50,-40,395,380,775,1654
90,60,-150,384,391,775,1551
70,-10,80,407,368,775,1580
110,60,-130,383,392,775,1594
140,-10,110,383,392,775,1490
100,10,-180,366,409,775,1526
100,10,180,366,409,775,1526
70,-10,10,387,388,775,1706
120,10,140,393,383,776,1643
30,40,-40,394,382,776,1703
-20,10,-50,391,386,777,1741
10,40,-50,395,382,777,1585
-30,40,0,388,389,777,1646
0,-10,10,395,382,777,1747
-70,50,30,390,387,777,1667
130,10,130,382,395,777,1558
-140,-50,170,392,386,778,1719
60,70,-80,392,386,778,1678
-30,60,0,410,368,778,1620
80,-10,100,406,372,778,1634
120,-60,110,390,388,778,1753
80,-20,80,411,367,778,1641
170,-80,110,400,379,779,1548
-10,-50,-70,392,387,779,1632
10,20,-40,391,388,779,1725
100,50,-180,374,406,780,1457
-160,-50,160,399,381,780,1717
-70,-60,-70,403,377,780,1680
80,-50,30,373,407,780,1494
-50,-60,-110,390,390,780,1583
110,10,150,375,405,780,1699
140,50,-170,402,378,780,1663
100,50,180,374,406,780,1457
-90,-60,-150,387,393,780,1552
160,-40,100,398,382,780,1475
-70,30,20,392,388,780,1723
-150,0,120,389,391,780,1668
20,10,20,397,384,781,1699
-20,-70,-80,379,402,781,1586
70,10,30,388,393,781,1539
110,-30,110,404,377,781,1660
-70,10,0,391,390,781,1665
130,-10,130,392,389,781,1788
130,20,-180,390,392,782,1617
130,20,180,390,392,782,1617
60,0,80,412,370,782,1653
0,-20,10,394,388,782,1754
20,40,-50,390,392,782,1660
40,-50,50,401,381,782,1694
10,70,-70,384,398,782,1646
40,50,-60,395,387,782,1728
60,-20,90,403,380,783,1732
70,50,-90,385,398,783,1663
-70,80,40,390,393,783,1650
-130,10,60,385,398,783,1432
70,-40,80,404,379,783,1673
100,-30,90,402,381,783,1650
10,-80,10,397,387,784,1728
-150,-80,-160,399,385,784,1695
-140,10,110,385,399,784,1709
-90,-40,-110,412,372,784,1614
-30,-80,-90,399,385,784,1530
-160,-80,-170,404,380,784,1677
160,80,170,382,402,784,1679
10,10,-40,391,393,784,1786
0,-80,0,399,385,784,1711
10,-20,20,398,386,784,1694
120,0,150,395,390,785,1762
140,70,140,376,409,785,1591
30,50,-40,409,376,785,1744
-50,-10,-70,390,395,785,1694
-50,-20,-20,398,387,785,1695
120,50,-140,401,384,785,1701
20,40,-10,405,380,785,1738
100,-40,70,408,377,785,1729
10,-30,20,412,374,786,1757
-10,0,0,392,394,786,1732
40,20,20,402,384,786,1577
-170,-30,110,392,394,786,1452
-120,-80,-130,394,392,786,1613
-130,-60,-160,405,381,786,1682
-110,20,60,388,398,786,1611
30,30,-10,400,386,786,1624
130,40,-160,402,385,787,1645
150,-30,100,380,407,787,1474
-150,-50,140,404,384,788,1500
-20,-50,-80,398,390,788,1662
-120,50,80,402,386,788,1664
-30,50,0,409,379,788,1671
150,70,180,393,395,788,1750
110,-40,80,409,379,788,1712
170,10,140,381,407,788,1756
-100,20,40,396,392,788,1625
90,30,-170,393,395,788,1398
10,-40,20,398,390,788,1761
150,70,-180,393,395,788,1750
50,10,40,404,384,788,1613
-50,70,20,408,380,788,1682
10,60,-30,403,386,789,1761
160,0,140,394,395,789,1792
20,60,-40,399,390,789,1701
50,30,-20,402,387,789,1656
140,70,-170,391,398,789,1643
50,50,-70,391,398,789,1702
-40,-30,-20,401,389,790,1696
90,-60,40,375,415,790,1601
-30,-20,-10,401,389,790,1630
-140,-80,-150,404,386,790,1664
-120,30,80,392,399,791,1733
70,0,60,409,382,791,1654
40,40,-40,399,392,791,1756
170,0,100,390,401,791,1483
170,20,140,395,396,791,1808
-160,-60,170,403,388,791,1661
-60,20,-30,401,390,791,1649
20,-80,20,406,385,791,1717
120,0,130,399,392,791,1656
20,50,-30,396,395,791,1775
30,-80,30,406,385,791,1729
-80,-50,-80,405,386,791,1723
90,-60,90,405,386,791,1827
40,50,-70,394,398,792,1628
0,-30,10,404,388,792,1835
60,20,20,389,403,792,1552
-60,-70,-60,406,386,792,1707
-10,-80,-10,402,390,792,1706
170,80,160,391,401,792,1732
40,20,-30,393,399,792,1707
140,60,-170,398,394,792,1694
-130,-80,-140,399,393,792,1610
-100,30,50,401,391,792,1664
10,-10,20,412,380,792,1665
40,30,-30,399,394,793,1674
150,-20,130,402,391,793,1764
160,40,160,392,401,793,1727
-80,80,50,397,396,793,1675
-90,-60,-100,399,394,793,1833
10,40,-10,402,391,793,1793
30,30,-30,394,399,793,1681
-130,-50,170,397,397,794,1731
-90,-40,-100,404,390,794,1738
70,-10,100,416,378,794,1572
120,-40,110,406,388,794,1699
90,-30,70,414,380,794,1689
0,40,-50,393,401,794,1604
-170,-50,120,407,387,794,1629
-170,20,130,402,392,794,1678
-40,-60,-100,393,401,794,1606
40,-80,40,402,393,795,1722
50,-80,50,403,392,795,1738
50,-50,60,417,378,795,1721
50,-60,-10,407,388,795,1689
-20,-80,-20,402,393,795,1760
-30,-50,-20,407,388,795,1745
110,-50,70,404,391,795,1689
90,20,-160,393,402,795,1557
-120,40,80,389,406,795,1670
110,0,150,393,402,795,1711
-140,0,90,399,396,795,1637
90,20,-170,404,391,795,1563
-180,40,140,389,407,796,1757
150,60,180,408,388,796,1766
180,40,140,389,407,796,1757
140,-70,130,412,384,796,1783
150,60,-180,408,388,796,1766
40,40,-30,395,401,796,1742
90,-20,120,414,382,796,1667
160,70,170,398,398,796,1809
0,40,-10,407,389,796,1744
-20,-80,-80,402,394,796,1558
-150,-20,110,388,409,797,1467
160,-60,140,395,402,797,1783
-120,-50,-170,403,394,797,1746
120,0,160,401,396,797,1698
-80,-30,-110,394,403,797,1668
-70,70,40,397,400,797,1788
40,30,-10,405,392,797,1623
-80,30,30,405,393,798,1763
170,40,150,396,402,798,1763
110,20,-150,414,384,798,1743
30,-50,40,410,388,798,1775
-170,30,130,396,402,798,1794
-150,10,120,402,396,798,1749
30,10,30,408,390,798,1720
110,80,-180,401,398,799,1612
120,-10,130,412,387,799,1813
110,-30,90,398,401,799,1674
60,-30,0,391,408,799,1740
110,80,180,401,398,799,1612
100,10,160,390,410,800,1658
-40,-70,-100,403,397,800,1534
50,50,-80,400,400,800,1589
-60,10,0,402,398,800,1675
-10,-80,-70,399,401,800,1566
0,-40,-60,392,408,800,1670
110,-20,100,406,394,800,1707
110,70,-130,410,391,801,1671
-90,80,60,393,408,801,1709
20,0,30,412,389,801,1737
70,10,0,397,404,801,1614
10,20,0,415,387,802,1698
0,-80,-60,400,402,802,1603
110,-20,120,403,399,802,1771
-70,0,-10,402,400,802,1695
-150,-60,180,407,395,802,1703
80,-20,110,404,398,802,1682
50,-10,80,417,385,802,1682
-150,-60,-180,407,395,802,1703
80,80,-100,411,391,802,1674
20,70,-40,410,392,802,1794
100,-20,100,404,398,802,1711
150,0,110,399,403,802,1608
-100,-70,-110,406,396,802,1709
-130,-90,170,404,399,803,1567
10,-90,-50,404,399,803,1567
-180,-90,120,404,399,803,1567
-60,-90,-120,404,399,803,1567
-120,-90,180,404,399,803,1567
0,-90,-60,404,399,803,1567
-80,-90,-140,404,399,803,1567
-170,-90,130,404,399,803,1567
-120,-90,-180,404,399,803,1567
60,-90,0,404,399,803,1567
50,70,-70,410,393,803,1726
180,-90,120,404,399,803,1567
90,-30,100,418,385,803,1700
-40,-90,-100,404,399,803,1567
100,-90,40,404,399,803,1567
-10,-90,-70,404,399,803,1567
40,-10,-30,396,407,803,1862
-110,-90,-170,404,399,803,1567
110,-90,50,404,399,803,1567
80,-90,20,404,399,803,1567
50,-90,-10,404,399,803,1567
-20,-90,-80,404,399,803,1567
30,-90,-30,404,399,803,1567
140,-90,80,404,399,803,1567
-30,-90,-90,404,399,803,1567
-50,-90,-110,404,399,803,1567
90,-90,30,404,399,803,1567
-70,-90,-130,404,399,803,1567
-30,20,0,400,403,803,1698
-100,-90,-160,404,399,803,1567
-140,-90,160,404,399,803,1567
70,-90,10,404,399,803,1567
150,-90,90,404,399,803,1567
40,-90,-20,404,399,803,1567
-160,-90,140,404,399,803,1567
70,10,20,397,406,803,1619
160,-90,100,404,399,803,1567
-90,-90,-150,404,399,803,1567
50,30,-30,409,394,803,1661
170,-90,110,404,399,803,1567
-150,-90,150,404,399,803,1567
120,-10,120,402,401,803,1708
130,-90,70,404,399,803,1567
-60,-10,-60,399,404,803,1702
120,-90,60,404,399,803,1567
20,-50,30,407,396,803,1809
20,-90,-40,404,399,803,1567
-20,20,0,405,399,804,1833
130,-60,120,407,397,804,1835
-160,40,70,415,389,804,1487
-90,-40,-120,414,390,804,1639
90,40,-160,407,397,804,1527
120,-50,110,400,404,804,1729
20,10,-40,395,409,804,1798
80,-70,80,412,392,804,1825
120,-20,120,410,395,805,1783
-80,20,-10,396,409,805,1673
-140,-60,-170,418,387,805,1708
50,20,-30,403,403,806,1774
-20,-50,-10,412,394,806,1798
20,30,-40,400,406,806,1706
0,10,0,407,399,806,1790
60,-50,70,422,384,806,1859
140,10,120,405,401,806,1531
-90,-50,-100,407,399,806,1714
160,-60,100,414,393,807,1566
180,-40,110,400,407,807,1606
130,0,150,406,401,807,1853
140,40,-170,409,398,807,1669
-180,-40,110,400,407,807,1606
-60,-10,-70,403,404,807,1740
70,50,-100,395,412,807,1639
-30,70,-40,397,410,807,1725
20,20,10,417,390,807,1715
-40,-50,-100,397,410,807,1660
-20,10,0,412,395,807,1781
-40,-20,-80,398,409,807,1801
-180,-50,150,412,396,808,1781
40,70,-60,412,396,808,1784
-110,10,40,414,394,808,1697
40,-70,-20,400,408,808,1601
0,60,-60,407,401,808,1507
100,-40,100,415,393,808,1780
40,50,-50,412,396,808,1813
180,-50,150,412,396,808,1781
-10,-40,0,408,401,809,1824
60,-80,60,409,400,809,1767
-30,40,-40,411,398,809,1559
0,-40,10,409,400,809,1906
60,50,-90,397,412,809,1656
-60,70,30,410,399,809,1748
-30,-70,-90,397,412,809,1589
40,40,-20,423,386,809,1790
180,80,150,393,417,810,1759
-180,80,150,393,417,810,1759
-50,30,10,414,396,810,1758
80,70,-140,402,408,810,1646
50,40,-40,406,404,810,1722
-100,10,20,408,403,811,1661
150,50,-180,417,394,811,1708
140,10,160,413,398,811,1752
100,60,-170,384,427,811,1655
150,50,180,417,394,811,1708
-100,80,70,399,412,811,1769
80,-40,90,417,394,811,1832
30,40,-50,411,400,811,1738
70,80,-90,415,396,811,1669
10,-80,-50,406,405,811,1586
60,-30,80,416,396,812,1879
110,-10,130,407,405,812,1842
-80,20,20,414,398,812,1690
-120,20,80,396,416,812,1660
-80,-20,-70,410,402,812,1652
90,80,-110,415,397,812,1720
-170,-40,150,410,403,813,1797
100,40,170,433,380,813,1567
100,-20,120,413,400,813,1800
-160,-20,140,399,414,813,1799
-90,-40,-130,413,400,813,1720
0,0,-50,388,425,813,1884
-80,10,0,401,412,813,1615
160,-70,100,420,394,814,1606
-160,0,90,408,406,814,1586
50,-10,-20,402,412,814,1796
-10,50,-10,424,390,814,1736
-90,60,10,389,425,814,1663
0,60,-20,412,402,814,1784
-30,-30,-80,403,411,814,1800
120,-60,70,416,398,814,1702
10,50,-20,421,393,814,1780
100,-50,60,412,402,814,1602
-60,-50,-50,419,395,814,1792
-90,50,50,404,411,815,1745
180,-30,140,409,406,815,1840
30,70,-50,415,400,815,1804
30,30,-40,411,404,815,1863
-180,-30,140,409,406,815,1840
110,0,160,422,393,815,1703
160,-80,100,421,394,815,1631
-40,60,10,424,391,815,1802
70,-80,70,414,402,816,1817
-100,50,60,391,425,816,1718
-160,0,130,406,410,816,1863
-10,10,0,415,401,816,1803
40,40,-50,419,397,816,1784
140,-20,130,420,396,816,1845
150,-70,140,420,396,816,1833
10,70,-30,417,399,816,1818
80,-20,70,427,390,817,1637
-110,10,50,411,406,817,1738
-60,-50,-120,407,410,817,1759
-80,-20,-80,403,414,817,1705
170,-40,140,422,395,817,1904
170,70,160,404,413,817,1826
130,0,120,403,414,817,1624
-70,-30,-110,407,411,818,1673
-110,70,30,407,411,818,1720
40,50,-40,413,405,818,1811
-170,80,140,400,418,818,1785
-30,-80,-30,416,402,818,1772
-150,40,60,412,406,818,1520
-130,40,40,398,421,819,1510
-10,30,0,413,406,819,1834
70,20,10,408,411,819,1681
60,40,-50,415,404,819,1787
-70,-20,-90,406,413,819,1644
10,10,10,417,402,819,1764
100,-30,110,417,402,819,1701
50,40,-50,411,408,819,1763
-70,-10,-20,415,404,819,1720
130,10,170,413,407,820,1725
-40,10,0,409,411,820,1730
-110,-60,-130,419,402,821,1836
-50,10,0,418,403,821,1699
60,80,-80,419,402,821,1717
120,60,-140,417,404,821,1701
140,20,170,416,405,821,1762
160,60,170,422,399,821,1822
-40,-10,-10,421,400,821,1725
70,-20,110,420,401,821,1778
-40,80,-30,411,411,822,1713
90,50,-150,403,419,822,1611
-70,-50,-130,413,409,822,1751
130,-30,120,420,402,822,1828
-20,30,0,413,409,822,1785
-60,40,20,416,406,822,1809
70,-20,100,418,404,822,1787
-130,10,100,410,412,822,1671
110,30,-130,404,419,823,1737
-10,10,-50,410,413,823,1884
90,40,-110,404,419,823,1642
-110,50,70,414,410,824,1703
70,-10,110,418,406,824,1660
-110,80,80,406,418,824,1784
-140,-20,130,405,419,824,1775
50,30,-10,432,392,824,1766
140,-60,130,419,405,824,1913
0,30,-50,401,424,825,1798
50,50,-60,419,406,825,1767
90,-20,90,427,398,825,1729
-80,30,-10,415,410,825,1699
-80,-30,-60,412,413,825,1722
0,0,10,419,406,825,1814
90,40,-150,397,428,825,1706
30,0,40,416,409,825,1803
100,-60,100,419,406,825,1956
70,50,-80,422,403,825,1785
60,-40,0,414,411,825,1768
-130,-50,-180,413,413,826,1782
60,10,60,413,413,826,1575
-30,10,0,420,406,826,1826
90,30,-140,420,406,826,1579
20,20,-40,418,408,826,1906
-30,60,-40,400,426,826,1619
-130,-50,180,413,413,826,1782
100,-10,120,415,412,827,1860
-70,-70,-70,431,396,827,1790
160,20,150,412,415,827,1993
100,10,-170,416,411,827,1754
-70,-40,-120,416,411,827,1772
-150,20,120,407,420,827,1802
-170,-20,140,412,415,827,1856
50,-30,70,429,398,827,1911
20,-80,-40,407,420,827,1588
80,-80,80,428,400,828,1881
50,80,-70,424,404,828,1723
30,30,0,422,406,828,1759
100,80,-120,419,409,828,1753
150,10,150,408,420,828,1853
-140,-10,110,405,423,828,1715
50,40,-30,427,401,828,1750
120,30,-150,424,405,829,1790
100,10,-150,417,412,829,1748
10,-30,-50,412,417,829,1809
-160,50,70,416,413,829,1675
30,40,-10,432,397,829,1843
90,20,-150,417,413,830,1586
-20,0,0,420,410,830,1859
-140,-20,120,396,434,830,1714
90,-10,120,429,401,830,1769
30,50,-30,411,420,831,1870
-110,-70,-120,421,410,831,1760
160,-50,100,416,415,831,1738
-90,10,10,417,414,831,1794
110,0,170,418,413,831,1718
-60,0,-50,394,438,832,1783
100,-50,100,422,410,832,1784
-90,30,40,420,412,832,1762
-20,-10,-60,408,424,832,1873
-80,70,50,409,424,833,1825
150,20,160,419,414,833,1855
-60,20,10,417,416,833,1762
110,0,140,404,429,833,1818
-160,80,130,406,427,833,1793
-150,-50,170,424,409,833,1764
100,10,-160,419,414,833,1893
30,-80,-30,410,424,834,1610
60,40,-60,422,412,834,1791
50,50,-50,415,419,834,1874
40,0,50,423,411,834,1852
150,-40,130,425,409,834,1919
10,-20,-50,421,413,834,1953
150,-50,130,426,409,835,1828
-10,20,0,416,419,835,1795
30,0,-40,405,430,835,1806
40,80,-60,423,412,835,1738
50,60,-60,424,411,835,1864
-40,10,-50,417,418,835,1892
10,0,20,435,400,835,1800
-40,30,-40,412,423,835,1590
-110,-50,-140,420,415,835,1815
180,70,150,417,419,836,1787
40,60,-90,410,426,836,1768
-180,70,150,417,419,836,1787
150,-80,90,434,402,836,1711
40,-20,60,424,412,836,1781
10,30,-50,417,419,836,1898
0,20,0,415,421,836,1815
130,-10,110,405,431,836,1687
150,-10,140,424,412,836,1898
-10,-20,-60,427,409,836,1876
80,50,-120,431,405,836,1660
90,-70,90,433,404,837,1897
-140,-40,150,431,406,837,1809
-40,-10,-70,422,415,837,1872
130,-40,120,427,410,837,1800
60,0,90,432,405,837,1694
70,-30,90,424,413,837,1875
70,-50,80,441,396,837,1845
10,50,-60,415,423,838,1644
-10,50,-50,410,428,838,1618
-130,0,100,423,415,838,1740
30,50,-70,408,430,838,1710
-110,10,30,431,408,839,1709
40,-80,-20,406,433,839,1605
50,0,80,427,412,839,1719
-130,80,100,413,426,839,1823
10,-50,20,428,411,839,1791
-100,10,30,416,423,839,1777
60,50,-70,430,409,839,1748
110,-40,110,425,414,839,1830
90,-80,90,434,405,839,1919
-120,80,90,412,428,840,1819
50,50,-40,421,419,840,1869
170,-10,100,413,427,840,1579
-140,80,110,414,426,840,1823
60,0,-20,405,435,840,1831
50,10,-30,408,432,840,1854
80,50,-90,424,416,840,1846
-150,80,120,413,427,840,1824
-150,-20,140,402,439,841,1819
-120,-50,-160,428,413,841,1770
-50,60,20,426,415,841,1881
40,-10,60,429,412,841,1820
100,70,-170,421,420,841,1763
160,-10,140,432,409,841,1895
-90,20,30,421,421,842,1737
30,80,-50,426,416,842,1739
-60,-20,-90,420,422,842,1810
160,60,110,415,427,842,1741
-120,10,80,416,426,842,1729
-140,40,50,432,410,842,1526
-80,-40,-70,428,414,842,1836
120,-10,140,422,420,842,1958
-40,-80,-40,430,413,843,1805
120,10,-180,407,436,843,1833
170,0,140,426,417,843,1844
-10,-50,0,420,423,843,1955
120,10,180,407,436,843,1833
50,-80,-10,412,432,844,1649
120,0,170,413,431,844,1800
-30,80,-40,423,422,845,1805
-70,-20,-30,427,418,845,1810
60,20,-30,421,424,845,1802
-70,0,-40,414,431,845,1669
50,-70,-10,417,429,846,1747
90,-40,50,424,422,846,1698
100,-60,50,412,434,846,1806
-80,-60,-80,433,413,846,1860
110,60,170,409,437,846,1823
150,-30,130,430,416,846,1890
130,70,150,409,437,846,1771
40,30,0,433,413,846,1796
140,-10,140,421,426,847,1980
-90,-30,-100,426,421,847,1874
10,-10,-50,419,428,847,1904
20,50,-20,430,418,848,1913
50,-20,80,436,412,848,1911
80,-30,100,428,420,848,1886
30,-20,50,437,411,848,1841
110,80,-130,431,417,848,1850
60,-10,100,436,412,848,1673
10,30,0,440,409,849,1847
-60,-40,-40,432,417,849,1877
-10,30,-50,417,432,849,1767
160,-70,150,444,406,850,1878
60,30,-30,432,418,850,1808
20,70,-80,424,426,850,1819
100,-80,100,441,409,850,1964
-140,20,110,405,445,850,1739
170,60,160,430,421,851,1873
100,-10,130,413,438,851,1934
120,40,-140,425,426,851,1843
20,30,0,434,417,851,1807
-20,-10,0,439,412,851,1943
-110,40,70,422,429,851,1785
-120,-50,180,430,422,852,1821
-120,-50,-180,430,422,852,1821
60,40,-40,443,409,852,1725
-60,60,30,423,429,852,1846
-110,10,60,423,429,852,1794
120,70,-140,437,415,852,1739
40,-60,50,426,426,852,1895
40,30,-40,426,426,852,1874
60,-80,0,419,433,852,1682
60,20,-20,442,410,852,1883
80,-40,30,417,436,853,1713
110,-10,120,436,417,853,1851
50,10,50,433,420,853,1816
-20,40,0,436,417,853,1841
-10,-40,-70,425,428,853,1820
150,30,170,426,427,853,1900
0,70,-20,435,418,853,1813
80,-50,90,442,411,853,1915
130,-50,120,429,424,853,1894
130,-10,140,423,430,853,1971
-50,-80,-50,429,424,853,1850
-140,50,50,439,415,854,1668
-100,-40,-140,431,423,854,1847
-80,10,-10,428,426,854,1692
-20,-60,-10,435,419,854,1949
-50,-50,-110,430,424,854,1848
80,-20,120,429,425,854,1776
0,-50,10,427,428,855,1898
-130,30,40,445,410,855,1468
-30,-60,-20,438,417,855,1877
-100,70,70,424,431,855,1881
110,10,-170,415,440,855,1829
-100,-50,-120,446,409,855,1919
160,50,170,424,431,855,1828
20,80,-40,439,417,856,1783
10,80,-30,440,416,856,1767
40,50,-30,430,426,856,1920
90,40,-170,437,419,856,1609
90,60,-100,438,418,856,1848
140,0,150,429,427,856,1972
110,-60,60,420,436,856,1808
100,10,-140,422,434,856,1777
-40,-30,-90,444,412,856,1937
110,50,160,438,418,856,1628
170,-60,150,432,425,857,1904
130,70,-150,432,425,857,1866
150,60,120,421,436,857,1754
-90,70,60,421,437,858,1885
-140,-40,160,435,423,858,1936
-140,-30,140,428,430,858,1721
40,60,-50,435,423,858,1897
90,-10,110,429,429,858,1828
10,-60,20,431,427,858,1904
-70,60,40,420,438,858,1847
180,-20,140,425,433,858,1983
90,30,-150,422,436,858,1635
-180,-20,140,425,433,858,1983
100,0,150,424,434,858,1813
80,-20,40,428,430,858,1655
-160,10,130,422,437,859,1865
90,-30,110,435,424,859,1864
-80,-70,-80,442,417,859,1842
170,-10,140,428,431,859,1978
50,30,-40,440,419,859,1880
-160,70,130,432,428,860,1859
80,-10,90,445,415,860,1758
-150,-40,130,432,428,860,1753
-70,10,-30,420,440,860,1732
-90,-40,-90,432,428,860,1948
50,40,-60,442,419,861,1891
30,20,20,442,419,861,1879
50,30,0,433,428,861,1910
30,40,-60,439,422,861,1917
-10,60,-10,450,411,861,1847
0,50,-10,448,413,861,1908
170,-70,160,445,416,861,1906
-50,-10,-10,439,423,862,1829
-70,40,30,424,438,862,1798
110,20,-140,438,424,862,1841
30,-60,40,436,426,862,1917
120,-30,120,431,431,862,1847
60,30,-20,445,417,862,1831
20,30,-50,428,434,862,1954
30,20,-40,434,428,862,1983
100,0,160,431,431,862,1761
20,-60,30,434,428,862,1954
50,-60,60,440,423,863,1944
-170,70,140,437,426,863,1845
-40,50,10,437,426,863,1906
-80,-20,-50,437,426,863,1795
100,-30,80,440,423,863,1891
120,-20,100,429,434,863,1765
100,80,-170,425,439,864,1765
50,10,70,444,420,864,1761
90,20,180,440,424,864,1658
100,10,150,423,441,864,1827
90,20,-180,440,424,864,1658
180,60,150,426,439,865,1914
-180,60,150,426,439,865,1914
-70,-10,-70,425,440,865,1842
-130,0,90,424,441,865,1775
90,10,-170,431,434,865,1809
90,-40,100,442,423,865,1948
-40,-60,-30,443,422,865,1824
40,40,-10,452,414,866,1902
180,-60,160,435,431,866,1908
110,-80,110,453,413,866,1987
90,10,-150,434,432,866,1811
-40,40,10,449,417,866,1891
-180,-60,160,435,431,866,1908
20,40,-60,438,428,866,1917
-170,-50,160,434,432,866,1955
90,10,-160,438,429,867,1847
60,60,-70,443,424,867,1896
-110,30,70,430,437,867,1841
60,-60,0,445,422,867,1805
50,0,-30,424,443,867,1915
0,30,0,428,439,867,1865
90,50,-100,438,429,867,1922
60,40,-30,450,418,868,1814
120,80,-140,439,429,868,1908
60,10,-20,427,441,868,2008
-140,-50,150,449,419,868,1696
-60,-80,-60,434,434,868,1883
50,40,-20,464,405,869,1827
40,50,-80,429,440,869,1736
150,10,110,445,424,869,1700
-120,-60,-140,445,424,869,1912
180,30,140,428,441,869,2065
-40,-40,-20,451,418,869,1921
-70,-30,-40,437,432,869,1857
-180,30,140,428,441,869,2065
90,-80,30,431,438,869,1813
-90,-30,-90,437,432,869,1870
100,-70,100,448,421,869,1937
-180,20,140,433,437,870,1899
60,20,-10,442,428,870,1892
40,30,-50,438,432,870,1982
180,20,140,433,437,870,1899
130,60,-150,434,436,870,1854
-50,40,-30,436,435,871,1769
0,80,-20,442,429,871,1809
30,-10,-40,421,450,871,2020
-100,-60,-110,445,426,871,1932
30,60,-40,451,420,871,1935
70,0,0,438,433,871,2040
-150,70,120,437,434,871,1916
60,-10,-10,429,442,871,1999
80,-10,120,441,431,872,1772
110,-10,140,427,445,872,1960
-60,10,-40,430,442,872,1865
130,50,-150,440,432,872,1838
70,60,-120,434,438,872,1806
-20,-20,0,448,424,872,2016
-50,-40,-30,443,429,872,1895
70,60,-80,442,430,872,1856
160,-30,100,433,439,872,1644
-180,0,140,443,429,872,1982
180,0,140,443,429,872,1982
-10,40,-50,423,450,873,1773
150,40,180,422,451,873,1870
150,40,-180,422,451,873,1870
-70,-10,-60,433,440,873,1829
30,-30,50,441,432,873,1941
110,-70,110,452,422,874,1972
-20,-40,-80,438,436,874,1948
-170,-10,140,438,436,874,2073
-120,40,30,445,429,874,1701
30,30,-50,435,439,874,1962
60,-50,0,422,452,874,1877
30,50,-20,439,435,874,1939
140,60,130,427,448,875,1809
-100,-50,-160,442,433,875,1865
120,-30,90,436,439,875,1789
-10,-60,0,440,435,875,1989
120,-80,120,452,423,875,1996
-140,70,110,430,445,875,1909
-30,50,-40,416,459,875,1763
110,-20,130,447,429,876,1995
-100,70,20,426,450,876,1915
-80,-50,-140,443,433,876,1842
90,-10,100,432,444,876,1824
-140,-10,120,418,458,876,1919
40,40,-60,440,436,876,1923
80,60,-90,446,430,876,1838
-150,50,60,442,435,877,1831
140,-80,80,454,423,877,1771
50,30,-50,444,433,877,1967
30,10,-40,428,449,877,1948
180,-70,170,450,427,877,1968
-180,-70,170,450,427,877,1968
130,20,130,447,431,878,1738
-40,30,10,450,428,878,1892
-90,20,0,435,443,878,1717
-120,70,90,434,444,878,1884
170,50,160,432,446,878,1916
120,20,140,442,436,878,1796
-120,-70,-130,449,429,878,1879
-20,80,-50,441,438,879,1941
70,70,-130,434,445,879,1864
70,70,-80,460,419,879,1971
110,-30,120,443,436,879,1828
100,30,-120,434,445,879,1814
-150,-10,130,424,455,879,1928
-80,-20,-90,436,443,879,1719
-60,-20,-20,453,426,879,1999
-10,80,-10,446,433,879,1849
-10,20,-50,441,438,879,1906
70,0,70,459,420,879,1716
-110,70,80,426,453,879,1908
-170,30,80,465,414,879,1639
-150,-30,120,439,440,879,1745
170,-30,140,438,442,880,1953
80,70,-90,461,419,880,1955
0,10,-50,440,440,880,1966
60,40,-70,448,432,880,1925
-120,10,40,452,428,880,1707
70,-80,10,423,457,880,1733
130,80,-150,442,438,880,1897
0,-60,10,447,433,880,1885
110,-60,110,450,430,880,2098
60,-60,70,455,425,880,2039
10,0,-50,425,455,880,1966
-70,30,-20,449,431,880,1786
-140,-10,100,428,453,881,1730
-20,-20,-70,430,451,881,1939
-30,-30,-10,459,422,881,1917
100,20,-130,429,452,881,1737
100,0,140,428,453,881,1812
130,-20,130,451,431,882,1932
100,50,-110,449,433,882,1906
50,-20,-20,435,447,882,1952
100,60,-110,455,427,882,1912
-180,-50,110,454,428,882,1795
-50,20,-40,437,445,882,1856
60,-40,80,453,429,882,1961
-30,0,0,444,438,882,1984
180,-50,110,454,428,882,1795
170,60,100,438,445,883,1785
-80,-20,-60,449,434,883,1809
-60,-30,-30,455,428,883,1904
120,-20,130,439,444,883,2022
60,30,-10,454,429,883,1886
70,-20,10,439,444,883,1946
-70,-80,-70,442,442,884,1890
40,-30,60,452,432,884,1943
60,30,-40,441,443,884,1816
-40,0,-60,437,448,885,2144
110,10,140,438,447,885,1906
-110,20,70,436,449,885,1877
-30,0,-60,434,451,885,2037
-130,-50,-170,449,436,885,2035
-80,10,10,438,447,885,1902
70,10,40,449,436,885,1747
70,-60,80,458,427,885,2016
130,0,160,444,441,885,1976
-80,40,40,440,446,886,1937
0,10,10,450,436,886,1889
90,-30,60,456,430,886,1818
-130,70,100,436,450,886,1911
-20,50,0,456,430,886,1860
160,30,160,450,436,886,2027
-70,-50,-60,455,431,886,1948
170,30,150,446,441,887,2130
100,40,-110,447,440,887,1959
-160,10,80,446,441,887,1724
130,-80,130,459,429,888,2026
-130,20,100,432,456,888,1739
40,20,-40,449,439,888,2096
-60,-10,-80,436,453,889,1916
180,-10,140,443,446,889,2018
80,-80,20,429,460,889,1772
-110,30,20,448,441,889,1696
-180,-10,140,443,446,889,2018
-80,-40,-130,437,452,889,1878
-80,60,0,444,445,889,1805
60,50,-60,446,443,889,1887
-20,70,-50,442,447,889,1885
-50,-30,-100,447,442,889,1889
170,-20,100,435,454,889,1636
60,20,-40,438,451,889,1973
40,-20,-30,434,455,889,1927
100,-90,100,459,431,890,1940
40,-90,40,459,431,890,1940
-50,-90,-50,459,431,890,1940
-70,-90,-70,459,431,890,1940
80,-90,80,459,431,890,1940
50,-90,50,459,431,890,1940
-60,-90,-60,459,431,890,1940
-100,-90,-100,459,431,890,1940
30,-90,30,459,431,890,1940
0,-90,0,459,431,890,1940
140,-90,140,459,431,890,1940
170,-90,170,459,431,890,1940
110,-90,110,459,431,890,1940
70,-90,70,459,431,890,1940
10,-90,10,459,431,890,1940
120,-90,120,459,431,890,1940
-90,-90,-90,459,431,890,1940
20,-90,20,459,431,890,1940
-10,-90,-10,459,431,890,1940
-110,-90,-110,459,431,890,1940
160,-90,160,459,431,890,1940
-120,-90,-120,459,431,890,1940
-50,-60,-40,454,436,890,1882
-20,-90,-20,459,431,890,1940
-80,60,50,433,457,890,1870
-40,-90,-40,459,431,890,1940
180,-90,-180,459,431,890,1940
180,-90,180,459,431,890,1940
-80,-90,-80,459,431,890,1940
60,-90,60,459,431,890,1940
130,-90,130,459,431,890,1940
-30,-90,-30,459,431,890,1940
90,-90,90,459,431,890,1940
150,-90,150,459,431,890,1940
110,-50,110,452,438,890,2003
-180,-90,-180,459,431,890,1940
-150,-90,-150,459,431,890,1940
-150,-30,150,450,440,890,1998
-140,-90,-140,459,431,890,1940
-130,-90,-130,459,431,890,1940
-180,-90,180,459,431,890,1940
-170,-90,-170,459,431,890,1940
-160,-90,-160,459,431,890,1940
160,10,150,429,462,891,2011
-10,70,-10,460,431,891,1865
-150,-40,160,445,446,891,1938
-100,20,50,449,442,891,1861
100,-20,130,452,440,892,1927
100,-10,140,437,455,892,1958
140,20,180,439,453,892,2029
-20,80,0,452,440,892,1891
80,40,-100,435,457,892,1819
-60,50,-20,432,460,892,1725
60,70,-70,459,433,892,2008
140,20,-180,439,453,892,2029
-110,-50,-170,454,439,893,1878
-160,-40,120,460,433,893,1902
0,20,-50,443,450,893,1951
40,10,40,454,439,893,1923
-50,-10,-80,440,453,893,2009
-90,10,20,452,441,893,1949
20,60,-30,454,440,894,1984
-10,40,0,460,434,894,1968
160,-50,140,461,433,894,1941
120,-70,120,462,432,894,2010
-50,50,20,447,447,894,1983
150,-60,140,455,440,895,2025
0,-30,-60,441,454,895,2034
60,10,70,448,448,896,1815
-140,60,110,443,453,896,1976
60,20,30,450,446,896,1751
-140,-20,140,430,466,896,2022
30,70,-90,452,444,896,1956
-90,-50,-90,461,436,897,1975
50,20,-40,444,453,897,2005
180,10,140,447,450,897,1940
150,-70,90,460,437,897,1827
10,20,10,454,443,897,1929
20,-20,40,455,442,897,1978
-180,10,140,447,450,897,1940
-90,-50,-150,442,455,897,1857
-120,30,30,462,436,898,1741
170,-20,140,449,449,898,2106
100,-10,110,443,455,898,1932
90,70,-100,471,428,899,1999
-80,-20,-40,463,436,899,1852
100,20,160,425,474,899,1808
100,-20,90,455,444,899,1960
-120,-50,-150,448,451,899,1928
50,-10,90,469,431,900,1875
-60,30,20,457,443,900,1922
-20,70,0,459,441,900,1924
60,50,-50,460,441,901,2020
-150,-60,140,449,452,901,1877
-90,-70,-90,465,436,901,1965
-70,-40,-50,449,452,901,1995
-140,-50,180,460,442,902,1915
90,-10,130,456,446,902,1887
-140,-50,-180,460,442,902,1915
-50,-20,-90,462,440,902,2032
-150,60,120,450,452,902,1971
-80,-80,-80,453,450,903,1904
-30,80,10,452,451,903,1940
-140,30,50,469,434,903,1614
160,-20,100,454,449,903,1710
180,20,90,473,431,904,1745
-180,20,90,473,431,904,1745
-100,-40,-130,463,441,904,1930
50,-40,70,472,432,904,2023
-50,20,10,453,451,904,1947
140,70,-160,455,449,904,1931
120,10,130,448,457,905,1888
-170,-70,-180,458,447,905,2062
50,20,30,455,450,905,1867
-170,-70,180,458,447,905,2062
110,20,150,436,469,905,1873
60,70,-120,455,450,905,1972
-90,-40,-140,459,446,905,1936
160,-40,140,467,438,905,2087
-130,50,40,436,469,905,1789
150,70,-170,466,440,906,2006
60,-20,100,462,444,906,2056
-10,-20,10,462,444,906,2185
130,-20,100,448,458,906,1853
-30,-40,-90,457,450,907,1902
50,70,-60,462,445,907,2027
50,30,10,448,459,907,1981
110,0,130,454,453,907,1896
140,80,-160,452,455,907,1918
130,30,-160,454,453,907,2013
-90,-30,-110,446,462,908,1933
130,-80,70,457,451,908,1842
-90,40,50,440,468,908,1989
100,-30,120,465,443,908,1921
100,0,170,441,467,908,1916
140,-30,130,461,448,909,2049
180,60,90,448,461,909,1811
-180,60,90,448,461,909,1811
-20,20,-50,457,452,909,1878
20,-30,40,453,456,909,2138
140,10,170,460,449,909,1925
-40,-20,-10,462,447,909,1965
10,50,-10,462,448,910,2037
-160,20,130,454,456,910,1994
20,-70,30,462,448,910,2019
70,20,0,453,457,910,1889
-40,0,0,457,453,910,1978
50,60,-100,463,447,910,1879
150,-20,100,451,460,911,1679
-30,-40,-10,457,454,911,2046
-130,-60,-150,466,445,911,2013
-80,-10,-30,459,452,911,1915
-160,-30,150,470,441,911,2020
140,20,120,462,449,911,1807
70,40,-80,461,450,911,1870
-130,-70,-140,464,448,912,1988
-120,60,90,450,462,912,2095
10,-30,30,465,447,912,2099
70,10,50,466,446,912,1875
40,-70,50,458,455,913,2081
180,-40,150,462,451,913,2016
-20,-30,0,456,457,913,2135
60,0,100,477,436,913,1824
-30,40,10,460,453,913,2087
30,-10,50,470,443,913,1931
-90,-30,-80,448,465,913,1963
-180,-40,150,462,451,913,2016
100,-80,40,453,460,913,1877
-170,60,140,445,469,914,2019
-140,30,110,449,465,914,1925
160,40,170,457,457,914,2041
-80,-10,-40,453,461,914,1910
-40,80,20,455,459,914,2022
20,-10,40,469,445,914,1961
-10,-30,10,457,457,914,2159
-140,-30,150,450,464,914,2116
160,-20,140,461,454,915,2138
90,-50,100,473,442,915,2014
180,50,150,460,455,915,1981
-10,-10,10,464,451,915,2095
-170,-60,170,467,448,915,2001
10,10,-50,451,464,915,2065
-180,50,150,460,455,915,1981
40,70,-50,469,447,916,2050
10,40,0,478,438,916,2007
-130,60,100,451,465,916,2047
50,40,-70,462,454,916,1968
-170,50,140,454,462,916,2065
-10,80,-60,463,453,916,2029
70,40,-50,462,454,916,1942
-70,-10,-80,459,457,916,1966
140,-80,140,473,444,917,2069
110,-80,50,458,459,917,1907
40,10,-40,449,468,917,2093
-120,10,90,441,476,917,1879
90,40,-100,468,449,917,2019
70,30,-30,473,445,918,1894
-160,-60,130,455,463,918,1837
140,60,-160,464,454,918,1996
140,-20,100,449,469,918,1849
-20,60,0,478,441,919,1985
10,-70,20,469,450,919,2058
-160,-10,140,443,476,919,2051
70,50,-70,462,457,919,1913
90,80,-160,450,469,919,1943
100,70,-110,476,444,920,2002
110,60,-120,473,447,920,1985
140,-40,90,458,462,920,1886
70,10,60,469,451,920,1899
-90,-60,-90,464,456,920,2016
-160,60,130,455,465,920,2028
30,-70,40,469,451,920,2043
-80,90,60,456,465,921,1965
-60,-60,-50,473,448,921,2015
-110,90,90,456,465,921,1965
60,30,-50,465,456,921,2035
-10,90,-10,456,465,921,1965
-20,90,0,456,465,921,1965
-100,90,80,456,465,921,1965
80,-30,30,456,465,921,2041
150,90,-170,456,465,921,1965
160,90,-180,456,465,921,1965
-50,90,30,456,465,921,1965
-120,90,100,456,465,921,1965
60,90,-80,456,465,921,1965
160,90,180,456,465,921,1965
70,-40,90,477,444,921,2053
-180,90,160,456,465,921,1965
-140,50,110,456,465,921,2006
-170,90,150,456,465,921,1965
170,90,170,456,465,921,1965
-150,30,120,457,464,921,1951
-160,90,140,456,465,921,1965
100,90,-120,456,465,921,1965
70,90,-90,456,465,921,1965
-140,90,120,456,465,921,1965
-160,-60,-180,465,456,921,2107
-40,90,20,456,465,921,1965
40,90,-60,456,465,921,1965
140,90,-160,456,465,921,1965
50,50,-90,460,461,921,1822
-130,90,110,456,465,921,1965
0,90,-20,456,465,921,1965
90,-20,80,469,452,921,2021
90,90,-110,456,465,921,1965
-90,90,70,456,465,921,1965
130,90,-150,456,465,921,1965
110,90,-130,456,465,921,1965
50,90,-70,456,465,921,1965
-150,90,130,456,465,921,1965
20,90,-40,456,465,921,1965
180,90,160,456,465,921,1965
120,90,-140,456,465,921,1965
130,30,130,475,446,921,1749
-30,90,10,456,465,921,1965
-60,90,40,456,465,921,1965
-70,90,50,456,465,921,1965
80,90,-100,456,465,921,1965
30,90,-50,456,465,921,1965
10,90,-30,456,465,921,1965
-160,-60,180,465,456,921,2107
-90,60,60,452,470,922,1970
-50,0,-60,453,469,922,2154
-10,-70,0,468,454,922,2002
60,60,-110,465,457,922,1913
-160,-70,-170,468,454,922,2102
-160,50,130,462,460,922,2009
0,-70,10,470,453,923,2022
150,10,160,458,465,923,2094
10,-20,30,464,459,923,2155
-90,10,0,450,473,923,1801
60,30,0,477,446,923,1943
150,80,-170,459,464,923,1951
-20,-70,-10,475,448,923,2039
-60,50,30,468,456,924,1980
50,60,-50,472,452,924,2013
10,20,-50,469,455,924,1990
-10,0,10,465,459,924,2063
120,-80,60,467,457,924,1911
70,50,-110,463,461,924,1857
-100,40,60,462,463,925,1918
120,-60,120,472,453,925,2124
-130,50,100,459,466,925,2022
60,40,-80,455,470,925,1938
70,0,80,480,445,925,1867
150,-60,90,473,453,926,1867
130,60,140,464,462,926,1873
-100,-50,-110,456,470,926,2045
-110,40,20,443,483,926,1849
-30,-70,-20,477,449,926,2066
120,20,-160,458,469,927,2053
120,70,160,446,481,927,1957
-50,-30,-20,481,446,927,2024
60,10,-30,453,474,927,2071
-80,-10,-50,454,473,927,1846
70,40,-70,475,452,927,1990
170,20,150,462,465,927,2117
-170,0,90,479,448,927,1881
-10,-10,-60,458,469,927,2056
140,-50,130,468,459,927,2122
20,20,-50,468,460,928,2050
40,50,-20,478,450,928,2004
-60,0,0,471,457,928,1992
10,60,-20,477,451,928,2023
140,-40,130,462,466,928,2054
60,-30,90,477,451,928,2117
-60,-10,-10,482,446,928,2109
-110,60,80,459,469,928,2112
140,50,-160,465,464,929,2010
80,-60,90,476,453,929,2077
170,-50,150,475,454,929,2065
60,60,-60,479,450,929,2017
130,-30,130,469,461,930,2047
30,-20,-40,463,467,930,2117
-170,60,80,459,471,930,1871
-30,60,10,474,457,931,2125
0,-10,20,481,450,931,2085
-80,-30,-50,465,466,931,2011
120,-10,110,453,478,931,1950
70,30,-40,467,464,931,1912
80,-40,100,470,461,931,2072
120,-40,120,470,462,932,1996
130,-70,130,485,447,932,2075
-40,-40,-100,470,462,932,1885
-130,-40,160,456,476,932,2062
80,-10,80,488,444,932,1975
80,40,-110,473,460,933,1904
110,70,-120,480,453,933,2037
-130,0,110,464,469,933,2014
50,70,-110,482,451,933,2084
40,70,-100,470,464,934,2064
-90,30,0,458,476,934,1883
-150,50,120,456,478,934,2012
110,50,-120,463,471,934,1952
30,70,-40,474,460,934,2140
-110,10,70,460,474,934,1947
90,30,-130,461,474,935,1889
-90,-80,-90,472,463,935,1987
-30,70,10,472,463,935,2011
20,50,-10,474,461,935,2094
-120,20,90,451,484,935,1918
90,-20,130,464,471,935,1970
10,10,20,481,454,935,2091
40,20,-50,476,459,935,2111
70,-30,100,476,459,935,2134
150,-20,140,472,464,936,2137
20,0,-50,450,486,936,2002
10,40,-60,462,474,936,2062
-50,80,30,461,475,936,2052
170,40,160,465,471,936,2069
130,20,-170,455,481,936,1887
40,60,-40,480,456,936,2072
90,30,180,482,455,937,1861
80,-10,50,482,455,937,1817
70,-10,0,470,467,937,2085
10,-10,30,487,450,937,2135
90,30,-180,482,455,937,1861
150,20,170,475,462,937,2071
20,50,-70,471,466,937,1912
-40,20,10,470,467,937,2048
80,-30,110,472,465,937,2035
60,30,10,470,467,937,1933
-100,60,70,456,482,938,2069
-110,-50,-130,479,459,938,2112
150,0,150,461,477,938,2203
-10,-30,-70,470,468,938,2095
30,20,-50,481,457,938,2088
0,20,10,479,460,939,1994
130,40,-150,469,470,939,2029
50,50,-30,477,462,939,2023
40,0,-40,462,477,939,2054
120,0,120,470,470,940,1925
-160,-40,160,471,469,940,2123
0,-20,20,490,450,940,2094
-70,20,20,466,474,940,1977
90,10,-180,441,499,940,1927
160,-30,140,471,469,940,2137
90,10,180,441,499,940,1927
-70,10,10,455,485,940,2057
70,0,100,479,461,940,1947
-140,-60,-160,473,468,941,2158
-140,-30,130,467,474,941,1907
80,40,-90,480,461,941,1939
-130,0,80,459,483,942,1838
160,70,-180,478,464,942,2058
160,70,180,478,464,942,2058
-50,10,-50,450,492,942,2159
-70,0,-50,460,482,942,2050
100,-40,110,477,465,942,2047
-160,30,130,476,467,943,2067
70,-30,10,474,469,943,2121
50,-30,80,479,464,943,2182
-80,0,-20,478,465,943,1938
50,0,90,477,466,943,1914
10,-40,30,482,461,943,2141
120,-10,150,473,470,943,2107
140,30,-170,478,466,944,2032
-100,20,10,472,472,944,1852
0,40,0,470,474,944,2017
40,30,-60,473,471,944,2046
70,20,-30,469,475,944,2056
-70,60,-10,467,478,945,1922
80,50,-80,476,469,945,2052
-160,-50,170,474,471,945,2072
70,40,-60,485,460,945,2028
30,-40,50,479,466,945,2131
-80,-40,-60,470,476,946,2088
180,80,100,473,473,946,1992
-150,-60,-170,474,472,946,2079
-180,80,100,473,473,946,1992
70,0,90,498,448,946,2014
70,10,-10,461,485,946,1923
160,80,180,474,472,946,2016
160,80,-180,474,472,946,2016
-50,0,0,477,469,946,1936
-20,20,10,476,470,946,2168
-170,0,140,468,478,946,2232
50,10,60,475,472,947,2009
-40,-70,-30,492,455,947,2098
-140,0,120,473,474,947,2097
140,-20,140,476,471,947,2115
-170,80,90,473,475,948,2012
150,-80,150,491,457,948,2119
-30,30,10,477,471,948,2141
20,10,30,489,459,948,2088
60,-20,-10,463,485,948,2054
150,20,110,460,488,948,1869
40,-40,60,481,467,948,2109
110,-20,140,464,484,948,2085
80,-10,70,501,448,949,1976
110,-10,150,469,480,949,2074
-30,-10,0,486,463,949,2145
-160,80,80,476,474,950,2037
-130,-50,160,488,462,950,1988
-130,80,50,465,485,950,2177
-10,10,10,475,475,950,2102
-100,-40,-150,482,468,950,2010
-130,-40,170,462,488,950,2145
70,20,20,460,490,950,1855
40,80,-50,488,462,950,2112
70,-50,10,477,474,951,2029
170,80,110,474,477,951,2019
-140,-70,-150,483,469,952,2078
60,-70,0,459,493,952,1956
60,80,-70,494,458,952,2056
-170,-30,150,482,470,952,2151
150,60,-170,480,472,952,2106
140,30,120,495,457,952,1771
0,-30,20,483,470,953,2206
70,80,-80,497,456,953,2058
50,30,-60,481,472,953,2035
130,-30,90,464,489,953,1876
120,-30,130,475,478,953,2029
90,30,-120,474,479,953,1882
-50,40,20,481,472,953,2109
-20,30,-50,463,490,953,1985
-20,0,-60,473,480,953,2114
-60,80,40,469,484,953,2095
90,50,-90,476,478,954,2142
50,-70,60,483,471,954,2142
-80,-50,-70,483,471,954,2162
20,70,-30,481,473,954,2159
50,80,-60,495,460,955,2077
-110,-40,-150,474,481,955,2064
20,-40,40,488,467,955,2218
30,40,0,498,457,955,2172
-120,80,40,470,485,955,2114
-10,50,0,489,467,956,2054
40,40,-70,487,469,956,2121
-100,-80,-100,483,473,956,2037
-150,80,70,469,487,956,2077
110,40,-120,473,484,957,2059
-90,-40,-80,484,473,957,2132
-140,-40,140,490,467,957,1964
-170,-60,120,476,481,957,1976
-130,30,100,465,492,957,1979
20,-10,-50,472,486,958,2244
20,40,0,499,459,958,1998
110,10,-160,480,478,958,2119
80,-10,60,501,457,958,1958
20,10,-50,481,478,959,2112
-70,50,40,473,486,959,1969
60,50,-40,494,465,959,2052
-60,0,-60,482,477,959,2182
0,-20,-60,482,477,959,2322
-140,80,60,469,490,959,2174
120,-50,120,494,465,959,2221
-130,10,50,493,467,960,1824
30,60,-30,494,466,960,2163
-90,70,10,473,487,960,2048
-30,20,10,486,474,960,2200
-70,-60,-60,495,465,960,2147
-20,-40,0,479,481,960,2234
130,-20,140,467,493,960,2136
-140,-40,170,476,484,960,2195
40,30,10,486,475,961,2159
-80,0,-10,484,477,961,2027
90,80,-100,494,467,961,2054
70,60,-70,496,465,961,2022
-100,-70,-100,493,468,961,2041
-110,-60,-120,498,463,961,2102
-140,-60,150,496,465,961,2013
-10,20,10,490,472,962,2138
120,-20,140,483,479,962,2156
70,40,-40,501,461,962,1940
30,30,-60,485,477,962,2166
-90,-30,-70,475,487,962,2012
130,-10,150,478,484,962,2199
40,-10,70,495,467,962,2081
-30,50,10,488,474,962,2189
-100,-40,-120,487,475,962,2078
90,-50,40,470,492,962,1964
40,20,30,492,471,963,2094
-100,30,60,476,487,963,2038
-40,70,20,485,478,963,2124
120,50,-130,493,470,963,2011
0,80,-70,493,470,963,2145
-140,40,110,484,479,963,2114
-180,-20,100,479,484,963,1832
180,-20,100,479,484,963,1832
-150,-70,-160,486,478,964,2138
40,-30,-30,477,487,964,2145
140,-70,140,506,458,964,2146
110,-30,130,489,475,964,2060
110,-10,110,485,479,964,2057
120,60,-130,498,466,964,2042
80,50,-130,481,484,965,1980
140,0,160,491,474,965,2232
-70,80,50,480,486,966,2144
-170,10,140,494,472,966,2090
-70,30,30,483,483,966,2089
90,-60,100,492,474,966,2232
80,80,-90,503,463,966,2066
0,30,10,496,470,966,2228
-150,0,130,483,483,966,2254
150,30,-180,479,488,967,2190
-130,-20,130,465,502,967,2061
150,30,180,479,488,967,2190
60,30,-60,480,487,967,2046
50,40,-10,515,452,967,2026
70,40,-90,478,490,968,1988
-30,-10,-70,475,493,968,2147
-150,40,120,471,497,968,2147
90,0,-160,486,482,968,2041
170,80,170,487,481,968,2061
10,60,-70,487,481,968,1985
20,30,10,498,471,969,2082
40,-20,70,491,478,969,2211
10,0,30,499,470,969,2222
-70,-10,-10,486,483,969,2175
70,-40,10,491,478,969,2055
-100,10,40,484,486,970,2086
90,-40,110,490,480,970,2174
160,-60,150,496,474,970,2159
170,10,150,490,480,970,2177
90,-30,120,488,482,970,2014
150,50,-170,480,490,970,2156
-10,-40,10,489,482,971,2266
-90,20,40,496,475,971,2067
120,-40,80,489,482,971,2117
90,-10,140,474,497,971,1997
30,80,-40,502,469,971,2122
90,0,160,476,495,971,1931
-40,-50,-20,514,457,971,2101
-110,-80,-110,495,477,972,2112
60,20,-50,497,475,972,2180
-110,0,50,487,485,972,2015
130,0,170,484,488,972,2021
70,20,-40,483,489,972,2061
0,-40,20,489,483,972,2197
-100,-40,-110,486,486,972,2089
70,80,-140,482,491,973,2118
10,70,-20,496,477,973,2197
130,10,-180,490,483,973,2138
20,60,-20,502,471,973,2228
130,10,180,490,483,973,2138
-120,50,90,489,485,974,2097
50,-20,90,491,483,974,2184
80,80,-150,477,497,974,2039
0,0,20,502,472,974,2159
-50,70,30,482,493,975,2174
0,60,-10,504,471,975,2101
-170,20,140,483,492,975,2149
160,20,160,485,490,975,2239
50,20,-50,488,487,975,2190
20,80,-30,501,474,975,2138
130,-60,130,497,479,976,2322
20,30,-60,493,483,976,2179
110,-40,120,491,485,976,2148
-20,60,-50,493,483,976,1991
30,-30,-40,483,493,976,2213
20,-80,30,498,478,976,2167
-30,-20,-80,494,482,976,2196
-160,40,130,481,495,976,2155
120,60,150,479,497,976,1931
-10,30,10,490,487,977,2257
120,70,-130,507,470,977,2070
-60,-30,-110,487,490,977,2148
120,30,-140,490,487,977,2123
80,-70,90,515,462,977,2255
60,80,-130,481,496,977,2174
120,30,140,493,484,977,1860
-80,-30,-120,486,492,978,2062
-110,-40,-160,487,491,978,2113
100,-30,130,493,485,978,2166
160,-80,160,504,474,978,2142
10,30,10,491,487,978,2140
-170,80,150,489,489,978,2149
-170,40,140,484,494,978,2240
180,80,160,493,485,978,2112
60,-70,70,489,489,978,2234
170,70,170,482,496,978,2163
-50,-40,-110,502,476,978,2154
170,-80,170,493,485,978,2205
80,40,-80,508,470,978,2090
-180,80,160,493,485,978,2112
-80,-10,-20,489,490,979,2091
50,-10,-30,480,499,979,2211
10,-80,20,500,479,979,2157
50,10,-40,478,502,980,2258
30,30,10,505,475,980,2200
-110,80,30,477,503,980,2131
90,50,-160,476,504,980,2042
30,40,-70,498,482,980,2213
160,-10,100,464,516,980,1990
-60,30,-30,501,480,981,2108
160,60,-180,485,496,981,2172
70,30,-50,496,485,981,2007
180,40,150,493,488,981,2244
160,60,180,485,496,981,2172
30,-80,40,501,480,981,2151
0,50,-60,480,501,981,2073
-180,40,150,493,488,981,2244
-80,20,30,493,488,981,2049
90,70,-160,483,499,982,2141
-70,0,0,503,479,982,2082
60,-50,80,509,473,982,2177
-130,40,100,492,490,982,2110
100,80,-110,498,485,983,2071
80,60,-140,482,501,983,2059
-140,-10,130,469,515,984,2266
60,50,-100,493,491,984,2032
-110,20,20,504,480,984,1982
40,-80,50,505,480,985,2216
-120,-40,180,486,499,985,2168
-120,-40,-180,486,499,985,2168
-120,-80,-120,502,483,985,2152
80,60,-80,507,478,985,2144
-140,0,80,488,497,985,1822
-20,30,10,491,494,985,2270
60,20,40,504,481,985,2030
70,-50,90,505,482,987,2213
90,50,-170,474,513,987,1972
70,-70,80,509,478,987,2272
70,30,-20,503,484,987,2052
-30,-50,-10,514,473,987,2213
150,-50,140,505,482,987,2277
-10,70,-60,506,481,987,2127
-80,0,0,482,506,988,2163
-80,-10,-80,496,492,988,2114
160,30,170,504,484,988,2324
-150,80,130,488,500,988,2199
100,30,160,489,500,989,2070
-50,0,-70,499,490,989,2334
100,0,-150,483,506,989,2236
10,80,-20,510,479,989,2193
90,20,170,484,505,989,2013
-80,70,0,487,502,989,2058
80,10,10,497,492,989,2065
-160,80,140,492,497,989,2169
-170,30,140,489,501,990,2247
-120,-40,-170,497,493,990,2215
90,10,170,481,510,991,1828
-150,30,60,508,483,991,1865
160,0,150,488,503,991,2325
-80,-20,-30,505,486,991,2150
-100,30,10,490,501,991,2075
-50,-70,-40,513,478,991,2174
10,80,-80,507,485,992,2195
-10,0,-60,497,495,992,2334
80,-50,100,506,486,992,2268
0,80,-10,513,479,992,2236
-30,10,10,504,488,992,2286
-140,-20,110,477,516,993,2024
90,-70,100,517,476,993,2285
60,10,80,512,481,993,1957
-80,10,20,487,506,993,2261
-130,80,110,491,502,993,2216
-80,80,60,500,493,993,2168
110,10,-150,511,483,994,2237
-30,20,-50,493,501,994,2133
-40,10,10,511,483,994,2168
140,-70,80,503,491,994,2070
-110,0,40,503,491,994,2145
160,80,120,490,505,995,2131
-50,-50,-30,523,472,995,2142
60,60,-50,525,470,995,2162
100,-10,150,481,514,995,2156
-170,-20,100,496,499,995,1885
60,40,-20,521,475,996,2080
-60,70,40,509,487,996,2175
50,60,-40,520,476,996,2211
0,70,-10,521,475,996,2236
-70,-20,-100,503,493,996,2178
120,10,-170,487,509,996,2144
40,0,60,510,486,996,2269
130,-50,80,501,495,996,2019
-140,80,120,489,507,996,2233
30,50,-10,522,475,997,2152
-110,0,60,502,495,997,2105
100,-50,110,504,493,997,2183
90,-10,90,496,502,998,2228
-40,60,20,508,490,998,2246
-120,80,100,497,501,998,2240
-20,10,10,512,486,998,2207
-80,-10,-70,500,498,998,2046
-80,0,-30,479,519,998,2058
-70,70,50,511,487,998,2189
70,0,-10,490,508,998,2242
100,0,-180,488,510,998,2089
100,0,180,488,510,998,2089
-90,-30,-120,504,495,999,2101
50,-50,70,520,479,999,2288
-120,0,70,512,487,999,1983
150,-30,140,510,489,999,2301
-70,-20,-20,499,500,999,2185
-100,-40,-100,502,497,999,2190
0,-80,10,512,487,999,2181
20,80,-90,504,495,999,2288
-60,10,10,501,498,999,2202
-130,-10,110,484,516,1000,2188
90,10,160,492,508,1000,1982
70,50,-60,513,487,1000,2163
180,-80,-180,504,496,1000,2255
-180,-80,-180,504,496,1000,2255
-180,-80,180,504,496,1000,2255
10,-50,30,507,493,1000,2293
180,-80,180,504,496,1000,2255
-50,-20,-10,511,490,1001,2255
-120,-60,-130,512,489,1001,2229
-70,-40,-130,508,493,1001,2178
130,-40,130,499,502,1001,2217
50,80,-120,505,496,1001,2238
180,70,160,497,504,1001,2233
-180,70,160,497,504,1001,2233
-60,40,30,507,494,1001,2154
-150,10,130,490,511,1001,2347
-140,-80,-140,505,497,1002,2244
-30,-20,0,501,501,1002,2289
110,80,-120,509,493,1002,2132
50,-80,60,516,486,1002,2263
-100,80,80,492,510,1002,2227
-100,80,20,493,509,1002,2197
-160,-30,110,501,501,1002,1872
170,-40,150,500,502,1002,2299
-90,80,70,502,500,1002,2202
40,-40,-30,498,504,1002,2242
-130,10,110,488,514,1002,2167
20,20,20,512,491,1003,2208
100,-20,140,484,519,1003,2136
150,-40,140,506,497,1003,2280
-130,-50,-160,504,499,1003,2235
-80,50,50,495,508,1003,2102
-20,-30,-80,508,496,1004,2373
0,50,0,510,494,1004,2332
50,10,80,514,490,1004,2007
-110,80,90,495,509,1004,2232
-160,30,70,509,495,1004,1990
110,20,-130,487,517,1004,2224
90,40,-90,507,498,1005,2205
30,10,-50,514,491,1005,2228
-10,-80,0,515,490,1005,2176
40,60,-30,514,491,1005,2287
140,-10,150,491,515,1006,2343
50,-30,-20,488,518,1006,2272
-50,60,30,508,498,1006,2258
80,-20,30,501,505,1006,2109
140,40,-160,505,501,1006,2211
110,30,150,502,505,1007,2057
70,20,-20,505,502,1007,2325
-80,30,40,511,496,1007,2209
-110,-40,-140,509,498,1007,2178
90,0,150,494,514,1008,1965
150,-70,150,526,482,1008,2208
40,80,-110,507,501,1008,2260
70,-60,10,502,506,1008,2080
100,60,180,489,520,1009,2176
-130,-80,-130,518,491,1009,2206
60,70,-60,526,483,1009,2277
100,60,-180,489,520,1009,2176
-120,0,80,506,503,1009,2111
-90,-20,-80,490,519,1009,2197
70,-30,110,506,503,1009,2232
130,60,-140,506,504,1010,2175
160,50,180,503,507,1010,2225
-40,-30,-10,515,495,1010,2219
160,50,-180,503,507,1010,2225
90,0,-150,512,498,1010,2129
-110,50,80,503,508,1011,2273
-60,-40,-120,532,479,1011,2165
90,20,-140,495,516,1011,2140
130,40,130,535,476,1011,2066
110,0,-180,491,520,1011,2155
-50,10,10,507,504,1011,2167
110,0,180,491,520,1011,2155
100,-60,110,514,497,1011,2353
90,60,-90,524,488,1012,2278
-120,-50,-140,515,497,1012,2289
140,0,110,500,512,1012,2050
-100,-50,-100,516,496,1012,2209
70,70,-70,526,486,1012,2268
-40,-10,0,506,507,1013,2357
-170,-80,-170,515,498,1013,2311
100,30,-110,499,514,1013,2175
10,30,-60,503,510,1013,2193
-50,30,20,511,503,1014,2155
30,-40,-40,495,519,1014,2306
-120,-50,170,497,517,1014,2143
-130,-40,180,505,509,1014,2279
-20,-50,0,515,499,1014,2299
-130,-40,-180,505,509,1014,2279
-120,40,90,506,509,1015,2206
-40,50,20,515,500,1015,2378
30,0,-50,497,518,1015,2203
-150,-50,180,515,500,1015,2202
50,40,-80,511,504,1015,2226
-150,-50,-180,515,500,1015,2202
170,60,170,504,513,1017,2244
60,30,-70,514,503,1017,2209
-150,-40,170,509,508,1017,2341
-140,10,120,506,511,1017,2304
-10,-50,10,517,501,1018,2335
-150,-80,-150,515,503,1018,2272
-60,-50,-40,527,491,1018,2270
170,-60,160,517,501,1018,2221
-130,-60,160,521,497,1018,2112
-60,0,-70,515,503,1018,2342
70,-70,10,501,517,1018,2115
-20,-10,10,519,500,1019,2381
-60,60,-20,505,514,1019,2162
-170,-20,150,501,518,1019,2381
80,-10,40,509,510,1019,2021
-100,20,60,502,518,1020,2216
-120,50,30,505,515,1020,2089
60,-80,70,522,498,1020,2326
130,70,-140,515,505,1020,2137
100,0,-160,516,505,1021,2233
100,50,170,509,512,1021,1942
-140,-30,160,513,508,1021,2368
30,80,-100,517,504,1021,2299
-20,-80,-10,525,496,1021,2202
-80,-20,-100,506,515,1021,2092
-60,-70,-50,521,500,1021,2223
40,70,-40,533,488,1021,2301
-90,10,30,511,511,1022,2259
50,70,-50,530,492,1022,2270
20,-50,-50,506,516,1022,2317
130,10,120,508,514,1022,1987
-170,70,150,510,512,1022,2283
150,80,130,501,522,1023,2197
100,-10,100,502,521,1023,2096
110,30,-120,501,522,1023,2223
20,-50,40,520,503,1023,2360
60,0,-30,501,522,1023,2196
-160,-80,-160,520,503,1023,2317
-100,-60,-100,515,508,1023,2177
-160,60,70,504,519,1023,2213
-10,80,0,523,500,1023,2326
-160,-20,150,508,516,1024,2432
-80,-10,-60,507,517,1024,2177
0,-50,20,526,498,1024,2315
70,0,110,518,506,1024,2217
180,-50,160,512,513,1025,2250
-180,-50,160,512,513,1025,2250
-20,0,10,521,504,1025,2326
90,-30,50,512,513,1025,2054
-10,60,0,530,495,1025,2258
70,20,-10,500,525,1025,2341
-160,70,140,510,516,1026,2304
110,-10,160,510,516,1026,2238
110,-20,90,512,515,1027,2198
-120,30,90,507,520,1027,2208
70,30,-80,511,516,1027,2124
-150,-10,140,502,525,1027,2219
100,-40,120,510,517,1027,2320
70,-80,80,525,502,1027,2363
180,-30,150,516,512,1028,2331
-20,40,10,521,507,1028,2324
90,60,-160,496,532,1028,2211
-180,-30,150,516,512,1028,2331
-10,70,0,535,493,1028,2348
120,-30,140,514,514,1028,2296
10,-60,30,528,501,1029,2401
120,-10,160,505,524,1029,2367
170,0,150,517,512,1029,2398
0,10,20,522,507,1029,2277
-40,0,-70,514,515,1029,2391
-90,50,60,516,513,1029,2244
40,-30,70,523,506,1029,2339
40,0,70,534,496,1030,2300
-90,-20,-70,520,510,1030,2177
170,-30,100,520,511,1031,2015
130,-50,130,517,514,1031,2408
110,10,-140,519,512,1031,2316
160,10,160,513,518,1031,2356
-60,20,20,516,517,1033,2282
30,10,40,528,505,1033,2261
30,70,-30,531,502,1033,2342
160,0,100,513,520,1033,2059
20,0,40,522,511,1033,2184
-140,-50,-170,517,516,1033,2319
-110,-70,-110,531,502,1033,2160
10,20,20,534,499,1033,2350
60,40,-90,518,516,1034,2237
-20,40,-50,506,528,1034,2181
100,-70,110,535,499,1034,2313
120,80,-130,528,506,1034,2222
120,-40,130,516,519,1035,2320
40,-50,60,527,508,1035,2346
-100,50,70,513,522,1035,2334
160,-10,150,515,520,1035,2379
60,10,-40,503,532,1035,2361
160,-50,150,524,511,1035,2335
80,70,-80,536,500,1036,2298
-20,10,-60,520,516,1036,2374
110,-30,80,515,521,1036,2258
-80,70,60,530,506,1036,2257
130,50,-140,506,530,1036,2247
80,0,20,523,513,1036,2290
-90,30,50,513,524,1037,2250
-80,10,-20,512,525,1037,2202
-40,-10,-80,513,524,1037,2310
-30,-80,-20,537,500,1037,2262
-130,-20,120,510,527,1037,2188
-20,-20,10,518,519,1037,2478
-120,0,90,505,532,1037,2192
30,-50,50,532,505,1037,2385
90,40,-180,526,512,1038,1910
70,10,-20,513,525,1038,2217
80,-10,30,529,509,1038,2184
90,40,180,526,512,1038,1910
-70,10,-40,514,524,1038,2394
-150,-20,150,528,510,1038,2377
-100,10,50,513,526,1039,2273
0,40,10,535,505,1040,2387
10,60,-10,532,508,1040,2339
70,30,-60,505,535,1040,2139
80,-30,120,523,517,1040,2192
120,40,-130,512,528,1040,2217
30,20,30,524,516,1040,2278
120,40,140,529,511,1040,2123
10,50,0,541,500,1041,2308
70,-10,120,517,524,1041,2116
140,-30,140,517,524,1041,2323
150,-10,150,521,520,1041,2391
-90,0,10,526,515,1041,2431
-150,-30,160,519,522,1041,2413
20,-20,-50,522,519,1041,2417
100,-40,60,519,522,1041,2200
40,40,0,541,501,1042,2302
90,10,-140,495,547,1042,2130
-110,-50,-120,533,510,1043,2351
-90,-50,-80,528,515,1043,2393
70,20,-50,530,513,1043,2246
170,30,160,534,509,1043,2396
-80,-60,-70,527,516,1043,2349
140,-60,140,534,509,1043,2438
-70,40,40,515,528,1043,2264
80,10,20,526,518,1044,2126
-180,60,160,509,535,1044,2418
-120,-60,170,519,525,1044,2236
180,60,160,509,535,1044,2418
-20,80,10,535,510,1045,2364
-130,20,40,543,502,1045,1918
130,-30,140,519,526,1045,2269
-30,-30,0,530,515,1045,2444
70,30,-70,530,515,1045,2135
-60,-20,-100,528,518,1046,2217
-140,70,120,519,527,1046,2325
-50,50,-30,501,545,1046,2195
30,60,-20,530,516,1046,2395
-90,-20,-90,521,525,1046,2208
80,-50,20,515,531,1046,2221
80,0,10,521,525,1046,2264
170,-10,150,523,523,1046,2440
-40,-80,-30,546,500,1046,2311
-130,0,70,532,515,1047,1916
-100,0,30,523,524,1047,2349
120,0,180,515,532,1047,2257
-100,10,10,515,532,1047,2126
0,-60,20,532,515,1047,2385
-120,-40,170,502,545,1047,2298
120,0,-180,515,532,1047,2257
130,80,-140,536,512,1048,2237
-90,-30,-60,541,507,1048,2249
-60,60,40,533,515,1048,2236
0,0,-60,528,520,1048,2451
-70,-30,-30,535,513,1048,2293
110,70,170,513,535,1048,2285
30,-20,60,525,523,1048,2275
-90,70,70,529,519,1048,2353
-180,30,150,527,522,1049,2410
110,20,140,533,516,1049,2220
180,30,150,527,522,1049,2410
160,-70,160,532,517,1049,2325
150,20,-180,521,529,1050,2397
-110,-60,-180,524,526,1050,2253
-110,-40,-170,522,528,1050,2265
40,-10,-40,510,540,1050,2324
50,-40,-20,513,537,1050,2367
150,40,-170,518,532,1050,2335
80,40,-120,528,522,1050,2190
60,-10,110,535,515,1050,2120
150,20,180,521,529,1050,2397
-110,-60,180,524,526,1050,2253
-100,70,80,523,527,1050,2378
-150,70,130,521,529,1050,2339
-120,0,60,520,530,1050,1986
60,-40,90,536,515,1051,2316
110,-60,120,539,512,1051,2504
-130,-10,120,509,542,1051,2364
-20,50,10,546,505,1051,2343
-130,60,40,522,529,1051,2259
20,60,-80,532,520,1052,2233
-180,-60,170,536,516,1052,2399
140,-40,140,526,526,1052,2458
120,20,-150,530,522,1052,2313
180,-60,170,536,516,1052,2399
-80,-30,-40,541,511,1052,2315
80,-80,90,533,519,1052,2413
-60,-30,-20,532,520,1052,2406
-110,40,80,525,527,1052,2333
70,30,-10,534,518,1052,2250
-50,90,40,539,514,1053,2348
-60,90,50,539,514,1053,2348
30,90,-40,539,514,1053,2348
-130,-30,160,528,525,1053,2396
50,90,-60,539,514,1053,2348
40,90,-50,539,514,1053,2348
-180,90,170,539,514,1053,2348
-160,90,150,539,514,1053,2348
10,90,-20,539,514,1053,2348
160,90,-170,539,514,1053,2348
60,90,-70,539,514,1053,2348
20,90,-30,539,514,1053,2348
70,-40,100,535,518,1053,2408
120,90,-130,539,514,1053,2348
-100,90,90,539,514,1053,2348
-70,90,60,539,514,1053,2348
-80,90,70,539,514,1053,2348
-70,0,-60,532,521,1053,2308
-170,90,160,539,514,1053,2348
150,90,-160,539,514,1053,2348
-70,-40,-40,542,511,1053,2355
130,90,-140,539,514,1053,2348
80,0,30,537,516,1053,2247
100,90,-110,539,514,1053,2348
-30,90,20,539,514,1053,2348
170,90,180,539,514,1053,2348
-40,90,30,539,514,1053,2348
0,90,-10,539,514,1053,2348
-120,90,110,539,514,1053,2348
90,90,-100,539,514,1053,2348
-140,90,130,539,514,1053,2348
-10,90,0,539,514,1053,2348
80,90,-90,539,514,1053,2348
-150,90,140,539,514,1053,2348
110,90,-120,539,514,1053,2348
-90,90,80,539,514,1053,2348
180,90,170,539,514,1053,2348
-20,90,10,539,514,1053,2348
140,90,-150,539,514,1053,2348
-130,90,120,539,514,1053,2348
170,90,-180,539,514,1053,2348
-110,90,100,539,514,1053,2348
70,90,-80,539,514,1053,2348
30,-50,-40,522,532,1054,2369
-180,-20,150,516,538,1054,2439
-120,70,100,532,522,1054,2330
60,-30,100,542,512,1054,2396
180,-20,150,516,538,1054,2439
80,-10,130,517,537,1054,2190
70,60,-60,550,504,1054,2252
100,10,140,527,528,1055,2258
30,50,-80,526,530,1056,2198
50,30,20,524,532,1056,2172
-90,-40,-70,532,524,1056,2291
70,50,-50,539,517,1056,2328
20,-40,-50,521,535,1056,2337
150,30,110,530,526,1056,2043
-110,10,80,516,540,1056,2231
-110,20,80,524,532,1056,2210
-70,-70,-60,536,520,1056,2334
110,-20,150,524,533,1057,2345
70,-20,0,517,540,1057,2325
140,60,-150,532,525,1057,2312
-80,40,-10,521,536,1057,2193
-30,80,20,547,510,1057,2417
-100,0,20,534,523,1057,2277
40,10,-50,535,522,1057,2340
20,-60,40,532,526,1058,2433
-40,40,-40,537,521,1058,2189
110,60,160,524,534,1058,2111
-130,-30,150,525,533,1058,2399
-160,-30,160,538,521,1059,2352
100,50,-100,530,529,1059,2367
-140,60,50,538,521,1059,2088
170,50,170,531,528,1059,2293
180,20,150,532,527,1059,2355
-60,-10,-90,528,531,1059,2301
140,-50,140,531,528,1059,2567
-160,0,140,529,530,1059,2488
110,-50,120,537,522,1059,2343
-180,20,150,532,527,1059,2355
-140,-20,150,526,533,1059,2457
70,20,30,503,556,1059,2188
10,20,-60,538,521,1059,2358
50,50,-20,548,511,1059,2274
-90,80,10,527,532,1059,2363
-120,20,30,551,509,1060,2121
-150,60,130,528,532,1060,2406
90,-50,110,551,509,1060,2418
-10,40,10,531,529,1060,2434
-130,70,110,531,529,1060,2344
-70,-30,-120,543,517,1060,2387
-170,-40,160,530,530,1060,2266
-140,20,120,528,533,1061,2407
30,20,-60,530,531,1061,2283
-130,-20,140,506,555,1061,2334
20,70,-20,546,515,1061,2412
0,-10,-60,533,528,1061,2395
-40,40,20,535,526,1061,2396
-50,-40,-20,547,515,1062,2403
0,40,-60,516,546,1062,2293
-20,60,10,543,519,1062,2411
90,30,-110,543,520,1063,2186
-70,-10,-90,531,532,1063,2273
140,40,120,536,527,1063,2210
90,0,170,536,527,1063,2246
100,-30,70,552,511,1063,2266
90,0,-170,522,541,1063,2274
-150,20,130,534,530,1064,2359
-10,-10,20,542,522,1064,2434
70,-60,90,548,516,1064,2455
-160,10,140,529,535,1064,2538
-110,0,30,544,520,1064,2269
-30,0,10,540,524,1064,2482
-60,-40,-30,537,528,1065,2419
-110,-40,-130,543,522,1065,2324
20,20,-60,542,524,1066,2212
100,60,-100,552,514,1066,2366
-50,50,30,543,523,1066,2360
-10,10,-60,533,533,1066,2466
-110,70,90,541,525,1066,2363
90,-20,70,550,517,1067,2217
170,-20,150,541,526,1067,2493
-170,60,150,522,545,1067,2471
140,80,-150,543,524,1067,2293
150,-50,90,523,544,1067,2137
50,-60,70,550,518,1068,2492
120,-20,150,531,537,1068,2395
90,70,-90,550,518,1068,2394
180,10,150,533,535,1068,2455
130,-10,160,526,542,1068,2542
-120,10,100,525,543,1068,2240
-180,10,150,533,535,1068,2455
-30,10,-60,526,542,1068,2408
10,-50,-60,529,539,1068,2389
60,-60,80,549,519,1068,2474
50,0,-40,531,537,1068,2391
-50,-80,-40,552,517,1069,2397
20,-30,-50,529,540,1069,2423
40,20,-60,545,524,1069,2371
-70,0,-70,538,531,1069,2390
20,-20,50,547,522,1069,2383
100,0,130,531,539,1070,2259
170,-70,170,551,519,1070,2386
150,10,170,533,537,1070,2393
90,0,180,535,535,1070,2176
100,0,-170,533,537,1070,2318
90,0,-180,535,535,1070,2176
160,20,170,544,527,1071,2451
160,10,100,532,539,1071,2090
-130,-70,160,540,531,1071,2278
50,20,40,540,531,1071,2329
30,-30,60,536,536,1072,2400
40,10,50,551,521,1072,2434
90,-70,30,521,551,1072,2205
-150,60,60,517,555,1072,2310
60,-10,-20,540,532,1072,2451
150,0,160,542,531,1073,2508
-60,-20,-10,540,533,1073,2450
-80,0,-40,531,542,1073,2254
180,0,150,531,542,1073,2566
-160,-20,100,539,534,1073,2123
-50,-10,0,533,540,1073,2354
-80,-40,-140,535,538,1073,2330
-180,0,150,531,542,1073,2566
-90,40,0,529,545,1074,2269
-130,-60,-140,534,540,1074,2356
160,-40,150,532,542,1074,2497
-70,70,-10,533,542,1075,2263
80,-70,20,534,541,1075,2202
-130,-10,130,522,553,1075,2501
-40,-20,-90,558,517,1075,2420
-110,50,20,533,543,1076,2232
90,-80,100,555,521,1076,2454
70,30,0,543,533,1076,2194
40,-60,60,545,531,1076,2506
90,-40,40,526,550,1076,2211
100,0,-140,530,546,1076,2286
-20,70,10,562,514,1076,2432
90,20,-130,520,557,1077,2084
-180,-10,150,537,540,1077,2503
130,-20,150,539,538,1077,2540
-100,-40,-160,546,531,1077,2338
180,-10,150,537,540,1077,2503
70,40,-100,545,533,1078,2276
70,40,-30,552,526,1078,2269
110,-30,140,532,546,1078,2413
-130,20,110,527,551,1078,2322
20,40,-70,541,537,1078,2411
40,-50,-30,525,554,1079,2448
170,-40,100,545,534,1079,2154
-120,-70,170,534,545,1079,2250
-120,-40,-160,540,539,1079,2346
80,50,-70,550,529,1079,2342
110,-70,120,565,514,1079,2416
-70,-50,-50,543,536,1079,2415
180,10,90,553,527,1080,2180
-120,0,100,531,549,1080,2203
50,-30,90,550,530,1080,2522
-180,10,90,553,527,1080,2180
50,-40,80,551,529,1080,2412
150,-10,100,537,543,1080,2143
110,-40,70,539,541,1080,2312
-160,60,140,521,560,1081,2459
-20,50,-50,508,573,1081,2314
-10,-60,10,554,527,1081,2450
-110,30,80,534,547,1081,2352
-90,-20,-60,547,534,1081,2300
-140,60,120,536,545,1081,2426
-20,-30,10,545,537,1082,2515
-90,-20,-50,552,530,1082,2214
130,30,-150,530,552,1082,2397
-170,20,80,537,545,1082,2135
80,40,-70,535,548,1083,2397
-130,-40,-170,546,537,1083,2533
60,-30,-10,531,552,1083,2392
-130,-50,-150,539,544,1083,2386
20,60,-10,561,522,1083,2506
-80,-10,-10,548,535,1083,2357
30,0,50,554,529,1083,2337
140,70,-150,545,538,1083,2284
140,80,140,524,559,1083,2339
80,0,40,544,539,1083,2266
-80,-70,-70,548,535,1083,2361
160,40,-180,536,548,1084,2395
-70,60,50,547,537,1084,2331
110,10,130,546,538,1084,2288
50,30,-70,560,524,1084,2282
160,40,180,536,548,1084,2395
130,-70,70,536,548,1084,2284
80,-40,20,529,556,1085,2393
-40,0,10,550,535,1085,2480
-110,-60,-110,560,525,1085,2351
-30,-60,-10,550,535,1085,2385
50,80,-50,556,529,1085,2514
-170,-60,-180,548,538,1086,2476
80,-40,110,542,544,1086,2532
-170,-60,180,548,538,1086,2476
-60,-80,-50,566,521,1087,2441
10,-20,40,552,535,1087,2522
0,20,20,546,541,1087,2451
120,20,130,548,539,1087,2143
-10,-20,20,553,535,1088,2528
80,40,-60,547,541,1088,2324
0,70,-70,552,536,1088,2459
110,-40,130,544,544,1088,2487
60,20,-60,546,542,1088,2357
40,80,-40,557,531,1088,2511
60,20,50,551,538,1089,2231
100,40,-100,545,544,1089,2409
100,-80,110,564,526,1090,2469
60,-40,-10,539,551,1090,2492
-100,-30,-100,546,544,1090,2322
40,30,20,547,543,1090,2383
80,-10,20,548,542,1090,2457
100,-50,50,544,547,1091,2305
100,-70,40,540,551,1091,2290
-30,-30,-90,567,524,1091,2424
-90,0,0,541,550,1091,2439
140,0,170,545,548,1093,2543
180,-60,110,550,543,1093,2240
-180,-60,110,550,543,1093,2240
-40,30,20,553,540,1093,2402
-100,-40,-90,552,541,1093,2432
170,-30,150,551,543,1094,2440
-40,80,30,566,528,1094,2469
-90,-20,-100,534,560,1094,2373
-140,-70,150,554,540,1094,2314
-60,10,-50,535,560,1095,2524
-100,-60,-170,539,556,1095,2301
-50,20,20,552,543,1095,2411
80,0,50,542,553,1095,2299
50,20,50,554,541,1095,2302
-20,-60,0,554,541,1095,2426
50,20,-60,552,544,1096,2355
80,0,110,544,552,1096,2374
80,30,-50,545,551,1096,2276
-10,-20,-70,540,557,1097,2530
60,50,-30,572,525,1097,2360
10,40,10,560,538,1098,2412
150,70,-160,556,542,1098,2351
-80,20,-20,540,558,1098,2429
60,10,90,551,547,1098,2267
40,50,-10,556,542,1098,2364
10,-40,-60,537,561,1098,2431
140,50,-150,547,551,1098,2504
10,-70,30,562,536,1098,2562
0,10,-60,554,545,1099,2540
-80,80,0,556,543,1099,2489
-80,-40,-50,557,542,1099,2448
-100,40,10,540,559,1099,2243
80,10,0,556,543,1099,2376
-120,0,50,548,551,1099,2140
90,-30,130,543,556,1099,2405
0,30,-60,539,561,1100,2323
-80,0,10,536,564,1100,2547
-80,40,50,554,546,1100,2333
20,-30,50,549,551,1100,2535
10,50,-70,547,554,1101,2384
60,80,-60,563,538,1101,2508
30,-60,50,551,550,1101,2546
-40,-60,-20,565,536,1101,2381
70,50,-120,555,546,1101,2389
-130,-10,100,532,569,1101,2266
80,30,-40,537,564,1101,2203
-40,20,-50,560,541,1101,2431
-50,-60,-30,574,528,1102,2453
-140,-10,140,543,559,1102,2487
30,80,-30,563,539,1102,2596
-110,-70,180,544,558,1102,2265
100,20,150,546,556,1102,2197
-130,60,110,548,554,1102,2461
50,20,60,553,549,1102,2296
-110,-70,-180,544,558,1102,2265
-60,20,-40,555,547,1102,2337
-40,10,-60,542,561,1103,2576
140,10,180,550,553,1103,2440
-180,-70,-180,562,541,1103,2485
-70,-80,-60,576,527,1103,2490
-180,-70,180,562,541,1103,2485
90,-40,120,550,553,1103,2507
80,-60,100,560,543,1103,2533
180,-70,-180,562,541,1103,2485
180,-70,180,562,541,1103,2485
-130,0,120,538,565,1103,2575
140,10,-180,550,553,1103,2440
-80,-20,-110,556,548,1104,2273
110,-80,120,571,533,1104,2487
-170,-10,150,553,551,1104,2532
-130,-30,140,551,553,1104,2404
-90,-40,-150,555,549,1104,2279
10,10,30,558,546,1104,2597
50,10,90,558,546,1104,2257
150,80,-160,561,544,1105,2421
-180,50,160,548,557,1105,2462
-140,-40,180,547,558,1105,2463
180,50,160,548,557,1105,2462
60,20,70,550,555,1105,2302
-140,-40,-180,547,558,1105,2463
50,10,-50,553,552,1105,2436
-40,-20,0,555,551,1106,2508
-110,0,70,546,560,1106,2344
120,-70,130,582,524,1106,2512
-80,-80,-70,571,535,1106,2479
-120,20,100,538,568,1106,2369
-100,0,40,558,548,1106,2493
-70,20,-30,548,559,1107,2370
150,60,-160,559,548,1107,2460
-120,-70,-120,572,535,1107,2334
70,10,-30,564,543,1107,2399
60,30,20,547,560,1107,2355
100,-10,160,549,558,1107,2302
40,-40,70,564,544,1108,2505
-10,60,-60,562,546,1108,2410
150,-20,150,552,556,1108,2607
70,-20,120,546,562,1108,2291
120,-50,130,560,548,1108,2552
160,-20,150,560,549,1109,2603
-170,-40,110,559,550,1109,2265
90,10,150,538,571,1109,2269
-90,-30,-130,545,564,1109,2390
-40,-40,-10,561,549,1110,2446
20,50,0,577,534,1111,2409
90,-20,60,564,547,1111,2355
150,-60,150,569,543,1112,2504
-50,30,-40,549,563,1112,2350
10,-30,40,564,548,1112,2518
-90,0,20,556,556,1112,2614
70,80,-70,564,548,1112,2510
170,-90,-180,564,549,1113,2453
30,-90,40,564,549,1113,2453
-150,-90,-140,564,549,1113,2453
40,-90,50,564,549,1113,2453
180,-90,-170,564,549,1113,2453
170,-90,180,564,549,1113,2453
-100,-90,-90,564,549,1113,2453
-60,-90,-50,564,549,1113,2453
170,20,160,560,553,1113,2518
-40,-90,-30,564,549,1113,2453
-140,-90,-130,564,549,1113,2453
-90,-90,-80,564,549,1113,2453
-20,-90,-10,564,549,1113,2453
10,-90,20,564,549,1113,2453
-30,-90,-20,564,549,1113,2453
-150,-70,140,570,543,1113,2317
0,-90,10,564,549,1113,2453
-180,-90,-170,564,549,1113,2453
20,-90,30,564,549,1113,2453
0,-50,-70,555,558,1113,2430
170,-50,160,557,556,1113,2521
-30,70,20,570,543,1113,2483
-10,-90,0,564,549,1113,2453
-50,-90,-40,564,549,1113,2453
-130,-90,-120,564,549,1113,2453
130,-40,140,554,559,1113,2580
150,-90,160,564,549,1113,2453
-160,-90,-150,564,549,1113,2453
70,-90,80,564,549,1113,2453
-170,-90,-160,564,549,1113,2453
-120,-90,-110,564,549,1113,2453
90,-90,100,564,549,1113,2453
130,-90,140,564,549,1113,2453
160,-90,170,564,549,1113,2453
50,-90,60,564,549,1113,2453
-120,-40,-150,548,565,1113,2388
110,-90,120,564,549,1113,2453
60,-90,70,564,549,1113,2453
-80,-90,-70,564,549,1113,2453
100,-90,110,564,549,1113,2453
-170,50,150,552,561,1113,2470
-70,-90,-60,564,549,1113,2453
120,-90,130,564,549,1113,2453
80,10,30,558,555,1113,2302
140,-90,150,564,549,1113,2453
-110,-90,-100,564,549,1113,2453
80,-90,90,564,549,1113,2453
-10,-30,20,565,549,1114,2568
-150,0,80,556,558,1114,2261
-130,-30,170,544,570,1114,2639
-50,0,10,567,547,1114,2435
-150,50,130,544,570,1114,2555
80,60,-70,576,539,1115,2388
-170,-50,170,563,552,1115,2459
50,0,100,578,537,1115,2284
110,40,150,571,545,1116,2272
-160,-60,-170,561,555,1116,2498
20,80,-20,571,545,1116,2620
-50,80,40,576,540,1116,2492
-160,50,140,556,560,1116,2572
80,80,-80,566,551,1117,2532
-60,30,30,563,554,1117,2458
-10,0,20,571,547,1118,2483
-130,-40,150,568,550,1118,2393
0,-40,-70,555,563,1118,2496
-150,30,130,549,569,1118,2484
-150,-50,130,567,551,1118,2299
140,-20,150,552,566,1118,2603
60,20,60,563,555,1118,2166
10,70,-10,569,549,1118,2506
-170,-30,160,575,544,1119,2577
70,10,70,546,573,1119,2304
-100,-30,-110,554,565,1119,2361
-90,-20,-40,572,547,1119,2424
90,0,140,553,566,1119,2378
50,-10,100,555,564,1119,2312
50,70,-40,577,543,1120,2531
-100,40,70,553,567,1120,2556
40,-20,80,562,558,1120,2502
-160,-70,130,569,551,1120,2331
-140,-60,-150,562,558,1120,2506
50,20,70,561,559,1120,2246
-130,-20,150,551,569,1120,2619
-30,-10,10,566,554,1120,2604
-30,0,-70,569,552,1121,2572
-50,-30,-10,575,546,1121,2471
80,-60,20,547,574,1121,2367
90,30,170,562,559,1121,2282
-60,70,-20,567,554,1121,2460
30,-40,60,564,557,1121,2599
70,60,-130,549,573,1122,2395
-30,60,20,572,550,1122,2599
-10,10,20,579,543,1122,2463
-90,-80,-80,578,544,1122,2503
20,-70,40,572,551,1123,2625
100,70,-100,576,547,1123,2481
160,80,-170,567,556,1123,2502
-160,20,140,557,566,1123,2431
0,60,0,582,541,1123,2464
30,60,-90,567,556,1123,2501
50,-50,-20,559,564,1123,2464
170,40,170,551,573,1124,2466
0,20,-60,568,556,1124,2490
110,-10,100,557,567,1124,2346
60,70,-50,589,536,1125,2488
-20,-10,-70,564,561,1125,2582
20,40,10,578,548,1126,2481
-70,40,-20,578,548,1126,2293
-160,-50,180,572,554,1126,2550
0,-60,-70,581,545,1126,2470
-160,-50,-180,572,554,1126,2550
160,70,-170,564,562,1126,2511
120,-80,130,580,546,1126,2572
-140,10,60,582,544,1126,2134
-20,-40,10,572,555,1127,2586
90,30,-100,573,554,1127,2322
-100,-30,-130,564,563,1127,2383
150,-50,150,571,556,1127,2714
-110,-50,180,555,573,1128,2391
80,30,-80,570,558,1128,2287
80,40,-50,559,569,1128,2331
-110,-50,-180,555,573,1128,2391
-90,-60,-80,577,551,1128,2503
50,60,-30,583,546,1129,2511
-140,0,130,566,563,1129,2621
140,20,-170,557,572,1129,2378
-40,70,30,582,547,1129,2489
130,80,150,545,584,1129,2505
150,40,110,570,560,1130,2274
-10,-70,10,580,550,1130,2585
-90,-70,-80,573,557,1130,2485
120,30,-130,549,582,1131,2572
100,-50,120,567,564,1131,2609
-170,-70,-170,569,562,1131,2547
-80,-50,-60,571,560,1131,2547
60,0,110,582,549,1131,2281
110,0,120,561,571,1132,2345
-100,-70,-170,557,575,1132,2350
110,0,-170,556,576,1132,2408
10,-30,-60,564,568,1132,2525
10,10,-60,574,558,1132,2551
90,80,-90,577,555,1132,2530
-120,60,100,563,570,1133,2429
180,-40,160,571,562,1133,2494
0,-70,20,577,556,1133,2561
-180,-40,160,571,562,1133,2494
130,40,-140,560,573,1133,2468
140,-10,160,563,570,1133,2725
100,-20,80,568,566,1134,2492
170,80,180,575,559,1134,2550
70,70,-60,582,552,1134,2531
100,20,-120,550,584,1134,2418
-120,-30,170,551,583,1134,2539
170,80,-180,575,559,1134,2550
-150,-50,-170,569,565,1134,2629
40,-10,80,587,547,1134,2460
80,30,-60,556,579,1135,2416
40,60,-20,586,549,1135,2546
-150,10,70,559,576,1135,2275
80,70,-150,548,587,1135,2543
-60,80,50,577,558,1135,2606
80,20,0,563,572,1135,2281
30,-10,-50,563,572,1135,2595
120,-70,60,562,573,1135,2438
-100,-30,-120,566,569,1135,2394
120,-50,70,551,584,1135,2448
-50,10,-60,568,568,1136,2670
80,20,-40,566,570,1136,2428
-10,50,10,582,555,1137,2557
140,10,110,578,559,1137,2285
-50,60,-30,564,573,1137,2418
80,20,10,574,563,1137,2299
110,-70,50,566,571,1137,2395
-30,30,-50,562,575,1137,2370
-110,60,90,573,564,1137,2417
-80,0,-50,562,576,1138,2382
70,20,-60,568,570,1138,2393
-130,-70,-130,588,550,1138,2490
-80,-20,-20,575,563,1138,2434
-30,-40,0,580,558,1138,2532
20,-40,50,586,553,1139,2640
0,-20,30,570,569,1139,2628
150,-40,150,565,574,1139,2757
80,-20,130,561,578,1139,2388
160,-30,150,567,572,1139,2648
50,-70,70,578,561,1139,2632
-60,50,40,572,568,1140,2431
-90,-30,-50,585,555,1140,2468
80,-20,20,565,575,1140,2422
120,-60,130,586,554,1140,2672
-60,-10,0,571,570,1141,2517
40,70,-30,596,545,1141,2598
70,10,-40,566,575,1141,2494
-100,-50,-90,576,565,1141,2595
40,30,-70,574,568,1142,2471
130,0,180,553,589,1142,2389
60,40,-10,598,544,1142,2297
10,70,-80,574,568,1142,2656
130,0,-180,553,589,1142,2389
40,40,-80,576,566,1142,2513
-160,-10,150,569,573,1142,2570
-140,-50,-160,567,576,1143,2578
-100,-30,-90,567,576,1143,2466
180,80,170,575,568,1143,2631
-180,80,170,575,568,1143,2631
-60,-50,-130,589,555,1144,2315
100,10,-130,578,566,1144,2459
-100,-80,-90,589,555,1144,2559
120,20,-140,566,578,1144,2507
-140,30,120,563,581,1144,2455
-100,10,60,568,577,1145,2412
90,50,-80,578,567,1145,2528
-50,-10,-90,569,576,1145,2537
30,-10,60,568,577,1145,2397
110,50,-110,572,573,1145,2539
-20,30,20,590,555,1145,2661
-90,10,-10,563,582,1145,2435
-70,80,-10,569,577,1146,2595
0,-30,30,583,563,1146,2591
120,10,120,565,581,1146,2332
10,-40,40,580,566,1146,2684
90,-60,110,586,562,1148,2630
-160,-40,170,556,592,1148,2618
30,-70,50,580,568,1148,2655
-20,20,20,590,558,1148,2681
-120,-50,-130,587,561,1148,2532
170,10,160,574,575,1149,2666
40,-70,60,575,574,1149,2684
-160,40,140,572,577,1149,2656
-180,40,160,579,570,1149,2613
-70,-60,-140,593,556,1149,2480
40,50,-90,575,574,1149,2518
180,40,160,579,570,1149,2613
80,40,-130,569,580,1149,2474
110,20,-120,560,589,1149,2535
-70,80,60,587,563,1150,2620
-160,30,140,573,577,1150,2595
130,20,-160,560,590,1150,2567
50,40,0,583,567,1150,2417
-120,-30,180,567,584,1151,2585
-30,50,20,586,565,1151,2656
130,-30,150,559,592,1151,2646
-10,20,20,597,554,1151,2578
-70,-20,-110,592,559,1151,2481
-120,-30,-180,567,584,1151,2585
90,-10,150,578,573,1151,2432
160,70,110,577,575,1152,2457
10,60,0,597,555,1152,2688
-80,60,60,572,580,1152,2494
-80,-10,-90,579,574,1153,2435
-100,60,80,580,573,1153,2510
-150,-60,-160,575,578,1153,2555
110,-50,60,563,590,1153,2568
80,0,0,575,578,1153,2565
-10,-60,-80,584,569,1153,2507
160,60,-170,576,578,1154,2530
80,30,-70,574,580,1154,2435
-50,0,-80,573,581,1154,2520
40,60,-100,579,575,1154,2501
70,-50,100,585,569,1154,2598
80,50,-140,555,599,1154,2444
80,20,-30,576,579,1155,2457
-40,20,20,585,570,1155,2566
80,20,-50,580,575,1155,2420
-10,-40,20,581,574,1155,2714
-60,0,10,571,584,1155,2551
-70,10,20,569,586,1155,2472
-100,0,50,575,581,1156,2543
-170,80,160,582,574,1156,2686
-60,-60,-40,591,565,1156,2577
-140,20,50,593,564,1157,2134
-20,-70,0,596,561,1157,2620
70,30,10,577,580,1157,2453
10,80,-10,595,562,1157,2692
-70,0,10,566,591,1157,2487
10,0,-60,583,574,1157,2696
90,0,-140,572,585,1157,2389
150,70,120,582,575,1157,2526
-140,-50,140,584,573,1157,2415
100,-30,140,570,587,1157,2528
-150,0,140,591,567,1158,2664
20,10,-60,583,575,1158,2659
130,-70,140,610,548,1158,2642
30,-60,-40,590,568,1158,2624
0,-10,30,579,579,1158,2653
-70,20,30,579,580,1159,2549
-50,40,30,596,563,1159,2543
80,-30,20,575,584,1159,2517
70,-10,-10,574,585,1159,2623
140,-30,150,569,590,1159,2690
-120,0,110,567,593,1160,2557
50,60,-110,586,574,1160,2550
10,-60,-60,597,563,1160,2498
80,0,90,582,578,1160,2475
170,70,-180,579,581,1160,2590
70,50,-40,603,557,1160,2467
170,70,180,579,581,1160,2590
30,30,20,590,570,1160,2653
20,-60,-50,594,566,1160,2586
-80,10,30,578,583,1161,2583
40,0,-50,588,573,1161,2478
-30,-70,-10,597,564,1161,2590
-100,30,70,584,577,1161,2588
-10,30,20,600,561,1161,2697
-140,50,120,563,598,1161,2594
60,-20,110,594,567,1161,2375
60,10,-50,585,576,1161,2520
-90,-10,-40,559,602,1161,2499
30,30,-70,590,572,1162,2502
-60,0,-80,583,579,1162,2623
-90,40,60,572,591,1163,2572
110,0,-160,582,581,1163,2621
160,0,160,578,585,1163,2718
150,30,-170,567,596,1163,2559
60,-70,80,604,559,1163,2676
50,50,-100,584,579,1163,2584
40,-30,80,594,569,1163,2686
90,-10,-160,581,583,1164,2428
140,50,120,587,577,1164,2344
60,-50,90,582,582,1164,2598
100,80,-100,596,568,1164,2603
120,-20,90,563,601,1164,2408
130,-80,140,592,573,1165,2637
0,70,0,596,569,1165,2650
130,0,110,590,576,1166,2373
-110,-40,180,579,587,1166,2426
70,0,-20,573,593,1166,2506
-110,-80,-100,604,562,1166,2620
60,60,-40,605,561,1166,2579
90,20,160,587,579,1166,2318
-90,-40,-60,592,574,1166,2560
80,50,-60,592,574,1166,2564
-110,-40,-180,579,587,1166,2426
80,0,60,581,585,1166,2434
-90,60,70,576,590,1166,2505
50,-50,80,584,583,1167,2685
60,50,-110,601,566,1167,2494
-140,-30,120,587,580,1167,2296
0,-40,30,597,570,1167,2680
-30,-20,10,581,586,1167,2709
-50,-60,-120,596,571,1167,2517
20,-50,50,588,580,1168,2790
140,-60,80,591,577,1168,2481
110,60,-110,604,564,1168,2508
80,20,20,571,597,1168,2499
30,70,-20,610,558,1168,2721
-170,0,150,569,599,1168,2827
150,50,110,583,585,1168,2323
10,30,20,589,580,1169,2639
80,30,-30,589,580,1169,2388
120,-10,170,558,611,1169,2533
40,-50,70,588,581,1169,2752
80,0,120,587,582,1169,2496
-30,40,20,596,573,1169,2697
140,-30,90,567,603,1170,2355
-130,-40,-160,577,593,1170,2737
-110,-50,-110,589,581,1170,2566
140,30,-160,570,600,1170,2600
-110,-40,-120,601,569,1170,2519
100,40,160,607,563,1170,2402
0,50,10,599,571,1170,2668
-160,-70,-160,583,588,1171,2629
-140,-30,170,586,585,1171,2783
-10,-40,-80,585,587,1172,2577
-80,80,70,599,574,1173,2694
160,-60,160,599,574,1173,2617
-80,10,-30,581,593,1174,2481
120,80,160,569,605,1174,2651
130,20,120,590,584,1174,2334
170,-50,100,580,594,1174,2303
80,0,100,586,588,1174,2430
90,-20,140,577,598,1175,2429
130,50,130,603,572,1175,2385
10,-10,40,599,576,1175,2601
150,50,-160,581,594,1175,2644
0,30,20,592,583,1175,2642
-130,-10,140,582,593,1175,2668
70,20,40,579,596,1175,2448
140,-70,150,610,566,1176,2696
-140,-70,-140,602,574,1176,2600
120,-40,140,580,596,1176,2704
-60,-60,-130,607,569,1176,2386
130,-60,140,606,571,1177,2722
-80,-30,-130,589,588,1177,2569
-150,-70,-150,591,586,1177,2610
-70,-60,-50,611,566,1177,2686
-170,10,150,593,584,1177,2764
20,-10,50,584,593,1177,2533
-50,70,40,614,563,1177,2578
90,40,-80,595,583,1178,2593
170,70,100,591,587,1178,2429
-170,40,150,592,586,1178,2658
-150,-20,100,575,603,1178,2415
-40,60,30,610,569,1179,2630
150,-30,150,587,592,1179,2735
40,10,60,600,579,1179,2637
80,30,-160,578,601,1179,2247
0,80,0,603,577,1180,2753
-110,10,20,588,592,1180,2438
170,60,180,574,606,1180,2671
170,60,-180,574,606,1180,2671
10,-20,-60,592,588,1180,2777
-170,-70,120,588,592,1180,2473
110,40,-110,586,594,1180,2568
-40,50,-40,577,604,1181,2545
110,70,-110,599,582,1181,2590
-170,20,150,598,583,1181,2660
-70,-70,-140,592,589,1181,2547
-160,-10,90,596,585,1181,2362
-90,10,40,593,589,1182,2647
-50,70,-30,595,587,1182,2624
-140,-40,130,594,588,1182,2411
160,30,180,587,595,1182,2720
160,30,-180,587,595,1182,2720
130,10,-170,582,600,1182,2586
130,-20,160,582,600,1182,2807
60,30,-80,599,583,1182,2551
120,-30,150,584,598,1182,2685
60,60,-120,585,598,1183,2672
30,-50,60,598,585,1183,2782
40,-60,-30,598,585,1183,2718
-120,-40,-140,606,577,1183,2579
10,-50,40,604,579,1183,2765
-40,-30,0,592,591,1183,2672
120,-10,100,571,613,1184,2531
140,-80,150,599,585,1184,2697
-20,10,20,614,570,1184,2660
-170,30,150,602,582,1184,2653
-130,50,110,574,610,1184,2577
-150,40,130,570,614,1184,2664
-30,20,20,620,565,1185,2588
-60,40,-30,602,583,1185,2458
150,-80,160,597,588,1185,2740
70,-70,90,604,581,1185,2659
-30,30,20,606,579,1185,2681
110,-10,170,581,604,1185,2532
-70,-30,-20,613,574,1187,2677
-70,-10,0,591,596,1187,2590
-40,-50,-10,612,575,1187,2581
80,30,-150,567,620,1187,2378
-160,80,150,592,595,1187,2715
-90,80,80,603,584,1187,2733
100,-40,130,584,604,1188,2709
80,10,-160,588,600,1188,2403
90,-60,30,590,598,1188,2503
-100,20,70,587,602,1189,2603
90,60,-80,603,586,1189,2636
-90,-70,-160,600,589,1189,2433
-30,-10,-80,592,597,1189,2773
-40,-70,-20,611,578,1189,2670
80,-50,110,603,586,1189,2688
-90,90,10,589,601,1190,2724
100,90,-180,589,601,1190,2724
-120,90,40,589,601,1190,2724
10,90,-90,589,601,1190,2724
-100,-40,-80,587,603,1190,2633
180,90,100,589,601,1190,2724
170,90,110,589,601,1190,2724
-120,0,40,621,569,1190,2321
-100,90,20,589,601,1190,2724
40,90,-120,589,601,1190,2724
30,90,-110,589,601,1190,2724
-70,90,-10,589,601,1190,2724
120,-20,160,588,602,1190,2632
80,90,-160,589,601,1190,2724
100,90,180,589,601,1190,2724
-150,90,70,589,601,1190,2724
-180,-30,100,588,602,1190,2391
120,90,160,589,601,1190,2724
-180,90,100,589,601,1190,2724
-10,90,-70,589,601,1190,2724
150,90,130,589,601,1190,2724
80,-40,120,598,592,1190,2690
70,90,-150,589,601,1190,2724
-30,90,-50,589,601,1190,2724
180,-30,100,588,602,1190,2391
-60,90,-20,589,601,1190,2724
140,90,140,589,601,1190,2724
130,90,150,589,601,1190,2724
20,90,-100,589,601,1190,2724
0,90,-80,589,601,1190,2724
-80,90,0,589,601,1190,2724
-160,90,80,589,601,1190,2724
-20,90,-60,589,601,1190,2724
-140,90,60,589,601,1190,2724
-40,90,-40,589,601,1190,2724
160,90,120,589,601,1190,2724
110,90,170,589,601,1190,2724
-100,-30,-80,600,590,1190,2609
20,20,30,605,585,1190,2699
-50,90,-30,589,601,1190,2724
-110,90,30,589,601,1190,2724
-130,90,50,589,601,1190,2724
90,90,-170,589,601,1190,2724
60,90,-140,589,601,1190,2724
-110,20,90,589,601,1190,2600
50,90,-130,589,601,1190,2724
-170,90,90,589,601,1190,2724
120,10,-160,592,599,1191,2620
-70,50,50,596,595,1191,2586
90,0,130,598,593,1191,2546
70,-40,0,569,622,1191,2648
-40,-10,10,599,592,1191,2732
-80,-30,-30,613,578,1191,2683
20,70,-90,599,593,1192,2755
-50,-20,0,606,586,1192,2721
-120,-10,120,586,606,1192,2655
-10,80,10,616,577,1193,2795
-120,-80,-110,610,583,1193,2701
150,-10,160,595,598,1193,2872
-90,-20,-30,604,589,1193,2620
30,60,-10,628,565,1193,2701
-180,70,170,597,597,1194,2680
-20,40,20,610,584,1194,2798
40,0,80,598,596,1194,2597
-150,80,140,599,595,1194,2731
-60,10,20,594,600,1194,2605
110,80,-110,607,587,1194,2662
180,70,170,597,597,1194,2680
-70,-50,-140,613,581,1194,2594
90,-30,40,586,608,1194,2465
-90,-60,-160,596,599,1195,2509
-80,-70,-150,601,594,1195,2502
-30,10,20,610,585,1195,2713
170,30,170,597,598,1195,2748
80,70,-70,608,587,1195,2686
90,-10,80,597,598,1195,2730
170,0,160,595,600,1195,2790
-10,-50,-80,607,588,1195,2535
70,-40,110,602,593,1195,2771
-40,-30,-100,605,590,1195,2543
60,-50,-10,591,605,1196,2660
80,10,-10,580,616,1196,2565
40,10,70,608,588,1196,2541
180,70,90,589,607,1196,2493
-180,70,90,589,607,1196,2493
90,0,120,579,617,1196,2513
-120,50,100,587,609,1196,2626
-100,80,90,605,591,1196,2797
100,-60,120,618,579,1197,2740
70,-30,0,584,613,1197,2680
30,40,10,631,566,1197,2643
-130,80,120,596,601,1197,2776
-140,-10,90,595,602,1197,2583
-100,50,10,587,610,1197,2553
-20,-20,-80,609,588,1197,2681
-130,-30,130,595,602,1197,2389
110,10,-130,595,603,1198,2632
160,30,100,604,594,1198,2428
-50,-70,-30,617,581,1198,2693
40,20,40,608,590,1198,2623
-90,-50,-70,602,596,1198,2712
30,10,-60,592,606,1198,2762
-160,-50,120,599,600,1199,2580
-100,-70,-90,613,586,1199,2600
-120,60,30,586,613,1199,2652
-150,-40,-180,589,610,1199,2722
90,-20,50,595,604,1199,2481
-90,-20,-110,600,599,1199,2448
-60,80,-20,599,600,1199,2718
-150,-40,180,589,610,1199,2722
70,10,-50,595,605,1200,2627
80,40,-160,590,610,1200,2410
110,0,-150,582,618,1200,2725
80,-70,100,614,586,1200,2674
150,-40,90,595,605,1200,2464
80,10,-170,611,589,1200,2496
-20,-50,10,615,586,1201,2784
-110,80,100,603,598,1201,2794
90,60,-170,597,605,1202,2655
140,70,130,604,598,1202,2601
-20,-10,20,600,602,1202,2802
130,70,140,596,606,1202,2625
-140,80,130,601,601,1202,2766
-10,60,10,616,586,1202,2658
-140,10,130,606,596,1202,2868
-100,-60,-90,614,588,1202,2631
100,-20,150,586,617,1203,2541
160,-80,170,605,598,1203,2790
80,0,80,605,598,1203,2566
-100,0,10,602,602,1204,2596
-50,10,20,622,582,1204,2701
-150,-10,90,610,594,1204,2510
70,40,-110,623,581,1204,2603
-130,30,110,599,605,1204,2594
-110,-30,-170,593,611,1204,2631
80,-10,10,589,617,1206,2734
-80,-60,-150,631,575,1206,2594
-30,-50,0,623,583,1206,2705
-20,0,20,623,584,1207,2739
-20,-60,-90,621,586,1207,2503
80,30,-90,618,589,1207,2461
-140,40,120,590,618,1208,2665
130,-10,170,597,611,1208,2680
20,30,20,611,597,1208,2755
90,40,-70,601,607,1208,2712
0,0,30,610,598,1208,2757
140,-40,150,607,601,1208,2959
-10,40,20,619,590,1209,2862
-90,20,50,591,618,1209,2652
160,40,100,613,596,1209,2394
-120,80,110,606,603,1209,2795
60,0,-40,605,605,1210,2690
70,30,-90,598,612,1210,2524
120,10,-150,598,612,1210,2835
-10,-50,20,611,600,1211,2805
-60,-70,-130,614,597,1211,2567
160,50,-170,593,618,1211,2685
160,20,100,601,610,1211,2337
-120,30,100,599,612,1211,2667
80,0,-160,617,595,1212,2432
90,0,110,603,609,1212,2600
160,10,170,602,610,1212,2770
110,0,-140,591,621,1212,2733
50,-40,90,614,598,1212,2837
80,40,-140,589,623,1212,2692
-140,-40,-170,607,606,1213,2847
130,-50,140,605,608,1213,2834
-110,50,90,608,606,1214,2722
-40,-60,-110,633,581,1214,2667
20,70,-10,623,591,1214,2843
-80,-10,0,608,606,1214,2790
120,50,140,623,591,1214,2444
-30,-60,-100,634,580,1214,2636
160,-50,160,611,603,1214,2806
-110,0,80,588,627,1215,2625
90,-10,-150,609,606,1215,2574
-120,-30,-170,595,620,1215,2735
-70,30,40,602,613,1215,2628
100,30,-100,605,610,1215,2704
-90,-10,-30,603,612,1215,2640
-120,-60,-120,623,593,1216,2580
80,10,40,617,599,1216,2450
-90,0,30,610,606,1216,2886
-80,20,40,608,608,1216,2686
-60,70,50,615,602,1217,2724
170,-40,160,611,606,1217,2794
-100,-30,-140,599,618,1217,2527
70,40,-20,623,595,1218,2495
-120,-10,130,602,616,1218,2734
80,20,-150,593,626,1219,2511
-70,-20,-10,614,605,1219,2686
-120,-30,160,605,614,1219,2722
100,0,120,607,612,1219,2643
-180,-30,160,618,602,1220,2837
180,-30,160,618,602,1220,2837
-60,10,-60,611,609,1220,2709
-50,-30,-110,615,605,1220,2619
80,20,-10,597,624,1221,2597
-170,70,160,613,608,1221,2809
80,40,-150,602,619,1221,2542
160,20,-180,608,613,1221,2844
160,20,180,608,613,1221,2844
-10,20,-60,613,608,1221,2700
-50,-50,-20,622,599,1221,2709
-60,-50,-30,618,604,1222,2827
-10,30,-60,601,621,1222,2685
100,60,170,592,630,1222,2533
120,0,-170,613,609,1222,2725
70,70,-140,598,625,1223,2747
-110,10,90,599,624,1223,2521
-100,-50,-170,613,610,1223,2685
80,40,-40,630,593,1223,2499
110,-40,140,619,604,1223,2821
150,0,170,597,626,1223,2900
80,60,-150,594,629,1223,2709
120,60,-120,629,594,1223,2712
70,60,-50,634,590,1224,2629
120,70,-120,618,606,1224,2716
80,20,-20,614,610,1224,2692
140,-60,150,632,592,1224,2861
-130,-20,160,615,609,1224,2889
-150,-30,170,598,627,1225,2897
-50,-70,-120,616,609,1225,2636
10,-10,-60,602,623,1225,2768
-180,60,170,604,621,1225,2770
180,60,170,604,621,1225,2770
-40,50,30,618,608,1226,2803
-150,-40,120,612,614,1226,2577
-120,40,100,606,620,1226,2764
-100,10,70,604,623,1227,2626
50,-20,100,623,604,1227,2603
30,50,0,625,602,1227,2672
-10,70,10,632,595,1227,2764
-50,60,40,624,603,1227,2793
170,20,170,615,612,1227,2777
-110,-30,-160,605,622,1227,2679
120,80,-120,620,607,1227,2727
-150,-20,160,614,614,1228,2814
90,-70,110,622,606,1228,2733
-110,-40,-110,622,606,1228,2610
170,-80,-180,626,603,1229,2831
170,-80,180,626,603,1229,2831
-80,-60,-60,636,593,1229,2800
-160,-20,160,609,620,1229,2854
-60,40,40,617,613,1230,2711
170,-60,170,615,615,1230,2831
30,70,-100,628,602,1230,2796
50,-60,-20,617,613,1230,2753
-80,0,20,604,626,1230,2822
-70,10,-50,611,621,1232,2819
-130,-50,-140,616,616,1232,2785
-130,-30,-180,606,626,1232,2848
10,-80,30,627,605,1232,2833
0,-50,30,630,602,1232,2827
-60,-40,-20,614,618,1232,2771
-130,-30,180,606,626,1232,2848
-130,10,120,613,620,1233,2930
-20,-50,-90,624,609,1233,2666
50,-80,70,638,595,1233,2788
-90,-10,-50,611,622,1233,2577
160,-10,160,620,614,1234,2931
-80,0,-60,623,611,1234,2755
180,30,160,625,609,1234,2757
-180,30,160,625,609,1234,2757
90,50,180,606,628,1234,2524
110,-50,130,626,608,1234,2922
90,50,-180,606,628,1234,2524
-180,-50,170,620,615,1235,2784
180,-50,170,620,615,1235,2784
100,-10,90,601,634,1235,2741
-40,60,-40,609,626,1235,2799
-130,-80,-120,626,609,1235,2788
40,-80,60,634,601,1235,2777
150,-70,160,641,594,1235,2812
-160,60,150,611,625,1236,2789
0,-80,20,625,611,1236,2830
-100,-30,-70,625,611,1236,2674
-110,-30,-150,620,616,1236,2702
110,30,-110,607,629,1236,2804
-60,-70,-40,634,603,1237,2788
-110,-30,-180,609,628,1237,2632
-110,-30,180,609,628,1237,2632
110,80,170,603,634,1237,2804
140,-20,160,631,606,1237,2855
150,0,100,614,623,1237,2526
60,-40,100,631,606,1237,2836
80,0,70,646,592,1238,2590
30,-20,70,622,616,1238,2843
-90,-10,-80,621,617,1238,2678
0,60,-70,635,604,1239,2759
-100,0,60,621,618,1239,2652
100,70,-180,604,636,1240,2784
-130,40,110,609,631,1240,2754
-30,-30,10,616,624,1240,2816
-10,-80,10,627,613,1240,2805
100,70,180,604,636,1240,2784
-10,-10,-70,633,607,1240,2950
50,30,-80,633,607,1240,2715
-180,20,160,620,620,1240,2900
180,20,160,620,620,1240,2900
-20,-20,20,621,620,1241,2895
-140,20,130,619,622,1241,2846
70,20,50,614,627,1241,2508
-150,10,140,621,620,1241,2987
-170,-20,160,623,618,1241,2838
30,40,-80,625,616,1241,2699
60,10,100,616,625,1241,2623
-20,80,20,639,603,1242,2869
-10,40,-60,613,629,1242,2733
-140,-20,160,617,625,1242,2904
120,50,-120,629,613,1242,2678
-180,0,90,629,614,1243,2574
100,-10,170,610,633,1243,2689
180,0,90,629,614,1243,2574
-150,-80,-140,622,621,1243,2836
-150,-10,150,613,630,1243,2928
-70,-40,-30,622,622,1244,2787
-80,50,60,620,624,1244,2742
80,50,-50,625,619,1244,2719
-70,-50,-40,618,626,1244,2856
100,20,-110,607,637,1244,2672
-140,-80,-130,629,616,1245,2865
30,-80,50,639,606,1245,2795
-180,10,160,624,621,1245,2883
-40,10,20,629,616,1245,2686
180,10,160,624,621,1245,2883
20,-80,40,632,614,1246,2813
-170,60,160,616,630,1246,2826
130,-40,80,617,629,1246,2655
-20,-70,-90,627,619,1246,2789
70,20,60,626,620,1246,2618
-160,70,150,626,620,1246,2840
-90,0,-10,617,629,1246,2657
170,-20,160,624,622,1246,2882
80,20,-160,605,641,1246,2393
-100,50,80,637,610,1247,2810
100,50,-90,612,635,1247,2846
0,-30,-70,621,626,1247,2790
-50,-50,-120,632,615,1247,2655
-50,-20,-100,652,595,1247,2661
-60,-30,-10,634,613,1247,2829
-70,0,-80,628,620,1248,2784
-40,-70,-110,623,625,1248,2711
-150,60,140,620,628,1248,2765
-10,50,-60,605,644,1249,2829
-160,0,150,623,626,1249,2924
50,-10,-40,602,648,1250,2735
170,50,-180,612,638,1250,2838
-160,-80,-150,628,622,1250,2882
-110,-30,-130,626,624,1250,2772
170,50,180,612,638,1250,2838
100,40,-90,634,617,1251,2861
170,-10,160,629,622,1251,2978
10,50,10,645,606,1251,2844
60,-80,80,640,611,1251,2847
-170,70,80,618,633,1251,2779
-130,0,130,622,630,1252,2863
80,20,-170,633,619,1252,2563
-180,-80,-170,634,618,1252,2855
180,-80,-170,634,618,1252,2855
100,-60,40,609,643,1252,2596
-120,-10,110,615,637,1252,2788
-150,70,140,626,626,1252,2842
-20,70,20,647,606,1253,2901
-20,50,20,626,627,1253,2933
-170,-40,170,631,622,1253,2872
70,10,80,646,607,1253,2569
-50,80,-30,632,621,1253,2816
110,-30,150,618,635,1253,2760
110,-60,130,637,616,1253,2838
-140,-10,150,623,631,1254,2982
60,-60,90,638,616,1254,2865
100,-70,120,635,619,1254,2827
-20,-80,0,635,619,1254,2856
80,30,-140,624,630,1254,2778
90,30,-90,631,623,1254,2612
-170,-80,-160,637,618,1255,2855
-110,-70,-100,647,608,1255,2704
120,-30,80,622,633,1255,2730
50,20,80,629,627,1256,2588
-110,-30,-140,625,631,1256,2735
-30,-70,-100,639,617,1256,2800
-120,-40,160,612,644,1256,2766
0,40,20,636,620,1256,2867
-50,30,30,638,619,1257,2748
180,-20,160,648,610,1258,2921
-110,40,90,626,632,1258,2853
-180,-70,110,621,637,1258,2652
-120,10,30,647,611,1258,2541
180,-70,110,621,637,1258,2652
-180,-20,160,648,610,1258,2921
40,10,-60,618,640,1258,2822
160,50,100,612,647,1259,2454
-80,-50,-50,648,611,1259,2898
140,-10,100,617,642,1259,2653
60,-60,-10,626,633,1259,2863
-80,0,-70,628,632,1260,2767
140,0,-180,621,639,1260,2667
130,-10,100,612,648,1260,2645
140,0,180,621,639,1260,2667
-120,-30,-160,622,638,1260,2835
100,-10,-160,619,641,1260,2755
40,40,10,657,603,1260,2755
-50,20,-50,623,637,1260,2799
180,0,160,637,623,1260,2975
40,-20,-40,624,636,1260,2867
150,10,-180,636,624,1260,2766
150,10,180,636,624,1260,2766
-180,0,160,637,623,1260,2975
-20,0,-70,643,617,1260,2884
0,-70,-70,637,624,1261,2774
-90,-50,-160,632,629,1261,2668
80,30,-110,622,639,1261,2680
90,-50,120,620,641,1261,2877
-30,-80,-10,641,620,1261,2884
20,30,-70,631,630,1261,2709
90,70,-80,650,611,1261,2863
20,10,40,641,620,1261,2777
-90,20,-10,612,650,1262,2715
30,-30,70,639,623,1262,2907
130,80,-130,641,621,1262,2799
0,10,30,639,623,1262,2988
-90,-30,-40,640,622,1262,2808
140,40,-150,631,632,1263,2843
80,30,-20,634,629,1263,2701
80,30,-170,625,638,1263,2554
140,20,110,633,630,1263,2609
60,-20,-20,618,645,1263,2854
-40,-80,-20,645,618,1263,2926
-30,40,-50,623,641,1264,2865
-90,-30,-140,625,639,1264,2727
-130,-20,110,614,650,1264,2720
-140,70,130,641,624,1265,2840
-140,0,140,629,636,1265,3014
90,30,-80,639,626,1265,2738
110,-70,130,645,620,1265,2925
-40,40,30,653,612,1265,2811
80,-10,140,626,639,1265,2678
70,-80,90,650,615,1265,2879
120,10,-140,626,640,1266,2968
-50,-80,-30,646,620,1266,2956
80,0,160,607,659,1266,2580
60,40,0,631,635,1266,2666
70,-60,100,639,628,1267,2887
-120,0,120,634,633,1267,2870
140,80,-140,642,625,1267,2814
160,-40,160,634,633,1267,3036
-80,-40,-40,647,620,1267,2837
80,-60,110,637,631,1268,2952
80,30,-10,623,645,1268,2699
-70,-70,-50,654,614,1268,2825
-40,70,-40,638,630,1268,2780
130,-40,150,633,636,1269,2979
-50,10,-70,625,644,1269,2880
-70,-30,-130,638,631,1269,2736
50,-20,-30,628,641,1269,2843
70,20,-70,642,629,1271,2725
-70,70,60,640,631,1271,2892
80,10,-150,624,647,1271,2617
0,60,10,667,604,1271,2949
130,70,-130,649,622,1271,2763
-140,-80,150,629,642,1271,2748
170,-30,160,638,634,1272,2994
-100,-30,-150,637,635,1272,2723
-110,30,90,621,651,1272,2810
50,40,-90,627,645,1272,2785
180,-60,180,649,623,1272,2897
180,-60,-180,649,623,1272,2897
-90,-80,-160,621,651,1272,2729
80,10,50,637,635,1272,2738
-180,-60,180,649,623,1272,2897
-180,-60,-180,649,623,1272,2897
-30,-20,-90,636,637,1273,2899
80,30,-100,642,631,1273,2659
-120,10,110,625,648,1273,2851
90,50,-70,642,631,1273,2819
-150,-80,140,635,639,1274,2827
-130,-50,150,641,633,1274,2754
-90,30,60,641,633,1274,2803
-130,-10,90,618,656,1274,2650
-120,-40,-130,651,623,1274,2756
-60,-80,-40,652,623,1275,2958
80,0,170,625,650,1275,2509
10,70,0,658,617,1275,3045
-180,-10,160,642,633,1275,2923
180,-10,160,642,633,1275,2923
20,50,-80,648,627,1275,2775
-150,20,140,626,649,1275,2955
60,20,-70,638,638,1276,2609
-90,-10,-20,631,645,1276,2706
20,0,-60,659,617,1276,2918
-80,30,50,640,636,1276,2849
10,-60,40,651,625,1276,3023
-100,-80,-170,624,652,1276,2709
-10,-70,-80,645,631,1276,2806
-90,-10,-70,633,644,1277,2670
140,-50,150,638,639,1277,3026
80,-80,100,666,612,1278,2915
50,30,30,649,629,1278,2744
-30,80,30,654,624,1278,2910
80,20,-60,633,645,1278,2755
50,-60,80,654,625,1279,2969
-150,-30,110,638,641,1279,2533
-130,-80,160,631,648,1279,2756
10,0,40,654,625,1279,2806
-130,0,60,659,621,1280,2457
10,40,-70,636,644,1280,2781
10,-70,-60,651,629,1280,2810
20,-60,50,653,628,1281,2983
-60,10,-70,649,632,1281,2795
30,-60,60,655,626,1281,3040
-180,50,170,640,641,1281,2840
140,-10,170,630,651,1281,3010
180,50,170,640,641,1281,2840
-110,-60,-100,649,633,1282,2819
-80,-50,-150,653,629,1282,2785
-130,-40,-150,627,655,1282,2788
80,50,-150,637,645,1282,2774
150,40,-160,634,649,1283,2856
130,30,-140,636,647,1283,2824
-110,-80,180,630,653,1283,2691
-130,20,120,635,648,1283,2943
160,-20,160,650,633,1283,3037
-110,-80,-180,630,653,1283,2691
50,50,-10,676,607,1283,2859
-20,20,-60,643,641,1284,2955
-90,50,70,641,643,1284,2835
-70,10,-60,635,649,1284,2933
-40,10,-70,642,642,1284,3015
80,0,-170,635,649,1284,2711
-50,-40,-10,634,650,1284,2837
110,-20,160,647,638,1285,2907
110,50,150,650,635,1285,2652
90,30,-70,638,647,1285,2732
-130,70,120,656,629,1285,2879
-90,50,0,638,648,1286,2873
150,-20,160,646,640,1286,3080
-170,-60,-170,659,627,1286,2959
-110,0,90,630,656,1286,2750
30,0,60,652,634,1286,2820
160,-70,170,655,631,1286,2929
80,60,-60,671,615,1286,2821
120,40,-120,632,655,1287,2783
-160,20,70,653,634,1287,2599
90,-50,30,638,649,1287,2820
60,30,30,640,647,1287,2662
-110,60,20,629,658,1287,2797
100,60,-90,655,632,1287,2924
40,70,-110,648,640,1288,2868
40,-60,70,657,631,1288,3018
-80,70,70,646,642,1288,2909
100,80,-180,620,668,1288,2937
100,80,180,620,668,1288,2937
90,-10,160,629,659,1288,2814
90,-40,130,654,634,1288,2926
70,30,20,636,653,1289,2624
-30,70,30,650,639,1289,3070
80,10,-180,633,656,1289,2607
80,10,180,633,656,1289,2607
90,-60,120,648,641,1289,2992
-10,90,10,656,634,1290,2868
180,90,-180,656,634,1290,2868
-70,90,70,656,634,1290,2868
-50,90,50,656,634,1290,2868
-40,90,40,656,634,1290,2868
170,90,-170,656,634,1290,2868
-150,90,150,656,634,1290,2868
-30,90,30,656,634,1290,2868
160,90,-160,656,634,1290,2868
-20,60,20,647,643,1290,2923
-20,90,20,656,634,1290,2868
0,90,0,656,634,1290,2868
-140,-50,-150,629,661,1290,2864
-140,90,140,656,634,1290,2868
50,10,-60,633,657,1290,2861
-160,90,160,656,634,1290,2868
100,-30,60,639,651,1290,2807
100,-40,50,636,654,1290,2696
100,90,-100,656,634,1290,2868
90,90,-90,656,634,1290,2868
-90,90,90,656,634,1290,2868
110,90,-110,656,634,1290,2868
80,90,-80,656,634,1290,2868
80,30,-120,634,656,1290,2804
120,90,-120,656,634,1290,2868
-180,90,180,656,634,1290,2868
70,90,-70,656,634,1290,2868
-180,90,-180,656,634,1290,2868
10,90,-10,656,634,1290,2868
130,90,-130,656,634,1290,2868
-80,90,80,656,634,1290,2868
60,90,-60,656,634,1290,2868
60,-30,110,657,633,1290,2890
50,90,-50,656,634,1290,2868
140,90,-140,656,634,1290,2868
150,-60,160,654,636,1290,2951
40,90,-40,656,634,1290,2868
40,-40,80,649,641,1290,2875
30,90,-30,656,634,1290,2868
150,90,-150,656,634,1290,2868
20,90,-20,656,634,1290,2868
20,60,0,668,622,1290,2963
-170,90,170,656,634,1290,2868
-60,90,60,656,634,1290,2868
180,90,180,656,634,1290,2868
-110,-50,-100,650,640,1290,2800
-120,90,120,656,634,1290,2868
-100,90,100,656,634,1290,2868
-110,90,110,656,634,1290,2868
-130,90,130,656,634,1290,2868
-100,-30,-160,642,648,1290,2815
-130,-60,-130,652,639,1291,2837
50,80,-40,667,624,1291,2992
90,-10,70,640,651,1291,2821
-40,-20,10,650,641,1291,2901
160,-30,160,648,644,1292,3059
-120,-80,170,636,656,1292,2737
-120,-20,130,635,657,1292,2670
130,60,-130,647,646,1293,2820
70,0,120,653,640,1293,2699
-140,60,130,640,653,1293,2794
60,80,-50,669,624,1293,2988
20,-70,-50,666,627,1293,2855
40,80,-30,673,620,1293,2961
100,0,110,639,654,1293,2671
-170,50,160,645,648,1293,2858
-150,20,60,663,631,1294,2681
-80,-80,-150,643,651,1294,2794
150,-30,160,645,649,1294,3099
-120,70,110,658,636,1294,2912
-80,10,-40,658,637,1295,2880
-10,-60,20,649,646,1295,2984
-20,-60,10,661,634,1295,2955
-40,30,-50,623,673,1296,2922
40,10,80,647,649,1296,2718
-160,-30,170,647,650,1297,3037
-40,0,-80,643,654,1297,2844
-60,20,30,650,647,1297,2916
-120,-20,160,648,649,1297,2891
150,20,-170,643,655,1298,2806
-60,60,50,659,639,1298,2932
-50,-10,10,655,643,1298,2965
10,20,30,659,640,1299,3004
90,20,-120,651,648,1299,2760
-40,80,-40,666,634,1300,2959
-160,-80,130,655,645,1300,2857
-130,70,40,645,656,1301,2909
120,70,150,634,667,1301,2786
-70,-80,-50,670,632,1302,2972
60,20,80,643,659,1302,2655
-60,-30,-120,659,644,1303,2861
80,-20,10,637,666,1303,2955
-80,-70,-60,668,635,1303,2889
0,-60,30,665,638,1303,2989
-130,-10,150,650,653,1303,3130
-20,-30,20,663,640,1303,3009
70,-30,120,659,645,1304,2767
90,40,-60,643,661,1304,2861
-100,70,90,656,648,1304,2944
-140,-30,-180,645,659,1304,3056
-140,-30,180,645,659,1304,3056
-130,-20,170,652,653,1305,3067
-100,-40,-70,657,648,1305,2868
50,0,-50,655,650,1305,2914
-30,-50,-100,676,629,1305,2861
170,-60,100,651,654,1305,2738
130,-60,70,655,651,1306,2869
-50,50,40,676,630,1306,2957
-10,-30,30,660,646,1306,3062
-120,-20,140,645,661,1306,2938
120,-60,140,658,648,1306,2957
-100,-30,-60,671,635,1306,2821
-90,-10,-60,655,652,1307,2804
120,20,-130,637,670,1307,2936
90,10,140,645,662,1307,2782
-170,-10,160,656,651,1307,3078
120,0,110,638,669,1307,2982
140,70,-140,659,648,1307,2836
40,30,30,664,644,1308,2962
60,70,-130,646,662,1308,2927
90,-10,-170,662,646,1308,2865
40,-10,-50,643,666,1309,2927
-70,-80,-140,669,640,1309,2826
-170,-50,-180,649,660,1309,2944
70,10,90,651,658,1309,2817
-30,-60,0,669,640,1309,2937
-70,-10,-100,660,649,1309,2853
-170,-50,180,649,660,1309,2944
90,-80,110,671,638,1309,2976
-160,10,150,654,656,1310,3152
20,-30,60,657,653,1310,2971
-50,40,-40,659,651,1310,2865
60,40,-100,659,651,1310,2899
-120,-70,-110,674,637,1311,2850
50,40,10,660,651,1311,2850
30,80,-20,679,632,1311,3035
-40,-40,0,667,644,1311,2883
80,10,-20,631,680,1311,2833
-40,80,40,662,649,1311,2970
-120,-50,-120,667,644,1311,2943
-90,70,80,660,651,1311,2929
-40,-50,-110,685,626,1311,2884
-40,-60,-10,678,633,1311,2963
70,40,-10,655,657,1312,2781
-60,-20,0,661,651,1312,2952
30,20,-70,643,669,1312,2806
-150,-50,-160,643,669,1312,2958
150,80,-150,665,647,1312,2898
70,-50,0,643,670,1313,3037
-90,-60,-70,671,642,1313,2970
-160,70,70,634,679,1313,2901
-120,-20,170,647,666,1313,2994
70,0,-30,647,667,1314,2753
80,0,130,644,670,1314,2727
-130,10,40,662,652,1314,2560
-20,-40,-90,646,668,1314,2838
-130,-30,-170,655,659,1314,3057
120,-70,140,667,648,1315,2969
130,-20,90,622,693,1315,2808
30,-40,70,665,650,1315,3046
0,-20,-70,650,665,1315,2963
-30,20,-60,659,656,1315,2989
130,50,-130,650,666,1316,2866
-30,0,20,659,657,1316,2894
90,30,-60,627,689,1316,2725
120,-50,140,660,656,1316,3238
-140,70,50,643,673,1316,2955
100,10,130,663,653,1316,2845
-110,70,100,667,649,1316,2992
-100,-20,-90,642,675,1317,2860
100,-10,-150,643,674,1317,2861
70,20,70,655,662,1317,2748
-10,-20,30,661,657,1318,3115
170,-70,-180,662,656,1318,3007
-90,-20,-20,671,647,1318,2977
170,-70,180,662,656,1318,3007
70,80,-60,685,633,1318,3092
10,40,20,673,646,1319,2938
-100,-50,-80,667,653,1320,2932
80,20,30,655,665,1320,2827
-90,-10,-90,650,670,1320,2867
0,-30,40,654,666,1320,3010
-90,0,-30,640,680,1320,2826
-30,-40,10,671,649,1320,3016
160,40,-170,651,669,1320,2997
60,30,-90,657,663,1320,2918
-90,0,-20,649,671,1320,2884
20,80,-10,686,634,1320,3070
140,60,-140,648,672,1320,2867
-100,-20,-80,658,663,1321,2839
80,20,180,675,646,1321,2799
80,20,-180,675,646,1321,2799
-120,-10,140,664,657,1321,3034
-110,-40,-100,669,653,1322,2865
-140,0,70,657,665,1322,2523
60,50,-20,680,642,1322,2859
100,-10,180,650,672,1322,2839
100,-10,-180,650,672,1322,2839
-90,-40,-50,672,651,1323,2940
-90,10,50,658,666,1324,3053
100,70,-90,677,647,1324,3021
20,50,10,680,644,1324,2961
-130,60,120,661,664,1325,2946
130,-30,160,655,670,1325,3116
160,0,170,649,676,1325,3223
80,-10,0,655,671,1326,2975
50,-30,100,679,647,1326,2946
-170,-80,120,667,659,1326,2917
-100,40,80,674,652,1326,3077
-170,-10,90,653,673,1326,2777
-10,50,20,676,651,1327,3146
80,10,60,670,657,1327,2886
-160,-50,-170,655,672,1327,3077
-160,50,150,658,669,1327,2813
-60,-40,-130,675,652,1327,2809
10,-30,50,666,661,1327,3029
140,-30,160,654,674,1328,3115
-100,60,10,673,655,1328,2819
-150,-40,-170,659,669,1328,3093
30,-70,-40,684,645,1329,2953
-30,-10,20,663,666,1329,3046
-80,-80,-60,691,638,1329,2986
150,60,-150,649,680,1329,2951
130,20,-150,653,676,1329,2969
-90,20,60,655,674,1329,3042
-30,80,-50,687,642,1329,3031
170,10,170,656,674,1330,3137
90,-40,30,660,670,1330,2907
40,-10,90,674,656,1330,2841
150,70,-150,670,660,1330,2942
70,-20,-10,659,671,1330,2992
40,0,90,673,658,1331,2712
50,10,100,683,648,1331,2720
50,70,-120,665,666,1331,2960
80,10,170,635,696,1331,2702
-50,-60,-20,683,649,1332,3074
150,-50,160,674,658,1332,3106
80,-30,10,651,681,1332,2913
0,70,10,689,643,1332,3182
-120,70,30,647,685,1332,2913
-120,-20,150,658,675,1333,3035
100,-80,120,678,655,1333,2995
-70,20,-40,660,673,1333,2910
20,-40,60,671,662,1333,3069
10,60,-80,673,660,1333,3080
-100,0,70,669,665,1334,2871
120,30,-120,645,689,1334,2991
80,0,140,656,678,1334,2742
140,10,-170,665,669,1334,2917
-80,-10,-100,686,649,1335,2935
-70,40,50,668,667,1335,2972
100,-50,130,657,678,1335,3123
50,20,-70,673,662,1335,2817
-80,-20,-120,689,647,1336,3083
-70,60,60,686,650,1336,2929
-90,-10,0,663,673,1336,3029
170,-50,170,669,667,1336,2985
100,20,140,673,663,1336,2769
40,30,-80,665,671,1336,2981
-130,-40,140,674,662,1336,2898
-100,20,80,643,694,1337,2981
-40,0,20,676,661,1337,3071
-140,-60,-140,663,674,1337,2908
170,40,90,682,656,1338,2682
-10,-10,30,678,660,1338,3111
100,40,-80,676,662,1338,3042
10,80,0,698,640,1338,3157
110,-20,80,642,696,1338,2935
-70,0,20,662,677,1339,2951
90,10,-130,659,680,1339,2903
-50,-30,0,673,666,1339,3006
-180,-40,170,678,661,1339,3083
180,-40,170,678,661,1339,3083
130,10,110,672,668,1340,2805
80,10,160,664,676,1340,2821
10,-40,50,684,656,1340,3080
-100,-20,-100,665,676,1341,2916
-110,0,20,674,667,1341,2737
140,60,120,688,653,1341,2593
40,-70,-30,674,667,1341,2998
-160,-40,180,671,671,1342,3113
-160,-40,-180,671,671,1342,3113
-100,30,80,655,687,1342,3032
-180,-80,110,674,669,1343,2984
180,-80,110,674,669,1343,2984
-70,10,30,672,671,1343,3027
80,0,180,663,681,1344,2758
80,0,-180,663,681,1344,2758
-50,80,50,675,669,1344,3025
-40,-10,-90,672,672,1344,3062
-80,-20,-10,668,676,1344,3064
-100,-40,-170,676,669,1345,2898
30,-20,-50,676,669,1345,3157
60,-50,100,677,669,1346,3120
110,50,-100,667,679,1346,3120
-160,-60,-160,672,674,1346,3044
-90,-70,-70,693,653,1346,2981
80,20,-140,656,690,1346,2764
-40,70,40,674,672,1346,3139
-120,-10,100,669,678,1347,2802
-140,-40,-160,657,690,1347,3062
-150,70,60,646,701,1347,2947
-120,-30,150,679,668,1347,3066
-100,10,80,657,690,1347,2867
50,70,-30,691,656,1347,3101
-10,-30,-80,668,680,1348,3109
40,20,-70,675,673,1348,2831
120,-40,150,668,680,1348,3109
-90,-10,10,675,674,1349,3053
-100,-10,30,675,674,1349,3023
160,80,-160,685,664,1349,3010
-90,-50,-60,684,665,1349,3020
-150,50,140,658,692,1350,2903
-50,-80,-120,674,677,1351,2960
-10,0,-70,691,660,1351,3159
90,-20,40,662,689,1351,2984
-60,-20,-110,698,653,1351,2997
-150,30,140,673,678,1351,2978
-20,-40,20,689,662,1351,3069
-120,-30,-150,688,664,1352,2923
-80,50,-10,663,689,1352,2970
90,80,-170,654,699,1353,3051
110,-10,-180,665,688,1353,2934
60,10,-60,671,682,1353,2914
170,40,-180,662,691,1353,3109
170,40,180,662,691,1353,3109
80,0,150,653,700,1353,2791
110,0,110,664,689,1353,2907
-170,-30,170,686,667,1353,3214
110,-10,180,665,688,1353,2934
-140,-20,100,659,695,1354,2769
-90,-30,-30,688,666,1354,2992
90,40,170,692,662,1354,2718
90,0,100,658,696,1354,2913
160,-60,170,675,680,1355,3102
-60,-10,10,675,680,1355,3069
-40,-80,-110,677,678,1355,2977
150,-40,160,682,674,1356,3191
90,-10,170,660,696,1356,2918
-40,30,30,687,669,1356,3055
-180,-70,-170,678,678,1356,3117
80,30,0,662,694,1356,2925
180,-70,-170,678,678,1356,3117
-60,-80,-130,683,673,1356,2861
-140,30,130,672,684,1356,3056
-170,-50,110,692,665,1357,2912
0,-40,40,688,669,1357,3130
-80,0,30,692,665,1357,3061
70,-60,0,686,672,1358,3016
-60,-60,-30,690,668,1358,3102
-10,-40,30,686,672,1358,3095
80,80,-70,709,649,1358,3128
-30,70,-50,695,663,1358,3033
100,-20,70,691,667,1358,3046
-130,0,140,683,675,1358,3187
150,-10,170,677,681,1358,3201
110,-80,130,690,668,1358,3044
-90,-10,-10,661,697,1358,2957
30,10,50,697,661,1358,3048
-50,20,30,687,671,1358,3128
-120,-20,-180,682,677,1359,3083
-100,-20,-70,683,676,1359,2901
-10,0,30,688,671,1359,3170
110,20,130,685,674,1359,2847
-120,-20,180,682,677,1359,3083
-160,40,150,670,689,1359,3031
80,40,-170,662,698,1360,2693
100,-60,130,677,683,1360,3126
-130,-70,-120,699,661,1360,3062
-160,-10,160,684,677,1361,3174
130,-20,170,681,680,1361,3149
-80,40,60,689,672,1361,3149
-150,40,140,675,687,1362,3045
10,-70,40,680,682,1362,3145
110,30,140,680,682,1362,2901
0,-70,30,687,675,1362,3166
-160,20,150,665,697,1362,3171
40,20,50,693,670,1363,3051
-30,50,-50,672,691,1363,3077
130,0,-170,673,690,1363,2991
80,-30,130,684,679,1363,3029
30,20,40,699,664,1363,3043
80,30,-130,658,706,1364,2968
90,-10,180,661,703,1364,2903
-150,-60,-150,679,685,1364,2973
90,-10,-180,661,703,1364,2903
-160,30,150,686,678,1364,3077
150,10,100,676,689,1365,2803
-30,60,30,687,678,1365,3124
-120,-50,160,671,694,1365,3055
-100,-20,-110,675,690,1365,2827
-170,40,160,691,674,1365,3116
60,-10,-30,670,695,1365,2961
50,-70,-20,689,677,1366,3030
50,-50,90,685,681,1366,3173
-70,30,-30,692,674,1366,3000
80,-10,-160,686,681,1367,2752
0,-20,40,678,689,1367,3097
120,-10,-180,667,700,1367,3017
-170,0,160,690,677,1367,3134
110,-30,70,684,683,1367,3068
-20,80,-60,703,664,1367,3152
120,-10,180,667,700,1367,3017
-100,-10,40,687,680,1367,2967
-70,10,-70,694,674,1368,2972
-130,-40,-140,690,678,1368,3023
40,50,0,701,667,1368,3011
-90,0,40,692,676,1368,3069
-90,-80,-70,703,665,1368,3045
60,30,40,682,687,1369,2921
80,50,-160,670,699,1369,2954
-120,60,110,681,688,1369,3036
-30,-80,-100,685,684,1369,3077
80,20,-70,691,678,1369,2933
40,-20,90,688,681,1369,3029
40,-50,80,692,677,1369,3185
-90,-20,-120,685,685,1370,2948
0,20,30,678,692,1370,3102
170,-70,100,675,695,1370,2985
-150,0,150,690,680,1370,3228
20,40,20,711,659,1370,3053
20,-70,50,691,680,1371,3240
160,-10,170,694,677,1371,3354
-170,10,160,689,683,1372,3259
-110,0,100,692,680,1372,2973
120,30,130,699,673,1372,2836
70,50,-30,698,674,1372,2936
60,40,10,666,706,1372,2877
80,-50,120,684,689,1373,3124
70,10,100,686,687,1373,2985
-120,20,110,675,698,1373,3041
0,-90,20,701,673,1374,3193
40,-90,60,701,673,1374,3193
-60,0,20,691,683,1374,3052
110,-60,50,670,704,1374,2978
160,-90,180,701,673,1374,3193
170,-90,-170,701,673,1374,3193
160,-90,-180,701,673,1374,3193
-140,50,130,674,700,1374,3005
-170,-90,-150,701,673,1374,3193
-90,-90,-70,701,673,1374,3193
50,-90,70,701,673,1374,3193
80,-90,100,701,673,1374,3193
90,-90,110,701,673,1374,3193
-110,-90,-90,701,673,1374,3193
-50,-90,-30,701,673,1374,3193
180,-90,-160,701,673,1374,3193
-10,-90,10,701,673,1374,3193
30,-90,50,701,673,1374,3193
-160,-90,-140,701,673,1374,3193
-30,-90,-10,701,673,1374,3193
130,-90,150,701,673,1374,3193
-180,-90,-160,701,673,1374,3193
120,-90,140,701,673,1374,3193
70,-90,90,701,673,1374,3193
110,-90,130,701,673,1374,3193
140,-90,160,701,673,1374,3193
-70,-90,-50,701,673,1374,3193
-140,-90,-120,701,673,1374,3193
-150,-90,-130,701,673,1374,3193
10,-90,30,701,673,1374,3193
20,-90,40,701,673,1374,3193
-60,-90,-40,701,673,1374,3193
-120,-90,-100,701,673,1374,3193
-100,-90,-80,701,673,1374,3193
180,40,170,693,681,1374,3141
60,-90,80,701,673,1374,3193
-40,-90,-20,701,673,1374,3193
100,30,150,689,685,1374,2849
100,-90,120,701,673,1374,3193
150,-90,170,701,673,1374,3193
100,30,-90,699,675,1374,3062
-130,-90,-110,701,673,1374,3193
-180,40,170,693,681,1374,3141
130,60,130,706,668,1374,2693
-20,-90,0,701,673,1374,3193
-80,-90,-60,701,673,1374,3193
40,70,-20,715,660,1375,3167
-110,-10,40,697,679,1376,2954
-80,-30,-20,702,674,1376,3120
50,60,-20,701,675,1376,3058
-90,-30,-150,678,698,1376,2926
130,-50,150,697,679,1376,3312
150,0,-180,692,685,1377,3139
-70,-10,10,682,695,1377,3156
60,70,-40,706,671,1377,3164
-100,-20,-60,704,673,1377,2988
150,0,180,692,685,1377,3139
130,30,120,693,684,1377,2894
-80,60,70,700,677,1377,3053
-30,10,-70,679,698,1377,3234
140,-50,80,674,704,1378,3040
-60,80,60,686,692,1378,3090
10,60,10,712,666,1378,3155
90,20,150,698,680,1378,2791
-10,-80,-80,681,697,1378,3206
70,-50,110,693,685,1378,3115
30,-70,60,701,677,1378,3196
-80,-30,-140,680,699,1379,3165
170,30,90,708,672,1380,2791
110,20,-110,691,689,1380,3075
-70,-40,-140,709,671,1380,3022
100,-40,140,688,692,1380,3177
-10,10,30,699,681,1380,3097
80,10,-30,710,670,1380,2989
-60,30,40,692,689,1381,3133
0,80,10,713,668,1381,3257
130,-60,150,695,686,1381,3084
-170,-70,-160,702,679,1381,3095
100,50,160,697,685,1382,2874
-20,-70,10,697,685,1382,3213
-90,40,70,693,690,1383,3170
160,60,-160,678,705,1383,3124
-130,-30,-160,683,700,1383,3130
110,60,-100,711,672,1383,3149
170,80,-170,698,686,1384,3119
120,-80,140,701,683,1384,3106
110,70,-100,713,671,1384,3190
-100,-60,-80,705,679,1384,3107
80,10,-50,681,703,1384,2951
130,-70,150,714,670,1384,3026
120,0,-160,671,713,1384,3079
-10,60,20,709,675,1384,3214
-100,-10,20,705,680,1385,3039
-20,-80,-90,692,693,1385,3189
-10,20,30,707,678,1385,3141
70,40,-120,687,698,1385,3128
90,60,-70,706,679,1385,3177
-170,30,160,704,681,1385,3167
-90,10,-20,678,707,1385,2993
80,80,-160,674,711,1385,3186
-30,60,-50,678,708,1386,3080
50,-70,80,707,679,1386,3230
-120,-60,-110,702,684,1386,3078
-80,0,-80,701,685,1386,3027
0,50,20,704,683,1387,3191
120,-60,60,689,698,1387,3127
-140,-20,170,691,696,1387,3323
150,60,110,702,686,1388,2850
40,-70,70,699,689,1388,3238
130,-10,-180,683,706,1389,3013
130,-10,180,683,706,1389,3013
-90,10,60,699,691,1390,3086
0,-80,-70,688,702,1390,3236
20,-10,-60,695,695,1390,3166
-80,-10,10,687,703,1390,3192
-70,-60,-40,712,678,1390,3219
140,50,-140,666,725,1391,3105
-30,50,30,700,691,1391,3147
130,10,-160,672,719,1391,3155
80,20,170,680,711,1391,2756
-70,20,40,696,695,1391,3158
-100,-30,-50,712,679,1391,3045
80,0,-10,687,705,1392,3078
160,70,-160,695,697,1392,3142
140,0,100,708,684,1392,3046
140,20,-160,672,721,1393,3108
-130,10,130,689,705,1394,3255
-80,10,40,713,681,1394,3206
-120,0,130,691,703,1394,3141
90,60,180,682,712,1394,3082
-170,20,160,690,704,1394,3266
-70,-30,-10,706,688,1394,3200
-60,50,50,719,675,1394,3090
90,60,-180,682,712,1394,3082
10,-20,50,702,692,1394,3093
-180,30,170,703,692,1395,3198
180,30,170,703,692,1395,3198
10,30,-70,688,707,1395,3084
-160,0,80,710,685,1395,2959
80,40,-30,706,689,1395,2913
-40,-30,10,694,701,1395,3081
60,60,-30,703,692,1395,3027
20,-20,60,703,693,1396,3125
-10,-70,20,700,696,1396,3180
-30,30,30,726,670,1396,3164
90,70,-170,687,709,1396,3204
-90,0,-40,693,703,1396,2938
-70,-20,-120,707,689,1396,3268
30,30,30,710,686,1396,3113
-80,10,-50,707,689,1396,3098
-150,-10,160,701,695,1396,3411
-20,10,-70,692,704,1396,3324
20,-50,60,705,692,1397,3321
-60,-10,-100,716,681,1397,3093
-10,80,-70,719,679,1398,3186
30,-10,70,683,715,1398,3094
160,10,-180,686,712,1398,3111
160,10,180,686,712,1398,3111
100,10,-120,669,729,1398,3029
170,30,-180,703,695,1398,3192
170,30,180,703,695,1398,3192
-50,0,20,714,684,1398,3113
40,10,90,714,685,1399,2747
-100,-20,-50,708,691,1399,3041
140,-20,170,695,704,1399,3270
-10,80,20,728,672,1400,3326
90,80,-80,726,674,1400,3235
-30,40,30,695,705,1400,3075
100,-10,-140,697,703,1400,3013
70,30,30,676,724,1400,2843
-10,10,-70,699,701,1400,3195
-90,60,80,708,692,1400,3135
100,50,-80,720,681,1401,3188
40,20,70,698,703,1401,2959
140,30,-150,687,714,1401,3129
-50,40,40,712,690,1402,3139
-50,-20,10,701,701,1402,3217
90,-10,50,699,703,1402,2945
-80,-40,-150,705,697,1402,3218
-120,-20,120,690,712,1402,2939
170,50,90,682,721,1403,2778
110,70,160,689,714,1403,3019
-170,10,80,719,684,1403,3039
110,40,-100,695,708,1403,3205
-50,70,50,711,692,1403,3224
-10,70,20,722,682,1404,3345
-110,-40,-90,711,693,1404,3024
10,-50,50,701,703,1404,3218
110,-50,140,704,701,1405,3322
-90,60,0,697,708,1405,3044
-140,40,130,709,696,1405,3115
0,-50,40,711,694,1405,3200
100,-10,-170,716,689,1405,3208
30,70,-10,726,679,1405,3287
80,-10,-170,715,690,1405,2948
-30,-20,20,713,692,1405,3139
160,30,-170,692,713,1405,3144
60,-70,90,710,696,1406,3288
170,-80,100,706,700,1406,3093
130,40,-130,683,723,1406,3166
120,-30,160,696,711,1407,3204
90,-10,60,700,707,1407,3022
30,-50,70,705,702,1407,3242
90,-30,140,702,706,1408,3042
20,20,-70,704,705,1409,2977
-70,-40,-20,715,695,1410,3156
-140,-70,-130,714,696,1410,3264
100,80,-90,734,676,1410,3252
-150,-30,180,691,720,1411,3359
70,50,-130,698,713,1411,3105
-150,-30,-180,691,720,1411,3359
-180,-30,170,720,691,1411,3468
180,-30,170,720,691,1411,3468
20,0,50,719,692,1411,3001
170,20,-180,701,711,1412,3199
170,20,180,701,711,1412,3199
70,40,0,694,719,1413,2858
-130,30,120,684,729,1413,3300
-100,-70,-80,721,692,1413,3109
90,30,160,701,712,1413,2832
-110,60,100,703,711,1414,3157
70,70,-50,722,692,1414,3247
-100,60,90,701,713,1414,3145
-70,80,70,713,701,1414,3206
-20,30,-60,704,710,1414,3167
-80,-40,-30,732,682,1414,3139
70,-10,130,702,713,1415,3020
-80,30,-20,703,712,1415,3061
-160,-70,-150,713,702,1415,3217
100,0,-130,717,698,1415,3006
30,0,-60,710,705,1415,3171
-140,-30,-170,685,730,1415,3271
-40,20,30,726,689,1415,3177
-100,-80,-80,718,698,1416,3115
90,50,-60,714,702,1416,3110
-130,-50,-130,709,707,1416,3150
40,-30,-40,690,726,1416,3280
-30,-70,0,717,699,1416,3183
170,-10,170,725,693,1418,3256
-180,20,170,696,722,1418,3246
180,20,170,696,722,1418,3246
-110,10,100,686,732,1418,3165
170,0,170,721,697,1418,3357
80,10,-40,719,700,1419,3075
170,70,-170,713,706,1419,3296
-10,-50,30,715,704,1419,3234
-40,-50,0,721,698,1419,3203
150,30,-160,703,716,1419,3174
-20,-30,-90,717,702,1419,3146
110,10,120,714,705,1419,3032
60,30,50,702,718,1420,2959
140,-70,160,731,689,1420,3126
170,-40,170,724,697,1421,3340
60,-70,-10,722,700,1422,3119
40,-30,90,703,719,1422,3152
110,0,-130,716,706,1422,3199
-90,-10,20,718,704,1422,3347
-30,-50,10,713,709,1422,3267
80,-50,10,718,704,1422,3348
-140,-10,160,714,708,1422,3374
50,-30,-30,701,721,1422,3202
70,10,-60,722,700,1422,3217
-60,20,-50,718,705,1423,3268
100,-50,40,702,721,1423,2974
30,50,-90,716,707,1423,3235
-130,50,120,707,716,1423,3163
-60,-50,-20,721,702,1423,3254
120,10,-130,714,709,1423,3359
130,-80,150,725,698,1423,3219
-140,0,150,712,711,1423,3377
150,-20,170,703,720,1423,3361
-120,10,120,695,728,1423,3424
-130,-20,180,713,711,1424,3284
-180,80,-180,712,712,1424,3199
180,80,-180,712,712,1424,3199
-130,-20,-180,713,711,1424,3284
-180,80,180,712,712,1424,3199
180,80,180,712,712,1424,3199
80,0,-150,710,715,1425,2928
40,40,-90,707,718,1425,3196
-70,0,-90,701,724,1425,3086
-20,30,30,733,692,1425,3217
10,-80,-60,709,716,1425,3243
-140,10,140,700,725,1425,3386
80,30,180,717,709,1426,3049
80,30,-180,717,709,1426,3049
-100,-40,-60,727,700,1427,3122
60,-10,120,710,717,1427,2986
-110,-20,180,715,712,1427,3118
-110,-20,-180,715,712,1427,3118
-50,-50,-10,723,705,1428,3208
-120,-20,-170,709,719,1428,3195
-40,60,40,716,712,1428,3229
-110,-40,170,690,738,1428,3176
40,20,60,722,707,1429,3068
-160,0,160,716,714,1430,3287
0,-10,40,714,716,1430,3290
-70,-50,-30,725,706,1431,3256
120,60,140,733,698,1431,2885
-20,20,30,733,698,1431,3245
-60,-40,-10,703,729,1432,3207
150,50,-150,703,729,1432,3176
130,20,-140,705,727,1432,3327
-110,-10,30,720,712,1432,3056
80,20,40,726,706,1432,3051
0,50,-70,709,724,1433,3304
20,-80,-50,715,718,1433,3273
180,-50,180,730,704,1434,3321
-180,-50,-180,730,704,1434,3321
-180,-50,180,730,704,1434,3321
180,-50,-180,730,704,1434,3321
-90,-40,-40,726,708,1434,3136
60,-30,-20,698,736,1434,3346
-60,30,-40,725,709,1434,3136
-110,-30,170,707,728,1435,3147
40,60,-10,731,704,1435,3173
-40,20,-60,721,715,1436,3217
30,-80,-40,714,722,1436,3323
-130,-10,160,723,713,1436,3435
170,-60,-180,726,710,1436,3315
10,10,40,735,701,1436,3188
80,-10,150,709,727,1436,3143
170,-60,180,726,710,1436,3315
-100,-30,-40,731,705,1436,3133
60,30,60,722,715,1437,2912
-20,70,-60,725,713,1438,3294
-140,-50,-140,721,717,1438,3311
-20,-10,-80,720,719,1439,3242
-110,-10,50,726,714,1440,2907
-20,10,30,739,701,1440,3322
70,-70,100,728,712,1440,3378
70,60,-40,711,729,1440,3112
-100,0,80,698,742,1440,3204
-160,70,160,720,720,1440,3327
120,20,120,727,713,1440,2984
-40,-10,20,726,715,1441,3248
-40,-70,-10,730,711,1441,3228
-120,50,110,702,739,1441,3259
-70,50,60,741,700,1441,3252
-170,80,170,717,724,1441,3311
-70,-20,0,714,727,1441,3381
0,80,-80,736,705,1441,3241
120,60,-110,728,713,1441,3314
-150,-70,-140,723,718,1441,3322
-50,-40,-120,750,691,1441,3125
80,-10,170,703,738,1441,3096
80,50,-170,713,729,1442,3072
170,60,-170,710,732,1442,3330
-160,-40,110,707,735,1442,3021
-110,70,20,706,736,1442,3177
-110,-30,-120,731,712,1443,3071
100,30,-80,731,712,1443,3099
-120,-30,-140,728,716,1444,3099
120,-40,70,724,720,1444,3282
-180,70,180,718,727,1445,3306
-180,60,180,715,730,1445,3349
-180,70,-180,718,727,1445,3306
180,70,-180,718,727,1445,3306
110,-10,90,709,736,1445,3104
90,20,-110,740,705,1445,3028
180,60,180,715,730,1445,3349
110,80,-100,746,699,1445,3305
180,70,180,718,727,1445,3306
90,30,-50,697,748,1445,2954
-180,60,-180,715,730,1445,3349
180,60,-180,715,730,1445,3349
0,-80,30,743,703,1446,3418
20,70,0,746,700,1446,3427
-110,0,110,715,731,1446,3160
-80,20,-30,735,711,1446,3214
80,30,10,718,728,1446,3075
-120,-10,90,713,734,1447,2998
-120,-10,150,729,718,1447,3334
-170,-30,100,709,738,1447,2926
-170,70,170,720,727,1447,3399
-60,0,-90,716,731,1447,3301
20,30,30,739,708,1447,3401
-90,-40,-160,729,719,1448,3076
80,-10,160,698,750,1448,3189
-170,-40,180,726,723,1449,3399
-80,80,80,731,718,1449,3292
-170,-40,-180,726,723,1449,3399
70,30,-100,739,711,1450,3221
90,20,-50,718,732,1450,3096
40,20,80,734,716,1450,3006
70,60,-140,693,758,1451,3184
140,-40,160,726,725,1451,3339
110,-10,-160,713,738,1451,3350
-20,70,30,743,708,1451,3426
-10,30,30,742,709,1451,3265
-20,80,30,745,706,1451,3369
-110,-80,-90,732,720,1452,3216
160,-50,170,733,719,1452,3341
-140,-60,140,737,716,1453,3189
90,-50,130,713,740,1453,3326
80,10,-140,696,757,1453,3014
-130,40,120,722,731,1453,3346
-60,70,60,732,721,1453,3313
40,40,20,731,723,1454,3180
90,20,-60,712,742,1454,3047
-100,10,0,737,717,1454,3122
-80,-90,-150,729,726,1455,3263
80,-90,10,729,726,1455,3263
-110,-90,-180,729,726,1455,3263
-100,-90,-170,729,726,1455,3263
-70,-90,-140,729,726,1455,3263
-30,-90,-100,729,726,1455,3263
-10,-90,-80,729,726,1455,3263
-150,-90,140,729,726,1455,3263
0,-90,-70,729,726,1455,3263
-140,-90,150,729,726,1455,3263
-50,-90,-120,729,726,1455,3263
160,-90,90,729,726,1455,3263
-120,-90,170,729,726,1455,3263
40,-90,-30,729,726,1455,3263
-110,-90,180,729,726,1455,3263
110,-90,40,729,726,1455,3263
20,-90,-50,729,726,1455,3263
30,-90,-40,729,726,1455,3263
170,-90,100,729,726,1455,3263
70,-90,0,729,726,1455,3263
-130,-90,160,729,726,1455,3263
-160,-90,130,729,726,1455,3263
150,-90,80,729,726,1455,3263
-10,-80,20,736,719,1455,3357
10,-90,-60,729,726,1455,3263
-20,-90,-90,729,726,1455,3263
50,-40,100,734,721,1455,3267
60,-90,-10,729,726,1455,3263
140,-90,70,729,726,1455,3263
90,-90,20,729,726,1455,3263
180,-90,110,729,726,1455,3263
-60,-90,-130,729,726,1455,3263
120,-90,50,729,726,1455,3263
50,-90,-20,729,726,1455,3263
-180,-90,110,729,726,1455,3263
100,-90,30,729,726,1455,3263
-170,-90,120,729,726,1455,3263
-90,-90,-160,729,726,1455,3263
-40,-90,-110,729,726,1455,3263
130,-90,60,729,726,1455,3263
-30,20,30,747,709,1456,3274
90,-30,30,709,747,1456,3269
-160,80,160,731,725,1456,3341
-60,10,30,736,720,1456,3337
-20,40,30,749,708,1457,3236
-80,-60,-50,748,709,1457,3339
120,0,-140,725,732,1457,3294
-110,-30,-110,712,745,1457,3140
-110,-50,170,708,750,1458,3296
80,50,-40,734,724,1458,3109
110,30,-100,720,738,1458,3354
-90,0,50,734,724,1458,3293
110,-10,-150,715,744,1459,3475
-80,20,50,736,723,1459,3326
160,-80,90,736,723,1459,3213
100,-30,150,725,734,1459,3194
170,-30,170,733,726,1459,3520
30,0,70,720,739,1459,3250
-150,-20,170,728,731,1459,3514
70,80,-150,715,745,1460,3269
-30,-40,-100,738,722,1460,3128
140,-10,-180,718,742,1460,3321
140,-10,180,718,742,1460,3321
140,-80,160,745,715,1460,3278
-130,20,130,717,743,1460,3415
80,20,-130,719,742,1461,3154
-90,0,-50,722,739,1461,3015
120,0,-150,714,748,1462,3329
130,30,-130,718,744,1462,3251
120,20,-120,723,739,1462,3271
-20,-80,10,737,725,1462,3335
-20,50,30,744,719,1463,3301
120,70,-110,761,702,1463,3395
-110,-30,-100,734,729,1463,3210
80,20,-80,724,739,1463,3094
120,-20,170,721,743,1464,3279
-80,10,-60,735,729,1464,3202
90,40,-50,725,739,1464,3049
-130,0,50,737,728,1465,2874
-90,80,90,731,734,1465,3371
70,-70,0,749,716,1465,3252
110,-40,60,733,733,1466,3274
-120,-30,140,726,740,1466,3218
80,-10,-180,727,739,1466,3112
-80,-20,-130,737,729,1466,3261
70,-10,-20,718,748,1466,3323
-80,-50,-40,745,721,1466,3288
80,-10,180,727,739,1466,3112
160,60,100,748,720,1468,3113
50,0,110,732,736,1468,3022
50,20,90,725,743,1468,2959
150,-70,170,747,721,1468,3250
30,40,20,753,715,1468,3200
-140,20,140,729,740,1469,3471
60,0,-50,726,744,1470,3239
-150,-60,130,754,716,1470,3091
-70,50,-20,732,738,1470,3139
0,30,30,746,724,1470,3336
40,-80,-30,734,736,1470,3394
-20,-50,20,729,741,1470,3321
50,40,20,728,742,1470,3188
-150,10,150,739,732,1471,3483
-50,-40,0,728,743,1471,3347
80,-70,110,744,728,1472,3427
-50,-70,-20,755,717,1472,3289
-150,70,150,735,737,1472,3348
140,-50,160,735,737,1472,3400
-90,-10,-100,754,718,1472,3260
120,80,-110,758,714,1472,3343
60,0,120,726,746,1472,3134
-160,-20,170,743,729,1472,3504
-120,-10,160,750,722,1472,3427
-100,-10,10,743,730,1473,3287
50,30,40,756,717,1473,3275
170,20,90,746,727,1473,3113
-90,-20,-130,736,737,1473,3186
90,10,20,728,745,1473,3210
-30,-30,20,745,729,1474,3330
50,30,-90,747,727,1474,3345
-110,-10,70,730,744,1474,3200
110,10,-120,727,748,1475,3329
-120,0,140,743,732,1475,3485
-110,50,100,723,752,1475,3354
-110,20,100,700,775,1475,3251
80,70,-60,751,725,1476,3478
140,-60,160,732,744,1476,3221
-110,-10,130,731,745,1476,3272
50,30,60,748,728,1476,3173
70,0,-40,735,741,1476,3310
-60,-30,0,739,738,1477,3377
170,-20,170,743,734,1477,3492
-170,60,170,738,739,1477,3390
20,60,-90,751,726,1477,3426
180,-60,-170,752,726,1478,3409
-180,-60,-170,752,726,1478,3409
10,30,30,747,731,1478,3419
90,10,10,744,734,1478,3256
-30,0,-80,724,755,1479,3378
10,-80,40,755,724,1479,3420
70,20,-80,748,731,1479,3223
-150,80,150,742,738,1480,3366
100,-10,80,736,744,1480,3229
-30,-80,0,750,730,1480,3365
140,-20,90,712,769,1481,3183
110,-10,-140,720,761,1481,3310
10,80,-90,749,732,1481,3283
-40,-40,-110,768,713,1481,3125
40,50,-100,741,741,1482,3382
130,10,-150,719,763,1482,3476
140,40,-140,718,764,1482,3496
-100,-20,-40,741,741,1482,3227
-90,-10,30,748,735,1483,3413
-180,-10,170,758,725,1483,3493
-90,-20,-10,727,756,1483,3344
-110,-70,-90,756,727,1483,3316
-150,-50,-150,736,747,1483,3345
-140,-40,-150,738,745,1483,3315
180,-10,170,758,725,1483,3493
100,40,-70,747,736,1483,3245
80,20,50,770,714,1484,3083
130,80,-120,761,723,1484,3414
0,-10,-70,755,729,1484,3479
-110,-50,-90,743,741,1484,3321
0,0,-70,741,743,1484,3417
120,50,-110,750,735,1485,3377
-130,-60,150,745,740,1485,3398
-180,10,170,732,753,1485,3494
80,-60,10,757,728,1485,3348
180,10,170,732,753,1485,3494
100,-30,50,738,747,1485,3281
150,-80,170,758,727,1485,3316
-60,20,40,754,732,1486,3445
-170,-20,170,746,740,1486,3512
90,20,-70,731,755,1486,3128
140,0,-170,735,751,1486,3241
-80,50,70,772,714,1486,3354
60,-40,110,743,743,1486,3360
-100,-50,-70,758,728,1486,3406
-160,60,160,740,747,1487,3356
180,-20,170,750,737,1487,3497
-110,-10,120,734,753,1487,3229
-180,-20,170,750,737,1487,3497
-30,10,30,756,731,1487,3475
-20,40,-60,752,736,1488,3413
110,-60,140,733,755,1488,3389
-110,-30,-90,739,749,1488,3221
-170,-10,170,767,721,1488,3526
-90,30,70,740,749,1489,3441
-90,50,80,750,739,1489,3369
160,-20,170,734,755,1489,3478
0,10,-70,732,757,1489,3409
100,20,-100,736,753,1489,3254
-50,60,50,763,726,1489,3343
60,20,-80,743,746,1489,3255
40,-40,90,745,745,1490,3393
-20,50,-60,732,758,1490,3504
50,-10,-50,736,754,1490,3334
-20,60,30,754,736,1490,3429
-130,0,150,752,738,1490,3506
-120,-80,-100,749,741,1490,3368
50,-10,110,740,751,1491,3269
0,40,-70,751,740,1491,3401
150,-30,170,739,752,1491,3520
10,50,20,777,714,1491,3338
-100,80,100,741,751,1492,3422
150,-80,80,741,751,1492,3337
-170,-50,-170,746,746,1492,3493
-100,50,90,729,763,1492,3401
160,-30,170,748,745,1493,3543
-130,-60,-120,761,732,1493,3324
160,50,-160,726,767,1493,3377
-120,80,120,737,756,1493,3483
-140,80,140,747,746,1493,3398
30,60,0,762,732,1494,3352
90,-70,120,751,743,1494,3458
80,10,150,744,750,1494,3116
-60,-70,-30,765,729,1494,3370
-100,-20,-120,763,732,1495,3332
-110,-20,-170,744,751,1495,3272
-10,-20,-80,762,735,1497,3358
90,-20,150,740,757,1497,3428
-30,80,40,768,729,1497,3409
-110,80,110,740,757,1497,3440
-80,60,-10,747,750,1497,3330
-120,-10,80,734,763,1497,3173
-60,40,50,770,727,1497,3428
-50,10,30,758,739,1497,3480
50,-80,-20,746,752,1498,3397
100,-20,160,746,752,1498,3385
-140,-20,-180,752,746,1498,3537
-140,-20,180,752,746,1498,3537
-120,40,110,747,752,1499,3513
180,0,170,761,738,1499,3418
-160,-50,-160,742,757,1499,3495
-40,50,40,759,740,1499,3369
-120,-50,-110,759,740,1499,3312
-130,-10,80,755,744,1499,3072
-20,0,30,753,746,1499,3406
-180,0,170,761,738,1499,3418
-110,-60,-90,764,736,1500,3389
50,-40,-30,728,772,1500,3328
-130,-20,-170,746,754,1500,3430
160,-80,180,758,742,1500,3416
160,-80,-180,758,742,1500,3416
-180,-40,100,744,757,1501,3268
-90,20,70,736,765,1501,3409
-120,-40,-120,759,742,1501,3288
30,-30,-50,741,760,1501,3547
-20,-10,30,767,734,1501,3410
180,-40,100,744,757,1501,3268
100,60,-80,753,748,1501,3447
90,20,0,735,767,1502,3108
30,-60,70,769,733,1502,3565
20,-20,-60,756,746,1502,3480
-70,30,50,766,736,1502,3416
20,-10,60,755,747,1502,3333
-160,-40,-170,733,769,1502,3455
-130,80,130,753,750,1503,3426
-40,-80,-10,756,747,1503,3385
30,50,10,771,732,1503,3237
-160,-30,180,760,743,1503,3605
-160,-30,-180,760,743,1503,3605
30,-80,60,757,746,1503,3454
-100,0,0,740,764,1504,3296
80,10,70,761,743,1504,3220
-160,10,160,741,763,1504,3562
80,30,20,749,755,1504,3089
40,-60,80,763,742,1505,3561
10,-60,50,768,737,1505,3439
180,-10,90,756,749,1505,3155
-180,-10,90,756,749,1505,3155
-110,40,100,748,757,1505,3444
-80,-10,20,774,732,1506,3394
-140,-80,-120,759,747,1506,3500
-40,10,30,742,764,1506,3544
50,50,-110,747,759,1506,3447
150,10,-170,750,756,1506,3369
50,40,-100,757,749,1506,3446
80,-40,10,741,765,1506,3445
50,-60,90,740,767,1507,3570
-50,20,-60,764,743,1507,3527
160,-70,90,756,751,1507,3376
50,30,50,769,738,1507,3237
-50,30,40,763,745,1508,3382
20,40,-80,748,760,1508,3465
10,70,10,770,738,1508,3570
-130,-80,-110,761,748,1509,3437
0,0,40,762,747,1509,3471
10,20,-70,755,754,1509,3245
100,0,100,745,764,1509,3270
90,0,90,736,773,1509,3314
-40,-20,-100,748,761,1509,3373
90,50,170,765,745,1510,3224
110,40,-90,760,750,1510,3396
60,80,-140,734,777,1511,3404
110,-10,-170,748,763,1511,3423
-160,-80,-140,778,733,1511,3569
80,40,-20,757,754,1511,3312
-90,0,-60,766,746,1512,3279
80,-70,10,751,761,1512,3284
-100,-10,50,770,742,1512,3298
-30,70,40,770,742,1512,3494
160,-40,170,760,753,1513,3533
-70,-70,-40,776,737,1513,3444
110,-40,150,752,761,1513,3465
70,30,40,747,766,1513,3201
30,10,60,772,741,1513,3357
170,10,90,753,760,1513,3169
20,-80,50,763,751,1514,3451
-110,-20,170,741,773,1514,3202
-40,-60,0,772,743,1515,3568
80,70,-160,740,775,1515,3520
40,-40,-40,732,783,1515,3328
-50,30,-50,746,769,1515,3331
160,20,-170,756,759,1515,3314
80,-20,140,732,784,1516,3316
80,60,-160,751,765,1516,3464
20,-60,60,765,751,1516,3540
-160,-60,120,767,749,1516,3233
-100,-20,-130,741,775,1516,3193
-160,-60,-150,765,751,1516,3485
0,60,20,778,738,1516,3454
-120,30,110,740,776,1516,3462
-40,-40,10,768,749,1517,3333
-90,-50,-50,768,749,1517,3423
60,-40,-20,747,770,1517,3448
0,-60,40,761,756,1517,3482
0,30,-70,759,759,1518,3346
60,50,-120,770,748,1518,3381
110,0,100,757,761,1518,3280
40,-80,70,768,750,1518,3468
150,-30,90,747,771,1518,3223
-120,-60,160,762,757,1519,3415
-150,0,160,761,758,1519,3576
-170,-80,-150,783,736,1519,3559
-100,20,0,750,769,1519,3299
90,-10,-140,746,773,1519,3168
-90,-30,-20,775,745,1520,3498
100,-20,60,773,747,1520,3367
110,20,-100,762,758,1520,3317
90,-10,40,760,760,1520,3484
80,20,60,766,754,1520,3372
20,80,-100,764,757,1521,3439
-40,40,-50,756,765,1521,3455
-140,70,140,753,768,1521,3441
-80,-20,0,758,763,1521,3453
130,-40,160,748,773,1521,3568
130,70,-120,773,749,1522,3486
-150,60,150,749,773,1522,3326
-130,-10,170,759,763,1522,3640
-150,-80,-130,780,743,1523,3568
90,20,-40,763,760,1523,3283
-70,10,40,767,756,1523,3491
30,80,-110,760,763,1523,3511
-50,-80,-20,771,753,1524,3451
120,-50,150,757,767,1524,3598
120,40,-110,761,763,1524,3460
-100,-30,-170,749,775,1524,3303
100,-70,130,767,757,1524,3504
170,-80,-170,773,752,1525,3505
100,30,-70,772,753,1525,3159
-80,0,-90,766,760,1526,3273
80,60,-50,753,773,1526,3336
170,50,-170,736,790,1526,3508
160,-50,90,762,764,1526,3332
60,10,110,747,779,1526,3261
90,10,0,762,764,1526,3338
-100,-40,-50,780,746,1526,3363
-180,-40,-180,782,745,1527,3556
130,60,-120,780,747,1527,3474
-110,0,120,743,784,1527,3404
180,-40,-180,782,745,1527,3556
90,0,20,759,768,1527,3406
-180,-40,180,782,745,1527,3556
-90,30,-10,766,761,1527,3393
-80,30,60,765,762,1527,3487
180,-40,180,782,745,1527,3556
-100,40,90,770,758,1528,3487
80,20,160,750,779,1529,3131
-50,-10,20,772,757,1529,3471
80,-20,0,740,789,1529,3458
60,40,-110,752,777,1529,3376
-110,-10,60,770,760,1530,3204
-130,-30,120,750,780,1530,3217
40,80,-120,757,774,1531,3489
70,-40,120,768,763,1531,3398
70,20,-90,782,749,1531,3289
-120,-10,170,786,745,1531,3523
-120,-40,150,780,751,1531,3382
60,-80,-10,760,771,1531,3445
-120,10,130,759,773,1532,3534
50,-80,80,773,759,1532,3562
-170,-60,-160,786,746,1532,3460
-140,0,160,770,763,1533,3678
160,-60,90,764,769,1533,3284
-120,0,30,782,751,1533,3109
-120,20,120,749,784,1533,3672
-150,-40,-160,754,780,1534,3467
160,-70,-180,784,750,1534,3321
90,70,-70,775,759,1534,3687
160,-70,180,784,750,1534,3321
60,-10,-40,764,770,1534,3414
70,-30,-10,757,777,1534,3385
140,-30,170,754,781,1535,3585
20,20,40,784,751,1535,3460
140,-80,70,767,768,1535,3456
-110,-40,-80,764,771,1535,3344
70,20,80,782,753,1535,3236
40,0,100,771,764,1535,3197
-130,10,140,760,776,1536,3604
10,10,-70,772,764,1536,3520
-20,-20,30,774,762,1536,3517
180,-80,-160,790,746,1536,3563
90,-10,30,781,755,1536,3502
-180,-80,-160,790,746,1536,3563
90,20,10,779,757,1536,3286
110,60,150,774,762,1536,3073
70,-60,110,769,768,1537,3504
-150,20,150,765,772,1537,3590
90,-10,20,754,784,1538,3571
-120,-20,-160,774,764,1538,3428
150,-10,180,752,787,1539,3622
60,-60,100,764,775,1539,3544
150,-10,-180,752,787,1539,3622
140,80,-130,793,747,1540,3448
-140,-60,-130,784,756,1540,3596
-100,10,90,766,775,1541,3457
-90,10,-30,743,799,1542,3359
90,10,130,775,767,1542,3491
-150,-10,170,790,752,1542,3694
-40,40,40,787,756,1543,3482
-70,70,70,778,765,1543,3424
80,20,-120,749,794,1543,3232
70,-20,130,756,787,1543,3371
-60,50,-30,773,770,1543,3379
20,10,-70,769,774,1543,3562
50,20,-80,752,792,1544,3295
-120,-70,-100,787,758,1545,3511
-20,60,-60,783,762,1545,3486
60,-20,120,765,780,1545,3330
-140,-10,80,772,773,1545,3244
150,-60,170,765,780,1545,3438
-110,-10,80,765,780,1545,3311
50,80,-130,761,785,1546,3506
-100,-30,-30,780,766,1546,3422
-70,0,30,778,768,1546,3528
-140,-10,170,785,761,1546,3755
100,70,170,777,769,1546,3309
-30,-60,10,775,771,1546,3584
-80,-10,-110,785,761,1546,3368
110,50,-90,783,764,1547,3516
-50,-60,-10,777,770,1547,3615
170,-50,-180,790,758,1548,3536
170,-50,180,790,758,1548,3536
-120,0,150,773,775,1548,3763
-110,-30,-80,779,769,1548,3282
90,-20,30,771,777,1548,3429
10,-10,50,780,769,1549,3381
-130,70,130,771,778,1549,3527
-40,-20,20,790,759,1549,3302
60,50,-10,787,762,1549,3292
-20,-60,20,771,778,1549,3554
160,0,180,764,785,1549,3676
160,0,-180,764,785,1549,3676
30,30,-80,761,788,1549,3408
130,0,-160,747,803,1550,3526
-100,-20,-30,786,765,1551,3439
90,20,-10,775,776,1551,3306
-30,30,-60,762,789,1551,3565
-90,-60,-60,801,750,1551,3535
130,-30,80,757,795,1552,3473
150,20,100,757,795,1552,3276
-160,-10,170,783,769,1552,3695
-80,-40,-20,787,765,1552,3640
-60,-80,-30,785,767,1552,3536
-80,-30,-10,793,760,1553,3489
70,-10,170,777,776,1553,3228
-110,-10,110,759,794,1553,3457
0,20,-70,778,776,1554,3526
-100,70,10,770,784,1554,3533
60,-80,90,784,770,1554,3613
-140,60,140,764,790,1554,3448
-70,40,60,809,745,1554,3623
90,0,80,779,776,1555,3414
80,-10,-150,776,779,1555,3236
70,10,110,747,809,1556,3410
130,10,-140,780,777,1557,3518
90,20,-80,792,765,1557,3353
-150,-30,-170,754,803,1557,3646
-20,-30,30,781,776,1557,3643
-110,30,100,765,793,1558,3512
-10,-60,30,785,773,1558,3568
30,-40,-50,764,794,1558,3299
90,30,-40,767,791,1558,3300
-40,80,50,792,766,1558,3503
170,-10,90,775,784,1559,3136
-30,0,30,798,761,1559,3630
-10,70,-70,776,783,1559,3584
90,0,30,781,778,1559,3447
80,20,-90,788,772,1560,3322
-120,70,120,785,775,1560,3562
70,-80,0,781,780,1561,3550
90,20,20,802,759,1561,3317
110,-30,160,771,790,1561,3488
-70,-40,-10,787,774,1561,3630
-140,-30,-160,776,786,1562,3578
80,-60,120,770,792,1562,3566
-80,-70,-50,798,764,1562,3522
60,20,90,781,781,1562,3271
130,-50,70,772,790,1562,3494
170,10,-180,780,782,1562,3615
170,10,180,780,782,1562,3615
90,0,10,759,803,1562,3521
-60,60,60,795,767,1562,3488
-50,-30,10,779,784,1563,3494
90,-20,-160,778,785,1563,3462
140,70,-130,801,762,1563,3521
-30,60,40,791,772,1563,3581
40,0,-60,775,789,1564,3597
-70,20,-50,794,770,1564,3505
120,-10,90,767,797,1564,3440
-130,-30,-150,792,773,1565,3374
-160,20,160,786,779,1565,3624
-100,30,90,760,805,1565,3583
130,-80,60,784,781,1565,3560
50,30,70,772,794,1566,3282
120,-10,-170,801,765,1566,3573
-60,-60,-20,779,787,1566,3606
-90,0,-70,786,780,1566,3553
-90,0,60,787,779,1566,3434
-60,-20,10,780,786,1566,3683
-30,-40,20,782,785,1567,3578
40,-10,100,790,778,1568,3388
-150,-60,-140,783,785,1568,3645
150,80,-140,809,759,1568,3619
-80,70,80,776,792,1568,3517
-10,40,30,802,767,1569,3511
-30,90,40,804,765,1569,3607
-170,90,-180,804,765,1569,3607
-90,90,100,804,765,1569,3607
-40,90,50,804,765,1569,3607
90,20,-30,767,802,1569,3373
10,90,0,804,765,1569,3607
60,90,-50,804,765,1569,3607
-10,90,20,804,765,1569,3607
-80,90,90,804,765,1569,3607
120,90,-110,804,765,1569,3607
80,90,-70,804,765,1569,3607
20,90,-10,804,765,1569,3607
-120,90,130,804,765,1569,3607
-140,90,150,804,765,1569,3607
-160,90,170,804,765,1569,3607
-60,90,70,804,765,1569,3607
-90,40,80,770,799,1569,3631
100,90,-90,804,765,1569,3607
-180,90,-170,804,765,1569,3607
-110,90,120,804,765,1569,3607
40,90,-30,804,765,1569,3607
0,90,10,804,765,1569,3607
70,-80,100,792,777,1569,3612
130,90,-120,804,765,1569,3607
180,90,-170,804,765,1569,3607
70,90,-60,804,765,1569,3607
170,90,-160,804,765,1569,3607
160,90,-150,804,765,1569,3607
20,-40,-60,765,804,1569,3431
-130,90,140,804,765,1569,3607
30,90,-20,804,765,1569,3607
-150,90,160,804,765,1569,3607
90,90,-80,804,765,1569,3607
-50,90,60,804,765,1569,3607
-20,90,30,804,765,1569,3607
150,90,-140,804,765,1569,3607
-170,90,180,804,765,1569,3607
140,90,-130,804,765,1569,3607
110,90,-100,804,765,1569,3607
50,90,-40,804,765,1569,3607
-110,-20,-160,765,804,1569,3474
-140,10,150,797,772,1569,3700
-100,90,110,804,765,1569,3607
-70,90,80,804,765,1569,3607
30,60,-100,800,769,1569,3550
-80,0,40,784,786,1570,3673
-70,-80,-40,793,777,1570,3582
-120,-10,70,790,780,1570,3303
110,-70,140,787,783,1570,3552
-80,10,50,793,778,1571,3549
-180,50,80,767,804,1571,3315
180,50,80,767,804,1571,3315
120,-60,150,762,809,1571,3608
-150,30,150,773,798,1571,3642
-110,-10,140,795,777,1572,3575
100,50,-70,797,775,1572,3492
150,-40,170,781,791,1572,3596
-160,30,160,788,784,1572,3675
-60,20,-60,808,764,1572,3604
40,-50,-40,771,801,1572,3579
-120,-30,-130,788,786,1574,3401
-160,80,70,772,803,1575,3594
-30,-30,-100,794,781,1575,3540
-60,-10,20,787,789,1576,3560
-170,0,170,798,778,1576,3657
70,30,-110,786,791,1577,3509
110,-20,170,768,809,1577,3706
-20,-40,30,797,780,1577,3674
150,-50,170,794,783,1577,3585
-90,70,90,775,803,1578,3591
-110,-10,90,778,800,1578,3328
60,40,20,787,791,1578,3506
100,10,120,800,778,1578,3417
70,50,-140,774,804,1578,3483
120,10,110,794,784,1578,3389
-90,-20,0,799,780,1579,3505
110,40,140,790,789,1579,3470
150,40,-150,763,816,1579,3661
-100,-10,-80,800,781,1581,3459
-180,30,80,792,789,1581,3225
180,30,80,792,789,1581,3225
80,-80,10,794,788,1582,3563
-110,70,110,790,793,1583,3558
130,20,-130,774,809,1583,3577
90,-20,20,784,800,1584,3632
130,50,-120,806,778,1584,3609
-90,0,-80,798,786,1584,3479
120,30,-110,781,803,1584,3534
-50,50,50,805,780,1585,3538
20,60,10,820,765,1585,3564
90,50,-50,802,783,1585,3452
-100,70,100,784,801,1585,3622
90,-60,130,779,806,1585,3602
-60,10,-80,776,809,1585,3447
-110,-30,-70,792,794,1586,3397
80,-40,130,791,795,1586,3595
-90,10,-40,811,775,1586,3469
-80,40,70,795,791,1586,3684
40,10,-70,785,801,1586,3395
-50,10,-80,775,812,1587,3325
-160,50,160,788,799,1587,3482
-70,-10,-110,809,778,1587,3491
-140,80,50,777,810,1587,3459
-130,-70,-110,793,795,1588,3660
110,-50,50,781,807,1588,3529
80,-80,110,799,789,1588,3656
70,40,-130,776,812,1588,3543
90,-70,20,788,801,1589,3527
30,-30,80,811,778,1589,3532
90,10,30,788,801,1589,3476
140,30,-140,790,799,1589,3648
0,70,20,811,778,1589,3674
-90,-40,-30,805,784,1589,3611
110,40,-80,816,773,1589,3432
80,40,-10,772,818,1590,3405
140,10,100,797,793,1590,3359
-90,70,0,800,790,1590,3627
-150,80,60,784,807,1591,3527
30,-20,80,801,790,1591,3675
-140,30,140,777,814,1591,3627
60,30,-100,804,787,1591,3608
90,0,40,796,795,1591,3649
-110,80,20,773,818,1591,3577
70,40,10,780,811,1591,3394
90,-80,120,801,791,1592,3665
-130,-40,-130,800,792,1592,3647
-160,40,160,809,783,1592,3680
-150,-20,180,808,784,1592,3863
100,-40,40,789,803,1592,3577
-150,-20,-180,808,784,1592,3863
130,-30,170,782,811,1593,3634
60,-20,-30,792,801,1593,3731
-170,-30,-180,815,778,1593,3767
-170,-30,180,815,778,1593,3767
-100,0,90,782,811,1593,3575
-170,80,80,788,805,1593,3732
180,50,-180,774,820,1594,3546
180,50,180,774,820,1594,3546
70,10,-70,804,790,1594,3403
-170,50,170,786,808,1594,3476
140,-40,80,776,818,1594,3481
-100,-10,60,793,801,1594,3511
50,-50,-30,771,823,1594,3537
-180,50,-180,774,820,1594,3546
-180,50,180,774,820,1594,3546
60,30,70,795,799,1594,3346
100,-50,140,800,795,1595,3707
30,-40,80,810,785,1595,3455
-130,30,130,775,820,1595,3591
140,30,110,805,790,1595,3460
90,-20,-170,822,773,1595,3603
80,-10,-10,809,786,1595,3719
-90,-10,40,799,796,1595,3578
-110,0,130,783,812,1595,3824
180,40,80,780,816,1596,3252
80,10,-60,782,814,1596,3457
-110,-60,170,796,800,1596,3557
-70,-50,-20,805,791,1596,3674
80,10,110,773,823,1596,3472
-180,40,80,780,816,1596,3252
-120,-60,-100,806,790,1596,3649
20,-30,-60,801,795,1596,3665
-40,70,50,811,786,1597,3627
50,-50,100,797,800,1597,3543
-140,10,50,828,769,1597,3234
170,-70,-170,824,774,1598,3458
-10,-40,40,797,801,1598,3675
80,0,-20,772,826,1598,3532
-50,0,-90,812,786,1598,3714
-70,-60,-30,801,797,1598,3643
30,-10,-60,814,784,1598,3481
140,10,-160,769,829,1598,3664
-130,0,160,796,803,1599,3773
90,-60,20,808,791,1599,3597
-110,10,110,781,818,1599,3569
-80,20,60,796,803,1599,3798
-80,-80,-50,808,792,1600,3715
150,-70,80,807,793,1600,3637
120,-80,50,800,800,1600,3652
30,10,-70,796,804,1600,3536
-120,80,30,782,818,1600,3523
-150,40,150,784,816,1600,3633
100,60,160,792,808,1600,3302
80,-20,180,802,799,1601,3315
-90,10,70,793,808,1601,3477
-100,20,90,784,817,1601,3625
-70,60,-20,807,794,1601,3554
80,-20,-180,802,799,1601,3315
-100,-10,0,804,798,1602,3493
-90,-10,-110,798,804,1602,3428
-10,-30,40,812,791,1603,3689
120,40,130,803,800,1603,3507
130,20,110,804,800,1604,3436
0,40,30,823,781,1604,3542
120,-10,-160,796,808,1604,3737
90,0,60,804,800,1604,3538
80,10,80,826,779,1605,3562
-170,30,170,816,789,1605,3736
-80,-50,-30,802,803,1605,3677
-130,80,40,779,826,1605,3471
70,30,-150,798,807,1605,3449
-130,60,130,785,821,1606,3508
80,10,90,806,800,1606,3519
170,0,90,796,811,1607,3483
0,10,40,816,791,1607,3586
50,50,0,830,777,1607,3510
100,-20,-150,790,818,1608,3611
-170,20,170,810,798,1608,3694
-60,0,30,805,803,1608,3706
160,-10,-180,815,793,1608,3710
160,-10,180,815,793,1608,3710
180,80,90,791,817,1608,3724
70,40,-150,805,803,1608,3493
100,70,-80,811,797,1608,3897
-180,80,90,791,817,1608,3724
-50,80,60,816,793,1609,3634
90,20,140,805,804,1609,3466
-180,-50,-170,803,806,1609,3702
180,-50,-170,803,806,1609,3702
160,80,-150,823,786,1609,3691
100,-80,30,807,803,1610,3663
110,30,-90,799,811,1610,3643
-80,20,-40,802,808,1610,3482
-110,-20,160,802,809,1611,3537
70,-40,-10,780,831,1611,3645
90,-80,20,807,804,1611,3649
120,-70,150,800,811,1611,3581
120,0,100,795,816,1611,3562
-150,10,160,811,801,1612,3832
100,-10,70,809,803,1612,3523
80,40,180,817,795,1612,3338
-100,-50,-60,820,792,1612,3627
-100,-60,-70,836,776,1612,3664
80,40,-180,817,795,1612,3338
-110,-10,100,785,828,1613,3390
110,60,-90,820,793,1613,3792
150,20,-160,793,821,1614,3706
-100,-10,-70,795,819,1614,3457
70,0,130,788,826,1614,3444
110,-80,40,817,798,1615,3680
-70,-20,-130,797,818,1615,3523
30,-10,80,813,803,1616,3626
120,-20,80,797,819,1616,3587
90,20,-20,806,810,1616,3385
0,-40,50,820,796,1616,3689
-50,-50,0,804,814,1618,3702
90,-50,20,815,803,1618,3667
-100,-10,-90,807,811,1618,3535
100,-80,130,819,800,1619,3724
-100,30,0,798,822,1620,3534
-110,-50,-80,829,791,1620,3702
-10,50,30,828,792,1620,3652
90,-20,-150,808,812,1620,3408
-100,-10,-40,810,810,1620,3468
-150,50,150,803,818,1621,3512
10,50,-80,835,786,1621,3707
-90,-70,-60,821,800,1621,3610
-110,-20,-150,815,807,1622,3640
-70,-10,20,808,814,1622,3665
-90,30,80,799,823,1622,3765
-40,30,40,826,796,1622,3759
10,0,-70,810,812,1622,3905
30,-50,-50,803,819,1622,3619
-100,-40,180,815,808,1623,3515
-60,10,40,804,819,1623,3669
-100,-40,-180,815,808,1623,3515
140,20,-150,794,830,1624,3642
170,80,100,795,829,1624,3694
-120,-40,-110,804,820,1624,3627
160,40,-160,799,825,1624,3747
-10,30,-70,811,813,1624,3719
90,0,50,808,817,1625,3552
0,-70,40,818,807,1625,3722
-170,10,170,797,828,1625,3891
-40,0,30,811,814,1625,3729
60,10,-70,816,809,1625,3700
-100,0,-10,815,810,1625,3467
-60,-50,-10,805,820,1625,3669
-70,-20,10,826,800,1626,3824
-120,-10,60,830,796,1626,3332
40,-50,90,804,822,1626,3791
-140,-30,110,804,822,1626,3566
170,60,90,819,808,1627,3334
70,50,-20,820,807,1627,3413
-150,0,70,807,820,1627,3481
90,20,-100,792,835,1627,3478
90,60,-60,806,822,1628,3659
-120,60,120,801,827,1628,3638
120,20,-110,817,812,1629,3560
-10,20,-70,819,810,1629,3762
150,70,-140,838,791,1629,3721
-50,0,30,815,814,1629,3871
-110,-30,160,826,804,1630,3639
130,0,-150,808,822,1630,3806
160,-60,180,818,812,1630,3651
160,-60,-180,818,812,1630,3651
80,30,30,806,824,1630,3453
30,10,70,808,822,1630,3578
90,0,-130,807,824,1631,3490
-90,20,-20,818,813,1631,3507
170,0,-180,797,834,1631,3937
-130,-20,-160,811,820,1631,3611
130,0,100,818,813,1631,3548
100,40,150,829,802,1631,3557
20,-70,60,841,790,1631,3738
160,80,110,794,837,1631,3777
170,0,180,797,834,1631,3937
40,20,90,820,811,1631,3263
-80,70,-10,832,799,1631,3661
-70,60,70,823,809,1632,3698
70,0,170,810,822,1632,3438
10,-70,50,831,802,1633,3750
-110,-10,170,829,804,1633,3722
50,-20,110,817,816,1633,3597
-10,60,30,835,798,1633,3734
-140,-20,-170,809,824,1633,3782
-50,20,40,820,814,1634,3816
-10,-70,30,816,818,1634,3774
170,-40,-180,818,816,1634,3826
170,-40,180,818,816,1634,3826
-170,-40,-170,809,825,1634,3787
-60,-40,0,820,815,1635,3744
90,20,-90,817,818,1635,3619
130,40,120,825,810,1635,3534
-70,-30,0,829,807,1636,3797
-30,-10,-90,816,820,1636,3756
30,20,50,819,817,1636,3696
-100,-20,-140,805,831,1636,3649
-50,50,-40,823,813,1636,3650
40,60,-110,805,832,1637,3605
-140,-70,-120,832,805,1637,3711
-120,-50,-100,821,816,1637,3731
-90,-80,-60,825,813,1638,3802
60,60,-130,806,832,1638,3670
-120,-10,180,818,820,1638,3761
-120,-10,-180,818,820,1638,3761
-160,0,170,821,817,1638,3804
90,-20,-180,793,845,1638,3604
130,-10,90,787,851,1638,3549
90,-20,180,793,845,1638,3604
-110,-20,-140,811,827,1638,3781
-130,-10,-180,822,817,1639,3828
-100,-50,-180,816,823,1639,3600
180,-30,180,833,806,1639,3977
-170,40,170,816,823,1639,3685
70,30,-120,801,838,1639,3540
-130,-10,180,822,817,1639,3828
-40,-50,10,823,816,1639,3725
180,-30,-180,833,806,1639,3977
-180,-30,180,833,806,1639,3977
-100,-50,180,816,823,1639,3600
-180,-30,-180,833,806,1639,3977
170,40,-170,811,828,1639,3676
130,40,-120,828,812,1640,3722
-80,-60,-40,832,808,1640,3687
-70,20,50,824,816,1640,3792
70,80,-50,832,809,1641,3911
40,30,-90,826,815,1641,3576
60,20,-90,812,829,1641,3556
-140,-50,130,826,815,1641,3653
-110,10,10,816,825,1641,3730
100,20,130,811,830,1641,3590
50,0,-60,808,834,1642,3686
50,-20,-40,837,806,1643,3769
-100,-10,-30,794,849,1643,3662
60,80,-40,835,808,1643,3891
60,-50,110,831,812,1643,3528
-140,0,170,837,807,1644,3879
-60,50,60,847,797,1644,3737
90,10,-10,800,844,1644,3491
120,0,-130,822,822,1644,3663
-100,-10,-50,827,818,1645,3495
70,70,-150,804,841,1645,3715
160,-40,90,830,815,1645,3545
-130,10,150,826,819,1645,3841
150,-20,90,808,838,1646,3597
30,-70,70,844,802,1646,3777
20,-30,70,824,822,1646,3667
-140,50,140,821,826,1647,3649
70,30,60,819,828,1647,3420
-30,50,40,846,801,1647,3621
-60,80,70,838,809,1647,3737
-20,-70,20,825,823,1648,3855
-130,-50,-120,834,814,1648,3676
-180,30,180,837,811,1648,3818
150,80,120,808,840,1648,3790
-110,-30,-60,832,816,1648,3669
40,80,-20,847,801,1648,3868
180,30,-180,837,811,1648,3818
-180,30,-180,837,811,1648,3818
-140,40,140,807,841,1648,3717
180,30,180,837,811,1648,3818
-140,-10,180,825,824,1649,3935
50,10,-70,810,839,1649,3668
-140,-10,-180,825,824,1649,3935
-10,60,-70,836,813,1649,3838
-100,-10,-10,824,826,1650,3760
-30,20,-70,831,819,1650,3859
-70,-30,-140,851,799,1650,3651
-110,20,10,835,815,1650,3655
-80,-30,-150,834,816,1650,3781
-50,-10,-100,838,812,1650,3658
100,-60,140,824,827,1651,3772
-140,10,160,825,826,1651,3845
30,80,-10,849,802,1651,3868
-110,-10,20,823,829,1652,3629
-40,60,50,853,799,1652,3814
-120,0,160,831,821,1652,3938
-110,-40,-70,833,819,1652,3597
20,-50,-60,831,821,1652,3631
90,40,-40,824,828,1652,3492
80,10,140,828,824,1652,3616
110,-80,140,839,814,1653,3793
120,-40,160,813,840,1653,3755
-20,20,-70,829,824,1653,3741
80,60,-170,828,825,1653,3693
120,10,-120,822,831,1653,3761
180,40,180,816,838,1654,3763
-10,-20,40,827,827,1654,3864
-90,0,-90,828,826,1654,3757
-180,40,-180,816,838,1654,3763
-180,40,180,816,838,1654,3763
180,40,-180,816,838,1654,3763
-80,-10,30,824,830,1654,3742
50,80,-30,853,801,1654,3866
-180,-70,-160,850,805,1655,3700
-100,-80,-70,836,819,1655,3851
170,-10,-180,839,816,1655,3856
-80,10,-70,837,818,1655,3625
40,30,40,824,831,1655,3749
-40,-30,20,841,814,1655,3647
170,-10,180,839,816,1655,3856
180,-70,-160,850,805,1655,3700
20,-40,70,825,830,1655,3667
150,0,-170,812,844,1656,3648
140,-70,70,821,835,1656,3765
100,-20,50,823,834,1657,3739
170,80,-160,840,817,1657,3831
80,80,-60,842,815,1657,3906
150,-20,-180,839,818,1657,3862
-130,20,140,817,840,1657,3925
150,-20,180,839,818,1657,3862
40,-90,70,829,829,1658,3840
50,-90,80,829,829,1658,3840
130,-90,160,829,829,1658,3840
180,-90,-150,829,829,1658,3840
60,-90,90,829,829,1658,3840
-130,-90,-100,829,829,1658,3840
-50,-90,-20,829,829,1658,3840
-30,-90,0,829,829,1658,3840
-40,-90,-10,829,829,1658,3840
80,-90,110,829,829,1658,3840
-100,-90,-70,829,829,1658,3840
-160,-90,-130,829,829,1658,3840
10,-90,40,829,829,1658,3840
170,-90,-160,829,829,1658,3840
120,-90,150,829,829,1658,3840
-120,-90,-90,829,829,1658,3840
-110,-90,-80,829,829,1658,3840
-180,-90,-150,829,829,1658,3840
100,-90,130,829,829,1658,3840
150,-90,-180,829,829,1658,3840
20,-90,50,829,829,1658,3840
70,-90,100,829,829,1658,3840
-20,-90,10,829,829,1658,3840
-60,-90,-30,829,829,1658,3840
-170,-90,-140,829,829,1658,3840
150,-90,180,829,829,1658,3840
-10,-90,20,829,829,1658,3840
90,-90,120,829,829,1658,3840
-70,-90,-40,829,829,1658,3840
0,-90,30,829,829,1658,3840
-150,-90,-120,829,829,1658,3840
30,-90,60,829,829,1658,3840
-80,-90,-50,829,829,1658,3840
80,10,120,814,844,1658,3716
-140,-90,-110,829,829,1658,3840
-90,-90,-60,829,829,1658,3840
140,-90,170,829,829,1658,3840
110,-90,140,829,829,1658,3840
160,-90,-170,829,829,1658,3840
180,20,180,841,818,1659,3901
-180,20,180,841,818,1659,3901
-180,20,-180,841,818,1659,3901
160,0,90,839,820,1659,3448
40,-60,-40,826,833,1659,3628
180,20,-180,841,818,1659,3901
80,-20,-170,847,812,1659,3714
70,-10,-30,830,830,1660,3728
70,30,50,822,838,1660,3503
80,30,170,832,828,1660,3574
70,0,-50,828,832,1660,3628
30,-60,-50,832,828,1660,3623
-120,-20,110,815,846,1661,3616
70,40,-140,817,844,1661,3801
40,10,100,845,816,1661,3442
-110,60,110,819,843,1662,3822
-90,20,80,814,848,1662,3776
90,20,30,820,842,1662,3492
-30,-70,10,837,825,1662,3889
40,-70,80,850,813,1663,3828
-120,10,140,846,817,1663,3923
70,30,70,818,845,1663,3453
40,20,-80,827,836,1663,3702
80,-30,0,805,858,1663,3851
90,10,-120,801,863,1664,3638
100,-20,-160,817,847,1664,3717
0,-30,50,838,827,1665,3655
70,10,120,813,852,1665,3455
10,-40,60,826,839,1665,3613
100,-20,-170,825,840,1665,3710
-60,60,-30,852,813,1665,3763
90,70,180,829,836,1665,3692
40,-20,100,839,826,1665,3590
90,10,-50,828,837,1665,3616
90,70,-180,829,836,1665,3692
-50,20,-70,836,829,1665,3865
30,0,80,842,823,1665,3761
-100,-40,-40,851,814,1665,3728
-10,70,30,845,821,1666,3813
100,-20,170,801,865,1666,3918
-50,40,50,847,819,1666,3863
130,-50,160,832,834,1666,3872
70,-10,140,799,867,1666,3715
-100,-60,-180,833,834,1667,3548
80,-20,-160,847,820,1667,3529
40,30,70,846,821,1667,3619
-100,-60,180,833,834,1667,3548
120,40,-100,845,822,1667,3822
-20,-50,30,838,830,1668,3920
70,-20,-20,851,817,1668,3924
130,-70,160,830,838,1668,3789
110,-30,60,859,809,1668,3856
-60,-20,-120,846,822,1668,3727
-140,-40,-140,832,836,1668,3701
-70,-50,-150,854,815,1669,3727
30,40,-90,849,820,1669,3714
10,40,30,844,825,1669,3721
-30,-50,20,843,826,1669,3953
140,60,-130,837,832,1669,3764
-100,-20,-150,832,838,1670,3718
-130,50,130,818,852,1670,3824
-100,-20,-20,816,854,1670,3748
-120,20,130,814,856,1670,3775
-40,-70,0,842,828,1670,3953
-40,20,-70,845,825,1670,3896
120,-50,60,848,822,1670,3815
-60,30,50,837,833,1670,3874
60,-50,-20,813,858,1671,3759
90,30,-30,833,838,1671,3571
-140,20,150,842,830,1672,3931
-130,-20,100,814,858,1672,3616
90,-10,10,806,866,1672,3836
160,-20,-180,834,839,1673,3878
160,-20,180,834,839,1673,3878
-50,-70,-10,846,827,1673,3931
90,-40,140,840,833,1673,3936
-150,20,160,839,835,1674,4052
140,80,130,818,856,1674,3872
-110,-10,160,830,844,1674,3761
70,40,-160,832,842,1674,3564
170,-30,180,851,823,1674,3903
-100,80,10,812,862,1674,3787
110,30,-80,832,842,1674,3690
-90,-20,-140,824,850,1674,3796
170,-30,-180,851,823,1674,3903
90,-20,160,830,845,1675,3878
-120,20,20,859,816,1675,3513
80,10,-70,846,829,1675,3628
80,0,-140,832,843,1675,3541
-160,-30,100,838,837,1675,3364
20,80,0,863,812,1675,3878
0,70,-80,854,822,1676,3786
10,20,40,855,821,1676,3808
-170,-70,-150,863,813,1676,3867
100,-10,-130,843,834,1677,3636
180,-10,-180,855,822,1677,3822
-80,-20,10,850,827,1677,3793
-180,-10,180,855,822,1677,3822
110,70,-90,861,816,1677,4034
-180,-10,-180,855,822,1677,3822
180,-10,180,855,822,1677,3822
-110,0,140,833,844,1677,4011
120,30,-100,839,839,1678,3838
-30,-10,30,848,830,1678,3746
-160,-30,-170,832,846,1678,3935
-100,-70,-70,848,830,1678,3771
-80,30,70,839,839,1678,3901
90,0,0,837,842,1679,3785
-10,-50,40,865,814,1679,3957
-150,-70,-130,854,825,1679,3889
10,-50,-70,844,835,1679,3620
-90,-30,-160,835,845,1680,3659
-100,10,-10,825,855,1680,3688
-110,-80,-80,851,829,1680,3902
130,0,-140,832,848,1680,3931
70,-10,180,828,853,1681,3456
70,-10,-180,828,853,1681,3456
100,40,-60,840,841,1681,3665
110,-20,70,858,823,1681,3865
120,-80,150,855,826,1681,3854
60,-70,100,850,831,1681,3927
130,-10,-170,832,849,1681,3842
-80,60,80,840,841,1681,3889
-100,-20,-160,837,845,1682,3620
30,-50,80,851,832,1683,3947
130,30,-120,829,854,1683,3843
20,0,60,848,835,1683,3729
-150,0,170,853,831,1684,3985
70,-10,160,840,845,1685,3643
120,-10,-140,824,861,1685,3900
50,60,-120,838,847,1685,3800
100,-70,30,839,846,1685,3707
90,0,70,863,822,1685,3894
80,10,130,839,846,1685,3807
120,50,-100,862,823,1685,3944
-110,10,120,829,857,1686,3872
80,10,100,825,861,1686,3730
80,40,0,826,860,1686,3569
-160,-70,-140,870,816,1686,3920
-130,40,130,828,858,1686,3778
-160,-20,-180,855,833,1688,4100
-160,-20,180,855,833,1688,4100
-50,-20,-110,879,809,1688,3774
70,-50,120,839,849,1688,3768
-110,-70,170,839,849,1688,3678
-50,70,60,856,832,1688,3826
-120,-20,-150,849,839,1688,3867
40,-20,-50,871,818,1689,3896
-70,80,80,862,827,1689,3819
50,-70,90,861,828,1689,3876
90,30,-20,831,858,1689,3516
130,-60,160,829,860,1689,3779
-90,60,90,852,838,1690,3924
110,10,110,858,832,1690,3896
100,20,-90,854,836,1690,3711
-40,10,-80,845,845,1690,3649
-110,-20,-90,851,840,1691,3644
-140,0,60,843,848,1691,3514
-20,-20,-90,837,854,1691,3807
90,10,40,851,840,1691,3837
80,20,-100,847,844,1691,3742
-70,70,-20,847,844,1691,3798
-90,-30,-10,852,839,1691,3755
-90,-60,-170,835,857,1692,3588
-120,-30,130,826,866,1692,3618
-120,50,120,841,851,1692,3909
-100,-10,-20,834,858,1692,3760
-110,-10,150,859,833,1692,3878
130,80,140,832,860,1692,3962
140,20,-140,832,860,1692,3876
-180,80,-170,858,835,1693,3972
-120,-40,-100,838,855,1693,3712
-180,-50,100,850,843,1693,3636
180,-50,100,850,843,1693,3636
180,80,-170,858,835,1693,3972
70,60,-150,836,858,1694,3952
20,-60,-60,849,845,1694,3798
-90,-50,-40,853,841,1694,3815
160,10,-170,849,845,1694,3751
130,10,-130,853,841,1694,3868
-70,10,-80,820,874,1694,3691
-100,-10,70,850,845,1695,3729
-170,-10,180,845,850,1695,4052
-170,-10,-180,845,850,1695,4052
160,-10,90,846,850,1696,3541
-150,-10,180,861,835,1696,4131
10,80,10,878,818,1696,3870
-80,-10,-120,847,849,1696,3829
-150,-10,-180,861,835,1696,4131
-80,80,90,866,831,1697,3887
90,10,120,845,852,1697,3636
-90,-60,-50,854,843,1697,3880
110,30,130,853,844,1697,3680
-100,60,100,840,857,1697,3923
120,-10,-150,852,845,1697,3973
130,-80,160,866,832,1698,3884
20,10,50,862,836,1698,3744
70,50,-160,874,824,1698,3788
70,0,180,832,867,1699,3524
70,0,-180,832,867,1699,3524
70,30,-160,836,863,1699,3569
-80,10,60,860,839,1699,3751
110,-20,-160,843,857,1700,3816
-90,-20,10,861,840,1701,3917
-120,30,120,822,879,1701,3917
140,-20,-180,856,845,1701,3958
140,-20,180,856,845,1701,3958
130,-20,-180,852,849,1701,3829
-170,-60,110,854,847,1701,3826
10,-30,-70,837,864,1701,3861
100,30,-60,807,894,1701,3567
130,-20,180,852,849,1701,3829
50,70,-20,845,857,1702,3844
-50,-40,10,857,845,1702,3806
90,-30,20,830,872,1702,3915
0,-50,50,861,841,1702,3838
110,50,-80,854,848,1702,3778
170,30,-170,851,851,1702,3861
90,30,-10,832,870,1702,3677
-70,50,70,864,839,1703,3977
-90,0,70,858,845,1703,3754
-130,-50,140,876,827,1703,3937
50,10,110,858,845,1703,3509
-160,10,70,860,843,1703,3509
-120,-70,160,845,858,1703,3707
-170,-50,-160,847,856,1703,3835
-110,50,110,839,864,1703,3913
100,-60,30,838,866,1704,3840
120,30,120,851,854,1705,3671
-10,-10,40,869,836,1705,4004
20,50,20,876,829,1705,3702
90,80,-70,867,838,1705,3975
-110,-20,-100,855,851,1706,3713
0,-50,-80,836,870,1706,3674
40,70,-10,863,843,1706,3851
-30,40,-60,870,836,1706,3987
50,-60,-30,852,854,1706,3796
10,-40,-70,839,867,1706,3773
-50,60,60,877,829,1706,4012
170,-60,-170,871,836,1707,3837
-110,0,150,854,853,1707,3928
70,-70,110,858,849,1707,3901
80,0,-30,846,861,1707,3789
-10,0,40,855,854,1709,3932
100,30,140,848,861,1709,3664
50,20,-90,864,845,1709,3690
70,30,-140,850,859,1709,3793
100,-30,40,830,879,1709,3858
60,70,-30,845,865,1710,3943
10,-20,-70,874,836,1710,3925
-130,0,170,880,830,1710,3973
-110,-20,150,862,849,1711,3924
-170,-20,-180,866,845,1711,4131
90,10,-40,848,863,1711,3723
100,10,110,840,871,1711,3842
-60,-30,-130,858,853,1711,3748
-120,-80,-90,863,848,1711,3959
-170,-20,180,866,845,1711,4131
-80,0,50,861,850,1711,3817
-130,-40,130,841,870,1711,3559
70,0,160,833,878,1711,3583
60,0,-60,847,865,1712,3831
-70,-60,-150,867,845,1712,3859
170,-20,-180,876,836,1712,4018
170,-20,180,876,836,1712,4018
-70,30,60,870,842,1712,3956
120,-30,70,855,858,1713,3959
90,-20,170,828,885,1713,4086
10,-60,-70,852,861,1713,3937
-60,-70,-20,873,841,1714,4043
140,-40,170,861,853,1714,4161
120,80,150,848,866,1714,4086
-140,-40,120,859,855,1714,3629
-110,-60,-80,883,832,1715,3900
110,20,120,862,853,1715,3717
40,50,10,876,839,1715,3789
70,10,170,841,874,1715,3577
-110,-70,-80,864,851,1715,3890
-40,50,50,873,843,1716,3942
-30,40,40,882,834,1716,3829
180,-20,180,862,854,1716,4086
-130,10,160,874,842,1716,3992
-110,-10,180,862,854,1716,4048
-180,-20,180,862,854,1716,4086
-180,-20,-180,862,854,1716,4086
180,-20,-180,862,854,1716,4086
-110,-10,-180,862,854,1716,4048
-100,0,-20,852,864,1716,3740
-110,0,10,869,848,1717,3783
-80,-30,0,875,842,1717,3898
-150,-10,80,844,874,1718,3742
90,-40,20,855,863,1718,3954
-150,10,60,880,838,1718,3735
-120,30,20,863,855,1718,3759
80,20,-110,844,875,1719,3809
90,10,110,858,861,1719,3852
-40,30,-60,863,857,1720,3901
160,70,-150,870,850,1720,3944
-10,50,-70,863,857,1720,3968
120,20,-100,867,853,1720,3845
20,-50,70,862,858,1720,3938
160,-30,90,858,863,1721,3820
-170,80,-180,872,849,1721,4002
-170,0,80,864,857,1721,3607
100,50,-60,865,856,1721,3739
-170,80,180,872,849,1721,4002
-40,20,40,865,857,1722,3844
20,30,-80,846,876,1722,3856
50,30,80,865,857,1722,3642
-100,-10,80,865,858,1723,3614
80,20,150,860,864,1724,3576
-60,-60,-140,872,852,1724,3822
-90,80,100,872,852,1724,3915
80,10,-130,835,889,1724,3697
80,-20,150,836,888,1724,3964
-110,-20,140,866,858,1724,3893
40,-70,-40,865,859,1724,3967
130,-70,60,846,878,1724,3907
-110,20,110,839,885,1724,4044
-10,10,40,864,860,1724,3896
160,-20,90,853,872,1725,3687
100,60,-70,867,858,1725,3970
-160,-40,-160,859,866,1725,3973
-140,-70,140,878,847,1725,3822
140,-10,-170,851,874,1725,4020
100,-20,-180,847,879,1726,3897
-80,-60,-160,873,853,1726,3838
-110,-20,-130,859,867,1726,3814
100,-20,180,847,879,1726,3897
-110,-20,130,864,862,1726,3653
-140,-50,-130,874,853,1727,4017
100,20,-80,854,873,1727,3736
160,60,-150,852,875,1727,4044
140,50,-130,845,882,1727,3970
150,-10,90,860,867,1727,3778
50,40,30,872,856,1728,3867
-130,-70,150,868,860,1728,3713
150,30,-150,849,879,1728,3897
-160,-50,-150,858,871,1729,3928
100,0,90,822,907,1729,3853
80,20,70,883,847,1730,3610
70,10,-180,848,882,1730,3588
70,10,180,848,882,1730,3588
-90,50,90,864,866,1730,3903
-30,-20,30,863,867,1730,3903
60,40,-120,858,873,1731,3816
60,60,-20,856,875,1731,3777
70,50,-150,856,875,1731,3891
160,-30,-180,877,854,1731,3967
160,-30,180,877,854,1731,3967
-110,30,10,868,863,1731,3874
20,-20,70,864,868,1732,3928
160,-50,-180,870,862,1732,3862
120,-20,180,853,879,1732,4004
160,-50,180,870,862,1732,3862
120,-20,-180,853,879,1732,4004
70,70,-40,860,872,1732,4056
120,-30,170,868,864,1732,3862
30,-70,-50,868,865,1733,3911
10,-50,60,870,863,1733,3898
140,0,-160,843,890,1733,3872
140,-80,170,878,855,1733,3981
-100,80,110,880,853,1733,3979
110,10,-110,864,870,1734,3794
80,50,-180,870,864,1734,3690
70,30,-130,855,879,1734,3858
-110,-20,-80,869,865,1734,3716
-120,-10,-170,861,873,1734,3955
80,50,180,870,864,1734,3690
80,-70,120,874,860,1734,3978
30,30,40,887,847,1734,3977
80,-20,170,861,874,1735,3992
-100,-70,180,882,853,1735,3773
90,60,170,867,868,1735,3692
10,-30,60,878,857,1735,3883
-150,-20,90,856,879,1735,3731
-90,-40,-20,875,860,1735,3950
80,50,-30,875,860,1735,3764
-100,-70,-180,882,853,1735,3773
-180,0,-180,873,863,1736,4046
180,0,-180,873,863,1736,4046
-180,0,180,873,863,1736,4046
180,0,180,873,863,1736,4046
-80,50,80,868,868,1736,3969
120,60,-100,878,858,1736,4065
-160,-10,-180,870,867,1737,4174
-20,0,-80,871,866,1737,3966
50,60,-10,878,859,1737,3832
-100,50,100,859,878,1737,3945
-160,-10,180,870,867,1737,4174
100,80,-80,891,847,1738,4053
110,-50,150,878,860,1738,4062
-130,-60,-110,880,858,1738,3968
-150,-70,130,880,858,1738,3924
-60,-30,10,865,873,1738,4018
-70,0,40,856,882,1738,3975
-100,-10,-60,864,874,1738,3759
-70,-70,-30,877,862,1739,4056
-110,10,130,858,881,1739,4022
-110,-20,-70,888,852,1740,3792
0,50,30,893,847,1740,4012
20,0,-70,871,869,1740,4053
20,50,-90,879,861,1740,3985
-140,0,-180,872,869,1741,4128
-140,0,180,872,869,1741,4128
-20,60,40,895,846,1741,3884
-100,0,-30,861,881,1742,3759
-160,10,170,869,873,1742,4144
-80,0,-100,869,873,1742,3988
-130,-80,-100,878,864,1742,3974
10,-10,-70,868,874,1742,4026
-120,80,130,882,861,1743,4063
-120,10,150,885,858,1743,4121
40,30,60,857,886,1743,3894
150,60,-140,871,872,1743,3982
-60,-50,-140,874,870,1744,3712
10,60,20,883,861,1744,3941
120,70,-100,886,858,1744,4162
90,40,160,869,875,1744,3796
-90,80,0,852,892,1744,3994
-80,-50,-160,881,863,1744,3839
-150,-30,-160,854,890,1744,3948
140,-70,170,870,874,1744,3940
50,-30,110,873,872,1745,3887
110,-20,-180,847,899,1746,4053
20,-70,-60,887,859,1746,3903
110,-20,180,847,899,1746,4053
70,0,150,848,899,1747,3636
140,40,110,875,872,1747,3787
-80,-40,-10,868,879,1747,4025
-60,40,60,889,859,1748,4039
70,20,-150,855,893,1748,3722
140,40,-130,865,883,1748,4131
-150,-40,-150,860,888,1748,4026
-120,-70,-90,884,864,1748,4050
-90,-50,-170,869,880,1749,3917
-110,80,120,888,861,1749,4047
-60,70,70,885,864,1749,4044
0,80,20,900,849,1749,3902
100,-10,60,885,864,1749,3952
140,10,-150,869,880,1749,4140
-120,40,120,868,882,1750,4062
-150,-20,-170,875,875,1750,4071
140,-10,90,857,893,1750,3854
-110,0,160,884,866,1750,3974
-70,-50,-10,885,865,1750,4006
150,-80,180,895,856,1751,4038
-130,-10,-170,887,864,1751,4008
50,-70,-30,871,880,1751,4122
100,10,-110,867,884,1751,3792
-10,-80,30,885,866,1751,4130
20,40,30,886,865,1751,3949
150,-80,-180,895,856,1751,4038
110,-40,50,878,874,1752,3909
60,-10,130,853,899,1752,3858
-60,20,50,869,883,1752,4000
100,20,-70,861,891,1752,3746
60,-60,-20,879,873,1752,4071
-130,-10,70,879,873,1752,3685
-50,-60,-130,876,876,1752,3893
-120,-10,50,896,856,1752,3628
10,70,-90,887,866,1753,4013
40,40,30,883,870,1753,3888
-50,-20,20,887,866,1753,3974
10,-70,-70,893,860,1753,3918
160,-40,-180,875,878,1753,4090
160,-40,180,875,878,1753,4090
-70,10,50,876,878,1754,4019
30,70,0,893,861,1754,3906
-160,20,170,879,875,1754,4144
-140,-30,-150,881,873,1754,3839
40,30,50,863,891,1754,3907
110,0,-120,871,883,1754,3958
-100,-30,-20,876,879,1755,3808
-130,80,140,887,868,1755,4086
-20,-80,20,886,869,1755,4168
-90,10,-50,874,881,1755,3909
-70,20,-60,886,870,1756,3948
-100,-20,30,871,885,1756,4026
10,0,50,892,865,1757,3879
-100,-10,-100,891,866,1757,3813
-90,10,80,861,896,1757,3759
-70,30,-40,889,868,1757,3867
-40,50,-50,875,883,1758,4109
-40,0,-90,900,858,1758,4096
-140,-80,-110,872,886,1758,3990
-70,-40,0,880,878,1758,4063
-80,-20,-140,890,868,1758,4072
-130,-30,-140,866,893,1759,3825
-140,80,150,891,868,1759,4089
-30,-60,20,897,862,1759,4204
-100,-20,-170,875,885,1760,3991
160,30,-160,897,863,1760,3990
-10,-70,-90,893,867,1760,3968
180,60,80,886,875,1761,3626
0,-70,-80,893,868,1761,3920
90,10,50,880,881,1761,3932
40,-30,100,901,860,1761,3771
-180,60,80,886,875,1761,3626
20,-60,70,896,866,1762,4166
110,80,160,872,890,1762,4197
-150,-50,120,870,892,1762,3950
-160,80,170,889,873,1762,4082
-50,10,40,874,888,1762,3981
-10,-10,-80,867,895,1762,4027
180,-40,-170,896,867,1763,4096
-110,-20,-110,876,887,1763,3862
90,30,150,879,884,1763,3734
-180,-40,-170,896,867,1763,4096
-30,10,-80,860,904,1764,3905
-70,0,-100,908,856,1764,4042
-40,-60,10,891,873,1764,4151
-50,60,-40,899,865,1764,3965
130,20,-120,869,895,1764,4104
110,-20,-170,864,900,1764,4006
60,50,0,892,872,1764,3953
-100,10,100,856,909,1765,4074
-90,-10,50,879,886,1765,3942
-150,-50,-140,887,878,1765,3994
0,20,40,885,880,1765,3989
-150,80,160,884,881,1765,4075
0,-80,40,896,870,1766,4139
170,70,-160,889,877,1766,4154
180,20,80,896,870,1766,3902
-100,-30,-180,871,895,1766,3851
-100,-30,180,871,895,1766,3851
-180,20,80,896,870,1766,3902
-120,0,170,906,860,1766,4215
90,30,0,874,893,1767,3774
110,-10,-130,880,887,1767,3905
180,-60,-160,893,875,1768,3975
-180,-60,-160,893,875,1768,3975
100,-20,-140,873,895,1768,3824
-130,20,150,896,873,1769,4055
90,10,60,874,895,1769,3873
-80,-70,-40,888,881,1769,4093
30,40,30,886,884,1770,3966
0,-60,-80,891,879,1770,4130
-110,-40,-60,911,859,1770,3967
20,-80,60,914,856,1770,4057
-40,-80,0,902,868,1770,4231
-100,0,100,877,894,1771,4093
110,-70,40,885,886,1771,3928
-80,-10,-130,870,901,1771,3958
70,-10,150,861,910,1771,3814
70,20,-160,870,901,1771,3642
10,-80,50,910,861,1771,4163
0,-40,-80,879,892,1771,3838
40,-10,-60,885,886,1771,4053
70,60,-30,874,897,1771,3847
180,10,-180,876,896,1772,4176
-180,10,-180,876,896,1772,4176
90,-70,130,878,894,1772,4014
120,-70,50,869,903,1772,4044
90,-20,10,882,890,1772,4057
-180,10,180,876,896,1772,4176
180,10,180,876,896,1772,4176
70,0,-170,878,895,1773,3610
140,70,120,883,890,1773,4025
120,40,-90,890,883,1773,3971
10,-20,60,894,879,1773,3993
60,30,80,875,898,1773,3631
-80,20,70,871,902,1773,4027
160,-80,-170,903,871,1774,4091
110,-20,-150,878,896,1774,4010
110,20,-90,890,884,1774,4045
30,20,60,900,874,1774,3978
-30,30,40,901,873,1774,3992
-110,-30,-50,906,868,1774,3859
-180,-20,90,885,890,1775,3808
180,-20,90,885,890,1775,3808
150,50,-140,876,899,1775,4043
70,50,-10,903,872,1775,3942
-140,30,150,885,890,1775,4175
-80,-60,-30,901,875,1776,4079
-150,10,170,892,884,1776,4202
-100,-20,20,890,886,1776,4050
160,0,-170,885,891,1776,4095
-60,70,-30,895,881,1776,3909
-120,10,160,896,880,1776,4091
110,80,-90,922,855,1777,4165
-30,-80,10,907,870,1777,4205
-10,40,-70,904,873,1777,4123
80,-30,140,883,894,1777,3973
90,10,-60,868,910,1778,3781
-60,30,-50,891,887,1778,3976
30,-80,70,913,865,1778,4119
-60,-50,0,890,889,1779,4104
-20,70,40,905,875,1780,4009
0,-20,50,893,887,1780,4027
-110,-50,-70,899,881,1780,3974
-90,-10,-120,898,882,1780,3985
-100,40,100,882,899,1781,4184
-170,50,70,893,888,1781,3599
-170,-30,-170,879,902,1781,4133
-110,-10,-170,878,903,1781,4098
170,60,-160,877,904,1781,4138
60,10,-80,899,883,1782,3944
-10,-40,-90,900,882,1782,3874
-30,20,40,894,888,1782,4059
-120,10,20,864,918,1782,3897
60,-70,-20,892,891,1783,4259
-40,-40,20,903,881,1784,3962
110,40,-70,886,898,1784,3935
-170,-20,90,900,884,1784,3899
-130,30,140,870,914,1784,4136
80,70,-50,880,904,1784,4165
-70,-70,-150,910,874,1784,3920
-100,-60,-60,906,879,1785,4082
-50,-60,0,897,888,1785,4134
-70,70,80,907,878,1785,4205
-110,40,110,894,891,1785,4303
80,30,50,906,880,1786,3832
-130,0,180,914,872,1786,4193
50,20,100,879,907,1786,3712
-130,0,-180,914,872,1786,4193
-90,40,90,895,892,1787,4162
90,-30,150,875,912,1787,4024
-90,-70,-170,902,885,1787,4028
-150,-80,-120,892,895,1787,4075
100,0,-120,848,939,1787,3971
40,60,0,908,880,1788,3985
-110,-20,-120,895,893,1788,4038
150,-60,80,885,903,1788,4163
70,40,20,887,901,1788,3886
30,-60,80,900,888,1788,4275
100,-50,30,899,890,1789,4052
140,-60,170,889,900,1789,4064
90,10,-30,911,878,1789,4016
-10,-50,-90,884,906,1790,4057
70,20,-100,893,897,1790,4021
-60,-60,-10,894,896,1790,4169
-140,20,160,899,891,1790,4198
-10,-60,-90,916,874,1790,4140
-40,-10,30,912,879,1791,4082
60,-30,120,876,915,1791,4001
170,-80,-160,911,880,1791,4136
-50,-80,-10,905,886,1791,4199
-70,-40,-150,923,869,1792,3972
-50,-30,-120,909,883,1792,3855
-120,-50,-90,910,882,1792,4096
170,20,-170,899,893,1792,4007
-140,10,170,912,880,1792,4064
70,-20,-180,889,904,1793,3736
150,70,110,890,903,1793,3979
-180,70,-170,887,906,1793,4223
70,-20,180,889,904,1793,3736
-130,40,30,894,899,1793,3879
30,10,80,890,903,1793,3905
180,70,-170,887,906,1793,4223
150,10,-160,884,910,1794,4096
-70,-60,-20,908,886,1794,4133
-80,-50,-20,910,885,1795,4030
-110,30,110,872,924,1796,4285
-100,-20,-10,883,913,1796,3972
-160,-70,120,913,883,1796,3999
-170,70,-180,896,901,1797,4312
130,50,-110,919,878,1797,4306
130,40,-110,916,881,1797,4299
100,-40,150,873,924,1797,4165
-170,-80,-140,904,893,1797,4097
-170,70,180,896,901,1797,4312
180,-80,-150,912,886,1798,4091
90,30,10,886,912,1798,3818
70,0,140,883,915,1798,3839
-60,40,-40,889,909,1798,4103
-180,-80,-150,912,886,1798,4091
90,10,-20,902,896,1798,3883
-90,-20,-150,885,914,1799,3984
130,10,100,899,900,1799,3968
70,20,90,923,876,1799,3947
20,-10,70,901,898,1799,4057
-130,0,40,926,874,1800,3691
-170,60,180,875,925,1800,4276
-90,-40,-170,898,902,1800,4047
-170,60,-180,875,925,1800,4276
70,10,160,892,908,1800,3806
110,50,-70,893,907,1800,4022
-120,-10,40,922,878,1800,3741
-60,20,-70,900,901,1801,4087
-80,80,-10,886,915,1801,4075
-100,0,-40,899,902,1801,3770
-90,-20,20,898,903,1801,4157
-10,80,30,927,874,1801,3967
-20,-60,30,916,886,1802,4347
90,20,40,910,892,1802,3962
-20,30,-70,901,901,1802,4092
-80,-70,-160,920,882,1802,4065
130,-10,-160,893,909,1802,4122
50,-10,120,905,897,1802,3901
-30,-20,-100,926,877,1803,4015
150,-30,180,906,898,1804,4194
150,-30,-180,906,898,1804,4194
-140,-20,-160,893,911,1804,3982
-100,-50,-50,923,882,1805,4055
120,80,-100,930,875,1805,4233
80,30,40,900,905,1805,3927
110,60,-80,898,908,1806,4232
70,10,-170,893,913,1806,3859
-160,-80,-130,904,902,1806,4104
10,40,-80,916,890,1806,4126
-130,-70,-100,916,891,1807,4184
70,-60,-10,912,895,1807,4110
110,-10,80,875,932,1807,4075
130,-40,70,906,901,1807,4206
-160,-20,90,895,912,1807,3905
-70,40,70,899,909,1808,4112
130,70,130,903,905,1808,4146
-50,30,50,917,891,1808,4155
-130,30,30,899,910,1809,3858
-50,-70,-130,920,889,1809,4088
-60,-80,-20,907,902,1809,4180
-160,-10,80,895,914,1809,3943
-70,40,-30,931,878,1809,4000
100,-10,50,892,917,1809,4028
-170,40,70,897,912,1809,3933
-80,-10,40,904,905,1809,4101
-150,30,160,902,908,1810,4364
150,-70,180,908,902,1810,4095
-130,20,30,908,902,1810,3789
60,50,-130,889,921,1810,4085
150,-70,-180,908,902,1810,4095
70,-20,170,901,909,1810,3958
70,0,-60,887,924,1811,3989
40,-80,80,926,885,1811,4154
160,70,100,904,907,1811,3916
140,10,-140,912,899,1811,4078
-20,30,40,917,894,1811,4169
-90,-70,-50,908,904,1812,4148
-80,40,-20,922,890,1812,4064
30,20,-80,899,914,1813,4042
-120,20,140,905,908,1813,4182
30,0,90,899,914,1813,4014
-70,-10,-120,913,901,1814,4145
130,70,-110,923,891,1814,4316
-100,20,100,893,921,1814,4343
-180,60,-170,890,924,1814,4247
60,70,-140,867,947,1814,4096
180,60,-170,890,924,1814,4247
10,-60,60,919,895,1814,4061
-30,-30,30,937,877,1814,4133
160,50,-150,899,916,1815,4225
100,-20,40,898,917,1815,4334
-20,-60,-100,917,899,1816,4136
-120,-60,-90,914,902,1816,4177
100,-30,160,902,914,1816,4201
-160,70,170,910,906,1816,4242
100,80,170,895,922,1817,4350
70,10,-80,925,892,1817,4029
-160,30,170,898,919,1817,4271
90,70,-60,918,900,1818,4374
30,20,70,906,912,1818,4062
70,-30,130,897,921,1818,4145
-80,40,80,907,911,1818,4131
-150,0,180,917,902,1819,4378
80,0,-40,930,889,1819,4085
-150,0,-180,917,902,1819,4378
90,40,-30,904,915,1819,3899
20,70,-100,912,907,1819,4129
-80,20,-50,913,906,1819,4035
-20,10,40,936,883,1819,4042
60,40,30,908,912,1820,3976
-60,-70,-140,919,901,1820,4074
-30,-70,-110,918,902,1820,4198
-20,-70,-100,916,905,1821,4136
-160,60,170,888,933,1821,4195
-40,-30,-110,944,877,1821,3944
-40,-60,-120,914,907,1821,4044
-20,20,40,925,896,1821,4029
60,30,-110,910,911,1821,4115
50,30,-100,910,912,1822,4007
0,60,-80,920,902,1822,4161
-40,-70,-120,912,910,1822,4168
-100,-20,0,906,916,1822,4119
80,60,-40,912,910,1822,4023
140,30,-130,901,921,1822,4240
120,70,140,914,909,1823,4202
50,-60,100,904,919,1823,4263
80,70,-170,895,928,1823,4093
60,20,100,904,919,1823,3834
60,-10,-50,904,919,1823,4237
70,20,-140,907,917,1824,3976
-10,20,40,929,895,1824,4100
-60,60,70,917,907,1824,4232
160,10,90,911,914,1825,4109
-110,20,120,895,930,1825,4257
-110,-20,-60,922,903,1825,3883
0,-30,-80,905,920,1825,4128
-50,50,60,928,898,1826,4176
40,-60,90,918,908,1826,4370
170,-20,90,905,921,1826,4029
-140,40,40,935,891,1826,3834
-120,-30,-100,925,902,1827,4102
20,30,40,905,922,1827,4216
110,-60,150,910,917,1827,4027
-70,-80,-30,913,915,1828,4224
-90,-20,30,916,912,1828,4190
120,-20,-160,897,931,1828,4223
-120,-30,-120,913,915,1828,4115
-120,30,130,896,933,1829,4090
-70,-10,30,910,919,1829,4222
-90,0,-100,900,929,1829,4222
40,40,-100,915,914,1829,4117
-90,40,-10,912,918,1830,3987
70,-50,-10,905,925,1830,4253
-110,-40,160,921,909,1830,4103
70,20,-170,892,938,1830,3980
-100,-40,-30,925,906,1831,3996
-110,-20,120,910,921,1831,4089
-160,0,180,918,913,1831,4331
130,60,-110,921,910,1831,4365
-160,0,-180,918,913,1831,4331
-100,-20,40,904,927,1831,3963
60,-30,-30,897,935,1832,4191
-80,70,90,926,906,1832,4282
130,80,-110,937,895,1832,4307
-140,-60,-120,943,890,1833,4281
-100,0,110,912,921,1833,4080
-120,-40,-90,918,916,1834,3926
0,-60,50,917,917,1834,4163
50,-80,90,930,905,1835,4184
-50,-50,10,930,905,1835,4219
120,50,130,934,901,1835,3985
120,50,-90,939,896,1835,4208
-10,30,40,952,883,1835,4062
-90,20,-30,932,904,1836,4128
150,-10,-170,918,918,1836,4259
40,30,80,906,930,1836,3822
80,-40,0,907,929,1836,4258
-10,-60,40,930,907,1837,4236
50,0,120,915,922,1837,3944
30,-20,-60,931,906,1837,4383
170,-50,-170,912,925,1837,4151
-130,10,170,931,906,1837,4084
80,-50,130,919,918,1837,4075
-20,80,40,932,905,1837,4054
180,-30,-170,917,921,1838,4274
150,40,-140,900,938,1838,4210
-80,-20,20,931,907,1838,4224
-180,-30,-170,917,921,1838,4274
-160,-20,-170,915,924,1839,4435
-100,-10,90,919,920,1839,3895
-70,80,-20,908,932,1840,4165
-90,30,90,906,934,1840,4222
150,0,90,919,921,1840,3981
140,-50,170,909,931,1840,4243
-140,40,150,922,918,1840,4336
30,0,-70,933,907,1840,4228
70,-10,-170,938,902,1840,3809
-180,50,-170,895,946,1841,4275
70,-60,120,923,918,1841,4173
110,-60,40,923,918,1841,4053
-120,-50,150,921,920,1841,4392
180,50,-170,895,946,1841,4275
-140,70,150,915,926,1841,4270
-60,-10,-110,957,885,1842,4192
-170,-60,-150,934,909,1843,4232
-160,50,60,910,933,1843,3930
-100,-20,10,930,913,1843,4184
-90,10,-60,933,910,1843,4065
80,-10,-20,918,926,1844,4170
-140,-10,-170,927,917,1844,4308
70,-10,-40,919,925,1844,4134
80,-20,160,910,934,1844,4306
-170,0,-180,919,925,1844,4253
-170,0,180,919,925,1844,4253
-140,-20,90,918,927,1845,4124
-70,20,60,921,924,1845,4156
130,30,-110,926,920,1846,4207
70,60,-160,917,929,1846,4292
-90,0,80,902,944,1846,4121
90,60,-50,915,932,1847,4227
-50,30,-60,933,914,1847,4267
-60,-20,20,936,911,1847,4321
100,-70,140,912,935,1847,4158
50,-30,-40,905,943,1848,4311
-150,40,50,921,927,1848,4007
-30,10,40,949,899,1848,4244
-110,-30,150,933,915,1848,4090
-20,50,40,937,913,1850,4172
20,70,10,936,914,1850,4093
60,10,120,905,945,1850,3876
90,50,-40,933,917,1850,4074
-150,70,160,923,927,1850,4261
-30,-60,-110,936,915,1851,4083
-40,10,40,922,929,1851,4209
30,-10,90,928,924,1852,4161
-120,0,180,937,915,1852,4429
-90,-60,-40,938,914,1852,4178
-120,0,-180,937,915,1852,4429
170,10,-170,921,931,1852,4283
-150,60,160,909,943,1852,4148
70,50,0,942,910,1852,4128
120,30,-90,941,912,1853,4092
50,50,10,939,914,1853,4259
-90,70,100,943,911,1854,4280
30,10,90,913,941,1854,3938
-80,-80,-40,926,928,1854,4303
-170,-40,100,913,942,1855,4001
150,-50,80,925,930,1855,4198
-20,40,40,961,895,1856,4298
90,10,100,904,952,1856,4052
-80,10,-80,918,938,1856,4087
-170,60,70,938,918,1856,4072
-30,-40,30,936,920,1856,4249
-120,40,20,921,936,1857,4051
170,50,-160,901,956,1857,4308
-50,-10,30,942,915,1857,4268
90,30,20,922,936,1858,3913
60,-80,100,943,915,1858,4271
-120,-40,140,929,929,1858,4110
70,-70,-10,936,923,1859,4362
-50,-50,-130,933,926,1859,3989
-140,30,40,954,906,1860,3934
110,50,140,939,921,1860,4111
-160,-30,-160,933,927,1860,4357
70,-20,140,910,950,1860,4274
-130,20,160,941,919,1860,4354
-100,-70,-60,937,923,1860,4253
-130,40,140,917,943,1860,4371
70,-80,110,942,919,1861,4261
-150,40,160,921,941,1862,4356
130,50,120,947,916,1863,4095
-60,-40,10,939,924,1863,4302
120,-40,60,942,921,1863,4199
60,-60,110,926,938,1864,4135
-160,-60,-140,960,904,1864,4237
-100,-10,-110,950,914,1864,4092
80,-20,-10,931,934,1865,4257
-100,30,100,904,961,1865,4354
-80,30,-30,939,926,1865,4194
-50,70,-40,943,922,1865,4214
-80,30,80,931,934,1865,4396
110,-20,60,939,927,1866,4225
-170,50,180,921,945,1866,4261
-170,50,-180,921,945,1866,4261
120,0,-120,957,909,1866,4275
140,20,100,934,932,1866,4123
20,-80,-60,938,929,1867,4314
170,70,90,939,928,1867,4151
-30,80,50,943,924,1867,4159
-150,20,170,939,929,1868,4336
100,-40,30,936,932,1868,4328
-150,50,50,938,930,1868,4128
-130,-50,-110,937,931,1868,4218
-40,60,-50,948,921,1869,4222
60,40,50,938,931,1869,4049
-170,30,-180,935,934,1869,4321
-70,-20,20,945,924,1869,4388
120,10,-110,939,930,1869,4075
-170,30,180,935,934,1869,4321
-50,-30,20,937,933,1870,4195
130,-40,170,938,932,1870,4238
90,10,-110,926,944,1870,4198
-170,-20,-170,933,937,1870,4482
110,0,90,913,957,1870,4192
-140,-70,-110,946,925,1871,4300
-110,-40,-50,950,921,1871,4209
-60,0,40,935,936,1871,4188
-90,-80,-50,930,941,1871,4341
110,10,-100,928,943,1871,4108
-170,20,-180,932,939,1871,4393
-150,-60,-130,956,915,1871,4397
-170,20,180,932,939,1871,4393
-120,-20,-140,934,937,1871,4282
70,10,130,920,953,1873,4103
-180,-90,-140,962,912,1874,4345
-120,-90,-80,962,912,1874,4345
-60,-90,-20,962,912,1874,4345
30,-80,-50,939,935,1874,4295
-10,-90,30,962,912,1874,4345
-140,-90,-100,962,912,1874,4345
30,-90,70,962,912,1874,4345
130,-90,170,962,912,1874,4345
-20,0,40,951,923,1874,4223
-150,-90,-110,962,912,1874,4345
180,-90,-140,962,912,1874,4345
-80,-90,-40,962,912,1874,4345
-30,-90,10,962,912,1874,4345
90,-90,130,962,912,1874,4345
-130,-90,-90,962,912,1874,4345
-170,-90,-130,962,912,1874,4345
-50,-90,-10,962,912,1874,4345
10,-90,50,962,912,1874,4345
30,60,10,952,922,1874,4294
-110,-90,-70,962,912,1874,4345
100,-90,140,962,912,1874,4345
170,-90,-150,962,912,1874,4345
50,-90,90,962,912,1874,4345
-90,-90,-50,962,912,1874,4345
-160,-90,-120,962,912,1874,4345
-20,-90,20,962,912,1874,4345
140,-90,-180,962,912,1874,4345
20,-90,60,962,912,1874,4345
150,-90,-170,962,912,1874,4345
120,-90,160,962,912,1874,4345
-40,-90,0,962,912,1874,4345
70,-90,110,962,912,1874,4345
80,-90,120,962,912,1874,4345
-100,-90,-60,962,912,1874,4345
60,-90,100,962,912,1874,4345
160,-90,-160,962,912,1874,4345
110,-90,150,962,912,1874,4345
140,-90,180,962,912,1874,4345
40,-90,80,962,912,1874,4345
-70,-90,-30,962,912,1874,4345
0,-90,40,962,912,1874,4345
140,80,-120,957,918,1875,4363
-80,-40,-160,942,933,1875,4187
-100,70,110,940,935,1875,4330
100,0,80,939,937,1876,4284
-100,0,-80,961,915,1876,4195
-170,-70,110,941,935,1876,4192
150,0,-160,918,958,1876,4295
-90,-80,-170,955,922,1877,4316
-170,10,180,942,935,1877,4483
-170,10,-180,942,935,1877,4483
130,-10,-150,948,929,1877,4377
-110,40,10,935,942,1877,4275
90,-10,0,946,932,1878,4329
80,50,-20,937,941,1878,4059
140,0,-150,932,946,1878,4348
30,50,20,948,930,1878,4393
-130,70,140,944,935,1879,4318
-90,-10,-130,933,946,1879,4208
-150,-10,-170,941,938,1879,4516
80,10,-80,942,937,1879,4231
70,-30,-20,914,965,1879,4176
-30,70,50,956,923,1879,4289
50,-40,110,945,935,1880,4161
-60,-10,30,943,937,1880,4301
-150,10,-180,959,921,1880,4393
-150,10,180,959,921,1880,4393
-40,-50,20,950,930,1880,4336
90,20,130,954,926,1880,4187
10,30,40,938,942,1880,4316
-90,-50,-30,940,941,1881,4231
90,10,90,940,941,1881,4206
150,30,100,942,939,1881,4090
160,-70,-170,947,934,1881,4285
-110,-60,-70,963,918,1881,4241
-100,-10,-120,946,936,1882,4188
30,70,-110,943,940,1883,4311
160,40,-150,924,959,1883,4308
60,50,10,941,943,1884,4232
-160,50,170,922,962,1884,4278
-110,0,170,961,923,1884,4455
40,-80,-40,952,933,1885,4346
160,-10,-170,947,938,1885,4379
-90,20,90,922,963,1885,4315
130,20,-110,934,951,1885,4193
10,-80,-70,942,943,1885,4357
-130,-60,-100,953,932,1885,4388
-120,20,150,957,929,1886,4338
-100,0,120,931,955,1886,4209
10,-70,60,966,920,1886,4351
90,80,180,930,956,1886,4497
-70,60,80,946,940,1886,4439
30,50,-100,944,942,1886,4167
90,80,-180,930,956,1886,4497
-40,40,50,965,921,1886,4335
100,70,-70,951,935,1886,4504
140,-30,-180,946,942,1888,4471
140,-30,180,946,942,1888,4471
-160,40,170,921,967,1888,4427
-130,-20,-150,954,934,1888,4220
120,-20,-150,942,946,1888,4398
120,20,110,943,946,1889,4221
140,0,-140,949,940,1889,4378
80,30,60,963,926,1889,4026
80,-80,120,948,941,1889,4283
-130,50,140,938,951,1889,4308
-140,50,40,962,928,1890,4015
-80,-80,-160,956,934,1890,4327
20,0,70,945,946,1891,4319
40,70,-120,935,956,1891,4387
140,60,-120,950,941,1891,4508
-120,-30,-110,937,954,1891,4270
70,40,-170,947,945,1892,3985
80,60,180,957,935,1892,4108
-160,40,60,944,948,1892,3865
160,20,-160,942,950,1892,4384
80,60,-180,957,935,1892,4108
100,20,-60,912,981,1893,3943
100,60,-60,954,939,1893,4297
70,-20,160,941,952,1893,4333
-110,-70,-70,953,940,1893,4414
80,0,-50,930,963,1893,4106
-60,80,-30,932,961,1893,4261
150,20,-150,963,931,1894,4442
-110,70,120,950,944,1894,4354
80,-60,0,951,943,1894,4353
10,30,-80,946,948,1894,4234
110,70,150,945,949,1894,4342
160,90,-140,978,917,1895,4261
-80,90,100,978,917,1895,4261
-10,90,30,978,917,1895,4261
10,90,10,978,917,1895,4261
-70,90,90,978,917,1895,4261
-170,90,-170,978,917,1895,4261
-150,90,170,978,917,1895,4261
-100,0,130,949,946,1895,4471
70,90,-50,978,917,1895,4261
80,40,10,941,954,1895,4077
30,90,-10,978,917,1895,4261
-60,90,80,978,917,1895,4261
140,90,-120,978,917,1895,4261
-100,90,120,978,917,1895,4261
-40,90,60,978,917,1895,4261
0,90,20,978,917,1895,4261
120,90,-100,978,917,1895,4261
50,90,-30,978,917,1895,4261
-160,90,180,978,917,1895,4261
110,90,-90,978,917,1895,4261
-110,90,130,978,917,1895,4261
-120,90,140,978,917,1895,4261
-160,90,-180,978,917,1895,4261
180,90,-160,978,917,1895,4261
100,90,-80,978,917,1895,4261
-50,90,70,978,917,1895,4261
-140,90,160,978,917,1895,4261
80,90,-60,978,917,1895,4261
40,90,-20,978,917,1895,4261
100,10,-100,925,970,1895,4209
90,90,-70,978,917,1895,4261
170,90,-150,978,917,1895,4261
-130,90,150,978,917,1895,4261
20,90,0,978,917,1895,4261
130,90,-110,978,917,1895,4261
-20,90,40,978,917,1895,4261
150,90,-130,978,917,1895,4261
-30,90,50,978,917,1895,4261
60,90,-40,978,917,1895,4261
-90,90,110,978,917,1895,4261
-180,90,-160,978,917,1895,4261
90,40,-20,948,948,1896,4147
-150,50,160,929,967,1896,4267
-20,-50,-100,933,963,1896,4128
90,10,-70,951,945,1896,4127
50,40,-110,928,968,1896,4447
70,10,-160,924,973,1897,3986
50,10,-80,957,940,1897,4210
-100,-80,-180,977,920,1897,4305
-100,-80,180,977,920,1897,4305
-90,-10,60,961,936,1897,4275
110,-70,150,931,966,1897,4306
150,-40,-180,942,956,1898,4484
-50,-70,0,963,935,1898,4428
90,40,-10,918,980,1898,4109
150,-40,180,942,956,1898,4484
120,60,-90,952,946,1898,4501
-110,-30,-40,947,952,1899,4124
-70,-30,10,955,944,1899,4356
140,70,-120,960,939,1899,4437
-60,-70,-10,949,950,1899,4456
-110,10,140,948,951,1899,4520
-70,-80,-150,966,933,1899,4343
70,30,-170,947,953,1900,4130
-100,-80,-60,953,947,1900,4405
-100,10,110,933,967,1900,4465
150,30,-140,951,950,1901,4265
40,0,110,959,942,1901,4114
80,-50,0,943,959,1902,4538
-170,30,70,946,956,1902,4073
-50,20,50,964,938,1902,4304
130,30,110,945,957,1902,4061
90,-80,130,957,946,1903,4310
-110,-80,170,971,932,1903,4397
150,-60,180,945,959,1904,4236
150,-60,-180,945,959,1904,4236
0,30,40,957,947,1904,4349
60,-20,-40,961,943,1904,4319
60,0,130,940,964,1904,4186
110,-30,170,932,972,1904,4388
100,10,100,934,970,1904,4351
110,-20,-140,927,978,1905,4255
-120,70,130,952,953,1905,4316
-170,40,180,941,965,1906,4417
-100,-10,130,952,954,1906,4312
-170,40,-180,941,965,1906,4417
130,-10,-140,955,952,1907,4278
-130,50,30,954,953,1907,4127
-50,40,-50,942,965,1907,4297
-30,-50,-110,959,948,1907,4189
100,40,-50,946,962,1908,4211
-80,10,70,947,961,1908,4275
-140,50,150,926,982,1908,4256
-130,-40,-120,956,952,1908,4316
130,0,90,954,954,1908,4291
170,-20,-170,954,954,1908,4402
80,-70,0,952,957,1909,4452
-60,50,70,956,954,1910,4404
-10,-70,40,961,949,1910,4508
-100,40,0,952,959,1911,4383
170,0,-170,952,959,1911,4315
170,-30,-170,948,963,1911,4436
0,-80,-80,954,957,1911,4449
-40,80,60,961,951,1912,4314
10,10,50,959,953,1912,4347
50,-80,-30,970,942,1912,4362
40,-40,100,977,936,1913,4179
-100,0,-50,964,949,1913,4106
160,90,110,954,960,1914,4250
90,90,180,954,960,1914,4250
-50,90,-40,954,960,1914,4250
-150,90,60,954,960,1914,4250
120,90,150,954,960,1914,4250
-130,90,40,954,960,1914,4250
-30,90,-60,954,960,1914,4250
-60,90,-30,954,960,1914,4250
0,90,-90,954,960,1914,4250
140,0,90,950,964,1914,4274
-80,90,-10,954,960,1914,4250
10,90,-100,954,960,1914,4250
90,90,-180,954,960,1914,4250
-40,-50,-120,965,949,1914,4134
-70,90,-20,954,960,1914,4250
-180,-20,-170,970,944,1914,4425
60,40,40,958,956,1914,4180
-170,90,80,954,960,1914,4250
40,90,-130,954,960,1914,4250
140,90,130,954,960,1914,4250
50,90,-140,954,960,1914,4250
-140,90,50,954,960,1914,4250
-110,90,20,954,960,1914,4250
180,90,90,954,960,1914,4250
-10,90,-80,954,960,1914,4250
70,90,-160,954,960,1914,4250
150,90,120,954,960,1914,4250
-120,90,30,954,960,1914,4250
-40,90,-50,954,960,1914,4250
30,90,-120,954,960,1914,4250
-100,90,10,954,960,1914,4250
100,90,170,954,960,1914,4250
80,-20,-150,941,973,1914,3991
110,90,160,954,960,1914,4250
170,90,100,954,960,1914,4250
130,90,140,954,960,1914,4250
180,-20,-170,970,944,1914,4425
-90,90,0,954,960,1914,4250
60,90,-150,954,960,1914,4250
-20,90,-70,954,960,1914,4250
-160,90,70,954,960,1914,4250
-120,-80,160,969,945,1914,4405
-180,90,90,954,960,1914,4250
80,90,-170,954,960,1914,4250
20,90,-110,954,960,1914,4250
-170,-40,-160,941,974,1915,4391
-140,30,160,956,959,1915,4434
-130,30,150,960,955,1915,4420
-30,60,50,967,948,1915,4263
0,-10,50,960,955,1915,4462
-90,10,90,937,979,1916,4377
-120,40,130,941,975,1916,4340
-100,-20,180,950,966,1916,4329
-100,-20,-180,950,966,1916,4329
-110,10,150,958,959,1917,4482
110,20,-80,950,967,1917,4306
-40,-70,10,979,938,1917,4417
70,20,-110,963,954,1917,4102
110,-30,50,958,959,1917,4399
30,20,80,954,964,1918,4139
70,20,-180,957,961,1918,4286
70,20,180,957,961,1918,4286
-60,-80,-140,983,935,1918,4398
120,-50,160,968,951,1919,4483
120,0,90,940,979,1919,4342
120,-20,-170,954,966,1920,4451
-100,20,-10,959,961,1920,4344
100,20,120,976,944,1920,4283
-100,10,-20,953,967,1920,4167
170,-40,-170,969,951,1920,4413
-100,0,-70,961,960,1921,4311
-160,10,-180,960,961,1921,4494
-160,10,180,960,961,1921,4494
90,0,-10,951,970,1921,4305
0,60,30,983,938,1921,4278
-120,10,170,978,943,1921,4408
-10,40,40,986,936,1922,4295
90,20,50,972,950,1922,4198
-80,60,90,980,942,1922,4410
-150,-20,-160,951,971,1922,4363
-140,60,150,946,976,1922,4292
110,30,-70,964,958,1922,4248
50,70,-130,950,973,1923,4426
150,80,-130,972,951,1923,4434
-30,-70,20,977,946,1923,4475
-30,50,-60,979,944,1923,4388
-20,-20,40,979,944,1923,4449
20,10,60,960,964,1924,4295
-100,0,-90,961,963,1924,4285
-110,30,120,948,976,1924,4407
170,-70,-160,976,948,1924,4470
140,20,-130,957,968,1925,4468
-140,10,-180,966,959,1925,4376
-140,10,180,966,959,1925,4376
120,10,-100,969,956,1925,4231
-120,-10,-160,969,956,1925,4442
-130,-60,140,987,939,1926,4407
130,-20,80,935,991,1926,4306
50,40,60,977,949,1926,4172
-10,-80,-90,963,963,1926,4437
-60,10,50,951,975,1926,4334
40,-30,-50,939,988,1927,4533
-40,-80,-120,970,957,1927,4457
-60,30,60,967,960,1927,4426
0,-70,50,980,948,1928,4426
-110,-20,-50,961,967,1928,4238
20,-70,70,975,953,1928,4456
60,-20,130,945,984,1929,4308
-150,-40,110,978,951,1929,4218
50,40,40,960,969,1929,4303
140,50,-120,973,956,1929,4629
-110,-80,-70,978,951,1929,4489
-110,20,130,963,967,1930,4434
10,-10,60,963,967,1930,4464
130,10,-120,970,960,1930,4546
-20,10,-80,945,985,1930,4370
120,10,100,975,956,1931,4378
170,-30,90,968,964,1932,4311
-10,-30,-90,967,965,1932,4403
110,-40,160,958,974,1932,4314
-100,10,-30,964,968,1932,4161
100,-80,140,979,953,1932,4407
30,-20,90,978,954,1932,4309
-70,-70,-20,967,966,1933,4525
-30,-50,30,970,963,1933,4569
60,60,-140,941,992,1933,4512
80,50,-10,974,960,1934,4301
-150,-30,100,956,979,1935,4217
-110,-50,160,974,961,1935,4362
170,40,-160,939,996,1935,4490
-30,-80,-110,981,954,1935,4494
110,70,-80,970,965,1935,4664
-100,0,140,981,955,1936,4523
120,40,-80,972,964,1936,4194
10,50,30,981,955,1936,4252
80,20,140,970,966,1936,4206
180,-50,-160,993,944,1937,4410
70,-20,150,943,994,1937,4524
-180,40,-170,946,991,1937,4460
-40,-10,-100,990,947,1937,4473
180,40,-170,946,991,1937,4460
90,-50,140,963,974,1937,4367
-10,0,-80,970,967,1937,4457
-180,-50,-160,993,944,1937,4410
100,30,-50,945,992,1937,4206
-50,0,40,957,980,1937,4423
-120,50,20,960,977,1937,4284
-150,-30,-150,978,960,1938,4481
120,50,-80,985,953,1938,4399
90,-30,10,961,977,1938,4428
140,-30,80,965,973,1938,4397
-50,80,-40,955,984,1939,4341
-20,-10,40,987,952,1939,4300
20,20,-80,968,971,1939,4357
100,0,70,986,953,1939,4438
-40,-20,30,988,952,1940,4423
-20,-70,30,973,967,1940,4503
100,50,150,966,974,1940,4224
70,0,-160,964,976,1940,4109
70,40,30,975,966,1941,3965
-140,0,-170,991,950,1941,4516
30,-30,90,981,960,1941,4356
-50,-80,-130,985,957,1942,4428
-30,0,40,988,954,1942,4452
70,20,-130,937,1006,1943,4232
60,20,-100,958,985,1943,4287
40,-10,110,972,971,1943,4462
80,30,160,975,968,1943,4117
40,0,-70,962,982,1944,4389
-100,-10,110,959,985,1944,4270
50,-20,-50,979,965,1944,4550
90,-10,-130,959,986,1945,4043
-150,30,50,974,971,1945,4198
-130,10,30,979,966,1945,4177
-60,-40,-140,995,950,1945,4127
110,10,100,959,986,1945,4487
70,40,40,984,962,1946,4100
160,20,90,981,965,1946,4297
90,10,70,989,957,1946,4286
30,-70,80,988,958,1946,4541
-110,10,160,986,960,1946,4557
-70,0,50,980,966,1946,4428
-140,20,170,975,971,1946,4561
-90,-30,0,992,954,1946,4399
-110,-10,-160,977,969,1946,4559
-60,0,-100,983,965,1948,4424
140,-10,-160,967,981,1948,4493
-150,-70,-120,984,964,1948,4449
60,40,60,976,972,1948,4106
-150,0,-170,981,967,1948,4695
110,-50,40,981,968,1949,4406
-140,-80,140,990,959,1949,4486
110,-80,150,991,958,1949,4429
70,50,-170,992,957,1949,4287
-20,-30,40,988,961,1949,4555
180,-70,-150,990,960,1950,4460
90,10,80,1004,946,1950,4438
-180,-70,-150,990,960,1950,4460
-110,0,180,992,958,1950,4623
50,50,-120,952,998,1950,4508
-110,0,-180,992,958,1950,4623
-90,60,100,984,966,1950,4540
170,-10,-170,990,960,1950,4497
-90,20,-40,984,966,1950,4240
-90,10,-70,976,975,1951,4432
-120,-80,-80,986,965,1951,4551
60,0,-70,968,983,1951,4408
180,10,80,964,988,1952,4204
-130,-80,150,984,968,1952,4425
-180,10,80,964,988,1952,4204
-20,-80,-100,976,977,1953,4459
-120,-60,150,1002,951,1953,4399
-170,-70,-140,991,962,1953,4525
-100,0,-60,984,969,1953,4254
120,-70,160,980,974,1954,4475
130,30,-100,990,965,1955,4396
20,-10,-70,986,969,1955,4539
-100,-10,100,967,988,1955,4307
-130,60,140,973,982,1955,4484
10,70,20,983,972,1955,4444
180,-60,100,985,970,1955,4545
-180,-60,100,985,970,1955,4545
-70,50,80,984,972,1956,4518
70,50,10,970,986,1956,4351
0,-20,-80,972,984,1956,4481
-80,-70,-30,984,972,1956,4580
180,70,80,961,995,1956,4364
60,-10,160,982,974,1956,4233
-180,70,80,961,995,1956,4364
-20,-10,-90,966,990,1956,4361
150,40,100,969,988,1957,4241
-110,-20,30,980,977,1957,4297
-70,30,70,980,977,1957,4482
-90,-40,-10,1000,957,1957,4456
50,40,50,976,981,1957,4363
160,-20,-170,990,967,1957,4534
-120,0,20,974,984,1958,4417
80,80,-170,959,999,1958,4614
-50,80,70,996,963,1959,4437
-120,-10,30,999,960,1959,4187
-100,-10,120,967,993,1960,4381
50,-20,120,978,982,1960,4392
130,40,-100,1009,951,1960,4564
100,20,-50,973,987,1960,4271
90,-20,-140,963,997,1960,4085
120,-60,160,964,996,1960,4444
-160,-50,110,969,991,1960,4539
-120,50,130,981,980,1961,4507
20,20,50,987,974,1961,4588
120,-60,50,983,978,1961,4483
-70,-50,0,990,971,1961,4392
130,0,-130,998,963,1961,4479
-120,-20,100,983,979,1962,4452
-160,20,-180,973,990,1963,4563
-140,-60,130,1000,963,1963,4386
60,40,-130,963,1000,1963,4365
-100,50,110,986,977,1963,4553
-160,20,180,973,990,1963,4563
180,-10,-170,986,978,1964,4679
-180,-10,-170,986,978,1964,4679
-80,0,60,1017,947,1964,4369
-120,-30,-90,970,994,1964,4208
-100,-50,-40,1012,953,1965,4456
60,-80,-20,988,977,1965,4479
-20,-40,40,1001,966,1967,4473
-130,0,-170,990,977,1967,4550
100,50,-50,982,985,1967,4392
-100,-60,-50,1010,957,1967,4359
150,70,-130,998,969,1967,4610
100,70,160,1001,967,1968,4497
70,-20,-30,994,974,1968,4406
80,10,-120,953,1015,1968,4331
-110,-10,10,973,995,1968,4276
110,60,-70,989,979,1968,4475
80,0,-60,988,980,1968,4414
-100,60,110,985,984,1969,4561
-130,-10,-160,1001,968,1969,4488
-150,30,170,991,978,1969,4495
160,80,-140,1002,967,1969,4566
120,-80,160,1005,964,1969,4489
30,0,100,977,993,1970,4174
-160,-40,-150,982,988,1970,4464
30,30,-90,995,975,1970,4486
50,-10,-60,985,986,1971,4653
-120,60,130,976,995,1971,4526
-110,-50,-60,994,977,1971,4418
-80,20,80,983,989,1972,4497
140,40,-120,992,980,1972,4649
-120,-70,-80,995,977,1972,4563
-160,-10,-170,1005,967,1972,4729
-120,30,140,978,994,1972,4526
-40,0,40,998,974,1972,4563
150,10,-150,988,985,1973,4750
130,50,-100,1010,963,1973,4642
-90,-20,40,990,983,1973,4505
40,10,-80,1003,971,1974,4422
10,60,-90,982,992,1974,4532
90,-40,10,981,993,1974,4603
-170,-30,-160,996,979,1975,4618
30,20,90,993,982,1975,4124
-100,-10,140,993,982,1975,4381
50,40,70,995,980,1975,4087
100,-10,40,964,1012,1976,4467
90,-30,-170,969,1007,1976,4364
-150,-80,130,1000,976,1976,4568
-110,60,120,985,991,1976,4537
-110,50,120,987,990,1977,4534
-40,70,60,1002,975,1977,4489
70,20,100,999,978,1977,4439
60,-40,120,969,1008,1977,4493
40,20,-90,986,991,1977,4318
120,-10,-130,980,998,1978,4510
80,20,80,1025,953,1978,4271
-130,-30,-130,976,1002,1978,4549
-130,-80,-90,1009,969,1978,4578
150,60,-130,977,1002,1979,4659
140,-60,70,991,988,1979,4563
130,-60,60,1001,978,1979,4573
-100,20,110,991,988,1979,4657
70,70,-160,981,998,1979,4597
70,30,80,989,991,1980,4147
110,20,110,1003,977,1980,4450
90,50,-30,988,993,1981,4352
-80,-50,-10,1002,979,1981,4381
40,40,40,983,998,1981,4578
-30,30,-70,989,992,1981,4530
-70,-60,-10,1001,980,1981,4425
-70,-10,40,978,1004,1982,4576
80,-60,130,983,999,1982,4588
80,50,0,988,994,1982,4324
-160,-70,-130,1006,976,1982,4565
140,30,-120,1011,972,1983,4591
180,30,-170,998,986,1984,4632
-160,60,60,1009,975,1984,4349
-180,30,-170,998,986,1984,4632
120,20,-90,994,991,1985,4492
50,0,-70,974,1011,1985,4560
-120,-60,-80,1006,979,1985,4513
70,20,-120,999,987,1986,4394
-110,-20,40,1017,969,1986,4208
130,-20,-170,993,993,1986,4655
160,-60,-170,997,989,1986,4449
20,60,20,1004,983,1987,4506
90,-60,10,987,1000,1987,4469
-60,80,80,1006,981,1987,4455
-150,-40,-140,1000,988,1988,4565
-20,-40,-100,973,1015,1988,4497
100,0,60,988,1000,1988,4320
-130,-30,110,968,1021,1989,4358
-90,-70,-40,1002,987,1989,4657
70,20,170,979,1010,1989,4170
60,30,-120,1002,987,1989,4516
50,-40,-40,979,1010,1989,4486
-140,-40,-130,1012,978,1990,4644
-130,10,180,1013,977,1990,4630
-130,10,-180,1013,977,1990,4630
-180,20,-170,985,1006,1991,4507
160,10,-160,992,999,1991,4611
180,20,-170,985,1006,1991,4507
-170,-10,-170,1005,986,1991,4771
-60,-60,0,994,997,1991,4522
-40,70,-50,1004,987,1991,4604
-90,-30,-170,1000,991,1991,4356
-40,30,50,993,999,1992,4537
-40,80,-50,985,1007,1992,4508
90,10,-80,998,995,1993,4509
140,50,110,1015,978,1993,4425
-20,-30,-100,994,999,1993,4479
60,-40,-30,986,1007,1993,4513
-100,10,120,976,1018,1994,4587
80,40,170,995,999,1994,4406
-80,-40,0,1013,981,1994,4584
60,50,-140,978,1018,1996,4654
60,-20,170,987,1009,1996,4231
-100,0,150,1024,973,1997,4517
-50,-60,10,1017,981,1998,4667
-70,80,90,1013,985,1998,4515
90,30,140,985,1013,1998,4226
-150,60,50,997,1002,1999,4453
100,-30,30,984,1015,1999,4563
120,70,-90,1002,997,1999,4742
80,-30,-10,988,1012,2000,4320
30,30,70,1004,996,2000,4371
150,-50,-180,1006,994,2000,4635
150,-50,180,1006,994,2000,4635
50,30,90,983,1017,2000,4320
-50,-90,-130,1018,983,2001,4674
30,-90,-50,1018,983,2001,4674
90,-90,10,1018,983,2001,4674
-170,-90,110,1018,983,2001,4674
50,-90,-30,1018,983,2001,4674
150,-90,70,1018,983,2001,4674
-100,-90,180,1018,983,2001,4674
60,-90,-20,1018,983,2001,4674
20,-90,-60,1018,983,2001,4674
0,-90,-80,1018,983,2001,4674
-40,-90,-120,1018,983,2001,4674
120,-90,40,1018,983,2001,4674
-160,-90,120,1018,983,2001,4674
-130,-90,150,1018,983,2001,4674
-100,-90,-180,1018,983,2001,4674
-80,-90,-160,1018,983,2001,4674
-10,-90,-90,1018,983,2001,4674
170,-90,90,1018,983,2001,4674
-120,-90,160,1018,983,2001,4674
-140,-90,140,1018,983,2001,4674
100,-90,20,1018,983,2001,4674
-110,-90,170,1018,983,2001,4674
-70,-90,-150,1018,983,2001,4674
140,-90,60,1018,983,2001,4674
130,-90,50,1018,983,2001,4674
-150,-90,130,1018,983,2001,4674
180,-90,100,1018,983,2001,4674
-20,-90,-100,1018,983,2001,4674
-90,-90,-170,1018,983,2001,4674
160,-90,80,1018,983,2001,4674
10,-90,-70,1018,983,2001,4674
40,-90,-40,1018,983,2001,4674
70,-90,-10,1018,983,2001,4674
80,-90,0,1018,983,2001,4674
-180,-90,100,1018,983,2001,4674
-60,-90,-140,1018,983,2001,4674
110,-90,30,1018,983,2001,4674
-30,-90,-110,1018,983,2001,4674
-140,-80,-100,1010,992,2002,4603
-70,-10,-130,1021,981,2002,4470
-70,10,60,1007,995,2002,4556
-110,40,120,988,1014,2002,4490
-80,-20,30,1008,995,2003,4628
-80,50,90,1004,999,2003,4623
70,10,150,980,1024,2004,4391
-100,10,-40,1008,996,2004,4480
150,50,-130,1005,999,2004,4728
50,50,20,1007,997,2004,4597
-50,40,60,1013,992,2005,4695
150,-20,-170,1013,992,2005,4691
-120,-50,-80,1017,988,2005,4501
-110,50,10,1004,1002,2006,4562
70,10,-150,984,1022,2006,4295
100,-30,170,1005,1002,2007,4813
-80,-10,50,1006,1001,2007,4438
-170,-50,-150,1012,995,2007,4498
40,-70,90,1018,989,2007,4740
-30,0,-90,1021,986,2007,4550
-120,-20,-130,999,1008,2007,4752
110,-10,70,1011,996,2007,4625
60,-10,140,965,1042,2007,4395
-80,-30,10,1028,980,2008,4609
-90,50,100,1000,1008,2008,4711
100,-20,30,984,1024,2008,4516
40,50,-110,988,1021,2009,4606
-70,20,-70,1008,1001,2009,4438
-80,0,-110,1016,994,2010,4416
-170,20,70,1015,995,2010,4300
-130,-40,-110,999,1011,2010,4492
90,-70,10,1001,1009,2010,4677
70,-20,-170,1000,1010,2010,4295
160,0,-160,990,1020,2010,4715
130,-80,170,1025,985,2010,4600
150,20,-140,1014,996,2010,4688
160,30,-150,980,1030,2010,4544
-40,-60,20,1013,998,2011,4779
90,30,30,1021,992,2013,4268
170,-40,90,1022,991,2013,4606
-80,-60,-20,1023,990,2013,4502
30,10,100,1005,1008,2013,4247
-110,30,130,998,1016,2014,4705
-10,50,40,1027,987,2014,4662
-160,30,60,1002,1012,2014,4157
30,30,50,1006,1008,2014,4759
-70,-20,-140,1043,972,2015,4574
-130,-20,90,994,1021,2015,4527
-130,-50,-100,1029,986,2015,4561
-80,20,-60,997,1018,2015,4550
60,-20,160,1004,1012,2016,4518
-120,20,160,1022,994,2016,4489
0,50,-80,1029,987,2016,4693
70,60,-20,996,1020,2016,4565
-110,-30,140,1018,999,2017,4542
140,-20,-170,1013,1004,2017,4698
-140,60,40,1018,999,2017,4390
-140,-10,70,1004,1013,2017,4193
-80,-20,-150,1000,1017,2017,4672
-50,70,70,1015,1003,2018,4666
40,40,70,1021,997,2018,4400
-180,-70,100,1007,1011,2018,4488
180,-70,100,1007,1011,2018,4488
-20,-50,40,1015,1004,2019,4678
-40,-30,30,1026,994,2020,4590
-90,0,90,994,1026,2020,4654
140,10,-130,1022,999,2021,4683
80,10,-90,1001,1020,2021,4585
80,-30,170,1004,1017,2021,4699
-100,-20,170,1011,1010,2021,4423
-140,-30,-140,1008,1014,2022,4659
-120,-40,-80,1001,1021,2022,4463
-140,-60,-110,1007,1015,2022,4560
140,-80,180,1035,987,2022,4667
140,-80,-180,1035,987,2022,4667
40,50,20,1017,1005,2022,4729
-30,50,50,1048,975,2023,4611
120,60,-80,1014,1009,2023,4602
180,0,-170,1013,1010,2023,4644
-180,0,-170,1013,1010,2023,4644
-20,-80,30,1026,998,2024,4632
150,40,-130,1022,1002,2024,4738
70,10,-140,988,1037,2025,4392
30,40,40,1013,1012,2025,4708
-160,-20,-160,1017,1008,2025,4759
-160,-80,120,1027,998,2025,4640
-120,-30,-80,1020,1005,2025,4539
40,10,110,1023,1002,2025,4399
-30,60,-60,1028,998,2026,4615
-110,-10,-80,1031,995,2026,4458
80,-30,150,985,1041,2026,4557
130,60,-100,1039,987,2026,4757
-110,-60,160,1019,1007,2026,4477
-100,-30,-10,1015,1011,2026,4522
-100,-40,-20,1016,1011,2027,4557
70,-80,-10,1021,1006,2027,4553
90,20,120,991,1036,2027,4465
-100,-10,-130,1014,1013,2027,4602
70,0,-70,1015,1012,2027,4395
130,-30,-180,1008,1020,2028,4750
140,40,-110,1031,997,2028,4659
130,-30,180,1008,1020,2028,4750
0,20,-80,997,1031,2028,4696
160,70,-140,1019,1010,2029,4763
70,20,160,1020,1010,2030,4253
-130,20,170,1020,1010,2030,4614
90,-50,10,1007,1023,2030,4607
-160,0,-170,1022,1008,2030,4907
180,10,-170,1013,1018,2031,4827
-180,10,-170,1013,1018,2031,4827
20,10,70,1014,1017,2031,4536
0,40,40,1036,995,2031,4640
-100,-50,170,1030,1002,2032,4480
-50,-40,20,1030,1002,2032,4702
60,60,-10,1018,1014,2032,4590
30,-10,100,1010,1023,2033,4569
70,40,50,1032,1001,2033,4398
-120,0,-170,1037,996,2033,4779
170,30,-160,1018,1016,2034,4814
70,80,-160,1000,1034,2034,4780
-110,-10,-90,1021,1015,2036,4445
60,50,20,1013,1023,2036,4573
100,-30,-170,989,1047,2036,4499
70,10,-90,1005,1031,2036,4519
-30,80,-60,1011,1025,2036,4625
-110,-40,-40,1017,1020,2037,4485
80,60,-30,1011,1026,2037,4714
80,-10,-140,991,1046,2037,4333
30,-30,-60,1004,1033,2037,4684
-30,-80,20,1026,1011,2037,4621
-70,10,-90,1018,1019,2037,4568
80,-10,-30,1012,1025,2037,4676
-140,20,40,1041,996,2037,4186
-10,-80,40,1034,1003,2037,4688
-110,-20,-40,1027,1011,2038,4418
40,20,100,1045,993,2038,4216
120,-20,-140,1004,1034,2038,4613
120,-20,70,1019,1019,2038,4683
100,30,130,1011,1029,2040,4420
170,80,-150,1038,1002,2040,4652
-140,-10,-160,1026,1014,2040,4605
-150,-80,-110,1036,1004,2040,4696
90,-30,170,1031,1009,2040,4819
-40,20,-80,1001,1040,2041,4689
140,20,-120,1033,1009,2042,4729
160,60,-140,1020,1023,2043,4743
30,-40,90,1035,1008,2043,4663
130,-20,-160,1025,1018,2043,4787
90,-30,-180,1004,1040,2044,4587
50,-50,110,1041,1003,2044,4511
90,-30,180,1004,1040,2044,4587
110,-40,40,1015,1029,2044,4617
-80,80,100,1032,1013,2045,4595
-100,30,110,1018,1027,2045,4906
50,-70,100,1022,1024,2046,4872
70,-40,130,1009,1037,2046,4710
120,-10,80,1002,1044,2046,4695
-20,40,-70,1043,1004,2047,4624
130,-70,170,1037,1010,2047,4647
-90,-20,-160,1023,1024,2047,4552
90,50,160,1034,1013,2047,4519
100,-30,-160,1012,1035,2047,4553
-90,-50,-20,1039,1008,2047,4558
70,10,140,1020,1028,2048,4551
-160,-80,-120,1035,1013,2048,4745
0,-80,50,1040,1008,2048,4731
100,-10,30,1002,1046,2048,4650
-100,-30,170,1033,1015,2048,4462
170,-60,-160,1027,1022,2049,4667
0,0,50,1025,1024,2049,4778
-100,-70,-50,1034,1015,2049,4736
-100,-10,-170,1017,1033,2050,4666
90,-30,160,1010,1040,2050,4785
-150,10,-170,1039,1011,2050,4816
90,-30,-160,1041,1009,2050,4581
-140,-50,-120,1045,1005,2050,4783
40,-20,-60,1029,1022,2051,4804
90,60,-40,1015,1036,2051,4788
-40,-80,10,1033,1018,2051,4613
-110,-10,-150,1029,1023,2052,4782
80,-30,-170,1013,1039,2052,4487
-130,60,30,1029,1023,2052,4415
100,20,-20,1031,1022,2053,4506
150,-80,-170,1048,1005,2053,4707
-60,20,60,1037,1017,2054,4801
-110,-30,-30,1028,1026,2054,4412
90,-20,0,1011,1043,2054,4506
-170,80,-170,1041,1014,2055,4834
-160,-50,-140,1039,1017,2056,4582
80,10,-110,1016,1040,2056,4466
120,-30,60,1031,1025,2056,4549
-120,-30,120,992,1064,2056,4401
-140,40,160,1023,1033,2056,4875
110,-30,-160,1002,1055,2057,4704
60,50,-150,1052,1005,2057,4641
60,80,-30,1046,1011,2057,4802
120,-50,50,1020,1037,2057,4614
100,-30,180,1021,1037,2058,4872
-60,-80,-10,1039,1019,2058,4692
-50,-80,0,1036,1022,2058,4626
100,-30,-180,1021,1037,2058,4872
150,10,-140,1033,1025,2058,4779
-110,20,140,1036,1022,2058,4834
130,50,-90,1056,1002,2058,4759
0,70,30,1028,1030,2058,4698
-150,-60,120,1028,1030,2058,4724
40,40,60,1035,1023,2058,4669
-100,40,110,1029,1030,2059,4730
100,20,-10,1009,1050,2059,4441
-170,-80,110,1048,1011,2059,4771
-180,80,-160,1045,1014,2059,4761
180,80,-160,1045,1014,2059,4761
-110,-10,-70,1023,1037,2060,4632
120,-30,180,1020,1040,2060,4894
120,-30,-180,1020,1040,2060,4894
130,-20,-150,1032,1029,2061,4732
130,20,-100,1023,1038,2061,4613
-60,-50,10,1049,1012,2061,4679
50,80,-20,1043,1018,2061,4782
70,-10,-160,1029,1032,2061,4388
-90,-10,-140,1036,1025,2061,4703
-160,30,-180,1024,1037,2061,4825
140,-10,-150,1043,1018,2061,4771
80,20,130,1013,1048,2061,4507
-160,30,180,1024,1037,2061,4825
-40,-20,-110,1037,1025,2062,4667
-60,-30,20,1028,1034,2062,4717
-130,-70,-90,1043,1019,2062,4756
100,0,50,1031,1031,2062,4711
70,80,-40,1061,1002,2063,4837
150,0,-150,1035,1028,2063,4876
-150,40,170,1034,1029,2063,4867
-40,20,50,1043,1020,2063,4782
40,30,90,1014,1050,2064,4388
-170,70,70,1024,1040,2064,4804
110,-20,50,1027,1038,2065,4557
80,-30,-180,1014,1051,2065,4534
90,0,-50,1019,1046,2065,4495
80,-30,180,1014,1051,2065,4534
-90,-10,70,1007,1059,2066,4669
-90,40,100,1045,1022,2067,4835
160,-30,-170,1033,1034,2067,4835
-30,-60,30,1052,1015,2067,4837
-110,-20,-30,1017,1050,2067,4644
130,-60,170,1029,1038,2067,4862
60,30,90,1041,1027,2068,4362
150,-10,-160,1045,1023,2068,4861
90,10,-100,1015,1054,2069,4564
100,20,-40,1015,1054,2069,4595
70,20,110,1024,1045,2069,4534
10,20,-80,1031,1038,2069,4821
-130,-10,60,1032,1037,2069,4323
-150,20,-180,1040,1029,2069,4855
-150,20,180,1040,1029,2069,4855
60,40,-140,1035,1035,2070,4624
-90,80,110,1039,1031,2070,4701
-60,10,-90,1017,1053,2070,4746
80,40,20,1032,1038,2070,4267
110,-30,-180,1036,1035,2071,5025
-100,0,-100,1028,1043,2071,4669
0,40,-80,1056,1015,2071,4791
-10,-40,50,1060,1011,2071,4662
40,80,-10,1062,1009,2071,4765
110,-30,180,1036,1035,2071,5025
-150,-10,-160,1048,1024,2072,4822
50,60,0,1033,1039,2072,4679
-160,10,-170,1043,1029,2072,4782
60,-20,140,990,1083,2073,4588
100,40,-40,1037,1036,2073,4618
-70,30,-50,1028,1045,2073,4676
90,20,60,1042,1031,2073,4695
-100,10,-50,1021,1053,2074,4569
-10,-50,50,1049,1025,2074,4720
100,10,-90,1032,1042,2074,4754
-130,40,150,1039,1035,2074,4924
-140,-20,-150,1060,1014,2074,4849
30,30,60,1046,1029,2075,4663
-100,80,120,1040,1035,2075,4767
70,-40,-20,1038,1037,2075,4609
60,40,-150,1046,1030,2076,4590
90,0,-120,986,1090,2076,4668
90,70,170,1061,1015,2076,4752
-170,0,-170,1041,1036,2077,4930
40,-20,110,1035,1042,2077,4848
80,-80,0,1047,1031,2078,4641
90,40,0,1019,1059,2078,4623
140,-40,180,1030,1048,2078,4780
80,20,90,1065,1013,2078,4779
-30,20,-80,1030,1048,2078,4673
60,-10,150,1026,1052,2078,4669
-30,-10,40,1045,1033,2078,4813
140,-40,-180,1030,1048,2078,4780
-70,-20,30,1047,1032,2079,4774
130,40,-90,1056,1023,2079,4781
-100,-10,180,1036,1043,2079,4657
-100,-10,-180,1036,1043,2079,4657
-110,80,130,1041,1039,2080,4787
-110,-20,110,1031,1049,2080,4621
10,-80,60,1062,1019,2081,4794
90,50,-20,1032,1049,2081,4613
120,-40,170,1049,1032,2081,4864
160,40,-140,1047,1034,2081,4853
120,30,-80,1051,1030,2081,4669
50,10,120,1003,1078,2081,4524
40,-40,-50,1014,1067,2081,4710
80,80,-50,1065,1016,2081,4873
70,-30,170,1034,1048,2082,4743
-170,-80,-130,1054,1028,2082,4723
110,40,-60,1052,1030,2082,4751
-100,-20,50,1062,1020,2082,4693
0,-10,-80,1018,1064,2082,4937
20,40,-90,1049,1033,2082,4875
20,-20,-70,1041,1041,2082,4875
100,0,40,1026,1057,2083,4635
60,10,-90,1048,1035,2083,4500
-130,30,160,1039,1044,2083,4779
160,-80,-160,1049,1034,2083,4730
-70,-80,-20,1056,1027,2083,4797
-60,70,80,1050,1033,2083,4811
-10,10,-80,1054,1030,2084,4731
100,10,90,1031,1053,2084,4624
-100,10,130,1033,1051,2084,4950
-100,20,120,1044,1041,2085,4830
150,10,90,1044,1041,2085,4600
20,-10,80,1051,1034,2085,4801
-110,-20,20,1020,1065,2085,4724
170,70,-150,1032,1054,2086,4899
80,70,-40,1036,1051,2087,4812
-130,-60,-90,1060,1027,2087,4824
-80,-80,-30,1060,1027,2087,4849
70,-70,120,1037,1050,2087,4787
130,-50,170,1047,1040,2087,4900
150,30,-130,1053,1034,2087,4895
180,-80,100,1056,1032,2088,4844
40,-50,100,1047,1041,2088,4679
-180,-80,100,1056,1032,2088,4844
20,-80,70,1058,1030,2088,4846
-40,60,60,1052,1036,2088,4695
-110,0,-170,1061,1027,2088,4872
-90,0,-110,1045,1044,2089,4617
180,-80,-140,1055,1034,2089,4740
-20,20,-80,1042,1047,2089,4764
-100,-10,160,1052,1037,2089,4589
70,70,-30,1047,1042,2089,4873
-10,-20,-90,1037,1052,2089,4585
60,70,-20,1037,1052,2089,4880
-180,-80,-140,1055,1034,2089,4740
-160,80,180,1061,1029,2090,4931
-160,80,-180,1061,1029,2090,4931
-80,40,90,1041,1049,2090,4906
80,20,110,1017,1073,2090,4631
100,20,110,1038,1052,2090,4606
-70,-40,10,1057,1034,2091,4756
-100,-10,170,1059,1032,2091,4655
-120,10,-180,1061,1031,2092,4799
-110,-60,-60,1066,1026,2092,4767
-120,10,180,1061,1031,2092,4799
-150,80,170,1055,1037,2092,4976
130,70,-100,1059,1034,2093,4944
-120,80,140,1051,1042,2093,4873
-120,-20,90,1046,1048,2094,4540
-70,20,70,1043,1051,2094,4895
60,-70,110,1051,1043,2094,4831
160,-50,-170,1047,1048,2095,4921
-100,50,0,1043,1052,2095,4738
-110,-10,-100,1058,1037,2095,4617
-40,30,-70,1032,1063,2095,4718
-100,-10,-140,1046,1049,2095,4797
90,80,-60,1072,1023,2095,4921
-50,-20,30,1057,1039,2096,4925
100,-50,150,1059,1037,2096,4895
-20,80,-70,1033,1063,2096,4748
-170,-20,-160,1052,1044,2096,4779
90,10,-90,1042,1054,2096,4703
-100,-40,170,1044,1052,2096,4637
30,30,80,1053,1043,2096,4420
-180,-30,-160,1051,1046,2097,4930
180,-30,-160,1051,1046,2097,4930
-170,20,-170,1039,1058,2097,4803
80,-30,160,1024,1073,2097,4816
-80,-30,-160,1060,1038,2098,4726
-110,20,150,1068,1030,2098,4806
110,-30,-170,1050,1048,2098,4937
110,50,-60,1043,1056,2099,4714
-80,10,80,1045,1054,2099,4691
90,70,-50,1036,1063,2099,4851
-120,-10,-150,1067,1032,2099,4992
90,-10,-10,1044,1056,2100,4707
-110,10,170,1060,1040,2100,4836
150,-40,80,1043,1057,2100,4884
-10,-30,50,1066,1035,2101,4854
110,30,120,1055,1046,2101,4541
100,0,30,1055,1046,2101,4809
160,-40,-170,1032,1069,2101,4941
60,20,110,1023,1078,2101,4564
140,30,-110,1054,1048,2102,4620
-60,-20,-130,1053,1049,2102,4678
30,80,0,1074,1028,2102,4858
80,20,100,1067,1036,2103,4628
80,-40,140,1035,1068,2103,5059
-30,-40,-110,1061,1043,2104,4699
-110,-50,-50,1076,1028,2104,4875
100,-60,20,1050,1054,2104,4807
-60,-10,40,1048,1056,2104,4884
20,-30,80,1072,1032,2104,4791
-130,80,150,1056,1048,2104,4944
-50,10,50,1056,1048,2104,4818
140,50,-110,1080,1024,2104,4933
20,-20,80,1068,1037,2105,4749
-120,-30,-70,1076,1029,2105,4713
70,-30,140,1036,1070,2106,4841
110,-10,-120,1058,1048,2106,4751
0,30,-80,1042,1064,2106,4843
-170,10,-170,1053,1053,2106,4922
-90,-60,-30,1077,1029,2106,4705
30,-10,-70,1056,1051,2107,4867
-10,60,40,1098,1009,2107,4757
-70,40,80,1056,1052,2108,4812
170,-80,-150,1067,1041,2108,4813
-20,-60,40,1074,1034,2108,4889
110,0,-110,1071,1037,2108,4721
20,50,30,1049,1059,2108,4919
-150,-50,-130,1074,1034,2108,4925
-120,60,20,1043,1066,2109,4692
50,60,-130,1034,1075,2109,4806
-100,-10,-150,1064,1046,2110,4836
70,-30,-180,1040,1071,2111,4677
70,-30,180,1040,1071,2111,4677
90,0,-20,1037,1074,2111,4849
-140,80,160,1056,1055,2111,4955
80,20,120,1050,1061,2111,4823
80,-20,-20,1041,1071,2112,4887
80,-70,130,1047,1065,2112,4851
-80,0,-120,1060,1052,2112,4856
-60,-20,30,1063,1049,2112,4999
-120,-40,-70,1082,1030,2112,4750
-80,0,70,1053,1060,2113,4781
-100,-60,170,1064,1050,2114,4558
150,0,-140,1064,1050,2114,4985
-140,30,170,1074,1041,2115,4717
90,-80,10,1054,1061,2115,4828
-110,-70,-60,1061,1054,2115,4906
70,60,-170,1075,1040,2115,4785
-40,40,-60,1064,1051,2115,4942
-60,-10,-120,1078,1038,2116,4870
-120,40,140,1063,1053,2116,4960
160,50,-140,1055,1061,2116,4949
70,-10,-50,1035,1081,2116,4930
30,10,-80,1040,1077,2117,4879
100,30,-40,1040,1077,2117,4726
-100,-10,-160,1049,1068,2117,4887
-90,30,-20,1063,1054,2117,4726
100,10,10,1061,1056,2117,4573
140,-70,-180,1075,1044,2119,4873
150,50,100,1076,1043,2119,4693
140,-70,180,1075,1044,2119,4873
30,-50,90,1074,1046,2120,4804
-140,10,-170,1067,1053,2120,4890
-100,0,160,1067,1054,2121,4722
-140,20,180,1072,1049,2121,4896
-150,-60,-120,1066,1055,2121,4895
-140,20,-180,1072,1049,2121,4896
-100,10,140,1054,1067,2121,4953
-80,10,-90,1083,1038,2121,4921
50,-10,130,1028,1093,2121,4713
60,-20,150,1028,1093,2121,4833
170,-80,90,1061,1061,2122,4986
-50,-40,-130,1071,1051,2122,4614
40,40,50,1052,1070,2122,4811
-100,10,150,1075,1047,2122,4876
100,80,-70,1077,1046,2123,5029
100,70,-60,1053,1070,2123,4880
110,10,-90,1048,1075,2123,4784
180,-40,-160,1051,1072,2123,4952
-180,-40,-160,1051,1072,2123,4952
30,-80,80,1081,1043,2124,4994
60,30,-140,1055,1069,2124,4743
60,60,0,1055,1069,2124,5041
130,-30,70,1068,1057,2125,4992
-90,10,-80,1075,1050,2125,4646
100,0,-110,1041,1084,2125,4813
-160,40,180,1054,1071,2125,4862
-160,40,-180,1054,1071,2125,4862
-100,-10,150,1080,1045,2125,4686
170,50,-150,1045,1081,2126,5169
100,-20,-130,1044,1082,2126,4677
60,70,-150,1056,1070,2126,4955
100,10,-80,1071,1055,2126,4748
-30,40,50,1095,1031,2126,5009
-90,-80,-40,1079,1047,2126,4964
-140,0,50,1081,1045,2126,4506
120,-30,-160,1044,1082,2126,4910
170,0,-160,1062,1065,2127,4985
-10,20,-80,1052,1076,2128,4835
-30,70,-60,1075,1053,2128,4882
10,0,60,1078,1050,2128,4844
-150,0,-160,1095,1033,2128,5108
100,40,140,1064,1064,2128,4715
-50,-10,-110,1090,1038,2128,4880
-60,30,-60,1068,1061,2129,4880
-100,-20,160,1056,1073,2129,4601
70,-30,160,1040,1089,2129,4926
30,-20,100,1063,1066,2129,4801
50,20,-100,1084,1046,2130,4646
-70,-30,-150,1064,1067,2131,4736
170,60,-150,1067,1064,2131,5052
10,40,40,1069,1062,2131,4910
100,60,-50,1064,1067,2131,4757
-50,-50,20,1074,1057,2131,5019
90,-60,140,1049,1083,2132,4958
-120,30,150,1082,1050,2132,4848
140,-50,70,1063,1069,2132,5098
-70,70,90,1080,1052,2132,4909
180,70,-160,1066,1066,2132,4994
100,-30,20,1060,1072,2132,4720
-180,70,-160,1066,1066,2132,4994
50,70,-10,1051,1082,2133,4797
150,50,-120,1074,1059,2133,4937
150,-30,-170,1078,1056,2134,5106
70,30,180,1056,1078,2134,4635
70,30,-180,1056,1078,2134,4635
100,10,80,1084,1050,2134,4914
-110,-10,-140,1078,1056,2134,4939
170,20,-160,1059,1076,2135,4968
40,30,-100,1098,1037,2135,4719
80,30,70,1080,1055,2135,4520
-170,-10,80,1070,1065,2135,4759
50,30,-110,1063,1073,2136,4762
20,40,40,1062,1074,2136,4960
20,30,50,1077,1059,2136,4943
-110,10,0,1063,1074,2137,5053
-60,40,70,1067,1070,2137,4865
-90,30,100,1064,1073,2137,4985
70,60,-10,1062,1076,2138,4972
60,60,-150,1069,1069,2138,4928
110,70,-70,1065,1074,2139,4963
130,60,-90,1074,1065,2139,4881
90,20,110,1056,1083,2139,4798
0,-40,60,1100,1039,2139,4796
60,80,-150,1049,1090,2139,5024
20,0,80,1068,1071,2139,4909
-150,20,50,1092,1047,2139,4560
180,0,80,1083,1057,2140,4693
-180,0,80,1083,1057,2140,4693
160,10,-150,1077,1063,2140,5189
-150,0,60,1071,1069,2140,4682
10,10,-80,1066,1075,2141,4934
-70,0,-110,1084,1057,2141,4883
60,-10,170,1048,1093,2141,4323
90,50,-10,1059,1082,2141,4819
140,60,-110,1086,1056,2142,4992
-80,-20,40,1058,1084,2142,4912
110,10,90,1055,1087,2142,4905
10,-40,70,1085,1058,2143,4922
-110,60,10,1072,1071,2143,4759
80,30,150,1055,1088,2143,4565
-160,70,60,1057,1086,2143,4978
100,30,-20,1049,1094,2143,4733
-150,50,170,1065,1078,2143,4913
20,80,10,1092,1052,2144,4957
100,50,-40,1064,1081,2145,4686
-80,-10,-140,1101,1044,2145,5023
-160,50,-180,1064,1081,2145,4978
-160,50,180,1064,1081,2145,4978
10,20,50,1075,1070,2145,5077
-80,50,-20,1077,1068,2145,4966
100,10,-50,1071,1075,2146,4532
-140,50,160,1054,1092,2146,4986
90,0,-30,1067,1079,2146,5123
160,20,-150,1076,1071,2147,5141
80,10,-100,1040,1107,2147,4947
120,-40,50,1065,1082,2147,4780
110,20,-70,1061,1086,2147,4903
100,20,-30,1067,1081,2148,4848
130,-10,80,1060,1089,2149,4955
130,60,120,1080,1069,2149,4694
-10,80,-80,1071,1079,2150,4860
-10,-20,50,1087,1063,2150,5014
110,40,130,1072,1078,2150,4785
60,-50,120,1081,1069,2150,4916
-90,-10,80,1056,1094,2150,4750
-120,-20,-120,1067,1084,2151,5062
70,20,150,1068,1083,2151,4621
170,-50,90,1074,1077,2151,4844
100,-20,20,1081,1070,2151,4775
40,-80,90,1086,1065,2151,5085
80,40,30,1058,1093,2151,4494
60,20,-110,1079,1073,2152,4695
-90,-20,50,1086,1066,2152,4808
100,-70,20,1086,1066,2152,4951
-160,-30,-150,1083,1069,2152,5065
80,60,-20,1079,1073,2152,4949
-160,-10,-160,1078,1074,2152,5024
110,0,80,1062,1091,2153,4957
-50,-10,40,1087,1066,2153,4889
170,10,-160,1064,1090,2154,5117
-50,20,-80,1075,1079,2154,4684
-160,20,60,1097,1057,2154,4673
110,-10,60,1112,1042,2154,4823
-140,-70,-100,1097,1058,2155,4926
-120,20,170,1097,1058,2155,4865
100,-30,-150,1053,1102,2155,4814
-80,70,100,1094,1062,2156,5008
100,-80,20,1082,1074,2156,5001
-110,30,140,1093,1063,2156,5090
50,50,30,1079,1077,2156,4947
150,40,-120,1082,1075,2157,4877
110,80,-80,1099,1058,2157,5063
-180,40,-160,1054,1103,2157,4972
180,40,-160,1054,1103,2157,4972
-150,70,50,1076,1081,2157,4898
110,-80,30,1078,1079,2157,5064
110,60,140,1090,1067,2157,4785
-130,50,150,1084,1073,2157,5012
80,50,170,1085,1073,2158,4767
-90,-30,10,1090,1068,2158,5062
-70,50,-30,1091,1067,2158,4999
-100,20,130,1081,1077,2158,5054
-180,-60,-150,1082,1077,2159,4911
180,-60,-150,1082,1077,2159,4911
0,-30,60,1091,1068,2159,4848
-110,-10,-30,1082,1077,2159,4759
-110,0,0,1084,1075,2159,4760
-110,-10,-40,1074,1086,2160,4748
50,0,130,1054,1106,2160,4768
100,60,150,1087,1073,2160,4764
-30,30,50,1105,1055,2160,5001
160,30,-140,1071,1089,2160,5059
-50,10,-90,1088,1073,2161,4818
160,-80,80,1072,1089,2161,5022
0,0,-80,1068,1093,2161,5002
-170,40,-170,1076,1086,2162,4987
80,-30,-160,1071,1091,2162,4726
20,60,-100,1087,1076,2163,5019
-110,-10,-20,1091,1072,2163,4898
-60,0,50,1081,1082,2163,4972
20,20,60,1083,1080,2163,5028
90,-40,150,1067,1097,2164,5095
80,0,-70,1076,1088,2164,4877
-90,0,100,1065,1099,2164,5176
100,10,-70,1061,1103,2164,4778
90,-30,0,1062,1103,2165,4908
40,40,80,1084,1081,2165,4609
160,-10,-160,1077,1088,2165,5145
-10,-60,50,1105,1060,2165,4988
-170,30,-170,1076,1089,2165,5135
-100,-80,-50,1096,1070,2166,4996
-40,-10,40,1091,1076,2167,4957
60,-30,170,1082,1085,2167,4866
-100,-50,-30,1112,1055,2167,4872
80,0,-130,1062,1105,2167,4788
110,60,-60,1080,1088,2168,4958
-170,70,-170,1083,1085,2168,5148
-90,50,-10,1093,1075,2168,4994
100,-40,160,1088,1080,2168,4933
120,50,-70,1083,1085,2168,4924
50,20,110,1089,1080,2169,4707
-180,-20,-160,1087,1082,2169,5008
90,0,-40,1083,1086,2169,4962
-140,0,-160,1115,1054,2169,5114
180,-20,-160,1087,1082,2169,5008
40,60,10,1076,1093,2169,4917
0,-50,60,1112,1058,2170,4835
-10,70,40,1099,1071,2170,4909
-110,-40,150,1097,1074,2171,4935
-40,-40,30,1087,1084,2171,5026
160,30,90,1093,1078,2171,4882
-50,30,60,1112,1060,2172,5027
-90,10,100,1055,1117,2172,5166
100,-10,20,1078,1094,2172,4832
10,80,20,1111,1062,2173,5061
20,10,-80,1073,1101,2174,5185
110,-30,-150,1058,1116,2174,4884
170,40,-150,1068,1106,2174,4930
60,-30,130,1078,1096,2174,4984
0,10,50,1089,1085,2174,5010
-90,10,-90,1099,1075,2174,4855
30,-40,-60,1065,1110,2175,4910
-120,-20,-110,1078,1097,2175,4881
-110,40,130,1083,1092,2175,5021
120,-80,40,1078,1097,2175,5179
150,20,-130,1086,1089,2175,5074
180,60,-160,1088,1088,2176,5308
60,-30,160,1087,1089,2176,4949
80,70,180,1098,1078,2176,4922
-90,20,100,1066,1110,2176,5112
-180,60,-160,1088,1088,2176,5308
80,70,-180,1098,1078,2176,4922
-170,-60,-140,1101,1075,2176,4980
-160,0,-160,1105,1071,2176,5086
90,-30,-150,1067,1109,2176,4757
120,40,120,1113,1064,2177,4875
-60,20,-80,1097,1080,2177,4693
140,-10,-140,1103,1074,2177,4972
100,10,20,1072,1105,2177,4793
-110,-10,-50,1083,1094,2177,4950
-130,-20,-140,1089,1088,2177,5186
10,-30,70,1097,1080,2177,4867
140,-20,80,1089,1088,2177,5108
150,-70,-170,1106,1072,2178,5097
120,70,-80,1104,1074,2178,5067
120,60,130,1097,1081,2178,4741
140,70,-110,1108,1070,2178,5168
-80,30,90,1067,1111,2178,4985
10,-20,70,1096,1082,2178,4933
0,80,-90,1083,1095,2178,4921
-70,-10,50,1095,1083,2178,5031
100,30,-10,1077,1102,2179,4797
20,-40,80,1111,1068,2179,4886
120,80,-90,1111,1068,2179,5161
170,-50,-160,1085,1094,2179,5101
-140,-30,100,1065,1115,2180,4884
150,60,-120,1100,1080,2180,5026
-170,50,-170,1071,1109,2180,5060
-30,-20,40,1111,1069,2180,4994
90,60,-30,1094,1086,2180,5012
90,-70,140,1087,1093,2180,4996
-110,20,160,1112,1068,2180,5005
130,30,-90,1098,1083,2181,4807
20,20,70,1100,1081,2181,4988
-160,0,70,1104,1078,2182,4900
-90,20,-50,1089,1093,2182,4899
60,10,130,1076,1107,2183,4811
-110,-10,-130,1082,1101,2183,4861
70,20,120,1084,1099,2183,4758
100,30,-30,1060,1123,2183,4841
-20,50,-70,1102,1081,2183,5000
40,50,30,1084,1099,2183,5152
-90,-60,-180,1100,1083,2183,4854
70,50,20,1101,1082,2183,4917
-90,-60,180,1100,1083,2183,4854
40,70,0,1077,1106,2183,4838
130,-20,-140,1090,1094,2184,5046
170,-70,90,1090,1094,2184,4923
50,-80,100,1097,1087,2184,5181
70,10,-100,1086,1098,2184,4684
-100,10,-90,1085,1099,2184,4610
50,80,-140,1079,1105,2184,5095
50,50,-130,1079,1106,2185,4994
-150,30,180,1090,1095,2185,5007
20,-50,80,1118,1067,2185,5054
90,40,150,1075,1110,2185,4768
-150,30,-180,1090,1095,2185,5007
130,-50,60,1105,1080,2185,4878
170,-60,90,1100,1085,2185,5021
-110,-10,0,1080,1106,2186,4987
100,20,10,1099,1087,2186,4808
90,60,160,1106,1080,2186,4870
-110,-10,-120,1093,1093,2186,4881
-180,50,-160,1081,1105,2186,5163
180,50,-160,1081,1105,2186,5163
-130,0,-160,1110,1076,2186,5067
110,30,-60,1074,1113,2187,4981
100,-50,20,1082,1105,2187,5057
-50,60,70,1113,1074,2187,5095
130,0,-120,1099,1089,2188,5139
20,10,80,1090,1098,2188,4894
60,40,70,1082,1106,2188,4716
10,-50,70,1118,1070,2188,5043
-160,-60,-130,1102,1086,2188,5027
-160,70,180,1102,1086,2188,5248
-180,-30,90,1086,1102,2188,4800
180,-30,90,1086,1102,2188,4800
-40,50,60,1116,1072,2188,5137
90,30,40,1095,1093,2188,4639
-160,70,-180,1102,1086,2188,5248
100,10,40,1098,1091,2189,4931
-90,70,110,1103,1086,2189,5109
-110,-10,-60,1102,1088,2190,5005
-50,0,-100,1109,1081,2190,5047
-140,70,40,1087,1103,2190,4893
60,0,170,1105,1085,2190,4567
120,40,-70,1088,1103,2191,4933
60,-30,-40,1084,1107,2191,5092
130,10,-110,1107,1084,2191,4876
10,60,30,1114,1077,2191,4919
50,-30,120,1083,1108,2191,5043
-120,-40,-60,1117,1075,2192,4887
-110,-70,160,1108,1084,2192,4906
-70,-30,20,1110,1082,2192,5087
-50,-70,10,1108,1084,2192,5168
110,-20,-130,1067,1125,2192,4885
0,10,-80,1096,1096,2192,5152
10,-10,70,1103,1090,2193,5025
80,50,10,1093,1100,2193,4801
80,-40,-10,1095,1098,2193,4961
120,-30,-170,1093,1100,2193,5182
60,50,30,1093,1101,2194,5015
-170,-10,-160,1098,1096,2194,5214
140,60,110,1110,1085,2195,4754
-90,-30,20,1108,1087,2195,5164
60,-20,-180,1077,1119,2196,4625
60,-20,180,1077,1119,2196,4625
-10,-10,50,1123,1073,2196,5129
120,0,-110,1124,1073,2197,4982
-100,-60,-40,1113,1084,2197,5087
60,-10,-60,1067,1130,2197,5097
40,0,120,1077,1120,2197,4766
130,-80,50,1085,1113,2198,5175
-40,-70,20,1122,1076,2198,5172
-130,-30,-120,1078,1121,2199,5202
40,-30,110,1102,1097,2199,5025
-170,60,-170,1094,1106,2200,5396
60,0,180,1088,1112,2200,4562
60,0,-180,1088,1112,2200,4562
-90,0,-120,1108,1092,2200,4976
140,0,-130,1107,1094,2201,5063
60,30,-130,1089,1113,2202,4969
-150,20,-170,1119,1083,2202,5222
-40,-40,-120,1107,1095,2202,4674
60,0,160,1085,1117,2202,4871
80,40,40,1123,1079,2202,4829
-160,20,-170,1086,1116,2202,5127
-120,-50,-70,1093,1110,2203,4996
-100,30,120,1108,1095,2203,5123
100,0,20,1101,1102,2203,4988
150,-80,70,1096,1107,2203,5072
-120,-20,-100,1098,1105,2203,4969
-110,-20,-20,1104,1099,2203,4870
140,50,-100,1120,1084,2204,5163
-120,-30,-60,1101,1103,2204,4781
-130,-40,-100,1121,1083,2204,4983
90,20,90,1126,1078,2204,4968
100,20,0,1077,1128,2205,4620
170,-10,-160,1120,1085,2205,5158
-120,50,140,1110,1095,2205,5050
-60,60,80,1107,1098,2205,5086
-50,-20,-120,1132,1074,2206,5015
-130,10,-170,1122,1084,2206,5055
160,0,-150,1096,1110,2206,5201
-40,10,50,1115,1091,2206,5183
-130,-10,-150,1123,1083,2206,5268
-100,70,120,1093,1114,2207,5194
-110,-10,-110,1118,1089,2207,4900
100,-10,-120,1101,1106,2207,4942
-110,10,-180,1115,1092,2207,5178
-110,10,180,1115,1092,2207,5178
70,-20,-160,1105,1103,2208,4778
140,40,-100,1119,1089,2208,5003
30,50,30,1084,1124,2208,5213
10,80,-100,1095,1113,2208,5019
60,0,-80,1114,1095,2209,4804
-130,-50,130,1108,1101,2209,4966
-150,-20,-150,1116,1093,2209,5145
160,20,-140,1107,1102,2209,5147
-110,-20,50,1125,1086,2211,4888
-130,20,180,1143,1068,2211,5071
-130,20,-180,1143,1068,2211,5071
140,-20,-150,1112,1100,2212,5022
0,-60,60,1131,1082,2213,5014
-120,-70,150,1115,1099,2214,4908
-100,0,170,1107,1107,2214,5137
-100,10,-60,1103,1111,2214,4945
110,-30,40,1088,1126,2214,4986
-110,-80,-60,1111,1103,2214,5048
-100,60,0,1109,1105,2214,5109
120,60,-70,1105,1110,2215,5035
50,60,10,1105,1110,2215,5244
30,-60,90,1116,1099,2215,5240
90,20,70,1130,1085,2215,4947
90,20,100,1119,1096,2215,4824
-130,-40,120,1104,1112,2216,4893
-90,-50,-180,1116,1101,2217,4903
-70,0,60,1117,1100,2217,5020
-90,-50,180,1116,1101,2217,4903
100,0,10,1114,1103,2217,4888
170,-30,-160,1107,1111,2218,5100
30,40,-100,1105,1113,2218,4916
-120,70,140,1098,1120,2218,5282
-150,-70,-110,1136,1083,2219,5096
120,10,90,1093,1126,2219,5036
-150,70,170,1117,1102,2219,5237
130,20,100,1118,1101,2219,5139
-110,20,0,1139,1080,2219,5086
30,20,-90,1120,1099,2219,5080
30,80,-120,1116,1103,2219,5047
160,40,90,1106,1113,2219,4832
70,0,-80,1115,1105,2220,4863
-130,70,150,1109,1111,2220,5352
60,-80,110,1105,1115,2220,5153
-160,60,-180,1099,1122,2221,5500
70,40,180,1105,1116,2221,4969
-30,20,50,1122,1099,2221,5140
70,40,-180,1105,1116,2221,4969
-160,60,180,1099,1122,2221,5500
140,80,120,1113,1108,2221,4998
30,0,110,1106,1115,2221,4925
40,80,-130,1113,1108,2221,5066
-70,60,90,1115,1107,2222,5122
-130,70,30,1105,1117,2222,4952
140,10,90,1106,1116,2222,4960
130,80,-100,1132,1090,2222,5238
20,30,-90,1119,1104,2223,5177
-110,0,-10,1107,1116,2223,5090
-100,0,180,1108,1115,2223,5164
-100,0,-180,1108,1115,2223,5164
70,30,90,1119,1104,2223,4864
-90,-40,0,1122,1102,2224,5188
-60,-70,0,1122,1102,2224,5137
110,0,70,1119,1105,2224,5171
-110,70,130,1097,1127,2224,5276
80,-10,-40,1083,1141,2224,5110
20,-30,-70,1087,1137,2224,5121
140,-80,60,1113,1112,2225,5173
160,-70,-160,1129,1096,2225,5188
-30,-70,30,1123,1102,2225,5192
140,-20,-160,1119,1106,2225,5310
180,-10,-160,1121,1105,2226,5300
70,60,0,1103,1123,2226,5165
-180,-10,-160,1121,1105,2226,5300
100,10,0,1097,1130,2227,4891
100,10,30,1094,1133,2227,5040
110,50,-50,1111,1117,2228,4855
110,-70,30,1111,1117,2228,5133
30,40,50,1085,1143,2228,5168
100,60,-40,1122,1106,2228,4975
140,-50,180,1131,1098,2229,5256
140,-60,-180,1111,1118,2229,5266
10,-60,70,1146,1083,2229,5134
140,-50,-180,1131,1098,2229,5256
40,-10,120,1107,1122,2229,5129
140,-60,180,1111,1118,2229,5266
-120,-70,-70,1129,1101,2230,5121
-100,10,160,1127,1104,2231,5207
50,50,40,1110,1121,2231,5075
-130,-70,140,1122,1110,2232,4981
-120,-60,-70,1132,1100,2232,5152
50,-30,-50,1130,1102,2232,5076
150,-10,-150,1123,1109,2232,5229
-140,70,160,1124,1108,2232,5263
110,20,100,1101,1131,2232,5089
150,80,110,1122,1111,2233,5033
130,-10,-130,1105,1128,2233,5105
70,-30,150,1082,1151,2233,5190
30,30,90,1109,1124,2233,4766
40,60,-120,1099,1135,2234,5225
20,0,90,1106,1128,2234,4934
70,70,-170,1110,1124,2234,5127
-20,60,-70,1133,1102,2235,5001
-80,-60,-170,1120,1115,2235,4988
-70,10,70,1125,1111,2236,5258
170,30,-150,1096,1140,2236,5247
20,80,-110,1129,1107,2236,5149
100,0,0,1127,1109,2236,4978
130,10,90,1125,1111,2236,5072
160,50,-130,1118,1119,2237,5081
150,30,-120,1128,1109,2237,5051
160,40,-130,1120,1117,2237,4958
30,40,70,1122,1115,2237,4981
110,-50,160,1115,1122,2237,5244
130,80,130,1121,1116,2237,5045
-70,30,80,1104,1133,2237,5177
120,-30,-150,1097,1141,2238,4945
-100,-70,170,1154,1084,2238,5003
-90,-50,-10,1142,1096,2238,4934
-180,30,-160,1113,1125,2238,5378
180,0,-160,1119,1119,2238,5221
-180,0,-160,1119,1119,2238,5221
180,30,-160,1113,1125,2238,5378
70,-80,120,1107,1131,2238,5176
-100,30,-10,1132,1107,2239,5209
-80,20,-70,1133,1106,2239,4877
100,10,-40,1082,1157,2239,5026
-30,-30,40,1142,1097,2239,5088
-90,0,110,1127,1112,2239,5104
130,70,-90,1130,1109,2239,5187
-150,-10,70,1117,1123,2240,4828
0,80,30,1130,1110,2240,5182
40,-60,100,1121,1119,2240,5176
70,40,60,1100,1140,2240,4767
90,0,-60,1123,1117,2240,5004
120,80,140,1125,1115,2240,5055
-10,0,50,1128,1112,2240,5259
-170,0,-160,1123,1118,2241,5173
-110,0,-70,1116,1125,2241,5057
110,-40,170,1119,1122,2241,5314
100,20,100,1116,1125,2241,5061
-120,-50,140,1133,1108,2241,5209
-100,10,-70,1131,1111,2242,4967
-80,20,90,1101,1141,2242,5140
-70,-70,-10,1130,1113,2243,5069
80,60,-10,1104,1139,2243,5091
-170,-50,100,1130,1114,2244,5212
-110,-20,80,1112,1132,2244,4914
-160,10,-160,1140,1104,2244,5227
60,0,140,1104,1140,2244,5078
20,-60,80,1142,1103,2245,5221
-130,-10,50,1135,1110,2245,4681
30,70,10,1108,1138,2246,4974
-140,-50,-110,1135,1112,2247,5167
-60,50,-40,1136,1111,2247,5188
-100,20,140,1136,1111,2247,5316
-90,-20,-170,1112,1135,2247,5179
-30,-10,-100,1120,1127,2247,5115
120,30,110,1132,1115,2247,4980
50,10,-90,1134,1114,2248,5027
60,30,-150,1113,1135,2248,4939
-100,60,120,1131,1117,2248,5265
140,10,-120,1134,1114,2248,5119
100,40,-30,1097,1151,2248,5000
110,-10,50,1130,1119,2249,4892
0,20,50,1103,1146,2249,5243
110,70,-60,1122,1127,2249,5110
-150,-30,-140,1138,1111,2249,5123
50,40,-120,1122,1128,2250,5239
40,40,-110,1132,1118,2250,5205
160,60,-130,1128,1122,2250,5146
-110,-20,100,1114,1136,2250,5003
-140,60,160,1113,1138,2251,5436
-20,-70,40,1144,1107,2251,5181
50,-20,140,1119,1132,2251,5119
-100,-30,0,1141,1110,2251,5171
-170,-40,-150,1143,1109,2252,5221
-80,-50,0,1141,1111,2252,4950
0,50,40,1136,1116,2252,5073
-50,-30,30,1133,1120,2253,5207
150,70,-120,1126,1127,2253,5315
-60,-40,20,1142,1111,2253,5103
100,70,-50,1121,1133,2254,5069
-140,-10,-150,1157,1097,2254,5397
60,60,10,1120,1135,2255,5398
-130,60,150,1126,1129,2255,5464
-80,-30,20,1137,1118,2255,5232
140,-30,-170,1123,1132,2255,5392
10,0,70,1130,1125,2255,5015
-90,60,110,1143,1112,2255,5261
-100,20,150,1137,1118,2255,5058
-130,40,160,1136,1119,2255,5418
-40,40,60,1163,1093,2256,5307
-90,20,-60,1135,1121,2256,4947
50,-20,130,1089,1167,2256,5058
-90,10,110,1089,1168,2257,5335
100,10,-10,1137,1120,2257,4887
-100,-20,150,1142,1115,2257,5064
-120,0,-160,1162,1095,2257,5385
110,80,150,1133,1124,2257,5137
-20,60,50,1151,1107,2258,5252
180,10,-160,1136,1122,2258,5261
110,40,-50,1099,1159,2258,4989
160,10,-140,1130,1128,2258,5266
-180,10,-160,1136,1122,2258,5261
-20,30,50,1166,1092,2258,5197
100,-90,150,1138,1121,2259,5326
30,-10,110,1125,1134,2259,5114
-20,70,-70,1141,1118,2259,5260
-160,-90,-110,1138,1121,2259,5326
-50,-90,0,1138,1121,2259,5326
0,-20,60,1144,1115,2259,5072
-110,-20,10,1125,1134,2259,5100
-100,-90,-50,1138,1121,2259,5326
30,-90,80,1138,1121,2259,5326
-180,-90,-130,1138,1121,2259,5326
-140,-90,-90,1138,1121,2259,5326
-130,-90,-80,1138,1121,2259,5326
-170,-90,-120,1138,1121,2259,5326
-10,-90,40,1138,1121,2259,5326
-60,-90,-10,1138,1121,2259,5326
-80,-90,-30,1138,1121,2259,5326
130,-90,180,1138,1121,2259,5326
-150,-90,-100,1138,1121,2259,5326
170,-90,-140,1138,1121,2259,5326
180,-90,-130,1138,1121,2259,5326
70,-30,-170,1127,1132,2259,4819
130,-90,-180,1138,1121,2259,5326
-30,-90,20,1138,1121,2259,5326
-110,-90,-60,1138,1121,2259,5326
90,-90,140,1138,1121,2259,5326
60,-90,110,1138,1121,2259,5326
-70,-90,-20,1138,1121,2259,5326
0,-90,50,1138,1121,2259,5326
-20,-90,30,1138,1121,2259,5326
110,-90,160,1138,1121,2259,5326
50,-90,100,1138,1121,2259,5326
80,-90,130,1138,1121,2259,5326
70,-90,120,1138,1121,2259,5326
10,-90,60,1138,1121,2259,5326
160,-90,-150,1138,1121,2259,5326
-90,-90,-40,1138,1121,2259,5326
120,-90,170,1138,1121,2259,5326
-120,-90,-70,1138,1121,2259,5326
40,-90,90,1138,1121,2259,5326
-40,-90,10,1138,1121,2259,5326
150,-90,-160,1138,1121,2259,5326
140,-90,-170,1138,1121,2259,5326
20,-90,70,1138,1121,2259,5326
120,20,100,1138,1122,2260,5164
100,-40,20,1110,1150,2260,5111
-40,-50,30,1143,1117,2260,5219
-100,-30,20,1123,1139,2262,5308
110,-60,30,1128,1134,2262,5174
120,10,-90,1137,1125,2262,4922
100,10,-20,1143,1119,2262,5092
-150,60,170,1122,1141,2263,5408
-20,70,50,1151,1112,2263,5168
100,10,-60,1124,1139,2263,4842
-80,60,100,1137,1126,2263,5310
-130,30,170,1133,1130,2263,5238
70,0,-150,1097,1166,2263,4820
-120,40,150,1135,1129,2264,5417
140,30,100,1160,1104,2264,5091
-110,0,-50,1121,1144,2265,4960
-120,-20,-90,1149,1116,2265,5043
140,80,-110,1145,1121,2266,5270
-110,0,-30,1131,1135,2266,4923
80,-10,-50,1126,1141,2267,5143
-110,-10,-10,1145,1122,2267,5135
-110,60,130,1158,1109,2267,5224
-170,10,-160,1140,1127,2267,5175
-50,0,50,1136,1132,2268,5197
100,20,20,1134,1134,2268,4948
-90,-40,-180,1127,1141,2268,5099
-90,-40,180,1127,1141,2268,5099
160,50,90,1155,1113,2268,4961
30,40,60,1136,1132,2268,5247
50,0,-80,1138,1130,2268,5158
-110,-40,-30,1150,1119,2269,4998
-120,60,140,1146,1123,2269,5357
-120,30,160,1147,1122,2269,5269
-100,-30,10,1142,1127,2269,5280
120,-10,-120,1139,1130,2269,5043
170,50,-140,1134,1135,2269,5245
100,-60,150,1122,1148,2270,5233
150,10,-130,1138,1132,2270,5334
-70,-20,40,1137,1133,2270,5387
160,80,100,1134,1136,2270,5187
60,-30,140,1122,1149,2271,5216
-110,50,130,1144,1127,2271,5303
-180,20,-160,1133,1138,2271,5397
80,-80,130,1137,1134,2271,5179
180,20,-160,1133,1138,2271,5397
-150,10,-160,1173,1099,2272,5280
-100,30,130,1159,1114,2273,5371
170,-20,-160,1151,1122,2273,5389
100,-70,150,1132,1141,2273,5179
60,-30,150,1106,1167,2273,5291
-130,-50,-90,1149,1125,2274,5185
-150,-20,80,1144,1130,2274,5011
120,-70,40,1113,1162,2275,5466
140,60,-100,1149,1126,2275,5289
-60,-60,10,1160,1115,2275,5045
10,50,-90,1129,1146,2275,5339
150,50,-110,1138,1137,2275,5110
130,-30,-170,1130,1146,2276,5324
20,20,80,1131,1145,2276,5188
-100,20,-20,1139,1137,2276,5143
70,30,170,1124,1152,2276,4830
60,-20,-50,1139,1137,2276,5368
70,-10,-60,1123,1153,2276,5090
-20,50,50,1166,1111,2277,5337
100,40,-20,1131,1146,2277,5148
120,70,-70,1141,1136,2277,5209
-120,70,20,1119,1159,2278,5144
100,10,50,1134,1144,2278,5133
-120,-80,-70,1151,1127,2278,5216
50,-10,140,1101,1177,2278,4977
90,30,50,1143,1135,2278,4971
140,20,-110,1148,1131,2279,5134
-20,20,50,1184,1095,2279,5240
100,10,70,1156,1123,2279,5217
-30,10,50,1139,1140,2279,5191
120,20,-80,1167,1112,2279,5334
160,70,-130,1139,1140,2279,5344
80,70,-30,1121,1159,2280,5139
-150,-10,-150,1153,1127,2280,5352
90,-80,140,1140,1140,2280,5218
110,0,-100,1127,1154,2281,5060
-100,50,120,1145,1136,2281,5283
60,0,150,1113,1168,2281,5046
-160,-20,-150,1142,1139,2281,5356
20,10,90,1142,1140,2282,5045
-160,-60,110,1144,1138,2282,5255
40,50,50,1141,1141,2282,5262
70,-40,170,1141,1141,2282,5112
90,70,-40,1127,1155,2282,5096
60,40,-160,1146,1136,2282,4940
-80,-70,-20,1163,1119,2282,5149
60,50,-160,1138,1145,2283,5209
80,0,-80,1134,1150,2284,5110
60,-10,180,1130,1154,2284,4641
70,10,-130,1114,1170,2284,5128
60,10,170,1132,1152,2284,4839
60,-10,-180,1130,1154,2284,4641
100,50,-30,1157,1127,2284,5003
-40,10,-90,1151,1134,2285,5121
-70,-60,0,1172,1114,2286,5026
130,50,-80,1186,1100,2286,5234
20,-40,-70,1140,1146,2286,5077
-160,0,-150,1158,1128,2286,5385
-10,20,50,1149,1137,2286,5283
-140,-50,120,1147,1139,2286,5198
-110,-20,90,1115,1171,2286,4837
-110,30,150,1164,1123,2287,5345
130,-40,180,1130,1157,2287,5307
-80,-10,60,1155,1132,2287,5266
170,10,-150,1120,1167,2287,5475
130,-40,-180,1130,1157,2287,5307
-10,30,-80,1144,1143,2287,5311
-80,30,-40,1161,1126,2287,5057
100,30,0,1101,1186,2287,4935
-90,-70,-180,1167,1121,2288,5060
-90,-70,180,1167,1121,2288,5060
-160,30,-170,1147,1141,2288,5334
100,80,160,1143,1145,2288,5263
100,80,-60,1158,1131,2289,5413
50,-50,-40,1133,1156,2289,5158
-50,30,-70,1157,1132,2289,5060
-100,0,-110,1133,1157,2290,5166
-20,40,50,1168,1122,2290,5238
-160,-70,-120,1164,1126,2290,5184
-110,40,140,1164,1126,2290,5522
180,-50,-150,1140,1150,2290,5173
130,-30,-150,1145,1145,2290,5074
70,60,10,1159,1131,2290,5186
-100,-30,160,1153,1137,2290,5211
-70,-50,10,1166,1124,2290,5024
-140,20,-170,1155,1135,2290,5416
-180,-50,-150,1140,1150,2290,5173
-170,-30,-150,1154,1137,2291,5412
-10,80,40,1152,1139,2291,5347
180,80,80,1142,1149,2291,5310
-180,80,80,1142,1149,2291,5310
-90,-10,90,1138,1153,2291,5222
20,-10,90,1133,1158,2291,5212
10,30,50,1146,1145,2291,5345
-110,0,-40,1139,1153,2292,5063
-60,30,70,1138,1154,2292,5244
-100,-40,-10,1164,1128,2292,5197
30,-30,100,1148,1144,2292,5178
120,0,80,1136,1157,2293,5214
-100,10,170,1157,1136,2293,5361
-110,0,-90,1157,1136,2293,5172
90,50,0,1140,1153,2293,4952
50,-60,110,1135,1158,2293,5115
-90,0,-130,1155,1139,2294,5460
70,-50,130,1138,1156,2294,5137
-110,0,-80,1164,1130,2294,5175
-120,-40,130,1141,1154,2295,5153
-100,40,120,1143,1152,2295,5260
-160,-40,100,1168,1127,2295,5267
-140,-30,-130,1139,1156,2295,5258
-60,-30,-140,1153,1142,2295,5070
90,20,80,1162,1133,2295,5248
-130,-30,-110,1135,1160,2295,5078
150,-60,-170,1152,1144,2296,5442
30,60,-110,1154,1142,2296,5477
-100,-20,140,1159,1137,2296,5319
-90,-30,30,1149,1147,2296,5363
100,-40,170,1152,1145,2297,5380
-140,-70,130,1152,1145,2297,5215
-90,50,110,1160,1137,2297,5251
-60,10,60,1160,1137,2297,5367
-140,-60,-100,1159,1138,2297,5259
170,80,90,1148,1150,2298,5348
-120,-10,-140,1177,1121,2298,5605
160,30,-130,1148,1150,2298,5220
40,50,40,1126,1173,2299,5284
-140,40,170,1156,1143,2299,5302
-10,-70,50,1173,1126,2299,5242
170,-70,-150,1169,1130,2299,5292
50,70,-140,1140,1160,2300,5306
100,10,60,1156,1144,2300,5032
80,60,0,1164,1136,2300,5128
70,-30,-30,1138,1163,2301,5363
110,60,-50,1152,1149,2301,5029
-120,-10,20,1134,1167,2301,5043
-80,0,-130,1170,1131,2301,5245
60,-50,-30,1128,1173,2301,5202
40,-10,-70,1135,1166,2301,5564
80,40,160,1134,1168,2302,4919
70,20,140,1145,1157,2302,4996
-100,-20,60,1155,1147,2302,5132
140,30,-100,1154,1148,2302,5183
-140,30,180,1163,1139,2302,5264
-140,30,-180,1163,1139,2302,5264
-100,-30,30,1156,1147,2303,5169
-110,0,-20,1136,1167,2303,5103
-70,0,-120,1151,1152,2303,5382
90,80,-50,1158,1145,2303,5372
-10,10,50,1171,1132,2303,5366
80,60,170,1141,1162,2303,5168
150,80,-120,1158,1145,2303,5399
50,40,80,1139,1165,2304,4951
-160,-40,-140,1158,1146,2304,5382
30,60,20,1147,1157,2304,5295
10,0,-80,1152,1152,2304,5475
-50,-60,20,1179,1128,2307,5252
50,-20,150,1134,1173,2307,5289
50,-20,160,1144,1163,2307,5229
130,-30,-160,1158,1150,2308,5389
90,-40,-180,1147,1162,2309,5336
-100,10,-80,1155,1154,2309,5195
90,60,-20,1152,1157,2309,5196
90,-40,180,1147,1162,2309,5336
90,-40,-170,1141,1169,2310,5184
140,70,-100,1151,1159,2310,5387
-90,-10,-150,1143,1167,2310,5399
-100,-20,70,1141,1169,2310,5070
150,60,100,1150,1161,2311,4869
-70,-60,-160,1162,1149,2311,5256
-120,-20,80,1146,1165,2311,5143
-20,10,50,1175,1136,2311,5226
-90,-70,-30,1168,1144,2312,5245
-90,-10,100,1138,1175,2313,5340
170,40,-140,1158,1155,2313,5434
70,70,-20,1132,1181,2313,5282
-100,30,140,1179,1135,2314,5388
150,-30,80,1137,1177,2314,5546
90,40,10,1150,1164,2314,4936
-130,-20,80,1147,1168,2315,5068
110,-40,-180,1161,1154,2315,5363
110,-40,180,1161,1154,2315,5363
50,50,60,1167,1148,2315,4953
-20,0,-90,1159,1157,2316,5275
70,-20,-40,1141,1175,2316,5479
-120,10,-170,1178,1138,2316,5467
90,-40,0,1142,1174,2316,5235
-80,-70,-170,1174,1143,2317,5300
-50,20,60,1184,1133,2317,5416
-110,0,-60,1148,1169,2317,5230
40,60,20,1158,1159,2317,5502
60,20,120,1143,1174,2317,5150
100,-40,-170,1147,1170,2317,5238
-80,-60,-10,1182,1135,2317,5176
-110,0,-160,1167,1151,2318,5531
-30,-30,-110,1166,1152,2318,5183
170,-40,-160,1158,1161,2319,5431
-80,50,100,1150,1169,2319,5408
100,-80,150,1157,1162,2319,5350
110,-30,-140,1146,1173,2319,5137
-120,-20,-80,1151,1168,2319,5123
-80,-40,10,1166,1154,2320,5370
130,10,-100,1151,1169,2320,5125
170,0,-150,1141,1180,2321,5513
-170,10,70,1181,1140,2321,5155
-120,-20,-70,1171,1150,2321,5068
60,-30,-180,1147,1174,2321,5074
-130,0,30,1183,1138,2321,4990
60,-30,180,1147,1174,2321,5074
60,60,-160,1160,1161,2321,5182
110,80,-70,1180,1141,2321,5508
70,50,-180,1166,1156,2322,4956
70,50,180,1166,1156,2322,4956
-30,-40,40,1178,1144,2322,5316
150,-40,-170,1157,1165,2322,5454
110,10,-80,1153,1169,2322,5309
150,-20,-160,1159,1163,2322,5505
-90,60,-10,1159,1163,2322,5340
110,-40,-170,1155,1168,2323,5286
10,10,60,1156,1167,2323,5390
100,-40,180,1154,1169,2323,5261
100,-40,-180,1154,1169,2323,5261
-110,-20,70,1156,1168,2324,5001
160,0,-140,1163,1161,2324,5363
-170,-70,-130,1172,1152,2324,5202
160,-70,80,1152,1172,2324,5475
40,10,120,1146,1179,2325,5055
40,50,60,1176,1149,2325,5260
120,-20,-130,1144,1181,2325,5217
-90,10,-100,1154,1171,2325,5194
170,10,80,1181,1144,2325,5264
120,-20,60,1183,1143,2326,5152
160,80,-130,1173,1153,2326,5473
-140,-20,80,1155,1172,2327,5136
20,70,20,1151,1176,2327,5182
0,-70,60,1169,1158,2327,5291
-180,-70,-140,1173,1154,2327,5305
30,20,100,1172,1155,2327,4883
180,-70,-140,1173,1154,2327,5305
80,80,-40,1174,1153,2327,5426
100,-30,-140,1145,1183,2328,5145
120,-10,70,1172,1156,2328,5417
50,-30,150,1155,1173,2328,5279
170,60,-140,1170,1159,2329,5444
-100,-50,-20,1188,1142,2330,5209
-130,-80,-80,1182,1148,2330,5434
100,10,-30,1155,1175,2330,5460
60,70,-10,1149,1181,2330,5398
-150,0,-150,1213,1117,2330,5629
-90,10,120,1169,1162,2331,5448
-50,50,70,1168,1163,2331,5528
80,-40,170,1154,1177,2331,5381
80,-50,140,1143,1188,2331,5393
80,-40,-180,1163,1169,2332,5211
20,30,60,1167,1165,2332,5429
-90,0,120,1168,1164,2332,5398
-20,-20,-100,1161,1171,2332,5197
80,-40,180,1163,1169,2332,5211
160,-10,-150,1164,1168,2332,5562
-150,90,-180,1169,1164,2333,5525
80,90,-50,1169,1164,2333,5525
10,90,20,1169,1164,2333,5525
-140,90,170,1169,1164,2333,5525
160,90,-130,1169,1164,2333,5525
50,90,-20,1169,1164,2333,5525
-90,90,120,1169,1164,2333,5525
140,90,-110,1169,1164,2333,5525
130,90,-100,1169,1164,2333,5525
60,90,-30,1169,1164,2333,5525
-80,90,110,1169,1164,2333,5525
30,90,0,1169,1164,2333,5525
-160,-10,-150,1188,1145,2333,5482
-130,90,160,1169,1164,2333,5525
-100,90,130,1169,1164,2333,5525
-180,90,-150,1169,1164,2333,5525
20,90,10,1169,1164,2333,5525
-30,90,60,1169,1164,2333,5525
130,20,-90,1182,1151,2333,5083
-90,20,110,1154,1179,2333,5530
0,90,30,1169,1164,2333,5525
170,90,-140,1169,1164,2333,5525
150,90,-120,1169,1164,2333,5525
100,90,-70,1169,1164,2333,5525
-110,90,140,1169,1164,2333,5525
180,90,-150,1169,1164,2333,5525
-120,90,150,1169,1164,2333,5525
-40,90,70,1169,1164,2333,5525
-170,80,70,1164,1169,2333,5400
-60,90,90,1169,1164,2333,5525
90,90,-60,1169,1164,2333,5525
-70,90,100,1169,1164,2333,5525
70,90,-40,1169,1164,2333,5525
-170,90,-160,1169,1164,2333,5525
40,90,-10,1169,1164,2333,5525
120,90,-90,1169,1164,2333,5525
150,20,90,1189,1144,2333,5294
20,30,70,1167,1166,2333,5444
130,40,-80,1190,1143,2333,5335
-150,90,180,1169,1164,2333,5525
-50,90,80,1169,1164,2333,5525
110,90,-80,1169,1164,2333,5525
-10,90,40,1169,1164,2333,5525
-20,90,50,1169,1164,2333,5525
150,60,-110,1175,1158,2333,5415
-160,90,-170,1169,1164,2333,5525
180,10,-150,1172,1162,2334,5486
-170,30,-160,1174,1160,2334,5483
-150,40,-180,1179,1155,2334,5310
-180,10,-150,1172,1162,2334,5486
-150,40,180,1179,1155,2334,5310
-100,-70,-40,1183,1152,2335,5394
150,20,-120,1166,1170,2336,5195
130,-40,60,1182,1154,2336,5247
180,50,-150,1176,1160,2336,5489
-180,50,-150,1176,1160,2336,5489
160,-20,-160,1187,1150,2337,5628
120,50,-60,1175,1163,2338,5247
-40,-20,40,1177,1161,2338,5464
-110,-60,-50,1182,1156,2338,5477
70,20,130,1158,1181,2339,5208
-110,-50,-40,1212,1127,2339,5281
-90,0,130,1193,1146,2339,5425
-180,0,-150,1178,1161,2339,5537
20,0,-80,1156,1183,2339,5499
-180,30,-150,1164,1175,2339,5449
180,0,-150,1178,1161,2339,5537
180,30,-150,1164,1175,2339,5449
40,-50,-50,1144,1195,2339,5304
120,-30,-140,1159,1181,2340,5385
-120,20,-180,1211,1129,2340,5272
-120,20,180,1211,1129,2340,5272
-130,-70,-80,1187,1153,2340,5587
170,20,-150,1154,1186,2340,5709
30,40,80,1170,1170,2340,5157
-80,-50,-170,1178,1163,2341,5210
-70,-50,-160,1194,1147,2341,5295
50,-20,-60,1151,1190,2341,5538
-110,10,-10,1169,1172,2341,5397
-140,-20,-140,1167,1175,2342,5684
-90,10,140,1183,1159,2342,5369
-140,-10,60,1189,1154,2343,4977
-160,80,60,1162,1181,2343,5440
-140,10,-160,1206,1137,2343,5598
40,-40,110,1168,1175,2343,5317
80,40,50,1167,1177,2344,4956
80,70,-20,1167,1177,2344,5410
150,-10,-140,1192,1152,2344,5513
100,70,-40,1180,1165,2345,5221
60,-60,120,1180,1165,2345,5412
30,0,-80,1158,1187,2345,5506
-90,40,110,1162,1184,2346,5366
90,0,-110,1147,1199,2346,5260
140,-40,70,1179,1167,2346,5381
-140,-40,110,1185,1161,2346,5171
40,-30,-60,1193,1153,2346,5333
90,-30,-140,1161,1185,2346,5158
10,-70,70,1179,1167,2346,5416
160,-60,80,1167,1180,2347,5436
50,60,20,1164,1183,2347,5622
120,60,-60,1197,1150,2347,5288
90,-40,160,1160,1187,2347,5447
50,50,50,1188,1159,2347,5266
90,80,170,1172,1175,2347,5401
30,-70,90,1191,1156,2347,5558
-70,50,90,1170,1178,2348,5455
120,30,-70,1162,1186,2348,5375
-140,-80,-90,1195,1153,2348,5533
170,20,-140,1166,1182,2348,5571
170,80,-140,1177,1172,2349,5632
110,-20,40,1171,1178,2349,5278
70,80,-30,1172,1177,2349,5468
-80,0,80,1164,1186,2350,5247
130,60,-80,1195,1156,2351,5337
110,-40,-160,1171,1180,2351,5206
150,-20,-150,1176,1176,2352,5555
110,-80,160,1183,1169,2352,5432
100,-10,10,1148,1204,2352,5280
50,60,-140,1186,1166,2352,5620
-110,-30,-20,1188,1164,2352,5191
90,60,-10,1175,1178,2353,5169
-120,-50,-60,1209,1144,2353,5407
120,0,-100,1171,1182,2353,5264
-100,-20,80,1147,1207,2354,5083
180,40,-150,1180,1174,2354,5561
-20,80,50,1181,1173,2354,5502
90,70,-30,1173,1181,2354,5207
-110,70,10,1163,1191,2354,5296
-180,40,-150,1180,1174,2354,5561
-140,-40,-120,1183,1172,2355,5586
-110,20,170,1213,1142,2355,5361
10,-10,-80,1175,1181,2356,5525
-130,-20,-130,1167,1189,2356,5339
-150,-40,-130,1200,1157,2357,5369
20,-70,80,1185,1172,2357,5431
40,-70,100,1184,1173,2357,5618
90,-40,170,1164,1194,2358,5415
100,60,-30,1176,1182,2358,5272
170,70,-140,1187,1171,2358,5531
110,50,-40,1180,1178,2358,5283
60,30,-160,1180,1179,2359,5119
60,10,-100,1166,1193,2359,5197
-60,0,-110,1188,1171,2359,5324
130,70,-80,1197,1162,2359,5380
-140,10,40,1188,1172,2360,5011
50,-30,160,1187,1173,2360,5165
100,40,-10,1161,1199,2360,5267
-40,-60,30,1206,1155,2361,5509
-80,10,-100,1198,1163,2361,5393
150,-50,-170,1186,1176,2362,5669
-80,10,90,1174,1188,2362,5539
-60,-50,20,1196,1167,2363,5346
20,40,50,1177,1186,2363,5466
120,80,-80,1194,1169,2363,5568
-60,50,80,1191,1172,2363,5482
100,0,-100,1167,1196,2363,5461
90,30,130,1178,1185,2363,5104
-70,-20,-150,1179,1185,2364,5333
-170,20,-160,1179,1185,2364,5621
30,10,110,1178,1186,2364,5115
50,-40,120,1179,1186,2365,5381
70,-50,-20,1149,1216,2365,5439
120,-60,40,1180,1185,2365,5390
60,20,-120,1186,1180,2366,5374
-10,-10,-90,1183,1183,2366,5482
-40,0,50,1182,1184,2366,5427
110,-50,30,1178,1189,2367,5456
150,40,-110,1172,1195,2367,5213
40,-10,130,1168,1200,2368,5347
170,30,-140,1178,1190,2368,5507
-90,10,130,1200,1168,2368,5551
-150,80,50,1176,1192,2368,5385
160,50,-120,1169,1199,2368,5334
20,-20,90,1195,1173,2368,5521
70,-40,140,1174,1195,2369,5401
-50,50,-50,1196,1173,2369,5539
100,30,120,1184,1185,2369,5163
-60,-10,50,1201,1168,2369,5376
-140,0,-150,1213,1157,2370,5690
-170,0,-150,1186,1184,2370,5387
60,80,-20,1181,1189,2370,5571
80,-10,-60,1168,1202,2370,5144
-80,-20,50,1194,1177,2371,5481
-160,20,-160,1192,1179,2371,5445
-110,10,-170,1203,1168,2371,5647
-170,10,-150,1191,1180,2371,5507
40,-20,120,1176,1195,2371,5456
90,-10,-20,1187,1184,2371,5545
-90,20,130,1204,1168,2372,5468
-160,10,60,1189,1183,2372,5293
-70,40,-40,1179,1193,2372,5544
50,30,100,1166,1206,2372,4993
-170,40,-160,1192,1180,2372,5578
160,60,-120,1194,1179,2373,5571
160,-30,-160,1186,1187,2373,5531
20,30,80,1179,1194,2373,5374
-90,0,140,1212,1162,2374,5377
140,50,-90,1203,1171,2374,5424
110,70,-50,1203,1171,2374,5355
-40,0,-100,1182,1192,2374,5450
110,20,-60,1141,1233,2374,5258
120,-40,-170,1206,1169,2375,5668
0,-70,-90,1188,1187,2375,5393
30,-20,-70,1186,1192,2378,5498
-90,-60,-20,1222,1156,2378,5346
-110,-30,130,1162,1216,2378,5282
-10,30,50,1230,1149,2379,5544
-100,70,0,1192,1187,2379,5416
-160,40,-170,1197,1182,2379,5487
10,-50,-80,1155,1224,2379,5335
30,-50,-60,1168,1212,2380,5540
180,80,-150,1194,1186,2380,5703
-180,80,-150,1194,1186,2380,5703
120,-80,170,1204,1176,2380,5579
60,20,-140,1179,1201,2380,5297
40,10,-90,1196,1185,2381,5340
140,-20,-140,1172,1210,2382,5403
160,10,-130,1209,1173,2382,5430
100,-40,-160,1187,1196,2383,5159
50,70,0,1181,1202,2383,5502
-30,-50,40,1219,1164,2383,5424
-140,80,40,1191,1193,2384,5397
100,-30,10,1187,1197,2384,5362
60,50,40,1205,1180,2385,5342
-150,30,-170,1206,1179,2385,5547
-40,30,60,1214,1171,2385,5523
160,20,-130,1202,1183,2385,5559
60,50,50,1219,1166,2385,5172
110,10,80,1201,1184,2385,5459
60,60,20,1192,1193,2385,5399
150,70,-110,1203,1182,2385,5549
70,10,-110,1165,1221,2386,5188
160,-60,-160,1197,1189,2386,5547
-130,20,-170,1211,1175,2386,5558
-110,-70,-50,1222,1164,2386,5465
0,-10,60,1197,1189,2386,5638
-100,0,-170,1195,1192,2387,5609
50,80,-10,1189,1198,2387,5601
20,20,90,1204,1184,2388,5184
40,0,-80,1181,1208,2389,5614
-110,-50,150,1203,1187,2390,5547
130,-20,70,1202,1188,2390,5623
80,-40,150,1187,1203,2390,5495
-100,0,-120,1204,1186,2390,5530
-170,-20,-150,1205,1185,2390,5712
130,0,-110,1196,1194,2390,5463
110,60,-40,1199,1191,2390,5198
170,0,80,1222,1168,2390,5460
-90,20,120,1182,1208,2390,5619
80,30,80,1213,1177,2390,5310
-80,40,100,1202,1188,2390,5466
30,-20,110,1181,1210,2391,5479
10,50,40,1205,1186,2391,5637
-80,-20,-160,1193,1199,2392,5501
100,70,150,1212,1181,2393,5332
-30,80,60,1199,1194,2393,5644
-180,-30,-150,1198,1196,2394,5563
180,-30,-150,1198,1196,2394,5563
-70,60,-30,1198,1196,2394,5691
-40,80,70,1200,1195,2395,5693
180,70,-150,1194,1201,2395,5627
-180,70,-150,1194,1201,2395,5627
-70,-10,-140,1220,1176,2396,5520
-70,20,80,1196,1201,2397,5552
-130,50,160,1214,1183,2397,5661
20,0,100,1197,1200,2397,5362
110,70,140,1211,1186,2397,5330
110,-70,160,1199,1199,2398,5489
-80,-40,-170,1220,1178,2398,5483
40,50,70,1207,1192,2399,5207
10,-40,-80,1176,1223,2399,5452
-150,10,50,1222,1177,2399,5241
70,60,20,1205,1195,2400,5434
-10,70,-80,1204,1196,2400,5555
90,-20,-10,1203,1197,2400,5423
-10,-70,-100,1199,1201,2400,5285
120,-30,50,1190,1210,2400,5377
100,50,-20,1185,1215,2400,5318
150,-70,70,1198,1202,2400,5728
90,-20,-130,1202,1198,2400,5215
140,40,-90,1206,1195,2401,5378
20,-50,-70,1168,1233,2401,5565
-80,-30,30,1216,1185,2401,5519
-150,-70,120,1214,1187,2401,5355
-170,-30,90,1199,1204,2403,5258
110,30,-50,1170,1233,2403,5398
-90,-30,180,1172,1231,2403,5507
60,-70,-30,1182,1221,2403,5385
-90,-30,-180,1172,1231,2403,5507
-90,20,140,1226,1177,2403,5524
-130,-40,-90,1205,1199,2404,5418
60,-40,130,1191,1213,2404,5569
120,-40,180,1193,1211,2404,5776
-80,60,-20,1208,1196,2404,5677
120,-40,-180,1193,1211,2404,5776
60,10,160,1188,1216,2404,5199
-30,40,-70,1213,1192,2405,5530
90,0,-70,1194,1211,2405,5447
-140,50,170,1220,1186,2406,5678
-170,80,-160,1212,1194,2406,5821
-160,50,-170,1214,1192,2406,5726
-170,50,-160,1215,1191,2406,5649
-120,10,10,1200,1207,2407,5477
-130,40,170,1215,1192,2407,5627
170,10,-140,1215,1192,2407,5615
10,40,-90,1196,1211,2407,5494
40,80,0,1195,1213,2408,5645
60,-40,160,1197,1211,2408,5449
100,80,-50,1201,1207,2408,5585
-90,30,110,1208,1201,2409,5629
-30,70,60,1220,1189,2409,5671
-120,50,150,1211,1198,2409,5729
90,80,-40,1195,1214,2409,5622
130,40,110,1209,1201,2410,5506
40,20,110,1184,1226,2410,5155
-160,10,-150,1225,1185,2410,5661
-110,-20,0,1188,1222,2410,5418
-110,-20,-10,1202,1209,2411,5472
-110,-20,60,1206,1205,2411,5318
-160,-30,90,1221,1190,2411,5411
-180,60,-150,1215,1197,2412,5727
70,70,-10,1199,1213,2412,5550
90,0,-80,1199,1213,2412,5472
180,60,-150,1215,1197,2412,5727
-130,80,30,1206,1206,2412,5433
130,-70,50,1197,1216,2413,5752
-120,30,170,1239,1174,2413,5700
-150,50,180,1213,1200,2413,5662
30,50,40,1199,1214,2413,5643
-150,50,-180,1213,1200,2413,5662
120,70,130,1222,1191,2413,5324
80,80,-180,1204,1209,2413,5475
80,80,180,1204,1209,2413,5475
60,70,0,1201,1212,2413,5669
-150,20,-160,1221,1193,2414,5636
140,-10,80,1199,1215,2414,5494
130,30,-80,1228,1186,2414,5573
40,70,-130,1192,1223,2415,5624
-60,-20,40,1217,1198,2415,5549
-160,-30,-140,1203,1212,2415,5635
0,30,50,1205,1211,2416,5619
110,-60,160,1206,1210,2416,5664
130,-80,180,1216,1200,2416,5672
130,-80,-180,1216,1200,2416,5672
-170,-10,-150,1229,1187,2416,5689
80,-30,-150,1200,1217,2417,5256
100,70,-30,1213,1204,2417,5689
170,-10,-150,1205,1212,2417,5740
-170,-50,-140,1235,1183,2418,5550
60,70,-160,1216,1202,2418,5605
10,-70,-80,1206,1212,2418,5400
-20,0,50,1239,1179,2418,5483
100,20,30,1190,1229,2419,5231
80,60,10,1211,1208,2419,5385
90,-10,-50,1200,1219,2419,5278
40,-20,130,1212,1207,2419,5612
80,30,140,1208,1211,2419,5224
20,20,-90,1212,1208,2420,5825
-30,0,50,1224,1196,2420,5451
50,50,-140,1209,1211,2420,5615
-100,10,-180,1220,1200,2420,5630
30,-60,-60,1208,1212,2420,5469
40,-60,-50,1201,1219,2420,5425
-100,10,180,1220,1200,2420,5630
60,60,30,1203,1218,2421,5445
140,-30,-150,1211,1210,2421,5499
-120,-30,-50,1226,1195,2421,5502
-130,-30,100,1199,1222,2421,5441
150,0,-130,1203,1218,2421,5549
-110,30,160,1243,1179,2422,5544
10,-30,-80,1194,1228,2422,5566
-130,10,-160,1240,1183,2423,5731
50,-70,-40,1192,1232,2424,5398
100,-20,10,1187,1237,2424,5366
-30,-80,30,1211,1213,2424,5590
-170,70,-160,1228,1196,2424,5857
180,20,-140,1205,1219,2424,5530
-180,20,-140,1205,1219,2424,5530
60,30,100,1203,1221,2424,5236
-150,-80,-100,1229,1196,2425,5683
80,-20,-30,1211,1214,2425,5638
50,60,30,1203,1222,2425,5562
-110,20,180,1230,1196,2426,5591
180,-10,80,1208,1218,2426,5553
120,80,-70,1207,1219,2426,5605
170,30,80,1210,1216,2426,5544
-110,20,-180,1230,1196,2426,5591
-180,-10,80,1208,1218,2426,5553
50,-60,-40,1200,1226,2426,5540
80,-20,-140,1191,1235,2426,5374
30,50,60,1239,1188,2427,5588
20,60,30,1197,1230,2427,5714
-30,60,60,1232,1195,2427,5658
-50,80,80,1211,1216,2427,5697
-70,-40,20,1226,1202,2428,5502
120,-50,170,1205,1223,2428,5673
130,80,-90,1222,1206,2428,5673
-10,60,-80,1198,1231,2429,5417
-160,30,-160,1210,1219,2429,5670
130,-30,-140,1210,1219,2429,5442
150,50,-100,1216,1214,2430,5487
80,80,-30,1219,1211,2430,5656
-60,-30,30,1226,1204,2430,5709
20,-10,100,1229,1201,2430,5458
-130,0,-150,1233,1197,2430,5803
-20,-80,40,1215,1215,2430,5616
110,80,-60,1212,1218,2430,5578
120,-40,-160,1198,1232,2430,5383
140,60,-90,1244,1187,2431,5589
160,70,-120,1232,1199,2431,5691
100,30,10,1209,1222,2431,5167
-120,-10,-130,1210,1221,2431,5640
-10,40,-80,1247,1184,2431,5690
80,-40,160,1188,1243,2431,5763
-50,-80,10,1214,1218,2432,5658
110,0,60,1240,1192,2432,5483
-150,-50,-120,1203,1229,2432,5528
-120,40,160,1239,1193,2432,5679
-170,60,-160,1215,1217,2432,5931
180,20,-150,1213,1219,2432,5815
-180,20,-150,1213,1219,2432,5815
-130,-10,-140,1220,1213,2433,5954
70,-40,160,1189,1244,2433,5714
-60,-80,0,1221,1212,2433,5651
-110,40,150,1217,1217,2434,5798
140,-10,-130,1210,1224,2434,5584
-100,20,160,1241,1193,2434,5598
130,-60,50,1224,1210,2434,5615
-120,-20,-60,1204,1231,2435,5501
0,60,40,1228,1207,2435,5588
-130,-60,-80,1241,1194,2435,5625
40,-80,-50,1202,1233,2435,5412
-40,-80,20,1226,1209,2435,5638
140,-70,60,1212,1223,2435,5723
-100,-20,130,1202,1234,2436,5428
70,0,-90,1216,1220,2436,5317
70,-60,-20,1201,1235,2436,5598
50,10,130,1188,1248,2436,5230
150,-20,80,1210,1226,2436,5563
30,-70,-60,1208,1228,2436,5462
-60,80,90,1210,1226,2436,5776
-120,-30,110,1206,1230,2436,5439
30,60,30,1213,1223,2436,5840
70,-60,130,1221,1216,2437,5611
120,40,-60,1190,1247,2437,5456
-100,30,150,1254,1183,2437,5642
60,-60,-30,1214,1223,2437,5572
90,70,-20,1225,1212,2437,5631
-90,30,-30,1234,1203,2437,5493
20,50,-100,1191,1247,2438,5546
-120,-60,-60,1244,1194,2438,5683
-20,-10,50,1239,1199,2438,5446
0,-50,-90,1202,1236,2438,5350
40,-70,-50,1209,1229,2438,5439
-60,20,70,1248,1190,2438,5717
-90,70,-10,1207,1232,2439,5639
170,40,80,1211,1228,2439,5301
-70,20,-80,1211,1228,2439,5252
80,-50,-10,1201,1238,2439,5625
120,-50,40,1204,1235,2439,5496
-70,-70,-160,1238,1202,2440,5359
10,70,30,1209,1231,2440,5540
30,80,10,1213,1227,2440,5696
-130,30,180,1241,1199,2440,5934
-130,30,-180,1241,1199,2440,5934
-120,80,20,1224,1216,2440,5514
170,-60,-150,1243,1197,2440,5678
-80,30,100,1241,1200,2441,5681
-10,40,50,1245,1196,2441,5596
140,70,-90,1242,1199,2441,5464
10,10,70,1228,1214,2442,5600
170,0,-140,1222,1220,2442,5556
20,-70,-70,1220,1222,2442,5514
80,70,-10,1218,1224,2442,5674
20,50,40,1206,1236,2442,5869
0,-40,-90,1203,1240,2443,5414
70,-40,-180,1219,1224,2443,5485
70,-40,180,1219,1224,2443,5485
40,-20,140,1212,1231,2443,5613
50,60,40,1224,1219,2443,5479
50,70,10,1232,1211,2443,5720
140,-30,70,1232,1211,2443,5762
-80,-10,-150,1223,1220,2443,5511
-80,40,-30,1240,1204,2444,5581
70,-70,-20,1207,1237,2444,5430
70,60,-180,1228,1216,2444,5582
-160,80,-170,1227,1217,2444,5858
-120,-40,-50,1250,1194,2444,5469
70,60,180,1228,1216,2444,5582
80,-30,-20,1215,1229,2444,5588
-50,-40,30,1241,1204,2445,5706
130,-20,-130,1195,1250,2445,5562
-160,70,-170,1237,1208,2445,6014
40,60,30,1226,1220,2446,5919
170,20,80,1238,1208,2446,5400
-120,0,10,1229,1217,2446,5420
50,40,-130,1210,1237,2447,5661
20,10,100,1225,1222,2447,5395
110,-10,-110,1214,1233,2447,5499
-70,-40,-160,1231,1216,2447,5701
-60,40,-50,1221,1227,2448,5619
140,-80,-170,1235,1213,2448,5699
-50,40,70,1243,1205,2448,5848
50,-70,110,1213,1235,2448,5769
170,60,-130,1224,1224,2448,5719
30,50,50,1213,1235,2448,5650
-100,20,-30,1226,1223,2449,5467
50,-10,-70,1200,1249,2449,5846
-100,-60,-30,1255,1194,2449,5570
100,0,-50,1196,1253,2449,5352
180,-10,-150,1231,1219,2450,5794
-90,10,150,1259,1191,2450,5613
180,-40,-150,1227,1223,2450,5815
-180,-10,-150,1231,1219,2450,5794
40,70,10,1218,1232,2450,5625
-180,-40,-150,1227,1223,2450,5815
160,40,-120,1234,1216,2450,5618
-160,-80,-110,1239,1211,2450,5689
-170,20,-150,1235,1216,2451,5681
-120,20,10,1236,1215,2451,5594
90,-50,0,1203,1248,2451,5533
-110,10,-70,1214,1238,2452,5426
80,-60,-10,1220,1232,2452,5608
-150,10,-150,1257,1195,2452,5772
10,-80,-80,1213,1239,2452,5441
-10,-80,50,1221,1231,2452,5662
90,60,0,1247,1205,2452,5344
30,-40,100,1231,1221,2452,5496
30,-80,-60,1208,1245,2453,5430
0,-80,-90,1227,1226,2453,5549
140,-40,-170,1216,1237,2453,5969
140,-30,-160,1221,1233,2454,5771
-20,-30,50,1247,1207,2454,5556
-40,70,70,1243,1211,2454,5834
90,70,160,1250,1204,2454,5467
-30,-60,40,1234,1220,2454,5632
160,-50,-160,1237,1218,2455,5890
-50,-20,40,1231,1224,2455,5676
-90,-20,60,1243,1212,2455,5650
-160,60,-170,1222,1234,2456,5938
30,50,70,1244,1213,2457,5317
70,50,30,1237,1220,2457,5508
70,40,70,1241,1216,2457,5332
-100,-40,160,1225,1232,2457,5637
0,-60,-90,1218,1239,2457,5412
-20,-40,50,1234,1224,2458,5538
130,80,-80,1226,1232,2458,5635
150,-80,-160,1246,1212,2458,5800
160,-20,-150,1213,1245,2458,5933
60,-10,-70,1218,1240,2458,5721
180,-40,90,1227,1232,2459,5641
-180,-40,90,1227,1232,2459,5641
0,-80,60,1221,1238,2459,5716
50,-10,150,1226,1233,2459,5472
70,80,-20,1224,1235,2459,5702
20,-80,-70,1207,1252,2459,5452
-70,-80,-10,1231,1229,2460,5745
50,-80,-40,1214,1246,2460,5441
-60,60,-40,1244,1216,2460,5714
-50,-30,-130,1212,1249,2461,5463
120,-40,-150,1229,1232,2461,5356
60,10,-180,1231,1230,2461,5352
60,10,180,1231,1230,2461,5352
-110,30,0,1231,1231,2462,5660
-100,40,130,1234,1228,2462,5828
60,-80,-30,1210,1252,2462,5480
-90,30,130,1265,1198,2463,5832
50,-30,130,1215,1248,2463,5757
130,60,-70,1238,1225,2463,5526
-90,-10,110,1232,1231,2463,5413
-140,-70,-90,1242,1221,2463,5868
170,20,-130,1236,1227,2463,5528
70,30,160,1249,1214,2463,5278
10,-20,-80,1242,1221,2463,5815
130,50,-70,1231,1232,2463,5352
-100,-20,120,1219,1244,2463,5583
70,80,-170,1224,1240,2464,5683
110,-40,30,1225,1239,2464,5739
90,-10,-30,1212,1253,2465,5756
50,-30,140,1239,1226,2465,5670
-60,-60,-150,1265,1201,2466,5448
-70,-30,30,1215,1251,2466,5687
10,20,60,1238,1228,2466,5838
100,20,90,1225,1241,2466,5498
-20,30,-80,1229,1237,2466,5589
-80,30,-50,1222,1244,2466,5469
80,-40,-170,1223,1243,2466,5571
60,50,60,1233,1234,2467,5175
70,10,-120,1205,1262,2467,5490
-110,-40,-20,1246,1221,2467,5647
-150,-60,-110,1252,1216,2468,5781
-70,30,-60,1231,1237,2468,5541
110,40,-40,1214,1255,2469,5650
130,-40,-170,1233,1236,2469,5947
140,80,-100,1237,1232,2469,5778
10,-60,-80,1216,1253,2469,5574
20,-80,80,1235,1234,2469,5771
90,40,20,1228,1242,2470,5414
60,70,10,1234,1236,2470,5685
30,30,-100,1242,1228,2470,5453
70,0,-140,1191,1280,2471,5262
-30,10,-90,1237,1234,2471,5382
-120,20,-170,1261,1210,2471,5708
100,-10,0,1226,1246,2472,5567
50,50,70,1253,1219,2472,5199
-150,80,180,1238,1234,2472,5855
-140,80,170,1247,1225,2472,5905
60,20,-150,1222,1250,2472,5445
-130,-50,-80,1243,1229,2472,5619
-150,80,-180,1238,1234,2472,5855
-100,0,-130,1261,1212,2473,5778
80,-70,-10,1201,1272,2473,5547
-80,-10,70,1231,1242,2473,5757
-170,0,-140,1234,1239,2473,5712
-100,-30,150,1252,1222,2474,5556
-80,-80,-20,1238,1236,2474,5788
10,-80,70,1228,1246,2474,5798
160,60,-110,1235,1240,2475,5575
170,50,-130,1240,1235,2475,5644
130,10,-90,1235,1240,2475,5414
140,20,-100,1228,1247,2475,5476
-170,-80,-120,1239,1236,2475,5768
-90,-80,-30,1247,1228,2475,5854
-50,-10,50,1243,1233,2476,5729
160,50,-110,1234,1242,2476,5593
50,30,-120,1239,1237,2476,5690
180,30,-140,1240,1236,2476,5840
-130,-30,-100,1249,1227,2476,5655
20,-30,90,1256,1220,2476,5791
-180,30,-140,1240,1236,2476,5840
120,70,-60,1248,1229,2477,5603
30,50,-110,1246,1231,2477,5872
150,60,-100,1258,1219,2477,5685
100,-40,10,1243,1234,2477,5466
130,70,120,1244,1233,2477,5488
160,-10,-140,1249,1228,2477,5717
-120,0,-150,1252,1225,2477,5984
-110,80,10,1226,1251,2477,5677
-20,-20,50,1261,1217,2478,5710
-20,-70,-110,1237,1241,2478,5383
-110,50,140,1246,1232,2478,5918
-150,-50,110,1248,1230,2478,5763
40,-80,100,1242,1237,2479,5792
100,60,-20,1246,1233,2479,5526
150,-60,70,1243,1236,2479,5760
120,50,-50,1235,1244,2479,5635
-10,-80,-100,1251,1228,2479,5631
160,-80,-150,1256,1224,2480,5929
40,50,-120,1240,1240,2480,5822
150,80,-110,1246,1234,2480,5840
-130,80,160,1231,1249,2480,5909
150,40,-100,1243,1237,2480,5569
-110,0,-150,1257,1223,2480,5966
20,80,20,1238,1242,2480,5803
100,50,-10,1245,1235,2480,5561
70,70,0,1240,1240,2480,5691
-160,40,-160,1257,1223,2480,5862
-160,-50,-130,1269,1211,2480,5873
20,-60,-70,1238,1243,2481,5574
-40,-30,-120,1264,1217,2481,5579
-160,20,-150,1262,1219,2481,5774
80,0,-120,1188,1293,2481,5577
60,-40,170,1247,1235,2482,5485
130,-10,-120,1239,1243,2482,5776
150,30,-110,1227,1255,2482,5694
-150,-20,-140,1247,1236,2483,5901
50,70,20,1249,1234,2483,5720
-60,0,60,1262,1222,2484,5745
30,-80,90,1249,1235,2484,5801
40,0,130,1230,1254,2484,5433
-100,20,-40,1239,1245,2484,5315
-150,40,-170,1272,1213,2485,5854
130,0,80,1228,1257,2485,5553
-110,-40,140,1260,1225,2485,5654
-100,-20,90,1214,1271,2485,5516
-90,-30,40,1244,1242,2486,5689
160,60,90,1249,1237,2486,5387
-120,80,150,1236,1251,2487,5928
-100,-80,-40,1253,1234,2487,5918
170,-80,-140,1251,1236,2487,5930
90,-10,-120,1224,1263,2487,5517
-70,80,100,1236,1252,2488,5893
120,-60,170,1241,1247,2488,5915
-100,-30,40,1288,1200,2488,5577
10,0,80,1258,1231,2489,5782
110,70,-40,1256,1233,2489,5733
-90,-50,0,1257,1232,2489,5547
-120,-70,-60,1278,1212,2490,5763
-120,-10,-120,1258,1232,2490,5845
-140,20,-160,1257,1233,2490,5880
150,-30,-160,1242,1248,2490,5903
140,0,-120,1246,1245,2491,5689
-180,70,-140,1252,1239,2491,5856
90,30,60,1257,1234,2491,5394
-20,-60,-110,1241,1250,2491,5626
180,70,-140,1252,1239,2491,5856
160,-50,80,1235,1256,2491,5843
30,40,90,1226,1265,2491,5368
170,70,-130,1269,1223,2492,5773
-140,40,180,1266,1226,2492,5854
140,30,-90,1265,1227,2492,5515
-90,-20,180,1258,1234,2492,5862
-140,40,-180,1266,1226,2492,5854
-70,40,90,1241,1251,2492,5797
-90,-20,-180,1258,1234,2492,5862
170,50,80,1245,1247,2492,5403
30,70,-120,1231,1262,2493,5814
-170,-60,100,1271,1222,2493,5796
40,-30,120,1250,1243,2493,5734
-110,80,140,1243,1250,2493,5900
10,40,50,1243,1251,2494,5914
-110,10,-40,1243,1251,2494,5511
-100,0,-160,1258,1236,2494,5927
120,-70,170,1239,1256,2495,5748
20,40,70,1254,1242,2496,5764
100,0,-20,1276,1220,2496,5692
90,-40,-160,1228,1268,2496,5532
140,10,-110,1262,1235,2497,5621
-100,10,-100,1247,1250,2497,5583
20,40,60,1232,1265,2497,5778
170,60,-120,1241,1257,2498,5651
100,20,80,1267,1231,2498,5640
40,60,40,1236,1262,2498,5780
-120,-80,150,1277,1222,2499,5732
-150,60,-180,1257,1242,2499,5991
-150,70,180,1259,1240,2499,5978
-150,70,-180,1259,1240,2499,5978
-150,60,180,1257,1242,2499,5991
-130,-10,40,1263,1237,2500,5473
160,-40,-160,1260,1240,2500,5893
-70,0,-130,1254,1246,2500,5648
-100,40,140,1264,1236,2500,5910
80,40,60,1244,1256,2500,5553
-100,80,130,1245,1256,2501,5963
-180,-60,-140,1266,1236,2502,5703
-180,-80,-130,1257,1245,2502,5883
60,80,-10,1253,1249,2502,5732
180,-80,-130,1257,1245,2502,5883
60,10,140,1227,1275,2502,5509
50,0,140,1210,1292,2502,5555
180,-60,-140,1266,1236,2502,5703
130,-50,50,1262,1241,2503,5701
-10,-60,-100,1237,1266,2503,5568
-80,80,110,1237,1266,2503,5972
-70,-20,50,1262,1241,2503,5769
120,60,-50,1273,1230,2503,5639
40,70,20,1269,1234,2503,5863
70,50,40,1261,1243,2504,5396
150,10,-120,1248,1257,2505,5712
-70,0,70,1281,1224,2505,5705
140,80,-90,1261,1244,2505,5691
-110,10,-60,1255,1250,2505,5579
-110,0,-100,1259,1247,2506,5734
-90,80,120,1237,1269,2506,5949
160,80,-120,1259,1248,2507,5887
-110,10,-90,1253,1254,2507,5485
110,0,-90,1259,1248,2507,5611
100,20,40,1245,1263,2508,5633
40,20,-100,1241,1267,2508,5531
-110,-80,-50,1269,1239,2508,6020
50,60,-150,1255,1253,2508,5973
20,40,80,1259,1249,2508,5541
-110,-80,160,1277,1231,2508,5789
-130,-20,-120,1244,1264,2508,5957
10,80,30,1255,1253,2508,5842
-30,50,60,1296,1213,2509,5926
20,-10,110,1252,1257,2509,5641
-80,10,-110,1256,1254,2510,5856
-180,10,-140,1253,1257,2510,5722
180,40,-140,1260,1250,2510,5812
70,-10,-70,1242,1268,2510,5708
180,10,-140,1253,1257,2510,5722
-180,40,-140,1260,1250,2510,5812
-170,40,-150,1267,1244,2511,5901
-120,10,-160,1273,1238,2511,6046
110,-40,-150,1247,1264,2511,5418
40,-50,110,1254,1257,2511,5738
90,80,-30,1279,1232,2511,5623
-110,-50,-30,1273,1238,2511,5706
60,40,80,1256,1255,2511,5437
-90,0,150,1268,1244,2512,5701
110,10,-70,1250,1262,2512,5869
110,50,130,1264,1248,2512,5561
-100,80,0,1262,1250,2512,5885
-170,30,-150,1258,1254,2512,5922
60,0,-90,1264,1248,2512,5366
-30,-70,-120,1247,1266,2513,5454
110,-20,-120,1262,1251,2513,5650
70,80,-10,1280,1233,2513,5623
0,70,-90,1248,1265,2513,5911
-140,60,170,1262,1251,2513,6004
-90,-10,-160,1240,1273,2513,5761
-10,50,-80,1245,1268,2513,5784
180,-20,-150,1292,1221,2513,5863
-180,-20,-150,1292,1221,2513,5863
60,80,0,1283,1231,2514,5637
-70,-10,60,1269,1245,2514,5911
50,80,10,1290,1224,2514,5701
-90,30,120,1261,1253,2514,5920
130,40,-70,1245,1269,2514,5601
80,30,90,1254,1260,2514,5612
130,-50,180,1266,1249,2515,5959
130,-50,-180,1266,1249,2515,5959
-60,-50,-150,1256,1259,2515,5521
60,-70,120,1255,1260,2515,5938
-140,70,170,1271,1245,2516,5997
40,60,50,1268,1248,2516,5676
10,10,80,1259,1257,2516,5760
-60,30,-70,1248,1268,2516,5583
-180,60,-140,1254,1262,2516,5860
180,60,-140,1254,1262,2516,5860
140,60,-80,1275,1241,2516,5576
30,70,20,1255,1262,2517,5758
-100,-50,-10,1290,1227,2517,5580
-160,-20,80,1274,1243,2517,5723
170,40,-130,1247,1270,2517,5731
-40,-10,-110,1282,1236,2518,5828
-90,-10,-170,1245,1273,2518,5889
100,50,140,1255,1263,2518,5612
-60,-70,10,1288,1230,2518,5830
-50,-50,30,1275,1244,2519,5830
170,-20,-150,1264,1255,2519,5960
90,40,30,1281,1238,2519,5557
-90,30,140,1274,1245,2519,5817
100,30,20,1262,1257,2519,5464
160,30,-120,1252,1267,2519,5808
70,-40,150,1225,1295,2520,5903
-60,-10,-130,1283,1237,2520,5764
-100,-80,170,1280,1240,2520,5847
100,0,-90,1263,1257,2520,5636
50,-80,110,1265,1255,2520,5870
-60,-70,-150,1289,1231,2520,5659
80,80,-20,1288,1232,2520,5628
150,-20,-140,1248,1273,2521,5741
40,70,30,1275,1246,2521,5728
150,80,-100,1266,1255,2521,5696
0,40,50,1252,1269,2521,6076
70,70,10,1278,1244,2522,5619
-130,-80,140,1287,1235,2522,5806
-70,10,-100,1284,1238,2522,5797
-20,-80,-110,1273,1249,2522,5719
-90,10,-110,1267,1255,2522,5799
-140,-40,-110,1247,1275,2522,5626
180,0,-140,1278,1245,2523,5668
-180,0,-140,1278,1245,2523,5668
120,20,-70,1239,1284,2523,5761
-150,-70,-100,1256,1267,2523,6017
-50,40,-60,1267,1256,2523,5957
70,-80,-20,1236,1287,2523,5605
150,70,-100,1270,1253,2523,5789
100,0,-10,1280,1243,2523,5673
-20,-50,50,1270,1254,2524,5698
-140,30,-170,1273,1251,2524,6083
10,-20,80,1282,1242,2524,5819
-130,-40,-80,1284,1241,2525,5681
90,-50,150,1262,1263,2525,5718
20,-20,100,1275,1250,2525,5721
-80,20,100,1258,1268,2526,5909
30,-10,120,1265,1262,2527,5773
-90,-80,-180,1281,1246,2527,5900
0,0,60,1258,1269,2527,5961
80,50,20,1263,1264,2527,5658
50,80,0,1273,1254,2527,5835
-50,10,60,1278,1249,2527,5828
-90,-80,180,1281,1246,2527,5900
170,-10,80,1275,1252,2527,5807
160,70,-110,1273,1255,2528,5874
130,-30,60,1277,1251,2528,5707
100,0,-80,1244,1285,2529,5819
140,70,110,1267,1262,2529,5574
-120,-20,70,1269,1260,2529,5627
90,-70,0,1244,1286,2530,5668
-100,-20,100,1257,1273,2530,5564
-80,0,90,1255,1275,2530,6201
170,80,-130,1274,1256,2530,5903
-170,-60,-130,1278,1253,2531,5854
40,30,100,1273,1259,2532,5529
130,70,-70,1285,1248,2533,5751
140,70,-80,1287,1246,2533,5682
-160,-70,110,1275,1258,2533,5716
-90,-10,120,1265,1268,2533,5682
60,10,150,1253,1280,2533,5676
170,10,-130,1254,1280,2534,5785
-90,-40,10,1267,1267,2534,5964
20,60,40,1277,1257,2534,5993
-100,20,-50,1256,1278,2534,5570
-60,40,80,1276,1258,2534,5873
-80,-30,-170,1275,1259,2534,5793
10,-10,80,1278,1257,2535,5742
-100,20,170,1280,1255,2535,5890
-110,10,-80,1259,1277,2536,5604
130,-40,-160,1278,1258,2536,5974
-40,-70,30,1276,1260,2536,5839
80,0,-90,1245,1291,2536,5739
-50,-70,20,1282,1254,2536,5853
150,-10,-130,1268,1269,2537,5817
80,70,170,1288,1249,2537,5758
-180,50,-140,1290,1247,2537,5890
10,30,-90,1269,1268,2537,5986
180,50,-140,1290,1247,2537,5890
80,70,0,1285,1253,2538,5764
110,30,110,1273,1265,2538,5652
-90,80,-10,1276,1263,2539,6003
150,-30,-150,1251,1288,2539,5906
140,-60,60,1281,1258,2539,5861
120,-10,-110,1271,1268,2539,5699
20,30,90,1299,1241,2540,5556
-170,70,-150,1274,1266,2540,5958
-70,-70,0,1290,1250,2540,5796
100,80,-40,1292,1248,2540,5772
-130,60,160,1287,1253,2540,6175
40,-30,130,1285,1256,2541,5914
-120,-10,-70,1277,1264,2541,5799
-90,40,-20,1277,1264,2541,5907
70,30,100,1290,1252,2542,5812
90,-60,0,1253,1289,2542,5693
40,60,-130,1278,1265,2543,5833
20,20,100,1270,1273,2543,5561
30,70,30,1286,1257,2543,5854
-160,-60,-120,1295,1249,2544,5917
-130,70,160,1287,1257,2544,6057
0,80,40,1284,1260,2544,5975
-160,0,-140,1281,1263,2544,5851
-90,20,150,1285,1260,2545,5823
50,10,-100,1276,1270,2546,5546
-50,60,-50,1283,1263,2546,5807
-80,-70,-10,1302,1245,2547,5815
170,50,-120,1276,1271,2547,5643
-80,70,-20,1255,1292,2547,5883
-80,-50,10,1296,1251,2547,5655
40,-30,150,1265,1282,2547,5640
-50,-10,-120,1310,1237,2547,5870
50,-10,160,1263,1284,2547,5424
-170,-40,-140,1274,1274,2548,5953
160,-10,80,1279,1269,2548,5783
-90,40,120,1289,1259,2548,6048
0,70,40,1263,1285,2548,5891
-100,0,-150,1290,1259,2549,5945
140,-30,-140,1286,1263,2549,5703
-140,10,-150,1312,1237,2549,6010
40,80,20,1310,1240,2550,5776
160,-40,80,1289,1262,2551,6201
-150,-30,90,1271,1280,2551,5810
160,80,-110,1282,1270,2552,5767
-40,-70,-130,1289,1263,2552,5689
170,70,-120,1289,1263,2552,5926
60,20,-130,1274,1279,2553,5782
-90,20,-70,1298,1255,2553,5684
60,70,20,1285,1268,2553,5672
30,-30,110,1274,1280,2554,5849
60,0,-170,1285,1269,2554,5516
10,20,70,1295,1260,2555,5923
-140,-50,-100,1294,1261,2555,5942
140,-50,60,1310,1245,2555,6004
-80,-30,40,1285,1270,2555,6046
40,-10,140,1280,1275,2555,5612
-80,-80,-170,1305,1251,2556,5908
70,-10,-150,1272,1284,2556,5570
10,-30,80,1291,1265,2556,5884
-100,-50,160,1293,1263,2556,5723
-10,-50,60,1310,1246,2556,5788
130,-40,-150,1272,1285,2557,5810
-70,-80,-160,1293,1264,2557,5855
-60,0,-120,1294,1263,2557,5792
-180,60,-130,1265,1292,2557,5854
-80,-60,0,1280,1277,2557,5720
100,60,-10,1302,1255,2557,5570
-40,50,-60,1280,1277,2557,6014
180,60,-130,1265,1292,2557,5854
-50,70,80,1282,1276,2558,6020
60,80,-160,1279,1279,2558,5925
110,20,90,1266,1292,2558,5765
-110,-60,-40,1320,1238,2558,5908
30,30,100,1291,1267,2558,5458
90,-10,-60,1265,1293,2558,5585
-120,0,-70,1293,1265,2558,5861
-140,-80,130,1301,1258,2559,5887
50,20,120,1265,1294,2559,5563
90,30,120,1272,1287,2559,5719
150,-10,80,1278,1281,2559,5909
30,0,120,1274,1285,2559,5744
-170,10,-140,1284,1276,2560,6007
-140,-10,-140,1295,1265,2560,6168
160,20,-120,1285,1275,2560,5760
60,-80,120,1290,1270,2560,5916
-90,-10,130,1293,1268,2561,5895
-40,60,70,1292,1269,2561,6103
-30,40,60,1317,1244,2561,6085
-70,-60,10,1294,1267,2561,5695
-180,80,-140,1299,1262,2561,6087
180,80,-140,1299,1262,2561,6087
130,30,100,1297,1265,2562,5845
-170,50,-150,1286,1276,2562,6005
-10,-50,-100,1256,1306,2562,5738
120,-10,60,1322,1240,2562,5899
-120,-10,-110,1291,1271,2562,5886
20,-20,110,1263,1300,2563,5921
-30,-80,-120,1284,1279,2563,5796
30,-50,100,1280,1283,2563,5877
-110,10,-30,1277,1286,2563,5651
-110,10,-50,1274,1289,2563,5777
100,-10,-110,1266,1297,2563,5817
-130,-30,-90,1288,1276,2564,5966
90,0,-100,1282,1282,2564,5779
80,-60,140,1278,1286,2564,5914
-80,0,-140,1313,1251,2564,5902
20,70,-110,1282,1283,2565,6011
-100,10,-170,1296,1269,2565,6152
170,30,-130,1285,1280,2565,5738
150,70,-90,1300,1265,2565,5739
-40,-80,-130,1273,1293,2566,5879
-110,60,140,1320,1246,2566,6218
-10,50,50,1295,1271,2566,5972
-160,-10,70,1296,1270,2566,5870
50,-50,120,1283,1283,2566,5853
-40,-30,40,1294,1273,2567,5906
90,0,-90,1282,1285,2567,5998
-50,-70,-140,1299,1268,2567,5848
-50,-60,-140,1298,1270,2568,5701
-10,-40,60,1290,1278,2568,5887
-90,-70,-20,1304,1264,2568,5955
-120,-80,-60,1292,1277,2569,6144
100,-50,160,1292,1277,2569,6012
-70,10,80,1303,1266,2569,6005
60,40,-170,1289,1280,2569,5634
70,-20,-50,1262,1307,2569,5977
-170,0,70,1287,1283,2570,5918
-10,80,50,1290,1280,2570,6071
80,-80,-10,1259,1311,2570,5755
-90,0,-140,1293,1277,2570,5819
20,-40,90,1308,1262,2570,5966
160,0,-130,1283,1287,2570,5875
-120,70,150,1304,1267,2571,6214
0,-30,70,1303,1268,2571,6039
-120,-50,-50,1334,1237,2571,5740
90,-20,-20,1290,1281,2571,5789
30,-20,120,1275,1296,2571,5877
-110,40,160,1318,1254,2572,6134
110,80,-50,1307,1265,2572,5904
130,0,-100,1265,1307,2572,5587
60,-40,140,1261,1311,2572,6040
-60,-80,-150,1300,1272,2572,5905
60,-40,150,1280,1292,2572,5941
-120,0,-60,1293,1279,2572,5799
40,-20,150,1287,1286,2573,5671
-160,50,-160,1289,1284,2573,6164
170,-10,-140,1277,1296,2573,5963
-120,50,160,1304,1269,2573,6134
-40,-10,50,1282,1291,2573,6054
-100,50,130,1296,1277,2573,6193
30,50,80,1273,1301,2574,5771
40,80,10,1289,1286,2575,5962
-30,-60,-120,1297,1278,2575,5708
-30,-70,40,1304,1271,2575,5801
20,50,70,1304,1271,2575,5926
100,0,-70,1259,1317,2576,5914
50,20,-110,1309,1267,2576,5849
-80,0,100,1273,1303,2576,6138
-10,-60,60,1326,1250,2576,6039
70,-30,-160,1277,1299,2576,5540
130,-70,180,1276,1301,2577,5975
110,20,-50,1242,1335,2577,5909
130,-70,-180,1276,1301,2577,5975
140,-40,-160,1305,1273,2578,6178
100,40,130,1298,1280,2578,5839
90,-30,-10,1261,1317,2578,6055
-40,20,60,1298,1280,2578,6085
110,20,-20,1302,1276,2578,5819
70,40,170,1276,1302,2578,5678
150,80,-90,1310,1268,2578,5824
-80,10,100,1273,1305,2578,6083
110,-10,40,1266,1312,2578,5715
140,-90,-160,1286,1293,2579,6180
-80,-90,-20,1286,1293,2579,6180
110,-90,170,1286,1293,2579,6180
10,-90,70,1286,1293,2579,6180
-100,-90,-40,1286,1293,2579,6180
50,-90,110,1286,1293,2579,6180
90,-90,150,1286,1293,2579,6180
150,-90,-150,1286,1293,2579,6180
-160,-90,-100,1286,1293,2579,6180
-170,-90,-110,1286,1293,2579,6180
0,-90,60,1286,1293,2579,6180
-20,-90,40,1286,1293,2579,6180
-60,-90,0,1286,1293,2579,6180
-180,-90,-120,1286,1293,2579,6180
-10,-40,-100,1275,1304,2579,5716
160,-90,-140,1286,1293,2579,6180
170,-90,-130,1286,1293,2579,6180
-10,-90,50,1286,1293,2579,6180
180,-90,-120,1286,1293,2579,6180
70,-90,130,1286,1293,2579,6180
-150,-90,-90,1286,1293,2579,6180
-110,-90,-50,1286,1293,2579,6180
-30,-90,30,1286,1293,2579,6180
130,-90,-170,1286,1293,2579,6180
-50,-90,10,1286,1293,2579,6180
-40,-90,20,1286,1293,2579,6180
30,-90,90,1286,1293,2579,6180
-90,-60,-10,1288,1291,2579,5713
-130,-90,-70,1286,1293,2579,6180
-120,-90,-60,1286,1293,2579,6180
-90,-90,-30,1286,1293,2579,6180
120,-90,-180,1286,1293,2579,6180
80,-90,140,1286,1293,2579,6180
-140,-90,-80,1286,1293,2579,6180
40,-90,100,1286,1293,2579,6180
60,-90,120,1286,1293,2579,6180
100,-90,160,1286,1293,2579,6180
120,-90,180,1286,1293,2579,6180
-70,-90,-10,1286,1293,2579,6180
20,-90,80,1286,1293,2579,6180
170,90,-120,1301,1279,2580,5850
10,90,40,1301,1279,2580,5850
40,90,10,1301,1279,2580,5850
-160,90,-150,1301,1279,2580,5850
-120,90,170,1301,1279,2580,5850
-40,90,90,1301,1279,2580,5850
10,70,-100,1266,1314,2580,6173
-70,90,120,1301,1279,2580,5850
-50,90,100,1301,1279,2580,5850
0,90,50,1301,1279,2580,5850
-100,90,150,1301,1279,2580,5850
120,90,-70,1301,1279,2580,5850
30,90,20,1301,1279,2580,5850
70,90,-20,1301,1279,2580,5850
-150,90,-160,1301,1279,2580,5850
50,90,0,1301,1279,2580,5850
20,90,30,1301,1279,2580,5850
150,90,-100,1301,1279,2580,5850
180,90,-130,1301,1279,2580,5850
-110,90,160,1301,1279,2580,5850
-80,90,130,1301,1279,2580,5850
140,90,-90,1301,1279,2580,5850
80,90,-30,1301,1279,2580,5850
-170,90,-140,1301,1279,2580,5850
130,90,-80,1301,1279,2580,5850
-180,90,-130,1301,1279,2580,5850
-130,90,-180,1301,1279,2580,5850
-90,90,140,1301,1279,2580,5850
110,90,-60,1301,1279,2580,5850
-10,90,60,1301,1279,2580,5850
-140,90,-170,1301,1279,2580,5850
-20,90,70,1301,1279,2580,5850
-60,90,110,1301,1279,2580,5850
-130,90,180,1301,1279,2580,5850
-30,90,80,1301,1279,2580,5850
100,90,-50,1301,1279,2580,5850
160,90,-110,1301,1279,2580,5850
90,90,-40,1301,1279,2580,5850
60,90,-10,1301,1279,2580,5850
-120,-20,-50,1293,1288,2581,5667
130,-60,180,1287,1294,2581,6126
20,70,40,1331,1250,2581,5913
130,-60,-180,1287,1294,2581,6126
170,-30,-150,1306,1275,2581,6070
20,0,110,1298,1283,2581,5667
-120,-10,-90,1284,1297,2581,5870
-40,-60,-130,1308,1273,2581,5796
-120,-60,140,1301,1281,2582,5901
10,60,40,1290,1292,2582,6113
20,-10,-80,1290,1292,2582,5924
-30,30,-80,1279,1303,2582,5661
30,80,30,1329,1253,2582,5831
70,-70,130,1296,1286,2582,6051
120,10,-80,1303,1279,2582,6016
-20,-60,50,1295,1287,2582,5860
160,0,80,1297,1285,2582,5876
-60,70,90,1289,1294,2583,6128
110,-30,30,1303,1280,2583,5914
60,20,170,1296,1287,2583,5499
-130,50,170,1309,1274,2583,6018
-130,20,-160,1310,1273,2583,6230
170,-50,-150,1302,1281,2583,6139
40,-30,140,1297,1287,2584,5869
120,80,-60,1305,1279,2584,5962
70,50,50,1301,1283,2584,5564
-60,-20,-140,1307,1278,2585,6000
20,50,60,1284,1301,2585,5981
-30,-10,50,1315,1271,2586,5961
-130,-60,130,1302,1284,2586,6054
-120,60,150,1316,1270,2586,6292
80,-40,-160,1281,1305,2586,5748
40,40,90,1270,1316,2586,5620
30,-30,120,1297,1290,2587,5972
80,90,-40,1290,1297,2587,6112
-50,90,90,1290,1297,2587,6112
120,90,-80,1290,1297,2587,6112
-80,90,120,1290,1297,2587,6112
-20,90,60,1290,1297,2587,6112
-130,90,170,1290,1297,2587,6112
40,90,0,1290,1297,2587,6112
-90,90,130,1290,1297,2587,6112
10,90,30,1290,1297,2587,6112
170,90,-130,1290,1297,2587,6112
60,90,-20,1290,1297,2587,6112
30,90,10,1290,1297,2587,6112
130,90,-90,1290,1297,2587,6112
0,90,40,1290,1297,2587,6112
-70,90,110,1290,1297,2587,6112
-100,90,140,1290,1297,2587,6112
-120,90,160,1290,1297,2587,6112
-10,90,50,1290,1297,2587,6112
110,90,-70,1290,1297,2587,6112
50,-40,160,1291,1296,2587,5777
-140,90,180,1290,1297,2587,6112
-60,90,100,1290,1297,2587,6112
90,-80,0,1272,1315,2587,5971
-30,90,70,1290,1297,2587,6112
-140,90,-180,1290,1297,2587,6112
30,10,-90,1258,1329,2587,5955
160,90,-120,1290,1297,2587,6112
-180,90,-140,1290,1297,2587,6112
100,-40,-150,1267,1320,2587,5819
100,90,-60,1290,1297,2587,6112
90,90,-50,1290,1297,2587,6112
70,90,-30,1290,1297,2587,6112
50,90,-10,1290,1297,2587,6112
160,80,-100,1316,1271,2587,5834
-50,30,70,1313,1274,2587,5943
-160,90,-160,1290,1297,2587,6112
20,90,20,1290,1297,2587,6112
-40,90,80,1290,1297,2587,6112
150,90,-110,1290,1297,2587,6112
-170,90,-150,1290,1297,2587,6112
-150,90,-170,1290,1297,2587,6112
140,90,-100,1290,1297,2587,6112
180,90,-140,1290,1297,2587,6112
-110,90,150,1290,1297,2587,6112
60,-10,-170,1288,1300,2588,5633
90,-10,-40,1288,1300,2588,5923
-70,30,90,1299,1289,2588,6018
40,40,-120,1280,1308,2588,5955
-160,70,-160,1296,1292,2588,6175
60,-40,-40,1282,1307,2589,5982
90,-50,-180,1283,1306,2589,6000
-120,-20,30,1326,1263,2589,5679
-10,60,50,1305,1284,2589,6045
150,-40,-160,1295,1294,2589,6014
170,80,-110,1323,1266,2589,5815
90,-50,180,1283,1306,2589,6000
-170,80,-150,1307,1283,2590,6149
30,60,40,1298,1292,2590,6035
120,50,120,1315,1275,2590,5748
100,-70,10,1300,1290,2590,5749
10,30,60,1274,1317,2591,6244
90,70,-10,1307,1284,2591,5819
-100,20,-60,1312,1280,2592,5737
30,70,40,1314,1278,2592,5971
180,70,-130,1307,1285,2592,5768
160,-30,80,1298,1294,2592,5959
-150,-10,-140,1327,1265,2592,6204
-180,70,-130,1307,1285,2592,5768
50,-40,-50,1282,1311,2593,5873
30,80,20,1297,1296,2593,5977
30,-20,130,1296,1297,2593,5955
50,-30,170,1277,1316,2593,5854
-110,20,-170,1309,1284,2593,6050
-120,40,170,1324,1269,2593,6160
60,50,-170,1308,1285,2593,5875
-110,10,-20,1315,1278,2593,5915
100,20,50,1295,1299,2594,5853
50,-20,170,1299,1296,2595,5548
-100,70,130,1301,1295,2596,6352
100,0,-40,1275,1321,2596,5778
-100,60,130,1319,1277,2596,6309
110,10,70,1321,1276,2597,5738
-110,10,-160,1312,1285,2597,6171
120,0,-90,1297,1300,2597,5820
-110,70,140,1311,1287,2598,6268
30,-30,-70,1294,1304,2598,6032
170,80,-120,1291,1307,2598,5941
50,70,-150,1300,1298,2598,6141
90,50,150,1280,1318,2598,5814
-10,-30,60,1317,1281,2598,6053
-160,-10,-140,1319,1280,2599,5987
10,20,-90,1295,1304,2599,5966
140,50,-80,1304,1295,2599,5804
-100,-40,0,1307,1292,2599,6125
-160,10,-140,1307,1292,2599,6038
-70,-30,40,1314,1285,2599,6107
-130,-50,-70,1326,1274,2600,5938
140,80,-80,1308,1292,2600,5890
-50,-80,-140,1308,1292,2600,6009
-160,-70,-110,1314,1286,2600,6062
160,-20,-140,1296,1305,2601,5860
0,-40,70,1316,1285,2601,5885
-150,0,-140,1329,1272,2601,6022
120,70,-50,1315,1286,2601,5903
140,-20,-130,1283,1318,2601,6127
10,20,80,1303,1298,2601,5947
100,-50,10,1304,1297,2601,5867
0,-30,-90,1274,1328,2602,5933
170,-40,-150,1319,1283,2602,6064
-120,-20,40,1335,1267,2602,5612
160,40,-110,1288,1314,2602,5884
-120,-10,-80,1309,1293,2602,5987
130,20,-80,1294,1309,2603,5871
120,20,90,1293,1311,2604,5890
-90,10,160,1335,1269,2604,6023
-70,70,100,1290,1314,2604,6229
70,-80,130,1314,1290,2604,5996
-100,0,-140,1326,1279,2605,5880
60,-20,-60,1286,1319,2605,6148
-160,80,-160,1317,1288,2605,6190
30,60,60,1318,1287,2605,5907
80,-50,-180,1307,1299,2606,5950
-100,-20,110,1302,1304,2606,5850
80,-50,180,1307,1299,2606,5950
-180,90,80,1295,1312,2607,5998
-10,90,-90,1295,1312,2607,5998
-100,90,0,1295,1312,2607,5998
0,90,-100,1295,1312,2607,5998
140,90,120,1295,1312,2607,5998
30,90,-130,1295,1312,2607,5998
-110,90,10,1295,1312,2607,5998
80,90,-180,1295,1312,2607,5998
60,90,-160,1295,1312,2607,5998
160,90,100,1295,1312,2607,5998
-150,90,50,1295,1312,2607,5998
80,90,180,1295,1312,2607,5998
-80,90,-20,1295,1312,2607,5998
-130,90,30,1295,1312,2607,5998
-50,90,-50,1295,1312,2607,5998
-20,90,-80,1295,1312,2607,5998
180,90,80,1295,1312,2607,5998
10,90,-110,1295,1312,2607,5998
50,90,-150,1295,1312,2607,5998
20,90,-120,1295,1312,2607,5998
120,90,140,1295,1312,2607,5998
-170,90,70,1295,1312,2607,5998
-40,90,-60,1295,1312,2607,5998
70,90,-170,1295,1312,2607,5998
-120,90,20,1295,1312,2607,5998
-140,90,40,1295,1312,2607,5998
130,90,130,1295,1312,2607,5998
110,90,150,1295,1312,2607,5998
170,90,90,1295,1312,2607,5998
-30,90,-70,1295,1312,2607,5998
40,90,-140,1295,1312,2607,5998
-160,90,60,1295,1312,2607,5998
-90,90,-10,1295,1312,2607,5998
100,90,160,1295,1312,2607,5998
-60,90,-40,1295,1312,2607,5998
-70,90,-30,1295,1312,2607,5998
10,-10,90,1307,1300,2607,6008
150,90,110,1295,1312,2607,5998
90,90,170,1295,1312,2607,5998
-30,-20,-110,1314,1294,2608,5811
40,50,80,1314,1294,2608,5445
-100,40,150,1323,1285,2608,6143
20,70,30,1301,1307,2608,5989
-20,-70,50,1318,1290,2608,5991
20,-20,120,1300,1308,2608,5790
-170,20,-140,1296,1312,2608,5963
-80,80,-20,1304,1304,2608,6133
-170,60,-150,1306,1302,2608,5967
-120,-40,-40,1328,1281,2609,5921
-90,70,120,1309,1300,2609,6323
-130,-70,-70,1328,1281,2609,6019
-150,70,-170,1312,1297,2609,6334
0,-20,70,1327,1282,2609,5891
30,60,50,1307,1303,2610,5970
-120,-10,-60,1321,1289,2610,5789
-110,0,-120,1314,1296,2610,6040
120,-40,40,1282,1329,2611,6011
130,80,-70,1320,1291,2611,5993
-80,70,110,1302,1309,2611,6267
20,80,40,1335,1276,2611,5833
-170,-30,-140,1327,1284,2611,6108
40,30,-110,1327,1285,2612,6044
150,-50,70,1304,1308,2612,6131
150,70,100,1312,1300,2612,5766
-80,-40,20,1302,1310,2612,6015
-80,20,-80,1296,1317,2613,5857
-140,-20,-130,1305,1308,2613,6151
-110,-60,150,1301,1313,2614,5991
-150,50,-170,1332,1282,2614,6156
70,-40,-30,1294,1320,2614,5932
-60,-60,20,1333,1281,2614,5872
-170,30,-140,1316,1298,2614,5980
110,20,-40,1295,1320,2615,6106
-140,50,-180,1331,1284,2615,6118
-140,50,180,1331,1284,2615,6118
-80,10,-120,1299,1317,2616,5954
-130,-60,-70,1333,1283,2616,6032
90,40,140,1314,1302,2616,5844
-60,-20,50,1325,1291,2616,6036
-80,-10,80,1303,1313,2616,6035
-140,-30,-120,1306,1310,2616,6134
140,-50,-170,1303,1313,2616,6166
90,40,40,1320,1296,2616,5856
50,40,-140,1299,1318,2617,6076
110,50,-30,1295,1322,2617,5940
-120,30,180,1337,1281,2618,6274
-50,60,80,1333,1285,2618,6279
110,0,50,1281,1337,2618,5733
80,30,130,1316,1302,2618,5867
-150,30,-160,1345,1273,2618,6053
-120,30,-180,1337,1281,2618,6274
0,-50,70,1324,1294,2618,5979
0,10,60,1303,1316,2619,6139
-160,-20,-140,1324,1295,2619,6121
60,20,-180,1325,1294,2619,5781
60,20,180,1325,1294,2619,5781
10,-40,80,1312,1307,2619,6160
100,-50,-170,1301,1318,2619,6042
-170,60,-140,1301,1319,2620,6031
120,10,80,1301,1319,2620,5889
-140,-60,-90,1350,1271,2621,6195
100,80,-30,1327,1294,2621,5973
80,80,-10,1331,1290,2621,6046
90,80,-20,1328,1294,2622,5986
-150,20,-150,1325,1297,2622,6077
140,20,90,1340,1283,2623,6106
-170,-10,-140,1326,1297,2623,5982
160,-30,-150,1304,1319,2623,6187
130,-10,-110,1305,1319,2624,5767
0,-10,70,1324,1300,2624,5918
-130,-40,-70,1337,1287,2624,5963
80,-10,-130,1297,1327,2624,5947
-60,-40,-150,1308,1316,2624,5816
80,-50,170,1314,1311,2625,5978
-130,40,180,1337,1288,2625,6052
-70,-50,20,1329,1296,2625,5903
-130,40,-180,1337,1288,2625,6052
110,-50,170,1288,1337,2625,6093
20,-50,90,1326,1299,2625,6198
150,0,80,1326,1300,2626,5983
-170,70,-140,1310,1316,2626,5825
-180,-10,-140,1322,1304,2626,6125
-90,-20,70,1307,1319,2626,5982
50,70,30,1324,1302,2626,5843
-170,-70,100,1316,1310,2626,5961
20,80,30,1307,1319,2626,6078
180,-10,-140,1322,1304,2626,6125
140,-40,-150,1307,1320,2627,6093
-140,-30,90,1321,1306,2627,5902
-150,-80,120,1341,1287,2628,6051
100,40,0,1266,1362,2628,5788
-100,40,-10,1327,1301,2628,6135
120,30,-60,1285,1343,2628,6007
-140,40,-170,1329,1299,2628,6068
-100,20,-180,1344,1285,2629,6144
-100,20,180,1344,1285,2629,6144
80,-40,-20,1317,1312,2629,5871
120,40,-50,1310,1319,2629,5773
-90,10,-120,1329,1300,2629,6097
150,30,-100,1320,1309,2629,5927
20,-30,100,1308,1322,2630,6027
-160,70,-150,1319,1311,2630,5898
-120,-10,-100,1312,1318,2630,5880
50,-40,150,1316,1315,2631,5921
-10,70,50,1315,1316,2631,6204
-180,80,-130,1324,1307,2631,6032
180,80,-130,1324,1307,2631,6032
-130,-20,70,1329,1303,2632,5818
110,-10,-100,1294,1338,2632,5886
-130,10,-150,1336,1296,2632,6280
-110,0,-110,1310,1322,2632,6017
140,40,100,1309,1323,2632,6102
-60,-40,30,1342,1290,2632,6076
100,0,-30,1327,1305,2632,6174
150,20,-110,1327,1306,2633,5788
60,20,-160,1305,1328,2633,5828
40,-40,120,1322,1311,2633,6150
-180,30,-130,1309,1324,2633,6039
-100,-70,-30,1336,1297,2633,6010
180,30,-130,1309,1324,2633,6039
80,-70,140,1325,1309,2634,6172
150,60,-90,1308,1326,2634,5940
-180,20,-130,1315,1320,2635,5791
-150,-40,100,1330,1305,2635,5934
180,20,-130,1315,1320,2635,5791
-150,-30,-130,1318,1317,2635,5974
120,0,70,1319,1316,2635,6078
60,10,-170,1297,1338,2635,6002
-90,40,130,1337,1298,2635,6203
-180,80,-120,1344,1292,2636,5755
-160,60,-160,1337,1299,2636,6235
140,-70,-170,1303,1333,2636,6123
-70,10,-110,1339,1297,2636,5991
180,80,-120,1344,1292,2636,5755
60,-50,130,1324,1312,2636,6151
-110,50,150,1322,1314,2636,6464
-150,80,-170,1324,1312,2636,6237
-20,80,60,1315,1322,2637,6204
-60,10,70,1340,1297,2637,6237
-70,-30,-160,1330,1307,2637,6091
60,20,160,1307,1331,2638,5656
-90,0,160,1336,1302,2638,6015
110,30,-40,1289,1349,2638,6143
50,-40,130,1309,1329,2638,6215
-110,30,170,1354,1284,2638,6243
120,-20,50,1328,1310,2638,5982
-90,50,120,1333,1305,2638,6422
-130,-10,-130,1333,1306,2639,6222
60,80,10,1345,1294,2639,6101
10,30,70,1317,1323,2640,6266
-120,-20,60,1329,1311,2640,5802
140,0,-110,1322,1318,2640,5989
30,-30,130,1332,1309,2641,5969
-170,80,-140,1329,1312,2641,6086
-110,-30,-10,1330,1311,2641,5942
70,-40,-170,1314,1328,2642,5872
70,80,0,1342,1300,2642,6089
-140,70,-180,1311,1331,2642,6416
-140,70,180,1311,1331,2642,6416
-10,-20,60,1333,1309,2642,6116
10,-20,90,1326,1316,2642,6184
-110,-30,20,1306,1336,2642,5973
-170,-20,80,1303,1339,2642,6129
160,10,80,1354,1289,2643,6046
70,-30,-40,1309,1334,2643,6102
-100,-60,-20,1331,1312,2643,6099
160,10,-120,1343,1301,2644,6015
80,30,100,1304,1340,2644,5940
-130,-20,-110,1315,1330,2645,6038
20,40,90,1322,1323,2645,5891
180,50,-130,1335,1311,2646,5973
110,-50,-160,1326,1320,2646,6033
-130,-80,-70,1336,1310,2646,6255
10,80,50,1360,1286,2646,5997
110,-30,-130,1302,1344,2646,5921
-120,0,-140,1332,1314,2646,6300
-180,50,-130,1335,1311,2646,5973
40,-40,-60,1310,1338,2648,5976
140,20,-90,1347,1302,2649,5936
-90,-10,150,1335,1314,2649,5930
-60,30,80,1343,1306,2649,6266
-110,-30,30,1328,1321,2649,5917
90,-50,-170,1328,1321,2649,6007
-100,30,160,1344,1305,2649,6051
60,-20,-170,1321,1328,2649,5679
160,70,-100,1342,1308,2650,6004
110,60,-30,1302,1348,2650,6022
80,-80,140,1337,1313,2650,6206
50,80,-150,1326,1324,2650,6133
10,40,60,1314,1336,2650,6403
0,-20,-90,1332,1318,2650,6112
100,-80,10,1304,1347,2651,6144
0,60,-90,1303,1348,2651,6037
70,-50,140,1330,1321,2651,6208
-140,-60,120,1328,1324,2652,6323
130,-40,50,1344,1308,2652,6115
-40,-50,40,1352,1300,2652,6186
80,50,30,1327,1325,2652,5850
-120,30,10,1343,1309,2652,6188
140,40,-80,1346,1306,2652,5907
110,10,-60,1301,1351,2652,6140
150,-30,-140,1338,1315,2653,6019
-90,60,120,1345,1308,2653,6383
80,50,160,1322,1331,2653,6014
100,-50,180,1315,1339,2654,6183
-130,-30,-80,1343,1311,2654,6102
-90,-10,180,1332,1322,2654,6252
-70,80,-30,1330,1324,2654,6230
90,-60,150,1312,1342,2654,6181
100,-50,-180,1315,1339,2654,6183
60,10,-110,1333,1321,2654,5996
-90,-10,-180,1332,1322,2654,6252
-140,80,-180,1334,1320,2654,6296
-140,80,180,1334,1320,2654,6296
-70,70,-30,1324,1330,2654,6178
10,60,50,1352,1302,2654,6080
-30,30,60,1335,1320,2655,6200
-120,-30,-40,1353,1302,2655,5826
110,-70,20,1328,1328,2656,6005
110,-50,-170,1318,1338,2656,6302
100,-20,-120,1358,1298,2656,5908
20,50,80,1311,1345,2656,5866
-150,10,-140,1354,1303,2657,6206
-170,80,-130,1358,1299,2657,5793
70,30,150,1336,1321,2657,5609
-170,-20,-140,1343,1314,2657,6197
20,50,50,1327,1330,2657,6170
110,80,-40,1342,1316,2658,6029
150,-50,-160,1346,1312,2658,6188
0,50,50,1345,1313,2658,6266
-110,0,-140,1346,1312,2658,6191
20,70,50,1343,1315,2658,6174
-130,30,-170,1345,1313,2658,6323
10,70,50,1367,1291,2658,6009
150,-70,-160,1332,1326,2658,6201
-30,-20,50,1344,1315,2659,6126
-170,-70,-120,1336,1323,2659,6134
10,0,90,1322,1339,2661,6038
-160,30,-150,1328,1333,2661,6109
30,20,110,1325,1336,2661,5674
140,-40,60,1345,1316,2661,6209
-30,80,70,1316,1346,2662,6321
-110,0,-130,1340,1322,2662,6249
180,-20,-140,1342,1321,2663,6224
-120,-10,10,1346,1317,2663,6029
120,-20,-120,1333,1330,2663,6057
180,-50,90,1357,1306,2663,6187
-130,80,170,1329,1334,2663,6341
-180,-50,90,1357,1306,2663,6187
-10,-70,60,1332,1331,2663,6131
90,50,10,1321,1342,2663,6063
-180,-20,-140,1342,1321,2663,6224
140,-60,-170,1317,1347,2664,6366
10,30,80,1331,1334,2665,6144
-10,0,-90,1317,1348,2665,6051
-40,-40,40,1365,1300,2665,6248
150,0,-120,1354,1311,2665,6114
-160,80,-140,1369,1296,2665,5854
-120,-60,-50,1367,1299,2666,6124
-90,30,-40,1333,1333,2666,6024
70,30,110,1341,1325,2666,5848
-80,0,110,1348,1319,2667,6228
20,-10,120,1335,1332,2667,5907
50,80,20,1355,1312,2667,6140
60,20,-170,1317,1350,2667,5814
-40,30,-80,1312,1356,2668,5762
50,-40,140,1328,1340,2668,6201
130,30,-70,1320,1348,2668,5975
-120,-20,50,1359,1309,2668,5800
-20,-10,-100,1336,1332,2668,6036
-70,20,90,1348,1321,2669,6297
10,80,40,1331,1339,2670,6248
60,-40,180,1324,1346,2670,6048
60,-40,-180,1324,1346,2670,6048
-160,80,-150,1342,1329,2671,6138
110,40,-30,1287,1384,2671,6091
110,-20,30,1318,1353,2671,6100
160,-20,80,1307,1364,2671,6220
90,-70,150,1341,1331,2672,6264
-170,40,-140,1342,1330,2672,6263
130,20,90,1327,1345,2672,6070
170,-20,-140,1317,1355,2672,6028
140,0,80,1324,1348,2672,6074
-150,40,-160,1364,1308,2672,6232
-110,-50,-20,1360,1312,2672,5943
0,80,60,1364,1309,2673,6057
110,50,-20,1339,1334,2673,5992
20,10,-90,1310,1363,2673,6257
20,-30,120,1349,1324,2673,5998
20,60,70,1368,1305,2673,6074
100,-10,-10,1338,1336,2674,6119
120,-50,-170,1341,1334,2675,6106
100,70,-20,1332,1343,2675,6177
130,-10,70,1354,1321,2675,6265
-180,-70,-130,1340,1336,2676,6248
180,-70,-130,1340,1336,2676,6248
100,0,-60,1338,1339,2677,6073
80,-50,150,1347,1330,2677,6150
60,20,130,1325,1352,2677,6005
0,-60,70,1341,1336,2677,6236
-150,70,-160,1347,1330,2677,6010
-80,60,110,1341,1338,2679,6416
70,-50,170,1346,1333,2679,5893
10,20,90,1350,1329,2679,5839
-80,40,110,1361,1318,2679,6372
170,60,80,1345,1335,2680,5935
-140,60,-180,1378,1302,2680,6364
-80,30,110,1358,1322,2680,6406
0,20,60,1324,1356,2680,6367
-140,60,180,1378,1302,2680,6364
40,-20,-70,1320,1360,2680,6163
-80,20,120,1373,1307,2680,6308
170,0,-130,1349,1331,2680,5918
-120,-10,-50,1350,1331,2681,6116
80,-20,-40,1332,1349,2681,6245
0,20,-90,1329,1352,2681,5945
160,-40,-150,1354,1328,2682,6287
30,-10,130,1337,1345,2682,6024
-100,-60,160,1360,1322,2682,6082
-150,60,-170,1355,1327,2682,6371
30,10,120,1356,1326,2682,6128
-90,-10,140,1361,1321,2682,6006
110,0,-80,1356,1327,2683,6210
120,60,-40,1334,1349,2683,6148
130,-50,-170,1338,1345,2683,6360
80,-90,-10,1336,1348,2684,6150
-150,-90,120,1336,1348,2684,6150
170,-90,80,1336,1348,2684,6150
20,-90,-70,1336,1348,2684,6150
-80,-90,-170,1336,1348,2684,6150
50,-90,-40,1336,1348,2684,6150
150,-90,60,1336,1348,2684,6150
-90,-90,-180,1336,1348,2684,6150
-170,-90,100,1336,1348,2684,6150
-100,-90,170,1336,1348,2684,6150
-110,-90,160,1336,1348,2684,6150
70,-90,-20,1336,1348,2684,6150
-120,-90,150,1336,1348,2684,6150
130,-90,40,1336,1348,2684,6150
180,-90,90,1336,1348,2684,6150
10,-90,-80,1336,1348,2684,6150
-180,-90,90,1336,1348,2684,6150
90,-90,0,1336,1348,2684,6150
140,-90,50,1336,1348,2684,6150
40,-90,-50,1336,1348,2684,6150
-80,20,110,1355,1329,2684,6480
-10,-90,-100,1336,1348,2684,6150
-130,-30,-70,1356,1328,2684,6003
-70,-90,-160,1336,1348,2684,6150
0,-90,-90,1336,1348,2684,6150
-20,-90,-110,1336,1348,2684,6150
-30,-90,-120,1336,1348,2684,6150
-50,-90,-140,1336,1348,2684,6150
90,-40,-150,1330,1354,2684,6050
-160,-90,110,1336,1348,2684,6150
60,-90,-30,1336,1348,2684,6150
-60,-90,-150,1336,1348,2684,6150
-140,-90,130,1336,1348,2684,6150
110,-90,20,1336,1348,2684,6150
-130,-90,140,1336,1348,2684,6150
-90,20,160,1369,1315,2684,6276
120,-90,30,1336,1348,2684,6150
30,-90,-60,1336,1348,2684,6150
160,-90,70,1336,1348,2684,6150
100,-90,10,1336,1348,2684,6150
-40,-90,-130,1336,1348,2684,6150
-90,-90,180,1336,1348,2684,6150
50,50,-150,1351,1334,2685,6134
-100,50,140,1356,1329,2685,6434
90,-50,170,1314,1371,2685,6249
10,70,40,1333,1353,2686,6209
160,-70,-150,1348,1338,2686,6310
-140,20,-150,1358,1328,2686,6383
-160,-80,110,1385,1301,2686,6241
110,-50,-180,1327,1359,2686,6229
10,-50,80,1361,1325,2686,6296
50,40,90,1329,1357,2686,5794
110,-50,180,1327,1359,2686,6229
40,70,40,1348,1339,2687,5972
-150,80,-150,1376,1311,2687,5948
-140,70,-170,1366,1321,2687,6165
80,30,110,1340,1348,2688,6014
90,-50,160,1340,1348,2688,6366
120,80,-50,1357,1332,2689,6175
100,30,110,1341,1348,2689,5903
-160,20,-140,1347,1342,2689,6155
-30,0,-100,1322,1368,2690,6247
110,40,-20,1308,1382,2690,6042
-160,40,-150,1349,1341,2690,6342
60,-30,-50,1315,1375,2690,6193
90,30,110,1337,1354,2691,6135
40,60,60,1368,1323,2691,6024
-20,10,-90,1332,1359,2691,6092
80,0,-100,1322,1369,2691,6078
50,60,50,1359,1332,2691,6099
130,50,-60,1343,1348,2691,6254
-120,20,-160,1356,1336,2692,6406
60,30,-170,1324,1368,2692,6092
10,-60,80,1364,1329,2693,6277
20,-30,110,1339,1354,2693,6244
20,40,-100,1324,1369,2693,6114
-60,60,90,1339,1355,2694,6265
130,60,-60,1359,1335,2694,6065
140,-10,-120,1355,1339,2694,6181
-80,10,120,1372,1322,2694,6357
30,-40,120,1345,1349,2694,6308
-110,-70,-40,1391,1303,2694,6128
100,-60,10,1325,1369,2694,5991
10,10,90,1355,1339,2694,5992
-180,40,-130,1363,1332,2695,6225
180,40,-130,1363,1332,2695,6225
110,20,-30,1348,1347,2695,6176
-40,50,70,1362,1334,2696,6502
70,70,180,1353,1343,2696,6186
-50,-60,30,1357,1339,2696,6130
-10,80,70,1373,1323,2696,6237
0,30,60,1345,1351,2696,6418
70,70,-180,1353,1343,2696,6186
-90,30,150,1377,1320,2697,6208
160,70,90,1371,1326,2697,6004
-130,0,-140,1353,1344,2697,6469
20,60,50,1348,1349,2697,6223
-140,0,-140,1368,1329,2697,6469
-50,80,100,1361,1336,2697,6258
130,50,110,1379,1318,2697,5930
40,90,20,1360,1338,2698,6240
-130,70,170,1347,1351,2698,6477
110,90,-50,1360,1338,2698,6240
-100,90,160,1360,1338,2698,6240
180,90,-120,1360,1338,2698,6240
170,90,-110,1360,1338,2698,6240
-90,-20,80,1341,1357,2698,5907
150,90,-90,1360,1338,2698,6240
-10,90,70,1360,1338,2698,6240
-70,90,130,1360,1338,2698,6240
-90,90,150,1360,1338,2698,6240
-140,90,-160,1360,1338,2698,6240
-60,90,120,1360,1338,2698,6240
-120,90,180,1360,1338,2698,6240
70,90,-10,1360,1338,2698,6240
50,90,10,1360,1338,2698,6240
-40,90,100,1360,1338,2698,6240
-150,90,-150,1360,1338,2698,6240
140,90,-80,1360,1338,2698,6240
120,-50,180,1340,1358,2698,6339
80,90,-20,1360,1338,2698,6240
0,90,60,1360,1338,2698,6240
-80,90,140,1360,1338,2698,6240
120,90,-60,1360,1338,2698,6240
40,80,30,1366,1332,2698,6237
30,90,30,1360,1338,2698,6240
100,90,-40,1360,1338,2698,6240
60,90,0,1360,1338,2698,6240
-20,90,80,1360,1338,2698,6240
10,50,50,1352,1346,2698,6344
120,-50,-180,1340,1358,2698,6339
10,90,50,1360,1338,2698,6240
90,90,-30,1360,1338,2698,6240
-30,90,90,1360,1338,2698,6240
160,90,-100,1360,1338,2698,6240
-170,90,-130,1360,1338,2698,6240
-120,90,-180,1360,1338,2698,6240
-110,90,170,1360,1338,2698,6240
130,90,-70,1360,1338,2698,6240
20,90,40,1360,1338,2698,6240
-50,90,110,1360,1338,2698,6240
-130,90,-170,1360,1338,2698,6240
-180,90,-120,1360,1338,2698,6240
-160,90,-140,1360,1338,2698,6240
80,0,-110,1331,1368,2699,5964
-50,-50,-140,1357,1342,2699,6098
110,30,-30,1317,1383,2700,6115
-60,-10,60,1363,1337,2700,6166
-80,-20,60,1366,1334,2700,6138
180,10,-130,1361,1340,2701,6031
-180,10,-130,1361,1340,2701,6031
-50,0,60,1361,1340,2701,6328
40,-60,110,1358,1343,2701,6313
40,-40,130,1374,1327,2701,6209
-30,80,80,1365,1337,2702,6346
140,10,-100,1353,1349,2702,6025
-50,20,-90,1363,1339,2702,6160
-150,80,-160,1349,1353,2702,6204
0,0,70,1354,1348,2702,6335
-160,0,60,1373,1330,2703,6086
-40,80,80,1337,1367,2704,6496
-140,80,-170,1356,1348,2704,6222
-120,10,-150,1361,1344,2705,6520
-120,0,-80,1345,1361,2706,6102
-90,20,-80,1347,1359,2706,6077
-80,20,130,1384,1322,2706,6354
-110,40,0,1368,1338,2706,6398
160,-30,-140,1363,1344,2707,6178
-120,80,160,1351,1356,2707,6458
-20,-50,-110,1349,1358,2707,5979
-90,0,-150,1376,1331,2707,6382
130,-20,60,1363,1344,2707,6163
-140,-20,70,1360,1347,2707,5941
40,50,-130,1374,1333,2707,6338
10,40,70,1348,1360,2708,6173
-70,50,100,1354,1354,2708,6494
170,40,-120,1374,1334,2708,6046
-90,10,-130,1371,1338,2709,6265
-70,60,100,1341,1369,2710,6295
130,70,-60,1373,1337,2710,6232
-60,80,-40,1360,1350,2710,6329
160,-10,-130,1353,1358,2711,6104
150,30,90,1372,1339,2711,6214
80,-10,-70,1359,1352,2711,6021
-160,60,-150,1362,1349,2711,6274
70,70,20,1359,1352,2711,5919
100,-50,170,1347,1365,2712,6360
100,-50,-160,1343,1369,2712,6017
-90,-40,20,1361,1351,2712,6273
-100,10,-110,1376,1337,2713,6222
110,30,-20,1342,1371,2713,6172
0,80,50,1353,1360,2713,6316
-130,60,170,1383,1330,2713,6645
-140,-80,-80,1363,1350,2713,6357
-140,30,-160,1375,1338,2713,6343
170,-70,-140,1359,1354,2713,6382
-90,-50,170,1369,1344,2713,6159
-80,80,130,1348,1366,2714,6144
-120,0,-50,1381,1333,2714,6121
-50,80,90,1355,1359,2714,6556
-90,10,170,1374,1340,2714,6233
-110,-30,120,1359,1355,2714,6139
-40,80,90,1365,1350,2715,6338
120,-40,-140,1348,1367,2715,6190
-90,-20,170,1363,1352,2715,6375
-140,-70,-80,1388,1327,2715,6279
-90,-10,160,1374,1341,2715,6288
-50,0,-110,1367,1348,2715,6433
100,-20,0,1334,1382,2716,6212
40,80,-140,1337,1379,2716,6287
-120,-20,-40,1354,1362,2716,6095
-60,80,110,1366,1350,2716,6190
30,80,40,1377,1339,2716,6294
-130,80,180,1366,1350,2716,6212
-130,80,-180,1366,1350,2716,6212
-120,60,160,1374,1343,2717,6552
-30,-50,-120,1359,1358,2717,6060
-70,80,120,1369,1348,2717,6198
-150,0,50,1371,1346,2717,5943
-110,80,150,1359,1359,2718,6476
-30,20,60,1386,1332,2718,6596
30,-40,110,1355,1363,2718,6280
90,-80,150,1371,1348,2719,6353
-130,10,20,1355,1365,2720,6129
-40,60,-60,1378,1342,2720,6290
-180,-50,-140,1389,1332,2721,6507
110,40,120,1383,1338,2721,6095
-90,80,140,1355,1366,2721,6226
-180,-70,90,1369,1352,2721,6126
180,-70,90,1369,1352,2721,6126
-90,-10,170,1353,1368,2721,6265
180,-50,-140,1389,1332,2721,6507
-40,10,60,1390,1332,2722,6421
-80,30,120,1377,1345,2722,6414
170,-20,80,1360,1362,2722,6187
-90,80,130,1354,1368,2722,6558
-150,-10,60,1377,1345,2722,6005
60,-10,-80,1384,1338,2722,6192
-160,-40,-130,1391,1331,2722,6407
170,-30,-140,1363,1359,2722,6286
10,0,100,1384,1339,2723,5986
-110,50,160,1389,1334,2723,6511
140,-50,-160,1350,1373,2723,6276
-80,50,110,1366,1357,2723,6625
-110,20,-10,1383,1340,2723,6223
100,20,70,1361,1362,2723,6083
-80,10,110,1371,1353,2724,6406
20,30,100,1374,1350,2724,5807
130,80,120,1392,1332,2724,6265
-100,80,150,1346,1378,2724,6222
-20,70,60,1356,1369,2725,6437
-70,10,-120,1369,1356,2725,6337
20,-60,90,1359,1367,2726,6412
-130,20,20,1353,1373,2726,6144
120,-30,-130,1346,1380,2726,6098
170,70,-110,1373,1353,2726,6197
-120,70,160,1367,1360,2727,6516
-90,0,170,1387,1341,2728,6273
-120,80,170,1373,1355,2728,6199
-60,20,80,1389,1339,2728,6486
160,30,-110,1375,1353,2728,6051
-20,80,70,1363,1365,2728,6357
-130,80,-170,1384,1344,2728,6104
120,80,130,1388,1341,2729,6239
140,-20,70,1383,1346,2729,6449
-120,80,180,1383,1346,2729,6140
-120,80,-180,1383,1346,2729,6140
-140,80,-160,1384,1345,2729,6031
100,-70,160,1356,1373,2729,6424
20,-40,100,1362,1367,2729,6313
110,60,-20,1374,1356,2730,6053
0,60,60,1396,1334,2730,6330
-180,40,70,1341,1389,2730,6003
60,60,40,1365,1365,2730,6181
180,40,70,1341,1389,2730,6003
50,0,-90,1371,1359,2730,6207
180,-30,-140,1387,1344,2731,6479
180,-60,90,1379,1352,2731,6424
30,60,-120,1363,1368,2731,6350
-180,-30,-140,1387,1344,2731,6479
-180,-60,90,1379,1352,2731,6424
-90,40,140,1399,1332,2731,6233
10,40,80,1379,1352,2731,6238
-120,10,-70,1353,1378,2731,6126
-170,-80,100,1406,1326,2732,6391
120,-50,-160,1355,1377,2732,6397
0,10,70,1374,1358,2732,6506
-100,80,140,1371,1361,2732,6516
10,30,90,1357,1375,2732,6063
0,70,60,1406,1326,2732,6213
150,50,-90,1372,1361,2733,6104
-60,70,-40,1384,1349,2733,6330
-110,80,160,1354,1379,2733,6214
160,-50,-150,1373,1361,2734,6342
-90,0,180,1394,1340,2734,6210
-90,0,-180,1394,1340,2734,6210
30,70,50,1370,1364,2734,6131
150,-60,-160,1360,1375,2735,6498
10,50,70,1385,1350,2735,6174
-10,20,-90,1359,1376,2735,6266
-180,-20,80,1366,1369,2735,6260
110,80,140,1387,1348,2735,6309
80,30,120,1361,1374,2735,6222
180,-20,80,1366,1369,2735,6260
-60,10,-100,1387,1349,2736,6458
-80,10,130,1398,1338,2736,6331
-120,0,-40,1381,1355,2736,6056
110,-80,20,1360,1376,2736,6384
-120,0,-130,1386,1350,2736,6370
140,80,110,1402,1335,2737,6234
80,70,10,1361,1376,2737,6001
-90,50,130,1370,1367,2737,6435
-50,-30,40,1390,1347,2737,6550
50,70,40,1375,1363,2738,6111
70,-10,-80,1380,1358,2738,6124
-100,20,-90,1352,1386,2738,6018
60,70,30,1370,1368,2738,5936
-60,-30,40,1370,1369,2739,6511
-180,-40,-140,1386,1353,2739,6479
180,-40,-140,1386,1353,2739,6479
30,-60,100,1364,1376,2740,6335
-130,70,180,1394,1346,2740,6289
110,-60,20,1355,1385,2740,6283
-150,-50,-110,1392,1348,2740,6471
150,-40,-150,1379,1361,2740,6448
20,80,50,1392,1348,2740,6318
-130,70,-180,1394,1346,2740,6289
130,80,-60,1369,1372,2741,6309
10,10,100,1380,1361,2741,6102
-90,0,-170,1371,1370,2741,6657
-10,80,60,1371,1370,2741,6419
80,50,40,1405,1336,2741,5959
60,60,-170,1390,1351,2741,6168
70,-50,160,1368,1373,2741,6401
70,50,170,1399,1342,2741,6144
-150,-40,-120,1356,1385,2741,6403
-140,-40,-100,1362,1379,2741,6424
-80,-10,90,1366,1375,2741,6365
150,10,-110,1379,1363,2742,6084
-40,40,-70,1382,1360,2742,6467
-60,80,100,1362,1380,2742,6559
-120,30,-170,1386,1356,2742,6472
-30,-40,50,1399,1344,2743,6231
100,-30,-130,1358,1385,2743,6222
-20,80,80,1400,1343,2743,6410
-120,-10,-40,1361,1382,2743,6072
-110,70,150,1378,1365,2743,6666
40,70,-140,1389,1354,2743,6433
110,70,-30,1357,1387,2744,6384
-100,20,-70,1348,1396,2744,6057
-80,30,-60,1366,1378,2744,5923
-40,-20,-120,1376,1368,2744,6014
-50,20,70,1390,1355,2745,6439
-150,-80,-90,1388,1357,2745,6434
-30,-30,50,1391,1354,2745,6264
40,70,50,1379,1367,2746,6201
50,-60,120,1382,1364,2746,6260
0,-70,70,1362,1384,2746,6454
180,50,70,1373,1374,2747,6203
-180,50,70,1373,1374,2747,6203
-80,80,120,1369,1378,2747,6591
-70,-10,-150,1384,1363,2747,6096
20,10,110,1384,1363,2747,6106
10,70,60,1392,1356,2748,6404
10,-10,100,1369,1379,2748,6177
-70,80,110,1367,1381,2748,6562
-70,-40,30,1374,1375,2749,6330
120,50,-40,1357,1392,2749,6242
-170,50,-140,1379,1370,2749,6291
-50,-20,50,1375,1375,2750,6357
170,60,-110,1384,1366,2750,6164
-50,-80,20,1384,1366,2750,6439
-120,-70,-50,1407,1344,2751,6266
20,60,60,1391,1360,2751,6240
-40,-80,30,1382,1369,2751,6529
170,70,80,1385,1367,2752,6138
80,40,150,1369,1383,2752,6112
100,20,60,1390,1363,2753,6121
130,-50,-160,1381,1372,2753,6260
-130,30,20,1387,1367,2754,6236
-50,50,80,1383,1371,2754,6575
80,-30,-30,1373,1381,2754,6287
30,-40,-70,1358,1397,2755,6326
30,-10,-80,1355,1400,2755,6476
-60,50,90,1386,1369,2755,6460
-100,10,-120,1400,1355,2755,6364
-10,-30,-100,1365,1391,2756,6028
0,70,50,1373,1383,2756,6344
0,20,70,1370,1387,2757,6515
-130,-50,120,1396,1361,2757,6379
130,10,80,1379,1379,2758,6271
-80,30,130,1413,1345,2758,6521
170,30,-120,1391,1368,2759,6246
10,-30,90,1383,1376,2759,6540
-140,-10,-130,1393,1366,2759,6603
-90,20,-90,1374,1385,2759,6156
-110,60,150,1390,1370,2760,6659
150,-20,-130,1364,1396,2760,6474
100,-60,160,1362,1398,2760,6476
50,-30,-60,1364,1396,2760,6393
-130,-10,-120,1359,1402,2761,6474
-140,-50,-90,1401,1360,2761,6473
30,60,70,1386,1375,2761,6150
-40,-50,-130,1405,1356,2761,6250
-60,-50,30,1395,1366,2761,6374
-120,-50,-40,1403,1359,2762,6207
170,20,-120,1391,1371,2762,6247
-60,-80,10,1386,1376,2762,6415
10,-70,80,1373,1389,2762,6402
10,-30,110,1373,1389,2762,6148
80,-50,160,1375,1387,2762,6448
-100,50,150,1404,1358,2762,6491
120,-10,-100,1366,1396,2762,6107
50,30,-130,1383,1380,2763,6402
170,-70,80,1392,1371,2763,6176
-10,-10,60,1383,1380,2763,6413
-110,80,170,1404,1359,2763,6229
120,-50,-150,1373,1391,2764,6235
130,0,-90,1377,1387,2764,6339
-70,30,-70,1382,1382,2764,6071
110,-40,-140,1367,1398,2765,6245
-140,0,40,1398,1367,2765,6061
-90,-50,10,1394,1371,2765,6293
90,-40,-10,1360,1405,2765,6324
100,-80,160,1388,1378,2766,6521
-70,10,90,1398,1368,2766,6553
-160,-50,100,1406,1360,2766,6466
110,-20,-110,1368,1399,2767,6207
-70,-80,0,1394,1373,2767,6386
120,-30,40,1369,1398,2767,6268
-90,-30,50,1398,1369,2767,6275
-20,60,60,1379,1388,2767,6506
150,40,-90,1406,1362,2768,6212
-10,70,70,1424,1344,2768,6367
-110,-30,10,1364,1404,2768,6468
30,80,-130,1371,1397,2768,6509
-140,-10,50,1417,1352,2769,6033
-100,60,140,1384,1385,2769,6597
-40,40,70,1403,1366,2769,6319
-110,10,-150,1405,1364,2769,6569
-80,-10,-160,1393,1376,2769,6358
-180,70,-120,1392,1378,2770,6337
40,-30,160,1378,1392,2770,6171
-90,50,140,1401,1369,2770,6575
180,70,-120,1392,1378,2770,6337
160,50,-100,1384,1386,2770,6220
-50,80,-50,1386,1385,2771,6510
-160,50,-150,1412,1359,2771,6397
-80,10,140,1385,1386,2771,6223
-180,0,-130,1406,1365,2771,6244
-30,-80,40,1385,1386,2771,6497
10,10,-90,1358,1413,2771,6370
180,0,-130,1406,1365,2771,6244
-90,-30,170,1418,1353,2771,6392
-20,-80,50,1399,1372,2771,6473
60,-50,160,1393,1379,2772,6330
-80,0,120,1410,1362,2772,6523
120,-70,30,1348,1424,2772,6567
40,-40,150,1393,1380,2773,6306
-120,-30,100,1385,1388,2773,6342
10,-20,110,1379,1394,2773,6270
-180,-80,90,1426,1348,2774,6588
180,-80,90,1426,1348,2774,6588
-70,40,100,1396,1378,2774,6485
170,-10,-130,1390,1384,2774,6274
130,10,-80,1390,1384,2774,6198
-120,-50,130,1408,1366,2774,6323
160,60,-100,1395,1381,2776,6306
-170,-40,90,1412,1364,2776,6578
-140,-30,-110,1384,1392,2776,6432
60,-30,-170,1357,1419,2776,6019
130,-40,-140,1371,1406,2777,6092
-150,-20,-130,1389,1388,2777,6498
-80,-80,-10,1403,1374,2777,6376
70,0,-130,1369,1408,2777,6428
-110,-60,-30,1398,1379,2777,6288
130,-30,-130,1385,1392,2777,6457
-30,80,90,1422,1356,2778,6544
40,10,130,1349,1429,2778,5991
-100,40,160,1405,1373,2778,6550
110,-70,170,1387,1391,2778,6640
0,60,50,1385,1393,2778,6330
-130,20,-150,1408,1370,2778,6580
-130,30,-160,1392,1387,2779,6622
-110,10,-100,1391,1388,2779,6360
100,30,30,1387,1392,2779,6010
-120,10,-80,1387,1392,2779,6044
-110,-30,0,1397,1383,2780,6397
-100,80,160,1415,1365,2780,6245
180,60,-120,1391,1390,2781,6253
-160,70,-140,1412,1369,2781,6295
-120,-20,20,1391,1390,2781,6063
-180,60,-120,1391,1390,2781,6253
-120,50,170,1413,1368,2781,6499
-40,-20,50,1410,1371,2781,6631
-100,-50,0,1413,1368,2781,6411
-40,-60,40,1397,1385,2782,6368
100,80,150,1425,1357,2782,6407
-120,-10,-30,1402,1380,2782,6303
20,70,60,1404,1378,2782,6290
20,50,90,1381,1402,2783,6247
-100,30,-20,1400,1384,2784,6502
30,40,-110,1410,1374,2784,6526
-100,-40,10,1391,1394,2785,6442
180,30,70,1376,1409,2785,6109
10,50,60,1377,1408,2785,6520
-180,30,70,1376,1409,2785,6109
-100,10,-160,1400,1385,2785,6563
20,-40,110,1396,1389,2785,6383
120,-60,30,1362,1423,2785,6493
-70,0,80,1388,1397,2785,6596
-80,-40,30,1399,1386,2785,6556
-90,10,180,1416,1370,2786,6593
20,-20,-80,1372,1414,2786,6411
-90,10,-180,1416,1370,2786,6593
-150,30,-150,1398,1389,2787,6283
-110,70,160,1412,1375,2787,6552
-90,-20,90,1393,1395,2788,6391
-20,20,-90,1399,1389,2788,6305
140,80,-70,1405,1384,2789,6405
50,-40,170,1385,1404,2789,6354
30,0,130,1385,1404,2789,6205
-90,20,170,1408,1381,2789,6393
60,80,20,1401,1388,2789,6411
160,-60,-150,1385,1404,2789,6626
-140,10,-140,1393,1397,2790,6417
-90,-40,170,1394,1396,2790,6440
70,80,10,1392,1398,2790,6407
150,20,-100,1400,1390,2790,6208
110,10,-20,1401,1389,2790,6440
-60,20,-90,1419,1371,2790,6249
-10,30,60,1403,1388,2791,6579
-20,70,80,1458,1333,2791,6494
-10,10,60,1389,1402,2791,6771
110,-30,20,1396,1396,2792,6378
20,-40,120,1409,1383,2792,6212
-30,-50,50,1420,1372,2792,6319
80,-20,-60,1382,1410,2792,6368
10,50,80,1419,1373,2792,6352
60,-60,130,1421,1371,2792,6460
-70,-10,70,1403,1390,2793,6500
-120,70,170,1404,1389,2793,6466
-20,-40,-110,1408,1385,2793,6094
-150,60,-160,1410,1383,2793,6510
110,-80,170,1405,1388,2793,6618
-120,0,-120,1400,1393,2793,6619
-160,-50,-120,1402,1392,2794,6512
130,40,-60,1406,1388,2794,6265
40,-40,140,1400,1394,2794,6302
0,40,60,1409,1385,2794,6685
150,80,-80,1417,1377,2794,6409
50,40,-150,1379,1415,2794,6486
150,-40,70,1406,1389,2795,6511
10,80,60,1412,1383,2795,6443
70,60,30,1397,1398,2795,6319
20,60,-110,1404,1391,2795,6656
120,-80,30,1397,1398,2795,6523
120,20,-60,1365,1430,2795,6436
-110,30,-180,1412,1384,2796,6533
-110,30,180,1412,1384,2796,6533
140,70,-70,1412,1384,2796,6488
110,-50,20,1377,1419,2796,6383
-30,70,70,1381,1416,2797,6493
140,-40,-140,1380,1418,2798,6389
-100,-30,50,1436,1363,2799,6369
-170,-10,-130,1413,1386,2799,6333
10,60,60,1411,1388,2799,6453
-120,40,10,1393,1406,2799,6522
-150,70,-150,1420,1380,2800,6408
30,50,90,1394,1406,2800,6169
170,50,-110,1408,1392,2800,6374
-80,-50,20,1406,1394,2800,6465
-170,50,-130,1395,1406,2801,6390
20,-70,90,1412,1389,2801,6482
-90,80,150,1420,1381,2801,6302
70,-50,150,1400,1401,2801,6618
-90,-20,160,1398,1404,2802,6315
10,60,-100,1389,1413,2802,6622
-150,50,-160,1424,1378,2802,6547
180,-10,-130,1408,1395,2803,6216
140,60,-70,1399,1404,2803,6399
60,20,150,1384,1419,2803,6096
-180,-10,-130,1408,1395,2803,6216
170,-20,-130,1408,1395,2803,6206
130,-80,40,1404,1399,2803,6643
30,-20,140,1378,1426,2804,6227
-130,50,-180,1429,1375,2804,6565
-70,30,100,1419,1385,2804,6679
-80,40,130,1429,1375,2804,6446
-20,40,-80,1387,1417,2804,6568
80,-50,-170,1391,1413,2804,6382
-130,50,180,1429,1375,2804,6565
70,40,80,1405,1399,2804,6189
120,70,-40,1387,1418,2805,6477
120,-80,-180,1408,1397,2805,6639
50,0,150,1394,1411,2805,6417
-100,60,150,1417,1388,2805,6600
120,-80,180,1408,1397,2805,6639
70,-50,180,1404,1401,2805,6352
-100,70,140,1414,1391,2805,6722
20,0,120,1406,1399,2805,6273
-10,0,60,1395,1410,2805,6764
70,-50,-180,1404,1401,2805,6352
-170,70,-130,1423,1383,2806,6263
-130,-30,90,1421,1386,2807,6256
-90,-80,-20,1419,1388,2807,6469
10,20,100,1418,1389,2807,6335
-40,70,80,1393,1414,2807,6562
-70,-70,10,1406,1401,2807,6540
-130,-60,-60,1443,1364,2807,6390
-50,-20,-130,1404,1403,2807,6422
-160,-80,-100,1410,1397,2807,6674
150,80,100,1432,1375,2807,6297
50,-50,130,1421,1386,2807,6782
-10,-80,60,1419,1389,2808,6441
-100,20,-170,1425,1383,2808,6710
-140,50,-170,1427,1382,2809,6612
-180,-30,-130,1445,1364,2809,6614
180,-30,-130,1445,1364,2809,6614
170,-80,80,1425,1384,2809,6781
40,20,120,1398,1412,2810,6058
-150,-60,-100,1430,1380,2810,6587
-80,20,140,1432,1378,2810,6297
-10,10,-90,1414,1396,2810,6432
120,10,-70,1387,1423,2810,6414
50,80,30,1417,1393,2810,6452
30,-70,100,1415,1395,2810,6581
90,60,150,1411,1399,2810,6371
-20,20,60,1436,1375,2811,6582
170,-40,-140,1417,1394,2811,6509
140,50,100,1420,1391,2811,6379
-110,20,-160,1430,1381,2811,6764
140,-70,50,1422,1389,2811,6687
-170,10,-130,1409,1403,2812,6468
120,-60,180,1403,1409,2812,6681
100,-40,-140,1379,1433,2812,6256
140,30,-80,1423,1389,2812,6288
-110,40,170,1423,1389,2812,6617
-180,20,70,1423,1389,2812,6351
180,20,70,1423,1389,2812,6351
120,-60,-180,1403,1409,2812,6681
130,-70,40,1392,1420,2812,6691
90,30,100,1381,1432,2813,6353
150,40,90,1434,1380,2814,6547
-80,40,120,1434,1380,2814,6679
-100,70,150,1426,1388,2814,6582
-20,50,60,1419,1395,2814,6700
-20,-30,60,1416,1398,2814,6344
-80,-60,10,1400,1414,2814,6347
-80,80,140,1415,1399,2814,6375
-130,-20,-100,1405,1410,2815,6545
-90,-60,0,1423,1392,2815,6267
160,80,-90,1430,1385,2815,6457
10,-40,110,1404,1411,2815,6296
180,40,-120,1403,1412,2815,6357
90,30,80,1418,1397,2815,6402
0,40,70,1403,1412,2815,6667
40,-10,150,1424,1391,2815,6279
-140,-60,-80,1418,1397,2815,6485
0,30,70,1394,1421,2815,6537
-100,-60,-10,1424,1391,2815,6487
-180,40,-120,1403,1412,2815,6357
140,-80,50,1403,1413,2816,6824
-100,20,-80,1404,1412,2816,6272
150,-80,60,1409,1407,2816,6886
-100,-80,-30,1423,1393,2816,6567
80,80,0,1402,1414,2816,6443
90,30,90,1400,1416,2816,6351
-130,-50,-60,1448,1369,2817,6356
170,-60,-140,1405,1412,2817,6692
-30,10,60,1432,1385,2817,6635
160,-80,70,1436,1382,2818,6844
90,30,70,1429,1389,2818,6383
-90,0,-160,1444,1375,2819,6703
10,40,90,1419,1401,2820,6306
-150,-60,110,1426,1394,2820,6601
-170,30,-130,1417,1403,2820,6539
-110,-30,40,1448,1372,2820,6094
-160,30,-140,1412,1408,2820,6465
10,-10,110,1406,1414,2820,6237
150,-70,60,1431,1389,2820,6723
-60,-70,20,1414,1406,2820,6543
30,-40,130,1415,1406,2821,6391
-80,-70,0,1422,1399,2821,6555
-90,-40,30,1435,1386,2821,6514
130,50,-50,1414,1407,2821,6419
-10,20,60,1415,1406,2821,6665
70,0,-100,1395,1427,2822,6234
90,80,-10,1405,1417,2822,6525
-100,-40,20,1427,1395,2822,6421
110,-10,30,1402,1421,2823,6377
90,70,0,1404,1419,2823,6131
-70,80,130,1417,1406,2823,6501
0,50,60,1436,1387,2823,6688
170,80,-100,1419,1405,2824,6413
-80,10,-130,1413,1411,2824,6547
-60,-30,-150,1425,1399,2824,6320
60,-50,-40,1392,1432,2824,6495
-70,-20,-160,1408,1416,2824,6400
-90,60,140,1417,1408,2825,6784
160,0,-120,1426,1399,2825,6364
130,-20,-120,1409,1416,2825,6489
-10,60,70,1431,1394,2825,6611
-120,0,-90,1397,1429,2826,6362
130,-80,-170,1419,1407,2826,6707
0,20,80,1417,1409,2826,6455
60,-50,140,1406,1420,2826,6670
-160,-30,-130,1429,1398,2827,6681
0,70,70,1422,1405,2827,6579
-110,60,160,1421,1406,2827,6621
130,-60,-170,1409,1419,2828,6666
30,-30,140,1419,1410,2829,6427
-150,-20,70,1414,1415,2829,6290
-20,-40,60,1430,1399,2829,6526
-40,80,100,1447,1382,2829,6671
-10,70,60,1403,1426,2829,6504
-40,20,-90,1413,1417,2830,6334
110,10,-40,1402,1428,2830,6476
80,60,160,1412,1418,2830,6374
40,80,40,1434,1396,2830,6493
-90,-60,170,1435,1395,2830,6406
70,-60,140,1440,1391,2831,6589
-170,40,-130,1412,1419,2831,6436
-170,20,-130,1402,1429,2831,6360
150,-40,-140,1416,1415,2831,6666
60,40,90,1419,1412,2831,6232
-80,-20,-170,1421,1411,2832,6679
30,-50,120,1433,1399,2832,6491
-140,70,-160,1421,1411,2832,6549
-40,80,-60,1419,1413,2832,6717
-50,70,100,1446,1387,2833,6752
-90,60,130,1409,1424,2833,6848
60,10,-140,1404,1429,2833,6462
60,40,180,1442,1392,2834,6321
60,40,-180,1442,1392,2834,6321
-120,-30,-30,1439,1395,2834,6255
60,10,-160,1354,1480,2834,6302
140,-30,-130,1398,1436,2834,6463
90,-50,-160,1409,1425,2834,6451
-130,40,-170,1435,1399,2834,6740
-90,90,160,1420,1415,2835,6563
-110,90,-180,1420,1415,2835,6563
80,90,-10,1420,1415,2835,6563
-180,90,-110,1420,1415,2835,6563
-50,90,120,1420,1415,2835,6563
-150,90,-140,1420,1415,2835,6563
-170,90,-120,1420,1415,2835,6563
-120,90,-170,1420,1415,2835,6563
90,90,-20,1420,1415,2835,6563
20,90,50,1420,1415,2835,6563
-20,90,90,1420,1415,2835,6563
-70,90,140,1420,1415,2835,6563
-100,90,170,1420,1415,2835,6563
-20,30,60,1447,1388,2835,6677
-40,0,60,1420,1415,2835,6632
-130,90,-160,1420,1415,2835,6563
-160,90,-130,1420,1415,2835,6563
160,-20,-130,1423,1412,2835,6495
50,90,20,1420,1415,2835,6563
40,90,30,1420,1415,2835,6563
-130,-70,-60,1436,1399,2835,6483
120,90,-50,1420,1415,2835,6563
150,90,-80,1420,1415,2835,6563
140,90,-70,1420,1415,2835,6563
160,90,-90,1420,1415,2835,6563
-30,90,100,1420,1415,2835,6563
60,90,10,1420,1415,2835,6563
60,0,-100,1420,1415,2835,6280
-10,90,80,1420,1415,2835,6563
-110,90,180,1420,1415,2835,6563
140,50,-70,1415,1420,2835,6572
110,-60,170,1414,1421,2835,6632
100,90,-30,1420,1415,2835,6563
-80,90,150,1420,1415,2835,6563
-60,90,130,1420,1415,2835,6563
10,90,60,1420,1415,2835,6563
0,90,70,1420,1415,2835,6563
180,90,-110,1420,1415,2835,6563
110,90,-40,1420,1415,2835,6563
170,90,-100,1420,1415,2835,6563
30,90,40,1420,1415,2835,6563
-140,90,-150,1420,1415,2835,6563
130,90,-60,1420,1415,2835,6563
70,90,0,1420,1415,2835,6563
-40,90,110,1420,1415,2835,6563
40,-50,120,1417,1419,2836,6519
-180,70,70,1432,1404,2836,6455
-80,-10,100,1400,1436,2836,6544
60,60,50,1421,1415,2836,6351
180,70,70,1432,1404,2836,6455
-120,-40,120,1421,1415,2836,6429
70,-20,-150,1414,1422,2836,6547
0,-80,70,1433,1403,2836,6567
160,20,-110,1429,1407,2836,6456
80,-50,-20,1420,1417,2837,6417
120,-70,-180,1421,1416,2837,6741
120,-70,180,1421,1416,2837,6741
140,-80,-160,1424,1414,2838,6769
-50,-10,60,1422,1416,2838,6516
60,30,180,1415,1423,2838,6257
-120,-20,-30,1418,1420,2838,6438
40,-70,110,1429,1409,2838,6634
0,10,80,1438,1400,2838,6568
140,-60,50,1449,1389,2838,6623
10,-40,90,1425,1413,2838,6675
60,30,-180,1415,1423,2838,6257
10,-30,100,1420,1419,2839,6482
0,80,70,1435,1404,2839,6569
0,10,-90,1409,1430,2839,6573
80,-20,-50,1378,1462,2840,6611
140,10,-90,1406,1434,2840,6438
180,50,-120,1425,1415,2840,6395
160,80,90,1450,1390,2840,6414
-180,50,-120,1425,1415,2840,6395
-130,-20,-90,1423,1417,2840,6592
30,-50,110,1407,1433,2840,6615
-140,-20,-120,1439,1401,2840,6799
0,-10,-90,1419,1421,2840,6615
0,40,-90,1415,1426,2841,6542
90,80,160,1447,1394,2841,6515
-130,-40,-60,1459,1382,2841,6364
-170,-80,-110,1425,1416,2841,6683
60,30,110,1433,1409,2842,6490
130,60,-50,1419,1423,2842,6505
-150,20,-140,1431,1411,2842,6550
-130,-40,110,1415,1427,2842,6603
-20,40,60,1451,1391,2842,6814
160,20,80,1442,1401,2843,6501
100,50,0,1401,1442,2843,6607
0,30,80,1430,1413,2843,6606
160,-70,70,1429,1414,2843,6491
70,-50,-30,1414,1429,2843,6456
40,-50,130,1434,1410,2844,6360
-130,0,-130,1439,1405,2844,6646
-60,80,120,1436,1408,2844,6640
120,0,60,1446,1398,2844,6411
-50,80,110,1446,1398,2844,6682
110,-40,20,1400,1444,2844,6548
180,-20,-130,1417,1428,2845,6411
-50,10,-100,1429,1416,2845,6575
-70,70,120,1426,1419,2845,6496
60,30,170,1439,1406,2845,6200
-180,-20,-130,1417,1428,2845,6411
-170,60,-130,1425,1421,2846,6347
150,-50,-150,1412,1435,2847,6568
-170,-40,-130,1448,1399,2847,6749
70,-20,-60,1378,1469,2847,6493
80,40,70,1422,1425,2847,6305
110,10,-50,1379,1468,2847,6314
-170,-50,-130,1427,1421,2848,6809
20,80,-120,1421,1427,2848,6590
150,70,-80,1433,1415,2848,6484
50,60,60,1432,1416,2848,6352
-50,70,90,1399,1449,2848,6795
-120,20,-150,1440,1408,2848,6719
-80,50,130,1443,1405,2848,6750
110,0,40,1414,1434,2848,6429
-120,-40,-30,1444,1405,2849,6341
-160,-20,-130,1440,1409,2849,6720
130,-10,-100,1437,1412,2849,6224
-60,70,100,1426,1423,2849,6864
40,60,-140,1456,1393,2849,6622
-90,70,130,1435,1414,2849,6879
-100,30,170,1450,1400,2850,6645
-150,-30,-120,1425,1425,2850,6744
110,20,-10,1409,1442,2851,6393
10,70,70,1456,1395,2851,6408
-160,0,-130,1441,1410,2851,6553
50,-10,170,1421,1430,2851,6095
-160,60,-140,1422,1430,2852,6417
-100,-30,140,1415,1438,2853,6600
30,70,60,1423,1430,2853,6469
90,40,50,1412,1441,2853,6335
140,10,80,1438,1416,2854,6598
150,-80,-150,1433,1421,2854,6797
10,-80,80,1422,1432,2854,6488
90,-20,-30,1433,1421,2854,6738
10,80,-110,1433,1422,2855,6681
-150,-10,-130,1460,1395,2855,6770
-70,-60,20,1426,1429,2855,6636
-90,70,140,1441,1414,2855,6571
10,50,90,1421,1435,2856,6338
80,-30,-140,1418,1438,2856,6174
170,-50,-140,1415,1441,2856,6655
130,-60,40,1417,1439,2856,6757
100,70,-10,1410,1446,2856,6346
50,-10,-80,1388,1468,2856,6592
110,-50,-150,1407,1449,2856,6345
-80,70,130,1434,1423,2857,6500
-30,70,90,1454,1403,2857,6668
180,-60,-130,1445,1412,2857,6723
110,10,60,1450,1407,2857,6661
-180,-60,-130,1445,1412,2857,6723
150,-10,-120,1435,1423,2858,6594
50,-50,150,1427,1431,2858,6532
50,30,-140,1423,1435,2858,6617
0,0,-90,1411,1447,2858,6550
-130,10,-140,1413,1445,2858,6762
-150,-70,-90,1449,1410,2859,6667
-80,-20,70,1418,1441,2859,6691
20,-80,90,1426,1433,2859,6649
0,40,80,1432,1427,2859,6585
10,-20,100,1436,1424,2860,6602
-30,60,70,1410,1450,2860,6873
-70,-20,60,1445,1416,2861,6844
110,-20,20,1404,1458,2862,6528
50,-50,-50,1417,1445,2862,6565
100,30,40,1427,1435,2862,6289
60,10,-120,1432,1430,2862,6656
-160,-10,-130,1438,1424,2862,6636
-110,-80,-40,1446,1416,2862,6647
-60,40,90,1454,1409,2863,6652
-140,60,-170,1435,1428,2863,6792
60,-50,150,1427,1436,2863,6585
-120,40,-180,1443,1420,2863,6794
100,60,140,1446,1417,2863,6578
180,80,-110,1449,1414,2863,6398
0,60,70,1467,1396,2863,6615
-180,80,-110,1449,1414,2863,6398
-120,40,180,1443,1420,2863,6794
-60,70,110,1448,1415,2863,6591
-50,70,-50,1442,1422,2864,6698
150,-30,-130,1412,1452,2864,6578
150,-30,70,1463,1401,2864,6778
-50,-40,-140,1437,1427,2864,6383
-160,-60,-110,1448,1416,2864,6776
-130,70,-170,1443,1422,2865,6715
-10,60,60,1429,1436,2865,6656
40,-20,160,1421,1444,2865,6255
-130,40,20,1455,1410,2865,6457
-120,0,0,1446,1419,2865,6651
100,-10,-100,1409,1456,2865,6607
-30,-60,50,1436,1429,2865,6453
10,60,70,1456,1410,2866,6458
-50,40,80,1430,1436,2866,6656
120,40,-40,1412,1454,2866,6624
-20,70,70,1413,1453,2866,6630
80,60,20,1417,1450,2867,6526
-80,-30,50,1429,1438,2867,6646
30,70,-130,1457,1410,2867,6732
30,-80,100,1431,1436,2867,6730
-40,30,70,1442,1425,2867,6707
-170,-60,-120,1461,1406,2867,6676
-10,40,60,1431,1436,2867,6955
120,0,-80,1463,1404,2867,6525
-30,70,80,1437,1430,2867,6817
40,0,140,1424,1444,2868,6273
-80,20,-90,1448,1420,2868,6598
-10,80,80,1447,1421,2868,6656
-130,-20,-70,1429,1440,2869,6393
20,40,100,1424,1445,2869,6112
-60,0,70,1442,1427,2869,6780
50,-50,140,1436,1433,2869,6484
100,80,-20,1434,1436,2870,6600
-140,40,-160,1454,1416,2870,6682
170,10,-120,1443,1427,2870,6376
-20,10,60,1458,1412,2870,6915
0,0,80,1444,1426,2870,6645
50,-70,120,1458,1413,2871,6759
150,-60,60,1457,1414,2871,6479
10,-50,110,1447,1424,2871,6493
90,-10,-70,1455,1417,2872,6505
-30,50,-70,1455,1417,2872,6663
-90,-70,-10,1434,1438,2872,6601
120,30,100,1437,1435,2872,6552
-90,-20,100,1418,1454,2872,6484
130,20,-70,1427,1446,2873,6587
170,-80,-130,1435,1438,2873,6762
-120,60,170,1443,1430,2873,6754
140,-10,-110,1432,1441,2873,6444
90,-10,-110,1421,1452,2873,6523
0,-20,80,1441,1432,2873,6745
-40,70,90,1453,1420,2873,6785
130,-50,-150,1405,1468,2873,6723
170,70,-100,1441,1432,2873,6587
-160,40,-140,1429,1444,2873,6797
30,80,50,1467,1407,2874,6572
80,-40,-150,1433,1441,2874,6426
160,-40,-140,1474,1400,2874,6586
130,40,-50,1447,1427,2874,6419
150,60,-80,1447,1427,2874,6534
-90,50,-20,1454,1421,2875,6771
0,-10,80,1460,1415,2875,6668
-120,10,0,1454,1421,2875,6571
60,-50,170,1425,1450,2875,6643
170,80,80,1457,1418,2875,6533
-50,-70,30,1427,1448,2875,6566
-70,70,110,1452,1424,2876,6909
-180,-80,-120,1438,1438,2876,6700
-60,40,-60,1443,1433,2876,6472
-140,30,30,1452,1424,2876,6660
180,-80,-120,1438,1438,2876,6700
10,-40,100,1436,1440,2876,6549
60,20,140,1438,1438,2876,6300
180,60,70,1432,1445,2877,6366
-150,40,-150,1449,1428,2877,6754
-70,40,-50,1427,1450,2877,6600
-180,60,70,1432,1445,2877,6366
-80,70,120,1458,1420,2878,6905
-120,-60,-40,1450,1429,2879,6562
-100,-40,150,1457,1422,2879,6564
100,30,100,1437,1442,2879,6531
160,-80,-140,1431,1448,2879,6804
10,30,100,1439,1440,2879,6375
130,-70,-170,1438,1442,2880,6839
-170,-30,-130,1462,1418,2880,6760
180,20,-120,1456,1424,2880,6442
-180,20,-120,1456,1424,2880,6442
100,-10,-20,1457,1423,2880,6609
120,-20,-110,1424,1457,2881,6623
-160,50,-140,1425,1457,2882,6553
0,50,70,1441,1441,2882,6681
-70,20,100,1476,1406,2882,6795
150,10,80,1450,1432,2882,6740
130,70,-50,1438,1444,2882,6651
100,-30,0,1417,1465,2882,6488
-20,60,80,1470,1413,2883,6826
170,40,-110,1446,1437,2883,6561
140,-20,-120,1439,1444,2883,6585
80,-60,150,1447,1436,2883,6741
120,30,-50,1425,1459,2884,6733
70,60,40,1461,1423,2884,6485
-50,-40,40,1458,1426,2884,6822
100,-10,-50,1429,1456,2885,6374
-140,30,-150,1431,1454,2885,6676
120,-50,30,1430,1455,2885,6676
60,10,-130,1431,1455,2886,6684
-110,-40,-10,1463,1423,2886,6604
-120,-70,140,1445,1441,2886,6668
150,30,-90,1470,1416,2886,6569
50,-20,-70,1414,1472,2886,6733
-120,10,-60,1452,1434,2886,6533
10,40,100,1457,1429,2886,6586
170,-30,-130,1461,1426,2887,6595
-70,20,-90,1445,1442,2887,6458
10,-20,120,1441,1446,2887,6383
-120,-80,-50,1455,1433,2888,6731
-170,0,-130,1455,1433,2888,6769
-20,80,90,1461,1427,2888,6758
-110,20,-80,1465,1423,2888,6265
-80,0,130,1455,1433,2888,6829
-120,30,-160,1444,1444,2888,6833
20,60,80,1442,1446,2888,6424
-20,-50,60,1455,1433,2888,6723
20,-40,-80,1416,1473,2889,6368
0,50,80,1470,1419,2889,6578
110,60,130,1455,1434,2889,6623
10,60,80,1469,1420,2889,6545
10,-50,90,1433,1457,2890,6722
-80,-10,110,1444,1446,2890,6527
-10,-30,70,1469,1421,2890,6649
-130,-20,60,1438,1452,2890,6396
0,50,-90,1441,1449,2890,6650
-100,10,-150,1467,1424,2891,6840
40,-60,130,1456,1435,2891,6526
-120,-50,-30,1461,1430,2891,6655
110,10,-30,1432,1460,2892,6582
10,-30,120,1459,1433,2892,6455
160,40,-100,1470,1422,2892,6534
40,-50,-60,1425,1467,2892,6634
-170,70,-120,1462,1430,2892,6497
120,-60,-170,1432,1461,2893,6799
-80,60,130,1462,1431,2893,6897
60,10,-150,1411,1482,2893,6571
100,-60,-180,1442,1451,2893,6771
-70,0,90,1458,1435,2893,6976
110,30,-10,1425,1468,2893,6501
100,-60,180,1442,1451,2893,6771
-10,50,60,1451,1443,2894,6986
-110,50,0,1464,1431,2895,6890
40,60,70,1440,1455,2895,6370
20,-30,130,1472,1423,2895,6625
70,30,140,1436,1460,2896,6322
140,-60,-160,1445,1451,2896,6764
160,70,-90,1463,1433,2896,6524
0,30,-90,1440,1456,2896,6934
-10,70,80,1469,1428,2897,6714
20,-50,100,1415,1482,2897,6518
-10,-20,70,1459,1438,2897,6797
50,-60,140,1455,1443,2898,6554
30,20,-100,1442,1456,2898,6582
-70,-30,50,1450,1448,2898,6773
-80,70,140,1466,1432,2898,6577
140,-50,50,1457,1442,2899,6563
-140,40,30,1459,1441,2900,6609
-80,0,-150,1474,1426,2900,6665
100,-60,-170,1474,1426,2900,6740
-170,80,-120,1477,1423,2900,6457
20,-20,130,1465,1435,2900,6647
70,30,120,1448,1452,2900,6405
-30,20,-90,1443,1457,2900,6607
70,50,60,1454,1446,2900,6355
30,-60,120,1469,1431,2900,6641
0,20,90,1453,1447,2900,6542
-140,-50,110,1477,1424,2901,6891
-110,30,-170,1447,1454,2901,6931
-120,0,-30,1473,1428,2901,6385
90,-60,180,1471,1430,2901,6811
90,-60,-180,1471,1430,2901,6811
-170,70,60,1472,1429,2901,6615
20,-50,120,1474,1428,2902,6568
40,-60,120,1459,1443,2902,6797
100,40,10,1427,1475,2902,6386
50,-60,130,1457,1445,2902,6946
20,-30,-80,1425,1478,2903,6707
-30,80,100,1465,1438,2903,6719
50,0,170,1435,1468,2903,6165
-20,0,60,1476,1427,2903,6883
-100,70,160,1466,1437,2903,6663
0,-30,100,1462,1441,2903,6636
80,-10,-80,1458,1445,2903,6470
-80,50,120,1475,1429,2904,7062
-170,-20,-130,1469,1435,2904,6796
150,-50,60,1463,1442,2905,6529
-100,10,-130,1472,1433,2905,6915
-40,80,110,1477,1428,2905,6631
40,-80,110,1446,1459,2905,6876
-100,50,-10,1478,1427,2905,6829
-10,-40,70,1481,1425,2906,6650
-10,-50,70,1459,1447,2906,6748
-90,20,180,1464,1442,2906,6693
0,-50,80,1467,1439,2906,6788
-90,20,-180,1464,1442,2906,6693
50,20,-120,1455,1452,2907,6734
0,-40,100,1463,1444,2907,6426
80,-60,-180,1473,1435,2908,6736
60,70,-170,1460,1448,2908,6682
-40,-70,40,1457,1451,2908,6657
80,-60,180,1473,1435,2908,6736
-30,80,-70,1456,1452,2908,6821
-120,70,180,1473,1436,2909,6806
-120,70,-180,1473,1436,2909,6806
120,-10,50,1460,1449,2909,6601
-80,50,-30,1478,1431,2909,6801
-90,20,-100,1468,1442,2910,6610
-50,30,-80,1443,1467,2910,6574
-130,60,-180,1463,1448,2911,6864
-130,60,180,1463,1448,2911,6864
-10,50,70,1452,1459,2911,6943
-180,70,-110,1466,1445,2911,6612
-50,10,70,1468,1443,2911,6827
-110,70,170,1467,1444,2911,6709
180,70,-110,1466,1445,2911,6612
100,-20,-10,1466,1446,2912,6559
50,-80,120,1457,1455,2912,6937
-160,80,-130,1493,1419,2912,6482
-60,-60,30,1454,1459,2913,6859
-70,-50,30,1472,1441,2913,6852
-90,30,-50,1435,1478,2913,6324
120,40,110,1480,1433,2913,6539
110,-30,-120,1437,1477,2914,6397
120,60,120,1473,1441,2914,6712
-30,0,60,1471,1443,2914,6868
110,30,100,1475,1439,2914,6566
100,-10,-30,1465,1449,2914,6642
-140,0,-130,1475,1440,2915,6860
-120,0,-110,1453,1462,2915,6676
-60,10,80,1463,1452,2915,6885
-20,-60,60,1467,1448,2915,6693
-70,10,100,1486,1430,2916,6995
-10,60,80,1485,1431,2916,6788
60,-70,130,1474,1442,2916,6861
110,10,-10,1441,1475,2916,6522
10,-50,100,1449,1467,2916,6652
0,-30,80,1461,1455,2916,6758
70,-50,-170,1440,1476,2916,6614
-120,10,-140,1460,1457,2917,7002
-10,40,70,1469,1448,2917,6973
-30,60,90,1499,1418,2917,6972
90,-30,-20,1454,1463,2917,6704
-90,10,-170,1472,1446,2918,6867
170,-60,80,1456,1462,2918,6798
100,-20,-110,1462,1456,2918,6454
40,-50,140,1464,1454,2918,6663
90,50,20,1442,1476,2918,6496
-130,-20,-80,1460,1458,2918,6693
60,50,70,1445,1473,2918,6384
-90,30,160,1500,1419,2919,6940
20,-50,110,1467,1452,2919,6607
-130,-10,30,1474,1445,2919,6302
150,0,-110,1453,1466,2919,6467
140,0,-100,1451,1468,2919,6585
140,-50,-150,1451,1468,2919,6780
-100,50,160,1475,1444,2919,6850
-150,50,-150,1457,1462,2919,6888
-90,70,150,1480,1439,2919,6573
120,50,-30,1452,1468,2920,6608
0,-40,80,1459,1461,2920,6706
40,-10,-80,1430,1490,2920,6860
-20,-30,-110,1435,1485,2920,6486
-110,-60,-20,1471,1449,2920,6674
80,-60,170,1472,1448,2920,6970
110,0,-70,1442,1479,2921,6820
110,-60,-170,1457,1464,2921,6858
60,-80,130,1464,1457,2921,7077
-20,-20,60,1474,1447,2921,6823
170,-40,80,1472,1449,2921,6688
0,-50,100,1476,1445,2921,6524
-70,70,130,1479,1443,2922,6626
-70,30,110,1492,1430,2922,6889
-160,-40,-120,1468,1454,2922,6747
-80,30,140,1493,1430,2923,6804
-180,30,-120,1472,1451,2923,6625
180,30,-120,1472,1451,2923,6625
110,-60,-180,1451,1472,2923,6733
110,-60,180,1451,1472,2923,6733
90,60,10,1434,1489,2923,6608
50,-50,160,1460,1463,2923,6655
-10,-60,70,1476,1447,2923,6872
0,80,-100,1481,1443,2924,6859
40,0,-90,1450,1474,2924,6999
10,0,110,1467,1458,2925,6475
-80,60,120,1478,1447,2925,7116
70,60,170,1486,1439,2925,6605
-160,70,-130,1472,1453,2925,6607
-70,30,120,1491,1436,2927,6764
140,-70,-160,1457,1470,2927,6918
-20,-10,60,1481,1446,2927,7016
-160,10,-130,1464,1463,2927,6842
60,-60,160,1481,1447,2928,6699
-90,40,150,1490,1438,2928,6739
20,30,-100,1457,1471,2928,6627
-70,20,110,1515,1413,2928,6946
-50,80,120,1483,1445,2928,6550
160,-30,-130,1462,1466,2928,6810
130,-30,50,1463,1465,2928,6790
-10,30,70,1481,1448,2929,7094
110,80,-30,1456,1473,2929,6665
-30,-40,-120,1457,1472,2929,6615
70,-60,170,1480,1450,2930,6660
70,-60,160,1473,1458,2931,6836
-100,30,180,1474,1457,2931,6916
-100,30,-180,1474,1457,2931,6916
80,80,170,1500,1431,2931,6755
-80,0,140,1465,1466,2931,6614
0,30,90,1467,1464,2931,6733
-70,40,120,1493,1439,2932,6796
-140,-50,-80,1495,1437,2932,6683
110,0,10,1449,1483,2932,6637
-70,80,140,1482,1450,2932,6646
-130,30,-150,1463,1469,2932,6853
10,-40,120,1498,1434,2932,6680
-170,40,60,1463,1469,2932,6716
-150,0,-130,1473,1459,2932,6832
-150,80,-140,1498,1434,2932,6598
-60,70,120,1468,1464,2932,6735
70,-70,140,1483,1449,2932,7054
100,-60,170,1463,1470,2933,6795
60,-60,150,1479,1454,2933,6627
-20,80,-80,1466,1467,2933,6922
70,0,-120,1445,1488,2933,6671
-70,0,-140,1489,1444,2933,6656
-70,20,120,1514,1419,2933,6786
20,-40,130,1476,1457,2933,6760
-90,60,150,1488,1446,2934,6818
110,70,-20,1440,1494,2934,6569
140,40,-70,1481,1453,2934,6811
-50,-50,40,1490,1445,2935,6959
-30,-70,50,1466,1469,2935,6660
60,-60,140,1477,1458,2935,6873
130,-60,-160,1463,1473,2936,7014
-110,-50,140,1495,1441,2936,6709
70,40,160,1489,1447,2936,6366
-110,-70,150,1482,1454,2936,6595
30,-60,110,1470,1466,2936,6771
-130,-80,-60,1465,1472,2937,6907
60,70,40,1482,1455,2937,6774
-130,-70,130,1482,1456,2938,6803
50,-60,150,1477,1461,2938,6785
-20,70,90,1503,1435,2938,6837
40,-40,160,1463,1476,2939,6552
-160,-70,-100,1485,1454,2939,6914
160,-60,70,1475,1464,2939,6725
-70,50,-40,1474,1466,2940,6954
90,-40,-140,1465,1475,2940,6598
-110,20,-30,1486,1454,2940,6740
-120,50,10,1482,1458,2940,6643
50,0,160,1483,1457,2940,6432
-60,80,130,1497,1443,2940,6613
70,-40,-160,1468,1473,2941,6589
60,-70,140,1471,1470,2941,6885
-40,70,100,1494,1447,2941,6916
-90,-40,40,1464,1477,2941,6864
-70,60,120,1479,1462,2941,6854
-40,-30,50,1478,1463,2941,6844
-140,50,30,1496,1446,2942,6662
-110,-50,-10,1499,1443,2942,6768
50,30,110,1489,1453,2942,6407
20,80,60,1488,1454,2942,6735
40,-30,-70,1457,1485,2942,6902
-40,60,80,1462,1480,2942,6986
110,40,-10,1449,1493,2942,6721
-30,60,-70,1478,1464,2942,6839
-140,20,30,1465,1477,2942,6625
-10,20,70,1472,1471,2943,6989
-80,60,140,1494,1449,2943,6845
-30,-10,60,1478,1465,2943,7026
-80,40,-40,1485,1459,2944,6840
110,-60,-160,1485,1459,2944,6720
110,-10,20,1433,1511,2944,6567
-60,-30,50,1505,1439,2944,6943
0,70,80,1494,1450,2944,6747
-140,-40,-90,1487,1457,2944,6927
-150,60,-150,1464,1481,2945,6689
20,-60,100,1470,1475,2945,6809
-80,-40,40,1485,1460,2945,6880
-60,-20,60,1495,1450,2945,6869
-70,-40,40,1481,1466,2947,6845
150,-70,-150,1478,1470,2948,6955
-100,-70,-20,1463,1485,2948,6727
50,50,-160,1487,1461,2948,6707
-10,30,80,1492,1456,2948,6699
-70,50,120,1507,1442,2949,6856
90,-60,160,1476,1473,2949,6742
-10,80,-90,1491,1458,2949,6870
90,-50,-10,1468,1481,2949,6554
-150,70,-140,1490,1460,2950,6690
90,-60,170,1481,1469,2950,6884
150,-60,-150,1474,1476,2950,6857
90,-20,-120,1477,1474,2951,6466
-120,0,-100,1477,1474,2951,6727
50,70,50,1475,1477,2952,6701
20,-60,120,1494,1458,2952,6707
80,-50,-160,1458,1494,2952,6871
-80,-50,180,1506,1446,2952,6665
-80,-50,-180,1506,1446,2952,6665
-140,80,-150,1495,1457,2952,6715
-50,-60,40,1485,1467,2952,6918
20,-60,110,1491,1461,2952,6755
30,-40,140,1483,1470,2953,6828
0,40,90,1476,1477,2953,6737
-150,-40,-110,1496,1457,2953,6669
-160,20,-130,1476,1477,2953,6555
-80,-40,-180,1482,1471,2953,6774
140,-10,70,1497,1456,2953,6891
-80,-40,180,1482,1471,2953,6774
30,40,100,1476,1477,2953,6528
70,-80,140,1481,1473,2954,7174
-180,10,70,1497,1457,2954,6911
140,-30,60,1489,1465,2954,6756
-70,10,110,1520,1434,2954,6957
180,10,70,1497,1457,2954,6911
40,10,-100,1475,1480,2955,6632
-80,-60,-180,1487,1468,2955,6788
-80,-60,180,1487,1468,2955,6788
100,-40,0,1461,1494,2955,6519
-170,-10,70,1514,1441,2955,6839
-130,0,-120,1489,1466,2955,7010
0,-50,90,1475,1480,2955,6749
50,-70,130,1481,1475,2956,6985
-40,70,-60,1491,1465,2956,7025
0,10,90,1481,1475,2956,6691
10,80,70,1495,1461,2956,6811
-10,40,80,1492,1464,2956,6865
-120,-10,-20,1496,1460,2956,6613
-60,-40,40,1487,1469,2956,6893
90,-30,-130,1459,1497,2956,6572
-60,60,100,1482,1475,2957,7133
170,-30,80,1487,1471,2958,6795
-120,10,-90,1482,1476,2958,6666
50,-70,140,1501,1458,2959,6691
70,70,30,1485,1474,2959,6752
-130,0,20,1492,1467,2959,6626
0,60,80,1487,1472,2959,6773
-110,10,-140,1502,1457,2959,6778
-20,-70,60,1499,1460,2959,6887
-60,30,90,1506,1454,2960,6933
-30,70,100,1499,1461,2960,6920
-150,-50,-100,1508,1452,2960,6974
-110,20,-150,1500,1460,2960,6951
130,80,-50,1464,1496,2960,6765
-180,-40,-130,1486,1475,2961,6860
-150,30,-140,1477,1484,2961,6710
170,30,-110,1497,1464,2961,6824
180,-40,-130,1486,1475,2961,6860
120,80,-40,1462,1499,2961,6728
-50,70,110,1481,1480,2961,6931
-120,10,-40,1500,1461,2961,6581
180,80,70,1499,1463,2962,6718
140,20,-80,1489,1473,2962,6695
-180,80,70,1499,1463,2962,6718
70,-70,160,1475,1487,2962,6694
-120,10,-130,1484,1478,2962,6826
-180,-50,-130,1495,1468,2963,6830
180,-50,-130,1495,1468,2963,6830
-170,50,60,1484,1479,2963,6688
-140,-70,-70,1486,1477,2963,6945
0,-60,80,1500,1463,2963,6921
50,-30,-180,1477,1487,2964,6354
50,-30,180,1477,1487,2964,6354
-50,60,90,1488,1476,2964,6995
-130,-30,-60,1504,1460,2964,6714
-80,80,150,1504,1460,2964,6662
-90,-60,10,1492,1472,2964,6834
-110,50,170,1509,1455,2964,6879
160,-50,-140,1472,1493,2965,6864
0,-30,90,1482,1483,2965,6899
90,-60,-170,1496,1469,2965,6758
-10,-20,-100,1481,1485,2966,6764
40,70,60,1500,1466,2966,6721
-140,-70,120,1505,1461,2966,6924
-70,60,110,1492,1475,2967,7236
110,0,30,1473,1494,2967,6753
20,20,110,1485,1483,2968,6731
-100,20,-160,1488,1480,2968,6863
-170,60,-120,1495,1473,2968,6718
-140,20,-140,1493,1475,2968,6889
0,-60,90,1492,1476,2968,6742
-110,20,-50,1477,1492,2969,6438
-90,50,150,1506,1463,2969,6993
30,50,-120,1496,1473,2969,7012
-30,50,70,1507,1463,2970,6968
30,-50,130,1472,1498,2970,6644
0,-30,110,1492,1478,2970,6644
120,60,-30,1489,1481,2970,6577
80,-70,150,1493,1477,2970,7109
-100,60,160,1501,1469,2970,6923
-80,50,140,1514,1456,2970,6879
-10,-10,70,1500,1471,2971,6975
60,-50,-180,1486,1485,2971,6774
20,70,70,1477,1494,2971,6693
-100,10,-140,1483,1488,2971,6879
-160,60,50,1485,1486,2971,6821
60,-50,180,1486,1485,2971,6774
-160,50,-130,1488,1484,2972,6747
-10,10,70,1496,1476,2972,7104
30,-60,130,1499,1473,2972,6835
170,-50,80,1499,1473,2972,7147
100,-10,-60,1460,1512,2972,6443
-90,10,-140,1494,1479,2973,7038
0,80,80,1494,1479,2973,6841
50,-90,120,1471,1502,2973,7158
-160,-90,-90,1471,1502,2973,7158
100,-90,170,1471,1502,2973,7158
120,-90,-170,1471,1502,2973,7158
-150,-90,-80,1471,1502,2973,7158
110,-90,-180,1471,1502,2973,7158
90,-90,160,1471,1502,2973,7158
130,-90,-160,1471,1502,2973,7158
-130,-90,-60,1471,1502,2973,7158
180,-90,-110,1471,1502,2973,7158
-140,50,-160,1507,1466,2973,6917
170,-90,-120,1471,1502,2973,7158
-140,-90,-70,1471,1502,2973,7158
-10,-90,60,1471,1502,2973,7158
140,-90,-150,1471,1502,2973,7158
160,-90,-130,1471,1502,2973,7158
-70,-90,0,1471,1502,2973,7158
-20,-90,50,1471,1502,2973,7158
-150,-60,-90,1492,1481,2973,7163
30,-90,100,1471,1502,2973,7158
-180,-90,-110,1471,1502,2973,7158
10,-90,80,1471,1502,2973,7158
-120,-90,-50,1471,1502,2973,7158
-40,-90,30,1471,1502,2973,7158
150,-90,-140,1471,1502,2973,7158
-60,-90,10,1471,1502,2973,7158
-170,-90,-100,1471,1502,2973,7158
20,-90,90,1471,1502,2973,7158
-90,-90,-20,1471,1502,2973,7158
-110,-90,-40,1471,1502,2973,7158
60,-90,130,1471,1502,2973,7158
110,-90,180,1471,1502,2973,7158
80,-90,150,1471,1502,2973,7158
-80,-90,-10,1471,1502,2973,7158
-30,-90,40,1471,1502,2973,7158
0,-90,70,1471,1502,2973,7158
-50,-90,20,1471,1502,2973,7158
-100,-90,-30,1471,1502,2973,7158
70,-90,140,1471,1502,2973,7158
40,-90,110,1471,1502,2973,7158
-130,50,20,1475,1499,2974,6624
110,20,80,1466,1508,2974,6787
-120,50,-180,1508,1467,2975,6829
60,-70,150,1495,1480,2975,6714
20,70,-120,1512,1463,2975,6970
130,30,-60,1493,1482,2975,6902
-120,50,180,1508,1467,2975,6829
-140,70,-150,1492,1484,2976,6786
-60,-10,-140,1488,1488,2976,6791
40,30,110,1469,1507,2976,6561
-130,-10,-110,1480,1497,2977,6933
20,0,-90,1447,1530,2977,7010
60,50,-180,1515,1462,2977,6824
160,60,-90,1501,1476,2977,6694
70,30,130,1494,1483,2977,6580
60,50,180,1515,1462,2977,6824
-90,90,170,1478,1500,2978,6789
10,-60,100,1506,1472,2978,6767
-140,90,-140,1478,1500,2978,6789
80,-80,150,1485,1493,2978,7204
60,90,20,1478,1500,2978,6789
-30,90,110,1478,1500,2978,6789
30,90,50,1478,1500,2978,6789
0,90,80,1478,1500,2978,6789
-80,90,160,1478,1500,2978,6789
-20,90,100,1478,1500,2978,6789
10,90,70,1478,1500,2978,6789
50,90,30,1478,1500,2978,6789
170,90,-90,1478,1500,2978,6789
-100,90,180,1478,1500,2978,6789
160,90,-80,1478,1500,2978,6789
-70,90,150,1478,1500,2978,6789
140,90,-60,1478,1500,2978,6789
-10,90,90,1478,1500,2978,6789
150,90,-70,1478,1500,2978,6789
-110,20,-70,1491,1487,2978,6805
-150,90,-130,1478,1500,2978,6789
110,90,-30,1478,1500,2978,6789
100,90,-20,1478,1500,2978,6789
-120,90,-160,1478,1500,2978,6789
-100,90,-180,1478,1500,2978,6789
130,90,-50,1478,1500,2978,6789
130,0,70,1511,1467,2978,6843
-110,90,-170,1478,1500,2978,6789
120,90,-40,1478,1500,2978,6789
-180,90,-100,1478,1500,2978,6789
180,90,-100,1478,1500,2978,6789
-40,90,120,1478,1500,2978,6789
-170,90,-110,1478,1500,2978,6789
-160,90,-120,1478,1500,2978,6789
-50,90,130,1478,1500,2978,6789
-130,90,-150,1478,1500,2978,6789
170,0,-120,1485,1493,2978,6886
40,90,40,1478,1500,2978,6789
70,90,10,1478,1500,2978,6789
80,90,0,1478,1500,2978,6789
-60,90,140,1478,1500,2978,6789
-120,40,-170,1476,1502,2978,6983
20,90,60,1478,1500,2978,6789
90,90,-10,1478,1500,2978,6789
40,-60,140,1502,1477,2979,6818
-20,50,80,1522,1458,2980,7053
90,50,30,1517,1463,2980,6565
-110,10,-110,1487,1493,2980,6991
40,40,-130,1534,1447,2981,6895
0,-20,90,1498,1483,2981,7028
-80,20,-100,1500,1481,2981,6762
40,-70,130,1516,1465,2981,6817
100,-10,-40,1477,1504,2981,6679
-110,-70,-30,1479,1502,2981,6807
-110,-30,110,1487,1494,2981,6714
20,-50,130,1477,1504,2981,6735
10,-60,90,1472,1510,2982,6886
-60,60,110,1503,1479,2982,7077
20,-70,110,1517,1465,2982,6867
60,-40,-170,1502,1480,2982,6631
40,30,-120,1499,1483,2982,6881
-90,80,160,1503,1479,2982,6764
-130,50,-170,1518,1464,2982,6885
110,10,10,1481,1502,2983,6539
90,-80,160,1499,1484,2983,7206
-30,-40,60,1507,1476,2983,6844
-130,0,-70,1507,1476,2983,6743
140,70,-60,1489,1494,2983,6842
-30,-50,60,1521,1463,2984,6977
30,0,-90,1470,1514,2984,7043
30,-70,120,1515,1469,2984,6876
80,50,50,1505,1480,2985,6652
-140,-80,-70,1488,1497,2985,7031
-40,70,110,1504,1481,2985,6810
-70,40,110,1539,1446,2985,7109
-110,-40,130,1510,1475,2985,6964
-10,20,80,1501,1485,2986,6815
70,80,180,1527,1459,2986,6906
0,-20,100,1489,1497,2986,6856
-10,50,80,1526,1460,2986,7029
70,80,-180,1527,1459,2986,6906
10,0,-90,1458,1528,2986,6972
-20,60,90,1513,1473,2986,6905
-60,0,-130,1520,1466,2986,6729
-10,-70,70,1492,1495,2987,6805
30,-50,-70,1477,1510,2987,6888
120,-20,-100,1476,1511,2987,6539
-130,-60,-50,1513,1474,2987,6878
-40,-40,50,1499,1488,2987,6955
130,-20,-110,1481,1507,2988,6699
90,-10,-80,1453,1535,2988,6776
-40,-50,50,1523,1465,2988,6968
30,-70,130,1509,1480,2989,6878
0,50,90,1518,1471,2989,6816
110,0,20,1468,1521,2989,6865
-40,-10,60,1489,1501,2990,7090
-10,60,90,1506,1484,2990,7010
-150,50,40,1515,1475,2990,6677
-80,-10,-170,1502,1489,2991,6978
0,40,100,1495,1496,2991,6694
170,-70,-130,1522,1469,2991,7061
10,-60,110,1508,1483,2991,6903
160,-70,-140,1504,1488,2992,7005
140,80,-60,1491,1501,2992,6828
-110,30,-160,1499,1493,2992,7109
150,50,-80,1473,1520,2993,6729
-110,10,-120,1508,1485,2993,7026
0,-40,90,1491,1502,2993,6929
-130,40,-160,1492,1501,2993,6876
-100,-70,160,1507,1486,2993,6667
-110,20,-90,1480,1514,2994,6664
170,60,-100,1520,1474,2994,6808
100,40,20,1537,1458,2995,6798
90,-70,160,1514,1481,2995,7080
-10,80,90,1493,1503,2996,6932
-10,0,70,1486,1510,2996,7070
100,-60,-160,1510,1486,2996,6829
-110,60,170,1503,1493,2996,6928
-160,40,-130,1500,1496,2996,6896
50,50,80,1487,1510,2997,6501
-40,60,90,1516,1481,2997,7140
-150,40,40,1509,1488,2997,6720
-150,10,-130,1512,1485,2997,6984
100,-80,170,1508,1490,2998,7286
0,0,90,1484,1514,2998,6825
-20,40,80,1520,1478,2998,6981
-180,-70,-120,1512,1486,2998,7040
180,-70,-120,1512,1486,2998,7040
70,-70,150,1520,1478,2998,6952
110,-40,-130,1466,1532,2998,6856
-80,40,140,1518,1481,2999,7002
80,-70,170,1500,1499,2999,6869
40,-50,150,1515,1484,2999,6919
110,-10,-90,1503,1496,2999,7001
-170,30,-120,1520,1479,2999,6844
-170,60,60,1496,1503,2999,6741
-30,60,80,1507,1493,3000,7242
-70,60,130,1526,1474,3000,6919
-50,-30,50,1504,1496,3000,7043
-130,80,-160,1519,1481,3000,6815
30,-70,110,1492,1508,3000,7161
10,-50,120,1519,1482,3001,6824
-10,-50,80,1502,1499,3001,7096
90,-20,-50,1502,1499,3001,6763
50,10,140,1485,1516,3001,6750
40,-70,140,1513,1488,3001,6896
0,-40,110,1503,1499,3002,6671
70,-10,-90,1511,1491,3002,6597
40,-70,120,1492,1510,3002,7113
-60,50,-50,1509,1493,3002,7025
30,-50,140,1504,1498,3002,7015
-50,60,100,1515,1487,3002,7127
-60,-50,40,1499,1504,3003,7078
110,70,130,1550,1453,3003,6753
-160,70,50,1499,1504,3003,6902
10,-10,120,1499,1504,3003,6655
20,-60,130,1503,1500,3003,6895
-160,-30,-120,1528,1475,3003,7098
180,60,-110,1516,1488,3004,6747
-180,60,-110,1516,1488,3004,6747
60,80,30,1471,1533,3004,6670
-170,-70,-110,1530,1475,3005,7047
-150,50,-140,1494,1511,3005,6802
-80,20,-110,1535,1470,3005,6951
50,30,-150,1491,1514,3005,6867
-90,-30,160,1517,1488,3005,6910
10,50,100,1513,1492,3005,6606
-170,-50,-120,1524,1481,3005,6873
130,-50,-140,1489,1518,3007,6921
-140,-30,80,1529,1478,3007,6808
100,-50,-150,1488,1519,3007,6780
120,40,-30,1515,1493,3008,6739
50,10,-110,1525,1483,3008,6956
0,-60,100,1512,1497,3009,6911
150,10,-100,1507,1502,3009,6870
-70,0,100,1521,1488,3009,7021
70,-10,-140,1478,1531,3009,6783
-10,70,90,1531,1479,3010,6965
100,-70,170,1521,1489,3010,7044
100,-40,-130,1490,1520,3010,6770
40,-80,130,1532,1478,3010,6860
-110,80,180,1519,1491,3010,6925
-130,-10,-70,1520,1490,3010,6985
-110,80,-180,1519,1491,3010,6925
-140,30,-140,1511,1499,3010,6864
150,50,90,1516,1494,3010,7032
100,70,140,1543,1467,3010,6808
110,10,50,1506,1505,3011,6836
-90,30,170,1519,1492,3011,7023
110,50,-10,1487,1524,3011,6902
-10,-60,80,1505,1506,3011,6977
50,-70,150,1500,1512,3012,6902
-140,10,-130,1500,1512,3012,7126
-20,-40,70,1528,1484,3012,6853
-120,80,-170,1525,1487,3012,6899
40,50,-140,1534,1478,3012,6908
50,80,40,1483,1529,3012,6716
-160,-50,-110,1523,1490,3013,6966
-110,20,-40,1512,1501,3013,6713
-80,-60,20,1519,1494,3013,6890
-50,-20,60,1517,1496,3013,7029
-160,30,-130,1503,1510,3013,6826
0,-70,80,1500,1514,3014,6877
0,50,100,1555,1459,3014,6702
-70,50,110,1534,1480,3014,7288
50,-40,-180,1490,1524,3014,6600
-100,30,-30,1510,1504,3014,6981
50,-40,180,1490,1524,3014,6600
-170,30,60,1510,1505,3015,6804
-150,40,-140,1487,1528,3015,6840
-20,60,70,1487,1528,3015,7041
-30,-20,60,1505,1510,3015,7172
70,-80,150,1518,1497,3015,7062
70,-60,150,1512,1503,3015,6897
120,-30,-120,1488,1527,3015,6812
-100,80,170,1525,1490,3015,6863
30,-80,120,1534,1482,3016,6909
130,50,-40,1505,1511,3016,6900
70,80,20,1480,1536,3016,6707
-70,10,120,1546,1470,3016,7054
0,-20,110,1521,1495,3016,6714
-130,20,-140,1524,1492,3016,7077
-60,70,130,1524,1492,3016,6692
-130,10,-130,1506,1510,3016,7033
60,-10,-90,1514,1503,3017,6886
-140,-10,-120,1502,1515,3017,6965
-20,80,100,1512,1505,3017,6970
-20,50,70,1503,1514,3017,7242
80,-60,160,1495,1522,3017,7029
10,10,110,1504,1513,3017,6802
-140,-40,100,1526,1491,3017,7072
30,-10,140,1521,1496,3017,6583
150,-20,70,1531,1487,3018,7056
-10,-30,80,1515,1504,3019,6828
-50,30,80,1508,1511,3019,7038
-10,-60,90,1526,1493,3019,6824
-60,50,120,1521,1498,3019,7053
150,80,-70,1505,1514,3019,6883
-80,-10,120,1512,1507,3019,6980
-40,20,70,1518,1501,3019,7254
10,-70,90,1507,1512,3019,6956
100,60,0,1479,1540,3019,6810
120,-10,-90,1495,1525,3020,6902
-100,-40,30,1510,1512,3022,6877
160,-60,-140,1514,1508,3022,7017
20,-70,100,1513,1509,3022,7064
-140,-20,60,1530,1492,3022,6668
40,20,-110,1505,1517,3022,6820
-90,-50,20,1521,1501,3022,7001
80,60,30,1533,1489,3022,6779
60,-80,140,1512,1511,3023,7066
110,10,20,1491,1532,3023,6852
50,-80,140,1548,1475,3023,6769
-110,20,-20,1540,1483,3023,6910
-110,40,180,1505,1519,3024,7159
130,0,-80,1521,1503,3024,6759
-110,40,-180,1505,1519,3024,7159
110,-70,180,1529,1495,3024,7175
160,80,-80,1519,1505,3024,6946
160,30,-100,1506,1518,3024,6972
110,-70,-180,1529,1495,3024,7175
50,-80,130,1506,1519,3025,7081
140,0,-90,1509,1516,3025,6842
120,20,-50,1482,1543,3025,6950
-100,-60,0,1532,1494,3026,6918
-120,20,-140,1516,1510,3026,6922
140,30,-70,1542,1485,3027,6976
110,-80,180,1522,1505,3027,7331
140,60,-60,1517,1510,3027,6926
110,-80,-180,1522,1505,3027,7331
20,-70,120,1528,1499,3027,7019
50,60,-160,1516,1511,3027,6959
-40,60,100,1542,1485,3027,7089
-50,70,120,1518,1510,3028,6722
30,60,80,1500,1528,3028,6812
80,-80,160,1528,1500,3028,7056
-160,60,-130,1550,1478,3028,6825
-170,50,-120,1525,1504,3029,6927
-110,10,-130,1500,1529,3029,7059
150,-20,-120,1499,1530,3029,6997
60,-80,150,1540,1490,3030,6749
80,80,10,1490,1540,3030,6729
0,-10,90,1528,1502,3030,6974
20,50,100,1529,1502,3031,6548
-80,-50,30,1535,1496,3031,7044
-150,-80,-80,1506,1525,3031,7177
-60,20,90,1532,1499,3031,7179
-10,-50,90,1530,1502,3032,6895
-90,-70,170,1535,1497,3032,6733
-50,60,110,1538,1494,3032,7171
140,50,-60,1515,1517,3032,7031
-40,-60,50,1529,1503,3032,6947
-90,-20,150,1532,1500,3032,6936
-120,-20,-20,1515,1518,3033,7013
40,80,50,1499,1534,3033,6789
-150,-20,-120,1531,1502,3033,7236
-120,-20,10,1533,1500,3033,6932
-170,20,60,1512,1521,3033,6683
-150,60,40,1531,1502,3033,6887
-10,50,90,1516,1518,3034,7140
-120,10,-50,1526,1508,3034,6816
-40,10,-100,1505,1529,3034,6951
80,70,20,1507,1527,3034,6864
-80,10,150,1524,1510,3034,7041
-70,-80,10,1512,1523,3035,7153
-140,60,-160,1491,1544,3035,7012
-10,-70,90,1549,1486,3035,7064
50,-20,180,1499,1537,3036,6538
120,-20,40,1511,1525,3036,7118
-30,60,100,1529,1507,3036,7065
-140,40,-150,1516,1520,3036,6963
-140,-30,-100,1527,1509,3036,7183
50,0,-180,1492,1544,3036,6501
50,0,180,1492,1544,3036,6501
50,-20,-180,1499,1537,3036,6538
160,-10,-120,1509,1528,3037,7002
50,40,-160,1506,1531,3037,6922
-170,40,-120,1515,1522,3037,6919
90,-80,170,1534,1504,3038,7131
160,10,-110,1525,1513,3038,6924
-20,-70,70,1521,1517,3038,6953
170,-40,-130,1534,1504,3038,7108
20,-50,-80,1500,1539,3039,7135
-120,60,-180,1512,1527,3039,6937
-120,60,180,1512,1527,3039,6937
130,-40,-130,1511,1528,3039,6989
-170,20,-120,1526,1513,3039,7065
80,-10,-120,1507,1532,3039,6807
10,-60,120,1544,1496,3040,6960
-120,0,-10,1558,1482,3040,7072
10,50,-100,1510,1530,3040,6981
-70,-60,30,1543,1497,3040,7035
120,-80,-170,1529,1511,3040,7404
-30,70,-70,1510,1531,3041,7274
0,-70,90,1539,1502,3041,7016
180,0,-120,1537,1504,3041,7078
-180,0,-120,1537,1504,3041,7078
-40,-40,-130,1537,1504,3041,6809
-20,-50,70,1536,1506,3042,7092
-90,-70,0,1520,1523,3043,7145
10,60,90,1516,1527,3043,6657
80,-70,160,1540,1503,3043,6980
20,10,120,1521,1522,3043,6707
-130,70,-160,1540,1503,3043,6848
160,-50,70,1538,1506,3044,7156
-120,-60,-30,1539,1505,3044,6980
110,-10,10,1475,1569,3044,6878
-100,30,-170,1533,1511,3044,7181
-150,60,-140,1543,1501,3044,6985
-150,-70,110,1537,1507,3044,7030
-20,-60,70,1523,1521,3044,7037
-120,-30,90,1534,1511,3045,6801
-30,-10,-110,1534,1511,3045,6971
130,-50,40,1523,1522,3045,6942
60,80,-170,1550,1495,3045,7113
-30,-30,60,1537,1508,3045,7083
-140,-20,-110,1509,1536,3045,7015
30,80,60,1501,1544,3045,6792
-60,60,120,1532,1514,3046,6998
-10,-40,80,1513,1533,3046,6997
0,20,100,1525,1521,3046,6761
-70,10,-130,1517,1529,3046,6796
30,60,-130,1564,1483,3047,7048
-60,10,-110,1540,1507,3047,6956
-170,80,60,1540,1507,3047,6956
40,-80,120,1522,1525,3047,7167
70,-80,160,1557,1490,3047,6793
90,80,0,1496,1551,3047,6743
60,30,120,1525,1523,3048,6867
-160,-60,100,1534,1514,3048,7103
60,-70,160,1521,1528,3049,7044
-120,-70,-40,1521,1528,3049,7116
10,-70,100,1547,1502,3049,6999
100,-80,180,1547,1502,3049,7081
-140,-40,-80,1551,1498,3049,7241
140,30,90,1542,1507,3049,7024
100,-80,-180,1547,1502,3049,7081
90,-70,180,1541,1509,3050,7025
-40,50,80,1520,1530,3050,7217
0,30,100,1525,1525,3050,6782
120,70,-30,1497,1553,3050,6838
90,-70,-180,1541,1509,3050,7025
30,-60,140,1511,1539,3050,7006
-120,30,-150,1521,1529,3050,7027
120,-40,-130,1488,1563,3051,6967
-20,-30,70,1525,1526,3051,7055
-50,40,-70,1529,1522,3051,6827
-40,50,100,1574,1477,3051,7077
-90,-80,-10,1528,1524,3052,7133
-80,20,150,1552,1500,3052,6902
-50,-50,50,1542,1510,3052,7199
-140,-60,-70,1539,1513,3052,7048
60,-80,160,1549,1503,3052,6943
-130,40,-150,1520,1532,3052,6945
-130,60,-170,1502,1550,3052,7018
-90,20,-170,1539,1513,3052,6986
30,70,70,1519,1533,3052,6735
-60,-20,-150,1550,1502,3052,6919
-80,-80,0,1522,1530,3052,7149
-10,40,90,1542,1511,3053,7120
-90,-20,110,1517,1536,3053,6880
20,-80,110,1545,1508,3053,7054
10,70,80,1526,1527,3053,6915
-90,10,-160,1561,1492,3053,7183
110,10,40,1513,1541,3054,6953
110,10,0,1551,1503,3054,6982
-60,-80,20,1523,1531,3054,7132
90,-60,-10,1515,1539,3054,6976
-60,50,100,1546,1509,3055,7337
-90,40,-30,1532,1523,3055,7015
-100,20,-100,1531,1524,3055,7098
-70,-10,80,1524,1532,3056,7193
110,0,0,1527,1529,3056,6938
-80,-70,10,1526,1531,3057,7173
110,0,-60,1510,1548,3058,7155
-90,20,-120,1544,1514,3058,6992
-180,0,70,1537,1521,3058,7065
180,0,70,1537,1521,3058,7065
20,50,-110,1530,1528,3058,7117
80,-80,170,1562,1496,3058,6854
-110,20,-60,1555,1503,3058,6693
-30,50,90,1574,1485,3059,7087
90,70,10,1503,1557,3060,6894
70,-30,-50,1515,1546,3061,7248
160,50,-90,1516,1545,3061,6949
-30,80,110,1533,1528,3061,7036
40,-80,140,1555,1506,3061,7081
-10,-50,100,1538,1523,3061,6820
-70,50,130,1556,1506,3062,6994
-10,-40,90,1532,1530,3062,7125
60,0,-160,1505,1557,3062,6817
-40,-20,60,1532,1531,3063,7268
160,20,-100,1543,1520,3063,7006
0,-50,110,1547,1516,3063,6849
-130,-20,50,1561,1502,3063,6823
-90,-30,60,1534,1530,3064,6937
-10,-70,100,1564,1500,3064,6787
-60,0,80,1531,1533,3064,7229
100,40,30,1553,1511,3064,6798
-40,80,120,1533,1531,3064,7084
-80,30,-70,1541,1523,3064,6820
-10,-10,80,1546,1518,3064,7136
0,-60,110,1557,1508,3065,7025
70,-70,170,1550,1515,3065,7201
70,0,-110,1519,1546,3065,7000
-70,0,110,1546,1519,3065,7195
-60,50,110,1557,1508,3065,7175
-10,-70,80,1549,1516,3065,7051
120,30,-40,1502,1563,3065,7237
50,70,-160,1541,1524,3065,7084
10,-70,120,1554,1511,3065,6916
-50,-80,30,1530,1535,3065,7097
-120,40,-160,1503,1563,3066,7076
-120,10,-120,1527,1539,3066,7244
160,-40,-130,1527,1539,3066,7252
-150,40,-130,1554,1512,3066,7125
-120,-10,-10,1537,1530,3067,7122
10,-80,90,1530,1537,3067,7091
70,-80,170,1548,1519,3067,7023
-140,50,-150,1523,1544,3067,7144
170,-10,-120,1544,1523,3067,7022
100,-60,0,1529,1538,3067,6786
-20,-80,60,1538,1529,3067,6989
140,-50,-140,1505,1562,3067,7247
-60,60,130,1540,1527,3067,6895
10,-70,110,1543,1524,3067,7130
-70,-50,40,1562,1505,3067,7183
-100,-70,-10,1551,1517,3068,7144
-50,0,-120,1535,1533,3068,6919
10,20,110,1540,1529,3069,6893
60,-20,-70,1516,1553,3069,7170
50,20,130,1501,1568,3069,7006
-20,30,80,1555,1514,3069,7328
-20,70,100,1553,1516,3069,7151
120,-70,-170,1557,1513,3070,7294
130,-80,-160,1542,1528,3070,7414
0,-80,80,1526,1545,3071,7071
-10,-80,90,1549,1522,3071,6913
180,10,-120,1536,1535,3071,7078
-180,10,-120,1536,1535,3071,7078
90,70,150,1571,1500,3071,6932
10,-80,100,1544,1527,3071,7156
120,10,70,1548,1523,3071,7135
20,-70,130,1565,1507,3072,7030
10,-80,110,1567,1505,3072,7083
-30,-60,60,1535,1537,3072,6950
0,-10,100,1549,1523,3072,7120
120,-60,-160,1526,1547,3073,7141
-20,-70,90,1558,1515,3073,6876
-70,30,130,1561,1512,3073,7057
20,-80,100,1530,1543,3073,7153
-80,-30,-180,1548,1525,3073,7081
-80,-20,-180,1551,1522,3073,7033
-80,-30,180,1548,1525,3073,7081
-80,-20,180,1551,1522,3073,7033
-50,-60,50,1546,1528,3074,7067
-160,-20,-120,1564,1510,3074,7415
-40,-40,60,1561,1513,3074,7319
0,60,90,1547,1527,3074,7023
-130,-50,-50,1558,1516,3074,7020
-140,40,-140,1531,1543,3074,7053
-20,30,70,1569,1505,3074,7353
-160,-10,60,1582,1492,3074,6909
-120,-10,0,1547,1527,3074,7167
30,-80,110,1532,1542,3074,7231
-150,-50,100,1561,1513,3074,7187
-90,20,-110,1548,1527,3075,7009
100,-30,-120,1517,1558,3075,6837
130,10,-70,1529,1546,3075,6998
-50,50,90,1538,1537,3075,7183
-160,-20,70,1560,1516,3076,7004
130,-10,60,1553,1523,3076,7135
-100,-30,130,1515,1561,3076,7148
-90,10,-150,1578,1498,3076,7225
-90,-20,140,1539,1537,3076,7081
-20,-10,70,1557,1519,3076,7276
0,-80,90,1547,1530,3077,7231
-140,60,30,1582,1495,3077,7112
-40,-80,40,1539,1539,3078,7013
100,-50,0,1548,1530,3078,6979
150,-10,-110,1531,1547,3078,7004
-160,-80,-90,1540,1538,3078,7310
-10,-60,100,1533,1545,3078,6934
-30,-40,70,1557,1522,3079,7082
170,80,-90,1542,1537,3079,6936
70,-30,-150,1531,1548,3079,6818
-10,-80,80,1547,1532,3079,7247
-100,40,170,1564,1515,3079,7363
-100,30,-160,1565,1514,3079,7115
150,70,-70,1524,1555,3079,7176
10,70,-110,1554,1525,3079,7275
0,-70,100,1548,1532,3080,7042
30,-20,-80,1506,1574,3080,7053
-60,30,-80,1535,1545,3080,6890
60,-40,-50,1527,1553,3080,7215
-10,-80,70,1541,1540,3081,7023
30,-70,140,1550,1531,3081,7007
-80,10,-140,1542,1539,3081,7173
0,-80,100,1562,1519,3081,6989
-120,70,-170,1563,1518,3081,6882
-20,-70,80,1565,1516,3081,6983
40,-60,150,1542,1540,3082,7117
-30,-70,60,1545,1537,3082,7055
80,-70,180,1551,1531,3082,7140
-20,-60,80,1543,1539,3082,6809
80,-70,-180,1551,1531,3082,7140
-50,60,120,1567,1515,3082,6921
30,-80,130,1571,1511,3082,7092
150,-50,-140,1532,1551,3083,7398
90,-80,180,1572,1511,3083,6982
140,10,-80,1546,1537,3083,7036
-110,-60,-10,1566,1517,3083,7047
90,-80,-180,1572,1511,3083,6982
50,-50,170,1529,1554,3083,7082
-70,70,140,1551,1532,3083,6847
-50,80,130,1543,1540,3083,7157
50,80,-160,1565,1519,3084,7211
-60,-60,40,1539,1545,3084,7173
-30,40,70,1545,1539,3084,7316
180,-80,-110,1540,1545,3085,7396
-150,20,-130,1547,1538,3085,7140
-180,-80,-110,1540,1545,3085,7396
-60,-10,70,1529,1556,3085,7238
-40,-50,60,1555,1531,3086,7160
80,40,140,1543,1543,3086,6973
-70,-70,20,1534,1552,3086,7135
-170,-80,-100,1546,1540,3086,7404
140,-80,-150,1541,1545,3086,7493
60,-60,-40,1529,1557,3086,7224
60,-60,170,1558,1529,3087,7278
120,-50,-140,1531,1556,3087,6963
-160,50,50,1558,1530,3088,6795
180,80,-100,1542,1546,3088,7068
-180,80,-100,1542,1546,3088,7068
-20,-80,80,1567,1521,3088,6863
110,0,-30,1550,1538,3088,7052
-110,40,-170,1530,1558,3088,7093
130,60,110,1550,1538,3088,7013
-20,40,70,1529,1559,3088,7339
-20,50,90,1573,1515,3088,7153
50,-80,150,1566,1523,3089,6975
150,40,-80,1564,1525,3089,6998
-100,-50,10,1559,1530,3089,7185
100,30,50,1559,1530,3089,7042
-30,-80,50,1547,1542,3089,7007
-10,30,90,1556,1533,3089,7109
-160,40,50,1540,1549,3089,7054
110,60,-10,1504,1586,3090,7008
-130,0,-80,1563,1527,3090,7067
-110,-30,100,1563,1527,3090,6922
90,-70,170,1549,1541,3090,7181
110,-80,-170,1567,1523,3090,7131
-30,-70,80,1552,1539,3091,6991
-100,-50,150,1560,1531,3091,7180
120,-40,30,1547,1544,3091,7214
0,-70,110,1577,1514,3091,6897
140,40,-60,1529,1562,3091,7055
130,-10,-90,1543,1548,3091,6947
-90,30,-180,1553,1538,3091,7056
130,60,-40,1544,1547,3091,6967
-90,30,180,1553,1538,3091,7056
70,-20,-70,1551,1540,3091,7134
-150,30,40,1554,1538,3092,6990
-130,50,-150,1555,1537,3092,7076
90,-50,-150,1528,1564,3092,7089
130,30,-50,1517,1575,3092,7011
-140,-50,-70,1575,1517,3092,7181
-110,70,-180,1584,1509,3093,6895
80,-30,-40,1550,1543,3093,7170
-50,0,70,1557,1536,3093,7363
-100,70,170,1586,1507,3093,7025
-110,70,180,1584,1509,3093,6895
160,-80,-130,1544,1550,3094,7493
20,80,70,1539,1555,3094,6855
-10,-20,80,1561,1533,3094,7252
140,-40,-130,1540,1554,3094,7078
170,-80,-120,1541,1553,3094,7413
-150,-70,-80,1547,1547,3094,7212
-20,-50,80,1545,1550,3095,7130
30,30,-110,1538,1557,3095,6896
-40,60,110,1559,1536,3095,7006
-120,0,-20,1562,1533,3095,6914
-100,-80,-20,1557,1538,3095,7173
-120,20,0,1576,1519,3095,7252
100,-70,-170,1559,1536,3095,7094
-30,-80,70,1572,1523,3095,6982
-130,-30,80,1579,1517,3096,7031
20,-10,130,1560,1536,3096,6979
120,-60,-150,1565,1531,3096,7072
140,-10,-100,1524,1572,3096,6909
90,-20,-40,1526,1571,3097,7015
80,-80,-180,1565,1532,3097,7110
130,40,-40,1546,1551,3097,7137
-120,50,-170,1576,1521,3097,6995
80,-80,180,1565,1532,3097,7110
150,-80,-140,1549,1548,3097,7501
50,60,70,1546,1552,3098,6791
110,10,30,1543,1555,3098,7077
-60,40,100,1579,1519,3098,7330
120,70,120,1573,1525,3098,6836
20,-80,120,1582,1516,3098,7111
-80,-40,50,1552,1547,3099,7308
110,20,0,1531,1568,3099,6927
-50,40,90,1566,1533,3099,7152
-70,40,130,1569,1530,3099,7256
-30,20,70,1582,1517,3099,7553
-60,10,90,1563,1536,3099,7349
-110,-80,-30,1558,1541,3099,7181
-10,-30,90,1550,1550,3100,7104
-10,30,-90,1539,1561,3100,7061
-50,-70,40,1538,1562,3100,7180
-170,0,-120,1559,1541,3100,7161
-130,-40,-50,1555,1546,3101,7052
-80,30,150,1573,1528,3101,7332
-60,-70,30,1541,1560,3101,7130
110,-20,-100,1544,1557,3101,6953
-110,30,-10,1581,1520,3101,7230
-10,0,80,1557,1544,3101,7104
0,10,100,1556,1545,3101,6864
-150,-10,-120,1561,1540,3101,7496
-10,10,80,1566,1535,3101,7178
50,-10,180,1523,1579,3102,6689
50,-10,-180,1523,1579,3102,6689
140,-60,-150,1538,1565,3103,7352
-160,-40,90,1606,1497,3103,7269
-20,-20,70,1560,1543,3103,7099
-170,10,-120,1563,1540,3103,7411
-110,40,-160,1559,1544,3103,7349
-60,80,140,1549,1554,3103,7084
-150,70,40,1559,1544,3103,7195
-110,-70,-20,1566,1538,3104,7159
90,40,130,1548,1556,3104,7018
-20,-40,80,1571,1533,3104,7162
-30,30,80,1582,1522,3104,7360
-20,-30,80,1552,1552,3104,7233
0,0,100,1550,1555,3105,7054
-40,-60,60,1562,1543,3105,7025
-30,-70,70,1570,1535,3105,6986
90,-80,-170,1566,1539,3105,7149
170,-50,-130,1559,1547,3106,7259
100,30,90,1529,1577,3106,7140
90,-20,-60,1545,1561,3106,6870
-20,20,80,1567,1539,3106,7311
-100,20,-120,1564,1542,3106,7273
60,60,60,1563,1543,3106,6744
130,-30,-120,1536,1571,3107,7082
-40,50,90,1567,1540,3107,7436
-130,10,-120,1540,1567,3107,7532
100,-10,-70,1551,1556,3107,7084
-150,-30,-110,1559,1548,3107,7144
50,-60,-50,1538,1569,3107,7208
-40,-70,50,1550,1557,3107,7159
-130,-10,-80,1560,1548,3108,7206
-170,-40,-120,1569,1539,3108,7085
70,-60,-30,1521,1587,3108,7201
-120,40,-150,1542,1566,3108,7232
100,80,-10,1516,1592,3108,6914
30,30,110,1548,1560,3108,6897
-50,50,110,1578,1530,3108,7280
-40,40,80,1558,1550,3108,7370
-50,-70,50,1549,1559,3108,7215
100,-70,-180,1554,1555,3109,7272
100,-70,180,1554,1555,3109,7272
-50,20,80,1574,1536,3110,7344
-40,-80,60,1584,1526,3110,7045
-30,50,80,1555,1555,3110,7452
-40,-70,60,1559,1551,3110,7021
80,-60,-170,1564,1546,3110,7266
130,-20,-100,1559,1552,3111,6972
110,-60,10,1556,1555,3111,7128
100,-10,-90,1572,1539,3111,7146
-30,-50,70,1575,1536,3111,7096
180,-10,-120,1551,1561,3112,7127
30,-40,150,1551,1561,3112,6957
-80,-20,80,1558,1554,3112,7248
70,60,50,1564,1548,3112,6875
-90,-20,130,1529,1583,3112,7137
-180,-10,-120,1551,1561,3112,7127
-70,-50,-170,1554,1558,3112,7176
-160,80,50,1576,1537,3113,7159
-150,30,-130,1558,1555,3113,7071
140,50,-50,1553,1560,3113,7060
110,-10,0,1558,1555,3113,7116
-80,0,-160,1581,1532,3113,7358
-170,80,-110,1543,1570,3113,7081
-40,0,-110,1549,1564,3113,7212
-80,-90,0,1554,1560,3114,7235
-10,-90,70,1554,1560,3114,7235
-50,-90,30,1554,1560,3114,7235
-180,-90,-100,1554,1560,3114,7235
90,-90,170,1554,1560,3114,7235
50,-60,160,1562,1552,3114,7253
180,-90,-100,1554,1560,3114,7235
-70,-90,10,1554,1560,3114,7235
20,-90,100,1554,1560,3114,7235
-30,-90,50,1554,1560,3114,7235
140,-90,-140,1554,1560,3114,7235
150,-90,-130,1554,1560,3114,7235
-150,-90,-70,1554,1560,3114,7235
10,-90,90,1554,1560,3114,7235
-120,-90,-40,1554,1560,3114,7235
130,-90,-150,1554,1560,3114,7235
-110,-90,-30,1554,1560,3114,7235
100,-90,-180,1554,1560,3114,7235
-100,60,-10,1568,1546,3114,7464
160,30,80,1581,1533,3114,7088
80,-90,160,1554,1560,3114,7235
-20,-90,60,1554,1560,3114,7235
-100,-90,-20,1554,1560,3114,7235
100,-90,180,1554,1560,3114,7235
-90,-90,-10,1554,1560,3114,7235
60,-90,140,1554,1560,3114,7235
120,-90,-160,1554,1560,3114,7235
-130,-90,-50,1554,1560,3114,7235
70,-90,150,1554,1560,3114,7235
-40,-90,40,1554,1560,3114,7235
50,-90,130,1554,1560,3114,7235
-60,-90,20,1554,1560,3114,7235
-140,-90,-60,1554,1560,3114,7235
40,-90,120,1554,1560,3114,7235
110,-90,-170,1554,1560,3114,7235
30,-90,110,1554,1560,3114,7235
-170,-90,-90,1554,1560,3114,7235
170,-90,-110,1554,1560,3114,7235
-160,-90,-80,1554,1560,3114,7235
160,-90,-120,1554,1560,3114,7235
0,-90,80,1554,1560,3114,7235
-30,-60,70,1556,1559,3115,6940
170,-60,-130,1562,1553,3115,7305
130,-70,-160,1568,1548,3116,7378
-20,-60,90,1547,1569,3116,7001
110,-50,10,1565,1551,3116,7082
60,60,-180,1582,1534,3116,7115
60,60,180,1582,1534,3116,7115
-130,-80,-50,1581,1535,3116,7205
-70,10,130,1577,1540,3117,7117
-80,70,150,1574,1543,3117,7136
-130,20,-130,1565,1552,3117,7279
10,40,-100,1546,1571,3117,6997
-120,50,-160,1549,1569,3118,7058
110,0,-20,1555,1563,3118,7189
70,-60,180,1568,1550,3118,7263
-140,50,-140,1561,1557,3118,7243
150,-40,-130,1553,1565,3118,7185
10,-10,-90,1533,1585,3118,7132
70,-60,-180,1568,1550,3118,7263
100,-80,-170,1584,1534,3118,7135
-80,20,-120,1555,1563,3118,7137
70,-40,-40,1568,1551,3119,7184
110,20,10,1561,1558,3119,6926
-130,60,20,1577,1543,3120,7062
90,-70,-170,1568,1552,3120,7129
-110,-40,0,1549,1571,3120,7242
-140,60,-150,1572,1548,3120,7137
-130,-20,-60,1573,1547,3120,7022
-60,40,110,1584,1536,3120,7277
0,70,90,1547,1574,3121,7188
170,20,-110,1572,1549,3121,7140
-10,-40,100,1547,1574,3121,6859
-160,30,50,1545,1577,3122,7050
-60,-40,50,1564,1558,3122,7390
160,40,80,1592,1531,3123,7226
70,-70,-30,1535,1588,3123,7010
-130,50,-160,1572,1551,3123,7079
-20,0,70,1557,1567,3124,7334
110,80,-20,1543,1581,3124,7043
-100,40,-180,1556,1568,3124,7146
100,-10,-80,1541,1583,3124,7091
30,-30,150,1544,1580,3124,6988
50,0,-100,1552,1572,3124,7022
-140,10,30,1563,1561,3124,7122
-100,40,180,1556,1568,3124,7146
-160,-60,-100,1585,1540,3125,7430
-70,-60,-170,1564,1561,3125,6957
60,-10,-160,1538,1588,3126,6913
150,30,-80,1562,1564,3126,6952
-20,10,70,1557,1569,3126,7529
-100,20,-150,1595,1532,3127,7238
110,-30,10,1559,1568,3127,7119
110,0,-40,1566,1561,3127,7089
110,-60,-150,1575,1552,3127,7181
-150,50,-130,1550,1577,3127,7216
-130,30,-140,1568,1559,3127,7245
-70,60,140,1577,1550,3127,7186
-30,40,-80,1567,1560,3127,7159
170,-20,-120,1569,1558,3127,7170
-90,40,160,1606,1522,3128,7399
140,40,-50,1546,1582,3128,7077
-120,60,10,1573,1555,3128,7094
10,-40,-90,1543,1585,3128,7097
-80,-70,-180,1596,1532,3128,6847
150,20,-90,1559,1569,3128,7193
-90,-50,30,1561,1567,3128,7197
-60,10,-120,1576,1552,3128,7023
-90,30,-60,1589,1539,3128,7035
-80,-70,180,1596,1532,3128,6847
-30,-60,80,1552,1576,3128,7132
-20,-80,70,1564,1564,3128,7293
-100,30,-40,1552,1576,3128,6991
-70,-40,50,1600,1529,3129,7336
-140,60,-140,1559,1570,3129,7143
-170,-50,90,1596,1533,3129,7342
-80,-50,40,1574,1556,3130,7204
-120,-80,-40,1582,1548,3130,7136
100,-80,-160,1579,1552,3131,7158
-170,-10,-120,1591,1540,3131,7260
100,70,0,1528,1603,3131,6955
-20,20,70,1572,1559,3131,7559
-120,-70,-30,1587,1545,3132,7211
160,70,-80,1539,1593,3132,7320
20,60,90,1571,1562,3133,7062
40,-70,150,1559,1574,3133,7098
-40,10,70,1577,1556,3133,7567
80,-20,-130,1586,1547,3133,7091
-120,-30,80,1571,1562,3133,7078
160,-70,60,1563,1570,3133,7161
-80,-20,90,1558,1575,3133,7192
80,-60,-20,1541,1592,3133,7182
-140,0,-120,1581,1553,3134,7482
-70,-10,90,1558,1576,3134,7246
-140,-30,-90,1564,1570,3134,7518
-150,80,40,1593,1541,3134,7406
130,70,-40,1543,1593,3136,7019
10,40,110,1578,1558,3136,6823
40,-60,-60,1542,1594,3136,7201
-20,0,-100,1572,1564,3136,7261
180,40,-110,1571,1565,3136,7268
60,-20,-160,1547,1589,3136,6890
-30,0,70,1591,1545,3136,7507
20,70,80,1564,1572,3136,6897
-180,40,-110,1571,1565,3136,7268
-20,60,100,1565,1571,3136,7419
-50,50,100,1588,1549,3137,7389
70,40,90,1594,1543,3137,6969
-130,60,-160,1580,1557,3137,7181
-30,30,70,1580,1558,3138,7705
-170,10,60,1586,1552,3138,7161
130,40,100,1567,1571,3138,7353
-100,40,-170,1564,1574,3138,7534
-110,-30,50,1582,1556,3138,6880
-170,-30,-120,1585,1553,3138,7435
-70,20,130,1578,1562,3140,7148
80,-70,-20,1557,1583,3140,6991
10,80,80,1551,1590,3141,7018
-140,-80,-60,1600,1541,3141,7214
120,-80,-160,1602,1539,3141,7182
40,-40,170,1567,1574,3141,6872
-90,20,-130,1586,1555,3141,7351
-90,70,160,1595,1546,3141,7187
-120,20,-130,1591,1551,3142,7026
-180,-30,80,1575,1567,3142,7472
-20,-50,90,1561,1581,3142,7074
-70,80,150,1565,1577,3142,7092
110,0,-10,1584,1558,3142,7097
180,-30,80,1575,1567,3142,7472
-120,10,-100,1573,1570,3143,7342
-30,-20,70,1602,1541,3143,7209
50,-40,-60,1549,1594,3143,7359
-100,-50,20,1589,1554,3143,7269
180,50,-110,1583,1560,3143,7251
-180,50,-110,1583,1560,3143,7251
-40,40,90,1594,1550,3144,7465
-30,40,80,1592,1552,3144,7484
170,50,-100,1565,1579,3144,7288
160,-20,-120,1569,1575,3144,7392
-60,50,130,1581,1563,3144,7272
-20,40,90,1598,1546,3144,7225
110,50,120,1557,1588,3145,7066
-50,-40,50,1574,1571,3145,7473
-50,-10,-130,1597,1548,3145,6934
-130,-30,-50,1584,1561,3145,6961
-40,-30,60,1589,1556,3145,7435
-20,70,-80,1558,1587,3145,7505
-140,20,-130,1593,1553,3146,7379
80,70,160,1581,1565,3146,7222
-140,-60,-60,1598,1548,3146,7322
-160,80,-120,1560,1586,3146,7095
-160,10,-120,1597,1549,3146,7242
-130,10,-80,1591,1555,3146,7033
-110,50,-180,1588,1559,3147,7199
-150,-10,50,1592,1555,3147,6871
-130,-10,-90,1563,1584,3147,7219
-130,-70,-50,1580,1567,3147,7421
-110,50,180,1588,1559,3147,7199
-90,-20,120,1567,1580,3147,7178
170,70,-90,1554,1593,3147,7296
-10,-20,90,1569,1578,3147,7408
-90,60,-20,1570,1577,3147,7374
-110,60,0,1590,1558,3148,7274
-130,10,-70,1590,1558,3148,6978
-60,30,100,1617,1531,3148,7550
-100,-30,60,1584,1564,3148,7011
-30,-80,60,1573,1575,3148,7249
150,-40,60,1597,1551,3148,7182
-160,30,-120,1611,1537,3148,7327
-80,-30,60,1562,1586,3148,7431
-10,20,90,1573,1576,3149,7236
180,70,-100,1553,1596,3149,7120
-90,80,170,1569,1580,3149,7051
-160,50,-120,1571,1578,3149,7373
-180,70,-100,1553,1596,3149,7120
-60,-50,50,1577,1573,3150,7352
10,-30,-90,1548,1602,3150,7226
120,-30,-110,1548,1602,3150,7147
50,20,-140,1568,1583,3151,7339
-150,-80,-70,1600,1551,3151,7258
110,0,-50,1553,1599,3152,7103
110,-20,10,1548,1604,3152,7049
-120,60,-160,1573,1579,3152,7284
160,0,-110,1590,1563,3153,7228
-10,-30,100,1592,1561,3153,7130
130,-80,-150,1612,1541,3153,7236
-80,60,150,1597,1556,3153,7306
60,30,160,1593,1560,3153,6924
130,20,-60,1583,1571,3154,7335
50,20,-130,1603,1551,3154,7253
-70,-90,20,1601,1554,3155,7214
-140,-90,-50,1601,1554,3155,7214
-110,-90,-20,1601,1554,3155,7214
-30,-90,60,1601,1554,3155,7214
110,-80,-150,1590,1565,3155,7254
0,-90,90,1601,1554,3155,7214
160,-90,-110,1601,1554,3155,7214
30,-90,120,1601,1554,3155,7214
70,-90,160,1601,1554,3155,7214
170,-90,-100,1601,1554,3155,7214
90,-90,180,1601,1554,3155,7214
40,-90,130,1601,1554,3155,7214
150,-90,-120,1601,1554,3155,7214
-160,-90,-70,1601,1554,3155,7214
-150,-90,-60,1601,1554,3155,7214
-30,30,90,1596,1559,3155,7270
-120,-90,-30,1601,1554,3155,7214
-80,-90,10,1601,1554,3155,7214
130,-90,-140,1601,1554,3155,7214
20,-90,110,1601,1554,3155,7214
180,-90,-90,1601,1554,3155,7214
-110,-30,90,1575,1580,3155,7075
-170,70,-110,1583,1572,3155,7199
-90,-90,0,1601,1554,3155,7214
-130,-90,-40,1601,1554,3155,7214
90,-90,-180,1601,1554,3155,7214
-30,-50,80,1567,1588,3155,7245
60,-90,150,1601,1554,3155,7214
80,-90,170,1601,1554,3155,7214
10,-90,100,1601,1554,3155,7214
140,-90,-130,1601,1554,3155,7214
100,-90,-170,1601,1554,3155,7214
-40,-90,50,1601,1554,3155,7214
110,-90,-160,1601,1554,3155,7214
-100,-90,-10,1601,1554,3155,7214
50,-90,140,1601,1554,3155,7214
-60,-90,30,1601,1554,3155,7214
-50,-90,40,1601,1554,3155,7214
-20,-90,70,1601,1554,3155,7214
120,-90,-150,1601,1554,3155,7214
-10,-90,80,1601,1554,3155,7214
-180,-90,-90,1601,1554,3155,7214
-170,-90,-80,1601,1554,3155,7214
-160,-30,80,1605,1551,3156,7207
-30,-30,70,1598,1558,3156,7421
-50,50,-60,1585,1571,3156,7428
40,80,-150,1601,1555,3156,7390
-160,-70,-90,1598,1559,3157,7532
60,70,50,1571,1586,3157,6994
-20,50,-80,1585,1572,3157,7479
-50,30,90,1607,1550,3157,7622
-10,70,-90,1550,1607,3157,7664
110,-80,-160,1606,1552,3158,7330
30,10,130,1560,1598,3158,7012
10,0,120,1575,1583,3158,6887
-130,0,-60,1594,1564,3158,7164
-130,60,-150,1580,1579,3159,7215
-60,-70,40,1587,1573,3160,7348
-160,-70,100,1592,1568,3160,7163
10,70,90,1575,1585,3160,7127
0,80,90,1560,1600,3160,7131
-40,20,80,1594,1566,3160,7424
-30,50,100,1587,1573,3160,7380
120,20,-40,1570,1590,3160,7231
140,-30,-120,1572,1589,3161,7278
-110,20,-140,1614,1547,3161,7440
120,80,-30,1561,1600,3161,7165
140,-70,-150,1595,1566,3161,7499
-60,30,110,1621,1541,3162,7503
-70,-10,100,1585,1577,3162,7403
60,-30,-60,1573,1589,3162,7461
-130,-60,-40,1612,1550,3162,7201
-90,20,-160,1583,1579,3162,7299
140,20,-70,1583,1579,3162,7243
150,60,-70,1560,1602,3162,7219
-130,-60,120,1618,1544,3162,7292
110,20,20,1579,1583,3162,7255
-30,-30,-120,1576,1587,3163,6961
40,-50,160,1574,1589,3163,7324
80,-10,-90,1581,1583,3164,7102
100,50,130,1573,1591,3164,7073
120,0,-70,1589,1575,3164,7181
-10,-60,110,1598,1567,3165,7359
-50,-80,50,1623,1542,3165,7144
150,20,80,1597,1568,3165,7281
110,-40,10,1581,1584,3165,7299
100,40,120,1583,1582,3165,7390
20,30,110,1598,1567,3165,7103
-70,-20,70,1586,1580,3166,7327
-30,40,90,1627,1539,3166,7313
120,30,-30,1552,1614,3166,7416
150,-70,50,1591,1575,3166,7219
-160,-10,-120,1619,1547,3166,7429
-60,0,90,1604,1562,3166,7475
-30,70,110,1593,1573,3166,7216
-10,50,100,1607,1560,3167,7346
-120,60,-170,1602,1565,3167,7137
110,-70,-170,1580,1587,3167,7488
90,-70,-10,1571,1596,3167,7026
130,80,-40,1571,1596,3167,7262
-120,-60,130,1594,1573,3167,7360
0,70,-100,1573,1595,3168,7532
-70,-40,-170,1599,1569,3168,7308
-130,-10,-60,1604,1564,3168,7239
100,-70,-160,1589,1579,3168,7269
-80,80,160,1576,1592,3168,7088
140,-40,50,1592,1576,3168,7070
-150,80,-130,1575,1593,3168,7113
-150,-50,-90,1583,1585,3168,7382
-10,40,100,1602,1566,3168,7341
50,70,60,1570,1598,3168,7078
160,-40,70,1600,1569,3169,7597
-120,20,-80,1591,1578,3169,7143
-150,-30,80,1609,1560,3169,7259
-160,20,-120,1611,1558,3169,7479
-70,-70,30,1597,1572,3169,7360
40,60,80,1571,1598,3169,7070
-60,40,120,1595,1575,3170,7293
-160,-40,-110,1587,1583,3170,7362
-170,-30,80,1601,1569,3170,7413
140,60,100,1606,1565,3171,7266
100,-70,0,1562,1609,3171,7146
110,-70,-160,1598,1573,3171,7283
170,-70,70,1586,1586,3172,7144
0,60,100,1604,1568,3172,6931
-10,-10,90,1591,1581,3172,7478
-160,-80,-80,1614,1559,3173,7241
10,30,110,1591,1582,3173,6991
-70,0,-150,1618,1556,3174,7337
-120,10,-10,1602,1572,3174,7165
-50,-60,60,1597,1578,3175,7392
20,20,-100,1582,1593,3175,7247
-110,60,-170,1600,1575,3175,7341
-120,30,-140,1612,1564,3176,7439
-80,0,150,1612,1564,3176,7417
-140,80,-140,1582,1594,3176,7129
180,-70,80,1622,1555,3177,7095
-110,30,-150,1582,1595,3177,7166
0,-10,110,1579,1598,3177,7134
-160,70,-120,1601,1576,3177,7408
-180,-70,80,1622,1555,3177,7095
-80,0,-170,1602,1575,3177,7369
40,90,-150,1598,1580,3178,7428
140,90,110,1598,1580,3178,7428
-30,90,-80,1598,1580,3178,7428
-120,90,10,1598,1580,3178,7428
-60,90,-50,1598,1580,3178,7428
-50,90,-60,1598,1580,3178,7428
110,90,140,1598,1580,3178,7428
0,90,-110,1598,1580,3178,7428
100,90,150,1598,1580,3178,7428
70,90,-180,1598,1580,3178,7428
50,90,-160,1598,1580,3178,7428
-80,90,-30,1598,1580,3178,7428
60,90,-170,1598,1580,3178,7428
120,90,130,1598,1580,3178,7428
160,90,90,1598,1580,3178,7428
-70,90,-40,1598,1580,3178,7428
-100,90,-10,1598,1580,3178,7428
180,90,70,1598,1580,3178,7428
-170,90,60,1598,1580,3178,7428
-10,90,-100,1598,1580,3178,7428
-180,90,70,1598,1580,3178,7428
-20,90,-90,1598,1580,3178,7428
30,90,-140,1598,1580,3178,7428
-130,90,20,1598,1580,3178,7428
-110,90,0,1598,1580,3178,7428
170,90,80,1598,1580,3178,7428
80,90,170,1598,1580,3178,7428
-160,90,50,1598,1580,3178,7428
10,90,-120,1598,1580,3178,7428
-80,50,150,1592,1586,3178,7198
-40,90,-70,1598,1580,3178,7428
-150,-40,-100,1597,1581,3178,7330
40,40,100,1588,1590,3178,7026
-140,90,30,1598,1580,3178,7428
-90,90,-20,1598,1580,3178,7428
70,90,180,1598,1580,3178,7428
150,90,100,1598,1580,3178,7428
130,90,120,1598,1580,3178,7428
90,90,160,1598,1580,3178,7428
20,90,-130,1598,1580,3178,7428
-150,90,40,1598,1580,3178,7428
-20,-40,90,1594,1585,3179,7165
-160,40,-120,1595,1584,3179,7485
0,-60,120,1617,1562,3179,7505
-110,50,-170,1584,1596,3180,7103
-80,10,160,1607,1573,3180,7310
-80,40,150,1605,1575,3180,7405
-100,50,-180,1585,1595,3180,7222
-40,-80,50,1582,1598,3180,7277
-110,60,180,1616,1564,3180,7064
-110,60,-180,1616,1564,3180,7064
180,-10,70,1606,1574,3180,7315
-100,50,180,1585,1595,3180,7222
-180,-10,70,1606,1574,3180,7315
-50,-30,-140,1597,1584,3181,7310
-40,-70,70,1593,1588,3181,7223
-100,80,180,1585,1596,3181,7071
-100,80,-180,1585,1596,3181,7071
-120,10,-30,1604,1578,3182,7130
-40,30,80,1602,1580,3182,7468
-120,10,-110,1590,1592,3182,7593
-130,80,-150,1582,1600,3182,7102
-70,-50,50,1599,1584,3183,7435
110,70,-10,1565,1618,3183,7143
-10,60,100,1605,1578,3183,7449
-20,-20,80,1602,1582,3184,7418
-60,-80,40,1632,1552,3184,7181
-40,-10,-120,1602,1582,3184,7098
90,-60,-160,1623,1561,3184,7370
90,-80,-10,1569,1615,3184,7086
-170,-80,-90,1621,1564,3185,7317
-80,-60,30,1616,1569,3185,7283
50,-70,-50,1553,1632,3185,7196
-100,20,-110,1606,1579,3185,7413
-140,70,30,1625,1561,3186,7424
-90,-60,20,1620,1566,3186,7243
-150,60,-130,1579,1607,3186,7264
120,10,-60,1576,1611,3187,7389
90,-10,-100,1591,1596,3187,7210
-50,-30,60,1601,1586,3187,7607
10,-20,-90,1587,1601,3188,7276
110,-70,10,1579,1609,3188,7028
60,0,-110,1643,1545,3188,7571
40,-30,170,1604,1585,3189,7021
-30,-80,80,1613,1576,3189,7007
60,-70,-40,1558,1631,3189,7106
120,-80,-150,1621,1568,3189,7390
-40,-60,70,1582,1607,3189,7282
110,-30,-110,1581,1609,3190,7221
50,-10,-90,1600,1590,3190,7402
-130,-10,-100,1601,1589,3190,7467
160,-80,-120,1616,1574,3190,7322
-90,30,-170,1610,1581,3191,7380
-150,-60,-80,1620,1571,3191,7510
140,-10,-90,1608,1584,3192,7196
40,-70,-60,1560,1632,3192,7181
-130,-70,-40,1619,1573,3192,7375
30,-60,-70,1577,1615,3192,7373
-110,80,-170,1591,1601,3192,7096
140,-80,-140,1630,1562,3192,7294
-110,20,-100,1608,1584,3192,7271
-10,30,100,1620,1572,3192,7286
130,70,110,1625,1568,3193,7032
60,40,170,1593,1600,3193,7215
-170,-70,90,1622,1571,3193,7210
-20,10,80,1613,1580,3193,7430
-30,10,70,1598,1595,3193,7479
-70,50,140,1632,1562,3194,7475
-30,-40,80,1615,1579,3194,7413
-160,20,50,1604,1590,3194,7097
130,-60,-150,1593,1601,3194,7447
120,-80,-140,1604,1590,3194,7238
-70,0,120,1623,1571,3194,7490
-40,0,70,1600,1594,3194,7698
-130,90,-140,1591,1604,3195,7345
-10,90,100,1591,1604,3195,7345
150,90,-60,1591,1604,3195,7345
-150,90,-120,1591,1604,3195,7345
70,90,20,1591,1604,3195,7345
80,90,10,1591,1604,3195,7345
90,90,0,1591,1604,3195,7345
-90,90,-180,1591,1604,3195,7345
50,90,40,1591,1604,3195,7345
110,90,-20,1591,1604,3195,7345
-180,90,-90,1591,1604,3195,7345
0,90,90,1591,1604,3195,7345
-80,90,170,1591,1604,3195,7345
10,90,80,1591,1604,3195,7345
140,90,-50,1591,1604,3195,7345
180,90,-90,1591,1604,3195,7345
-70,90,160,1591,1604,3195,7345
-110,90,-160,1591,1604,3195,7345
-100,90,-170,1591,1604,3195,7345
-60,90,150,1591,1604,3195,7345
100,90,-10,1591,1604,3195,7345
40,90,50,1591,1604,3195,7345
-120,90,-150,1591,1604,3195,7345
-170,90,-100,1591,1604,3195,7345
-40,90,130,1591,1604,3195,7345
130,90,-40,1591,1604,3195,7345
120,90,-30,1591,1604,3195,7345
-20,90,110,1591,1604,3195,7345
-70,-80,20,1598,1597,3195,7466
60,90,30,1591,1604,3195,7345
160,90,-70,1591,1604,3195,7345
-90,90,180,1591,1604,3195,7345
-160,90,-110,1591,1604,3195,7345
170,90,-80,1591,1604,3195,7345
30,90,60,1591,1604,3195,7345
-50,90,140,1591,1604,3195,7345
20,90,70,1591,1604,3195,7345
-140,90,-130,1591,1604,3195,7345
-30,90,120,1591,1604,3195,7345
-100,50,170,1600,1596,3196,7352
-140,-40,-70,1631,1565,3196,7501
90,50,40,1597,1599,3196,7075
-60,20,100,1648,1548,3196,7627
-80,20,160,1608,1589,3197,7304
-130,70,-150,1592,1605,3197,7506
-90,60,160,1600,1597,3197,7190
-160,60,-120,1577,1620,3197,7392
-90,-40,160,1596,1601,3197,7398
-120,80,-160,1594,1603,3197,7149
-20,60,-80,1588,1609,3197,7550
20,0,130,1572,1625,3197,7157
-70,-60,40,1628,1569,3197,7436
-80,-70,20,1610,1587,3197,7328
50,10,170,1585,1613,3198,7059
150,0,-100,1588,1610,3198,7482
150,-80,-130,1624,1574,3198,7334
-100,-40,40,1617,1581,3198,7190
-50,-80,40,1597,1602,3199,7351
-180,-80,-100,1622,1578,3200,7310
140,-20,-110,1575,1625,3200,7275
-10,80,100,1580,1620,3200,7298
-30,-10,70,1612,1588,3200,7532
40,50,90,1576,1624,3200,7074
140,60,-50,1583,1617,3200,7252
-20,30,90,1615,1585,3200,7444
110,30,0,1563,1637,3200,7151
180,-80,-100,1622,1578,3200,7310
100,50,10,1587,1613,3200,7321
-50,40,110,1614,1587,3201,7495
-130,30,-130,1625,1576,3201,7474
-50,40,100,1616,1585,3201,7542
90,60,20,1618,1583,3201,7287
-60,-80,30,1598,1603,3201,7433
90,-10,-90,1621,1580,3201,7326
100,-80,0,1578,1623,3201,7116
-50,0,80,1602,1599,3201,7531
40,70,70,1587,1615,3202,7240
120,-70,20,1594,1608,3202,7086
150,10,-90,1603,1599,3202,7368
-140,30,-130,1612,1591,3203,7422
-70,-10,-160,1613,1590,3203,7218
-60,-30,60,1605,1598,3203,7636
30,80,-140,1611,1592,3203,7446
-170,-60,-110,1639,1565,3204,7430
-10,-80,100,1633,1571,3204,7188
80,-40,-30,1594,1610,3204,7293
-80,-10,130,1612,1592,3204,7477
-30,20,80,1613,1592,3205,7660
-20,-80,90,1630,1575,3205,7076
90,50,140,1595,1610,3205,7227
-150,70,-130,1601,1604,3205,7512
10,-50,-90,1572,1633,3205,7362
-130,40,-140,1601,1604,3205,7345
20,-40,140,1597,1608,3205,7289
-70,-90,30,1628,1578,3206,7229
-130,-90,-30,1628,1578,3206,7229
-170,60,-110,1586,1620,3206,7457
-10,-90,90,1628,1578,3206,7229
130,-90,-130,1628,1578,3206,7229
80,-90,180,1628,1578,3206,7229
80,-90,-180,1628,1578,3206,7229
-90,-90,10,1628,1578,3206,7229
0,-90,100,1628,1578,3206,7229
140,-90,-120,1628,1578,3206,7229
-160,-90,-60,1628,1578,3206,7229
30,-90,130,1628,1578,3206,7229
-170,-90,-70,1628,1578,3206,7229
-150,-90,-50,1628,1578,3206,7229
170,-90,-90,1628,1578,3206,7229
160,-90,-100,1628,1578,3206,7229
-40,-40,70,1610,1596,3206,7568
70,-90,170,1628,1578,3206,7229
-40,-90,60,1628,1578,3206,7229
110,-90,-150,1628,1578,3206,7229
-30,-90,70,1628,1578,3206,7229
60,-90,160,1628,1578,3206,7229
60,-50,-170,1594,1612,3206,7378
-180,-90,-80,1628,1578,3206,7229
-20,-90,80,1628,1578,3206,7229
120,20,80,1599,1607,3206,7348
20,-90,120,1628,1578,3206,7229
-50,-90,50,1628,1578,3206,7229
120,-90,-140,1628,1578,3206,7229
-140,-90,-40,1628,1578,3206,7229
-80,-90,20,1628,1578,3206,7229
180,-90,-80,1628,1578,3206,7229
-110,-90,-10,1628,1578,3206,7229
50,-90,150,1628,1578,3206,7229
-120,-90,-20,1628,1578,3206,7229
100,-90,-160,1628,1578,3206,7229
-100,-90,0,1628,1578,3206,7229
-10,70,100,1588,1618,3206,7386
10,-90,110,1628,1578,3206,7229
-40,-80,70,1617,1589,3206,7121
40,-90,140,1628,1578,3206,7229
-60,-90,40,1628,1578,3206,7229
90,-90,-170,1628,1578,3206,7229
150,-90,-110,1628,1578,3206,7229
-120,-50,-20,1630,1577,3207,7336
-90,-70,10,1609,1598,3207,7279
-80,-80,10,1607,1600,3207,7444
-100,60,170,1619,1588,3207,7094
-80,-60,40,1603,1604,3207,7299
-50,50,120,1625,1582,3207,7287
-90,50,160,1586,1621,3207,7296
-90,-80,10,1636,1571,3207,7246
-170,-20,-120,1633,1575,3208,7503
70,70,40,1591,1617,3208,7257
0,-50,120,1628,1580,3208,7399
0,40,110,1617,1591,3208,7014
50,-70,160,1601,1608,3209,7318
10,-60,130,1610,1599,3209,7509
10,60,100,1623,1587,3210,7121
50,40,100,1621,1589,3210,6992
180,30,-110,1613,1597,3210,7455
-10,0,90,1611,1599,3210,7397
170,10,-110,1613,1597,3210,7399
60,80,40,1575,1635,3210,7185
-180,30,-110,1613,1597,3210,7455
180,-20,-120,1633,1578,3211,7559
-180,-20,-120,1633,1578,3211,7559
-130,-80,-40,1628,1583,3211,7418
-50,-40,60,1626,1585,3211,7537
150,80,-60,1597,1614,3211,7340
-50,-10,70,1606,1605,3211,7666
180,-60,-120,1619,1592,3211,7435
-180,-60,-120,1619,1592,3211,7435
140,-70,40,1609,1602,3211,7337
-100,40,-160,1601,1611,3212,7299
-50,-50,60,1618,1594,3212,7476
-10,10,90,1610,1602,3212,7590
-40,-50,70,1603,1609,3212,7506
80,60,40,1613,1599,3212,7155
-70,-80,30,1629,1583,3212,7243
-160,10,50,1607,1606,3213,7079
-170,-60,90,1615,1598,3213,7455
-140,-70,-60,1618,1595,3213,7461
-130,0,-110,1605,1608,3213,7696
-20,80,110,1581,1632,3213,7348
-100,-80,-10,1627,1586,3213,7464
-20,-10,80,1631,1582,3213,7472
20,60,-120,1629,1585,3214,7634
130,-80,-130,1619,1595,3214,7277
-100,20,-130,1612,1602,3214,7376
-180,60,-100,1589,1625,3214,7455
180,60,-100,1589,1625,3214,7455
-40,30,90,1642,1572,3214,7561
-80,60,-30,1626,1588,3214,7528
-50,10,80,1616,1598,3214,7518
-140,80,30,1634,1581,3215,7553
-130,70,20,1639,1576,3215,7515
160,40,-90,1603,1612,3215,7424
30,-50,150,1616,1600,3216,7383
170,-80,-110,1629,1587,3216,7327
-110,20,-130,1603,1613,3216,7371
110,-10,-80,1638,1578,3216,7432
30,-80,140,1622,1594,3216,7228
70,70,170,1614,1602,3216,7414
-90,-80,0,1614,1602,3216,7464
120,-70,-160,1606,1611,3217,7600
20,80,90,1583,1634,3217,7126
-40,70,120,1620,1597,3217,7260
-70,-30,60,1596,1621,3217,7772
-130,-10,-50,1628,1589,3217,7435
-140,70,-140,1605,1613,3218,7546
-120,20,-70,1620,1598,3218,7188
130,-80,-140,1626,1592,3218,7536
-40,40,100,1634,1585,3219,7447
-120,70,-160,1612,1607,3219,7592
130,-20,50,1612,1607,3219,7558
140,30,-60,1621,1598,3219,7254
-40,-10,70,1613,1606,3219,7647
150,50,-70,1599,1620,3219,7453
110,-50,-140,1597,1622,3219,7451
110,30,20,1627,1592,3219,7239
-50,-60,70,1603,1616,3219,7245
140,80,-50,1602,1617,3219,7310
50,30,-160,1622,1597,3219,7209
80,-80,-20,1584,1635,3219,7264
70,80,30,1571,1649,3220,7211
120,60,-20,1582,1638,3220,7338
80,70,30,1575,1645,3220,7335
0,-80,110,1628,1592,3220,7207
-110,20,-120,1601,1620,3221,7523
70,80,40,1592,1629,3221,7153
-80,-80,20,1642,1579,3221,7220
-90,-60,30,1610,1611,3221,7208
-30,80,120,1590,1631,3221,7359
30,20,120,1612,1610,3222,7286
-110,-40,10,1604,1618,3222,7342
-100,50,-170,1618,1604,3222,7406
-100,60,-180,1636,1587,3223,7396
-140,20,-120,1627,1596,3223,7482
-40,10,80,1644,1579,3223,7442
-100,60,180,1636,1587,3223,7396
-90,40,170,1621,1602,3223,7547
-120,-20,-10,1637,1587,3224,7304
40,-80,150,1636,1588,3224,7271
120,50,-20,1593,1631,3224,7371
10,-80,120,1630,1594,3224,7303
30,10,-100,1569,1655,3224,7369
150,-80,-120,1633,1591,3224,7553
-120,20,-120,1628,1596,3224,7477
-180,-30,-120,1631,1593,3224,7586
180,-30,-120,1631,1593,3224,7586
-160,0,-120,1616,1609,3225,7560
-120,-80,-30,1639,1586,3225,7462
-80,20,170,1615,1610,3225,7249
-100,-60,10,1647,1578,3225,7334
50,80,60,1597,1628,3225,7105
-180,80,-90,1617,1608,3225,7443
180,80,-90,1617,1608,3225,7443
-50,-80,60,1635,1590,3225,7253
-180,-40,-120,1643,1584,3227,7513
30,-70,-70,1587,1640,3227,7268
50,-80,160,1633,1594,3227,7343
180,-40,-120,1643,1584,3227,7513
0,-40,120,1626,1602,3228,7430
-180,-50,-120,1623,1605,3228,7418
50,80,50,1580,1648,3228,7185
180,-50,-120,1623,1605,3228,7418
70,-80,-30,1584,1644,3228,7281
-50,-70,60,1615,1614,3229,7303
-60,20,110,1649,1580,3229,7585
140,-80,-120,1632,1597,3229,7293
80,80,20,1586,1643,3229,7271
-90,70,170,1619,1610,3229,7364
40,80,70,1579,1651,3230,7127
140,-80,-130,1626,1604,3230,7529
10,80,100,1599,1631,3230,7234
-30,-30,80,1620,1611,3231,7637
90,70,20,1589,1642,3231,7355
160,10,-100,1603,1628,3231,7545
60,80,50,1603,1628,3231,7079
-20,70,110,1607,1624,3231,7469
170,40,-100,1622,1609,3231,7521
-50,-70,70,1595,1636,3231,7386
-30,20,90,1618,1613,3231,7550
-40,60,120,1631,1601,3232,7457
160,-30,-120,1602,1630,3232,7657
150,-70,-140,1637,1595,3232,7633
-110,50,-160,1622,1611,3233,7525
-40,-30,70,1637,1596,3233,7476
-20,-30,90,1623,1610,3233,7388
-100,-80,0,1645,1588,3233,7245
-180,-80,80,1621,1613,3234,7454
180,-80,80,1621,1613,3234,7454
-120,-30,-20,1618,1616,3234,7472
-130,-50,-40,1615,1619,3234,7490
-50,70,130,1621,1613,3234,7385
0,80,110,1607,1627,3234,7323
-120,40,-140,1607,1628,3235,7441
-60,-60,50,1644,1591,3235,7528
20,-80,130,1631,1604,3235,7238
90,80,10,1589,1646,3235,7274
60,-30,-160,1619,1617,3236,7157
-50,-50,70,1621,1615,3236,7349
120,20,-30,1594,1642,3236,7482
-20,50,100,1629,1608,3237,7592
-30,60,110,1628,1610,3238,7471
-70,-60,50,1614,1624,3238,7361
180,20,-110,1622,1617,3239,7388
-140,-50,-60,1639,1600,3239,7495
-110,40,-150,1616,1623,3239,7427
-180,20,-110,1622,1617,3239,7388
170,60,-90,1605,1634,3239,7619
70,50,160,1640,1600,3240,7223
-140,-80,-50,1637,1603,3240,7431
170,-80,70,1628,1612,3240,7398
-150,-80,-60,1630,1610,3240,7465
160,80,-70,1606,1634,3240,7421
150,-60,-140,1628,1612,3240,7690
-100,-70,0,1624,1617,3241,7342
30,-20,150,1626,1615,3241,7231
120,-40,-120,1593,1648,3241,7466
140,0,-80,1589,1652,3241,7403
-40,-20,70,1646,1595,3241,7711
-80,10,-160,1619,1622,3241,7626
70,-50,-160,1589,1653,3242,7396
110,-80,10,1606,1636,3242,7243
-170,50,-110,1619,1623,3242,7646
40,80,60,1591,1651,3242,7167
-170,-70,-100,1644,1598,3242,7788
-90,40,-180,1611,1631,3242,7546
-130,-80,130,1614,1628,3242,7291
100,-50,-140,1615,1627,3242,7329
-140,10,-120,1625,1617,3242,7574
-90,40,180,1611,1631,3242,7546
-60,-80,50,1633,1610,3243,7311
180,-40,80,1647,1596,3243,7687
-50,30,100,1640,1603,3243,7739
-180,-40,80,1647,1596,3243,7687
170,80,-80,1608,1636,3244,7441
-110,-80,-20,1641,1603,3244,7469
-40,50,110,1643,1601,3244,7416
-160,-80,100,1632,1612,3244,7333
-20,0,80,1635,1610,3245,7609
-150,-80,110,1637,1608,3245,7405
-10,-20,100,1640,1605,3245,7446
80,80,30,1603,1642,3245,7219
100,-60,-150,1642,1604,3246,7618
160,-30,70,1647,1599,3246,7495
-110,70,0,1624,1622,3246,7620
90,40,60,1644,1602,3246,7403
-130,20,-120,1644,1602,3246,7480
80,50,150,1623,1624,3247,7272
30,70,80,1606,1641,3247,7204
110,-40,-120,1630,1617,3247,7278
80,-20,-70,1648,1600,3248,7390
-120,50,-150,1637,1611,3248,7582
130,-70,30,1626,1622,3248,7376
-140,-60,110,1666,1582,3248,7502
110,20,70,1624,1624,3248,7481
-170,-80,90,1630,1618,3248,7316
-150,-20,60,1655,1593,3248,7383
-170,80,-100,1634,1614,3248,7487
0,30,110,1641,1607,3248,7285
-130,-20,-50,1622,1626,3248,7467
-60,-60,60,1614,1634,3248,7271
160,-10,-110,1612,1637,3249,7453
30,80,80,1587,1662,3249,7112
-40,-30,-130,1643,1607,3250,7360
160,-80,-110,1651,1599,3250,7526
-70,40,-60,1630,1620,3250,7286
20,-50,140,1605,1645,3250,7383
-60,-50,60,1618,1633,3251,7453
120,-80,20,1609,1642,3251,7382
-60,-70,60,1636,1616,3252,7449
-60,10,100,1667,1585,3252,7835
60,-70,170,1626,1626,3252,7469
50,-50,180,1606,1647,3253,7461
10,-50,130,1627,1626,3253,7444
50,-50,-180,1606,1647,3253,7461
130,-40,40,1632,1622,3254,7395
-120,-60,-20,1654,1601,3255,7473
-100,70,180,1614,1641,3255,7515
170,-80,-100,1654,1601,3255,7590
-100,70,-180,1614,1641,3255,7515
-50,20,90,1672,1583,3255,7676
130,-30,-110,1601,1654,3255,7327
-40,20,90,1667,1589,3256,7703
70,-70,180,1631,1625,3256,7580
120,0,50,1637,1619,3256,7508
150,50,-60,1622,1634,3256,7501
70,-70,-180,1631,1625,3256,7580
140,70,-50,1608,1648,3256,7296
-110,70,-170,1624,1633,3257,7588
110,20,30,1608,1650,3258,7573
-70,-70,40,1622,1636,3258,7445
-120,70,10,1627,1631,3258,7583
-180,50,-100,1610,1649,3259,7547
-150,20,40,1624,1635,3259,7334
150,20,-80,1627,1632,3259,7483
-30,10,-100,1612,1647,3259,7346
180,50,-100,1610,1649,3259,7547
110,40,110,1649,1611,3260,7657
-60,-70,50,1640,1620,3260,7368
-100,-40,140,1630,1630,3260,7591
-80,10,170,1655,1605,3260,7595
-20,-20,-110,1615,1645,3260,7202
-120,-20,0,1653,1607,3260,7657
0,50,110,1622,1639,3261,7227
-110,-70,-10,1652,1609,3261,7360
100,50,20,1641,1620,3261,7327
130,-60,-140,1651,1610,3261,7414
160,60,-80,1603,1658,3261,7423
-150,-70,-70,1647,1614,3261,7607
-140,-80,120,1636,1626,3262,7362
-140,-30,-80,1635,1627,3262,7667
30,60,90,1613,1649,3262,7376
-20,-70,100,1631,1631,3262,7290
170,-30,-120,1645,1617,3262,7674
10,-30,130,1639,1624,3263,7500
100,80,0,1593,1670,3263,7420
-30,10,80,1655,1608,3263,7728
20,-30,140,1625,1639,3264,7452
-10,-70,110,1651,1613,3264,7377
140,-80,40,1626,1638,3264,7586
170,50,-70,1645,1619,3264,7466
150,-80,-110,1649,1616,3265,7331
60,-80,-40,1624,1641,3265,7390
-150,10,-120,1646,1619,3265,7495
-60,70,140,1649,1616,3265,7487
40,70,-150,1639,1626,3265,7480
-80,-70,40,1644,1622,3266,7448
50,10,150,1608,1658,3266,7389
150,-30,-120,1618,1648,3266,7737
160,-80,60,1646,1620,3266,7421
110,30,90,1627,1639,3266,7469
-40,80,130,1627,1639,3266,7409
90,80,20,1616,1650,3266,7220
20,70,90,1595,1671,3266,7276
20,80,80,1611,1655,3266,7258
-40,10,90,1664,1602,3266,7710
160,50,-80,1626,1641,3267,7779
-70,80,160,1645,1622,3267,7633
50,10,-180,1619,1648,3267,7039
150,0,-90,1629,1638,3267,7616
40,-80,-60,1623,1644,3267,7491
50,10,180,1619,1648,3267,7039
110,80,0,1616,1651,3267,7170
-20,-60,100,1636,1632,3268,7371
-130,50,-140,1657,1611,3268,7581
100,70,10,1614,1654,3268,7370
120,-60,20,1608,1660,3268,7441
100,80,10,1614,1654,3268,7232
-10,-50,110,1644,1624,3268,7437
-70,60,150,1653,1615,3268,7421
20,-60,140,1629,1639,3268,7544
130,-80,30,1624,1644,3268,7606
30,40,-120,1651,1617,3268,7596
120,50,110,1638,1631,3269,7463
10,-40,130,1622,1647,3269,7504
-20,20,90,1655,1614,3269,7643
-170,-80,-80,1654,1615,3269,7518
-130,0,-90,1632,1638,3270,7587
80,-70,-170,1649,1621,3270,7625
-70,-10,110,1618,1652,3270,7425
-90,50,-180,1646,1625,3271,7560
50,-80,-50,1624,1647,3271,7437
-90,60,170,1657,1614,3271,7501
130,-70,-150,1633,1638,3271,7671
-90,50,180,1646,1625,3271,7560
-130,-10,20,1643,1628,3271,7317
-80,70,160,1622,1650,3272,7375
-80,-10,180,1678,1594,3272,7443
-30,0,80,1672,1600,3272,7539
180,-80,-90,1674,1598,3272,7549
-80,-10,-180,1678,1594,3272,7443
140,70,100,1661,1611,3272,7415
-180,-80,-90,1674,1598,3272,7549
10,80,90,1615,1658,3273,7375
-120,-80,140,1647,1626,3273,7343
-70,-30,-170,1653,1620,3273,7394
30,80,70,1619,1654,3273,7270
-160,-80,-70,1649,1624,3273,7545
-120,-40,110,1630,1644,3274,7420
150,-20,-110,1610,1664,3274,7496
-30,-70,90,1648,1626,3274,7290
80,40,80,1661,1613,3274,7345
-150,20,-120,1659,1615,3274,7566
-90,-50,160,1633,1641,3274,7575
110,30,10,1645,1629,3274,7343
30,-30,-80,1612,1663,3275,7701
-70,-70,-170,1674,1601,3275,7300
20,80,-130,1660,1615,3275,7625
-90,50,170,1652,1623,3275,7362
160,-60,60,1662,1613,3275,7356
140,-50,-130,1619,1657,3276,7502
60,-80,170,1643,1633,3276,7392
-110,-30,80,1623,1653,3276,7394
150,40,-60,1635,1641,3276,7588
20,-10,-90,1607,1669,3276,7742
120,70,-20,1614,1662,3276,7381
120,80,-10,1610,1667,3277,7141
80,50,60,1661,1616,3277,7404
150,-60,50,1675,1602,3277,7334
-150,-40,90,1670,1607,3277,7738
-90,-40,50,1664,1615,3279,7667
120,30,90,1628,1652,3280,7622
170,0,70,1668,1612,3280,7639
-10,60,110,1660,1620,3280,7428
-110,-80,-10,1667,1613,3280,7339
-110,-60,140,1643,1637,3280,7511
20,-70,-80,1607,1673,3280,7344
-110,-40,20,1654,1627,3281,7552
-140,40,-130,1667,1614,3281,7633
-120,30,-130,1658,1623,3281,7756
-180,-70,-110,1665,1617,3282,7937
40,30,-130,1674,1608,3282,7504
180,-70,-110,1665,1617,3282,7937
-70,40,140,1646,1636,3282,7727
-130,80,20,1660,1622,3282,7799
0,70,100,1628,1654,3282,7396
-100,70,-10,1642,1641,3283,7772
100,40,40,1627,1656,3283,7304
10,50,110,1661,1622,3283,7208
-120,20,-90,1647,1637,3284,7503
100,-30,-10,1637,1647,3284,7565
-150,-20,-110,1651,1633,3284,7667
150,-80,50,1641,1644,3285,7539
-170,50,-90,1646,1639,3285,7385
-70,70,150,1646,1639,3285,7505
110,80,-10,1617,1668,3285,7593
140,-20,60,1655,1630,3285,7777
-110,20,-110,1651,1634,3285,7436
-40,-50,80,1650,1635,3285,7433
-60,80,150,1651,1634,3285,7623
-50,10,90,1676,1610,3286,7741
130,20,80,1627,1659,3286,7699
-80,80,170,1642,1644,3286,7642
-10,80,120,1627,1659,3286,7336
-170,-20,70,1643,1643,3286,7663
40,-40,-70,1619,1667,3286,7471
-120,60,-150,1669,1617,3286,7515
40,40,-140,1666,1621,3287,7689
-130,40,-130,1642,1645,3287,7683
-70,20,-100,1682,1606,3288,7625
100,-20,-20,1651,1637,3288,7652
120,-70,-150,1652,1636,3288,7701
-90,-70,20,1654,1634,3288,7475
30,-80,-70,1629,1660,3289,7513
-60,10,110,1663,1626,3289,7654
-130,-10,-40,1656,1633,3289,7527
150,40,-70,1641,1648,3289,7761
80,-40,-140,1648,1642,3290,7348
110,-70,-150,1656,1634,3290,7446
130,80,-30,1637,1653,3290,7645
130,20,-50,1634,1656,3290,7514
-80,10,-170,1660,1630,3290,7580
-110,-50,0,1656,1634,3290,7621
-30,-20,80,1661,1630,3291,7633
-110,30,-140,1669,1622,3291,7754
-170,40,-110,1656,1635,3291,7816
120,-10,-80,1668,1624,3292,7622
-80,0,-180,1655,1637,3292,7691
-80,0,180,1655,1637,3292,7691
0,-20,120,1654,1638,3292,7604
-40,-60,80,1640,1652,3292,7367
160,-80,-100,1652,1640,3292,7398
-70,-80,40,1645,1648,3293,7370
70,90,40,1636,1658,3294,7436
-20,90,130,1636,1658,3294,7436
90,90,20,1636,1658,3294,7436
-70,20,-110,1665,1629,3294,7585
-170,90,-80,1636,1658,3294,7436
-180,90,-70,1636,1658,3294,7436
-90,90,-160,1636,1658,3294,7436
-140,90,-110,1636,1658,3294,7436
120,90,-10,1636,1658,3294,7436
-30,90,140,1636,1658,3294,7436
-150,90,-100,1636,1658,3294,7436
-170,0,60,1669,1625,3294,7617
-110,90,-140,1636,1658,3294,7436
-40,90,150,1636,1658,3294,7436
40,90,70,1636,1658,3294,7436
170,90,-60,1636,1658,3294,7436
30,90,80,1636,1658,3294,7436
-120,90,-130,1636,1658,3294,7436
-80,90,-170,1636,1658,3294,7436
0,90,110,1636,1658,3294,7436
130,30,-40,1643,1651,3294,7822
160,90,-50,1636,1658,3294,7436
-130,90,-120,1636,1658,3294,7436
180,90,-70,1636,1658,3294,7436
-60,90,170,1636,1658,3294,7436
140,90,-30,1636,1658,3294,7436
-10,90,120,1636,1658,3294,7436
60,90,50,1636,1658,3294,7436
100,90,10,1636,1658,3294,7436
150,90,-40,1636,1658,3294,7436
-100,90,-150,1636,1658,3294,7436
80,90,30,1636,1658,3294,7436
-50,90,160,1636,1658,3294,7436
160,-70,-130,1664,1630,3294,7731
20,90,90,1636,1658,3294,7436
10,90,100,1636,1658,3294,7436
110,90,0,1636,1658,3294,7436
-70,90,-180,1636,1658,3294,7436
50,90,60,1636,1658,3294,7436
-70,90,180,1636,1658,3294,7436
130,90,-20,1636,1658,3294,7436
-160,90,-90,1636,1658,3294,7436
-60,-40,60,1667,1628,3295,7759
-110,60,-160,1685,1610,3295,7495
120,-30,30,1645,1650,3295,7828
-60,30,120,1672,1623,3295,7752
-150,0,-120,1666,1629,3295,7665
-160,80,-110,1649,1646,3295,7584
-150,40,-120,1666,1629,3295,7638
130,-20,-90,1643,1652,3295,7379
140,0,70,1661,1635,3296,7866
70,50,70,1649,1647,3296,7444
-20,30,-90,1650,1646,3296,7526
-120,-30,20,1679,1618,3297,7465
0,-70,120,1659,1638,3297,7564
150,80,-50,1622,1675,3297,7555
-80,-70,30,1651,1646,3297,7502
150,-10,-100,1630,1667,3297,7679
-50,0,90,1657,1641,3298,7939
-120,-30,30,1679,1619,3298,7251
120,80,-20,1633,1665,3298,7710
-160,-30,-110,1665,1633,3298,7701
-50,60,130,1654,1644,3298,7443
60,30,130,1645,1653,3298,7409
30,-40,160,1658,1640,3298,7423
-150,50,-120,1672,1627,3299,7515
150,80,-40,1628,1671,3299,7282
120,-10,40,1669,1630,3299,7738
-70,-70,50,1658,1641,3299,7440
20,-60,-80,1634,1665,3299,7568
-70,30,-80,1642,1658,3300,7538
0,10,110,1653,1647,3300,7312
130,70,-30,1622,1678,3300,7510
0,20,110,1650,1650,3300,7330
120,10,-50,1630,1670,3300,7462
10,80,-120,1672,1628,3300,7785
-50,-20,70,1652,1648,3300,7869
160,50,80,1679,1622,3301,7536
-100,30,-150,1652,1649,3301,7648
-80,10,-150,1677,1624,3301,7675
-40,-70,80,1643,1658,3301,7403
170,60,-70,1645,1656,3301,7447
-80,-20,100,1643,1659,3302,7758
-130,-40,-40,1676,1626,3302,7624
-90,-50,40,1669,1633,3302,7819
-10,-10,-100,1671,1631,3302,7651
-50,80,140,1651,1651,3302,7566
-100,20,-140,1668,1634,3302,7858
-30,70,120,1652,1650,3302,7471
150,60,-60,1635,1667,3302,7546
-90,80,-180,1651,1652,3303,7622
0,-30,120,1650,1653,3303,7546
-90,80,180,1651,1652,3303,7622
100,60,10,1645,1658,3303,7685
-90,30,-70,1659,1644,3303,7400
110,70,0,1636,1667,3303,7379
-130,0,-50,1667,1636,3303,7369
120,30,-20,1639,1665,3304,7606
-60,0,100,1686,1618,3304,7839
-80,50,160,1655,1649,3304,7534
140,-60,-140,1660,1644,3304,7757
-30,-10,80,1678,1626,3304,7648
-150,80,-120,1660,1644,3304,7599
170,70,-80,1647,1657,3304,7658
-140,50,-130,1676,1628,3304,7570
-100,-30,120,1624,1681,3305,7615
-40,0,80,1674,1631,3305,7861
160,40,-80,1637,1668,3305,7760
-100,40,-20,1662,1643,3305,7912
-100,80,-170,1660,1646,3306,7634
-90,60,-180,1675,1631,3306,7636
160,80,-50,1630,1676,3306,7307
-80,-50,50,1662,1644,3306,7888
-80,40,-50,1649,1657,3306,7398
-90,60,180,1675,1631,3306,7636
-130,0,-40,1660,1646,3306,7357
-110,-80,150,1664,1642,3306,7424
140,80,-40,1636,1670,3306,7632
130,80,-20,1634,1673,3307,7208
-120,-40,-20,1673,1634,3307,7680
10,-70,130,1652,1655,3307,7585
-30,10,90,1661,1646,3307,7685
-130,-30,70,1679,1628,3307,7318
-30,-50,90,1656,1651,3307,7531
130,-60,30,1652,1655,3307,7458
-160,-50,-100,1664,1643,3307,7740
-90,40,-170,1644,1664,3308,7643
30,-60,150,1655,1653,3308,7611
-120,-70,-20,1696,1612,3308,7524
-70,60,-40,1669,1639,3308,7802
-100,-30,70,1657,1652,3309,7459
0,80,100,1623,1686,3309,7448
-60,60,140,1668,1641,3309,7506
0,0,110,1643,1666,3309,7472
140,10,-70,1661,1648,3309,7511
90,-70,-160,1674,1635,3309,7652
-10,-40,110,1656,1654,3310,7538
-10,50,110,1664,1646,3310,7482
-140,-30,70,1699,1612,3311,7637
150,70,-60,1659,1652,3311,7531
140,80,-30,1633,1679,3312,7240
-30,40,100,1671,1641,3312,7876
130,-40,-120,1627,1685,3312,7557
-100,-60,20,1640,1673,3313,7384
-130,-20,-40,1659,1654,3313,7523
150,50,-50,1675,1638,3313,7537
70,-60,-170,1652,1661,3313,7826
10,70,100,1628,1686,3314,7430
-20,80,130,1649,1665,3314,7483
120,-30,-100,1622,1693,3315,7487
-140,-70,-50,1695,1620,3315,7553
60,-60,-180,1648,1667,3315,7809
60,-60,180,1648,1667,3315,7809
-160,50,-110,1671,1644,3315,7569
170,-70,-120,1666,1649,3315,7780
20,-70,140,1666,1650,3316,7690
-70,0,130,1652,1664,3316,7757
-80,60,160,1677,1639,3316,7562
-70,70,160,1663,1653,3316,7535
-140,-20,50,1667,1649,3316,7559
140,-70,-140,1670,1646,3316,7692
-80,30,160,1679,1638,3317,7776
20,-80,-80,1650,1667,3317,7698
-130,-20,40,1672,1646,3318,7344
-40,40,-80,1661,1657,3318,7501
90,60,30,1653,1665,3318,7419
120,40,-20,1649,1670,3319,7652
-140,-20,-100,1639,1681,3320,7990
-130,10,-60,1638,1682,3320,7591
-150,-40,-90,1671,1649,3320,7798
-60,-20,70,1677,1643,3320,7833
-80,0,160,1683,1637,3320,7672
90,-30,-30,1673,1647,3320,7711
-20,-50,100,1666,1654,3320,7549
-100,50,-160,1653,1668,3321,7756
-90,-70,30,1681,1640,3321,7545
-160,60,-110,1654,1667,3321,7781
-100,60,-170,1694,1627,3321,7622
-20,40,100,1661,1660,3321,7786
40,-60,160,1651,1670,3321,7688
160,70,-70,1669,1652,3321,7672
180,60,-80,1662,1660,3322,7477
80,-60,-160,1664,1658,3322,7717
-180,60,-80,1662,1660,3322,7477
-150,30,-120,1679,1643,3322,7800
160,30,-90,1662,1661,3323,7736
-150,-60,-70,1685,1638,3323,7710
170,-80,-90,1666,1657,3323,7509
-140,-10,-110,1661,1662,3323,7876
-140,60,-130,1682,1641,3323,7728
-10,20,100,1684,1639,3323,7408
-180,60,-70,1682,1642,3324,7304
160,-50,-130,1657,1667,3324,7875
10,-60,-90,1637,1687,3324,7694
180,60,-70,1682,1642,3324,7304
170,50,-90,1657,1667,3324,7799
-60,70,150,1671,1654,3325,7495
-120,30,0,1693,1632,3325,7924
-130,-40,100,1675,1650,3325,7731
50,10,-120,1686,1639,3325,7851
-70,10,140,1680,1645,3325,7621
-120,80,10,1676,1650,3326,7954
180,40,-100,1660,1666,3326,7771
-180,40,-100,1660,1666,3326,7771
-40,0,90,1694,1632,3326,7619
-100,-80,160,1664,1663,3327,7485
130,-50,-130,1652,1675,3327,7519
-20,60,110,1671,1656,3327,7580
-80,60,170,1686,1642,3328,7759
-40,70,130,1657,1671,3328,7601
-120,-80,-20,1695,1633,3328,7497
-90,20,-140,1668,1660,3328,7954
120,-60,-140,1678,1650,3328,7621
-10,80,110,1637,1691,3328,7463
-110,80,-160,1675,1653,3328,7654
-140,80,-130,1682,1647,3329,7689
-80,20,-130,1662,1667,3329,7779
-130,-80,-30,1691,1639,3330,7475
-160,-50,90,1694,1637,3331,7782
70,-80,180,1672,1659,3331,7538
170,30,-100,1658,1673,3331,7954
70,-80,-180,1672,1659,3331,7538
40,-10,-90,1652,1679,3331,7757
160,80,-60,1646,1686,3332,7655
130,30,90,1657,1675,3332,7892
10,-70,-90,1636,1696,3332,7488
170,0,-110,1676,1656,3332,7879
-70,20,140,1688,1645,3333,7764
0,80,-110,1688,1645,3333,7822
50,-60,170,1661,1672,3333,7700
80,-50,-150,1656,1677,3333,7645
150,-10,70,1660,1673,3333,7823
-60,-60,-160,1675,1658,3333,7716
-130,60,-140,1677,1656,3333,7658
100,30,80,1668,1666,3334,7709
-50,-40,70,1652,1682,3334,7765
-90,-80,170,1672,1662,3334,7550
180,-50,80,1673,1662,3335,7785
-160,50,-100,1674,1661,3335,7436
-180,-50,80,1673,1662,3335,7785
-180,80,-70,1659,1677,3336,7373
120,-20,-90,1683,1653,3336,7601
-140,50,-120,1686,1650,3336,7575
180,80,-70,1659,1677,3336,7373
120,70,-10,1650,1687,3337,7294
-120,-50,120,1697,1640,3337,7787
-170,60,-80,1684,1653,3337,7376
-60,-10,80,1678,1659,3337,7918
-50,20,100,1692,1646,3338,7870
170,80,-70,1656,1682,3338,7652
-10,40,-90,1657,1681,3338,8075
40,-50,170,1676,1662,3338,7705
-20,-20,90,1682,1657,3339,7714
120,20,-20,1650,1689,3339,7685
-10,-10,100,1682,1657,3339,7781
60,40,100,1671,1668,3339,7406
130,60,-30,1660,1679,3339,7563
10,-80,-90,1648,1691,3339,7743
-10,40,110,1672,1668,3340,7673
40,10,140,1621,1719,3340,7433
-60,40,-70,1651,1689,3340,7504
30,50,-130,1696,1645,3341,7820
-50,70,140,1674,1667,3341,7622
-30,-60,90,1673,1668,3341,7408
180,70,-90,1664,1677,3341,7668
-10,-30,110,1676,1665,3341,7591
-170,-80,-70,1677,1664,3341,7590
170,80,-60,1663,1678,3341,7348
30,0,140,1664,1677,3341,7305
-180,70,-90,1664,1677,3341,7668
150,60,90,1696,1646,3342,7567
60,0,-150,1626,1716,3342,7570
-100,-30,100,1659,1683,3342,7579
-160,70,-90,1671,1671,3342,7454
130,-30,-100,1670,1672,3342,7473
-80,20,180,1676,1667,3343,7524
-120,80,-150,1685,1658,3343,7760
80,-10,-110,1649,1694,3343,7701
-80,20,-180,1676,1667,3343,7524
40,-20,-80,1666,1677,3343,7881
-80,-30,170,1670,1674,3344,7915
-90,30,-160,1684,1660,3344,7576
-110,-60,0,1703,1641,3344,7667
-50,-30,70,1696,1648,3344,7877
50,-30,-70,1628,1716,3344,7723
40,60,-150,1682,1662,3344,7741
-70,30,140,1693,1651,3344,7946
-90,20,-150,1680,1664,3344,7929
-140,-10,40,1686,1658,3344,7283
110,20,60,1670,1674,3344,7895
-130,10,-90,1675,1670,3345,7551
-90,-30,70,1662,1683,3345,7505
30,70,-140,1696,1649,3345,7935
-150,60,-120,1687,1658,3345,7801
-160,-60,-90,1709,1636,3345,7880
-160,-70,-80,1703,1642,3345,7908
-80,-80,-180,1693,1653,3346,7619
-30,30,-90,1646,1700,3346,7578
-180,-60,80,1689,1657,3346,8006
130,-70,-140,1689,1657,3346,7937
150,70,90,1712,1634,3346,7721
-80,-80,180,1693,1653,3346,7619
180,-60,80,1689,1657,3346,8006
-70,-40,60,1664,1682,3346,7880
160,60,-60,1687,1659,3346,7784
-130,80,-120,1666,1680,3346,7553
130,-40,-110,1650,1697,3347,7732
30,-50,160,1668,1679,3347,7623
-150,70,-100,1660,1687,3347,7418
-30,80,130,1668,1680,3348,7587
0,70,110,1665,1683,3348,7510
40,0,150,1687,1661,3348,7324
-180,80,-80,1675,1673,3348,7587
-150,-30,-100,1677,1671,3348,8080
-130,50,-130,1685,1663,3348,7688
180,80,-80,1675,1673,3348,7587
160,70,-60,1678,1671,3349,7794
140,20,-60,1694,1655,3349,7680
-20,80,120,1654,1695,3349,7487
-140,-30,-70,1691,1659,3350,7594
0,60,110,1694,1656,3350,7529
120,-50,20,1680,1670,3350,7761
-60,0,110,1697,1653,3350,7762
170,-60,70,1699,1651,3350,7770
-110,80,-140,1672,1679,3351,7525
-130,80,-140,1694,1657,3351,7758
170,20,-100,1670,1681,3351,8089
30,-70,150,1665,1686,3351,7823
-120,50,-140,1690,1662,3352,7850
-180,-80,-80,1676,1676,3352,7583
180,-80,-80,1676,1676,3352,7583
150,30,-70,1671,1681,3352,7928
-150,-50,-80,1702,1650,3352,7796
-100,-70,10,1691,1662,3353,7600
110,-50,-130,1652,1701,3353,7536
170,-10,-110,1681,1673,3354,7883
0,-80,-100,1648,1706,3354,7775
-160,60,-90,1675,1679,3354,7433
10,10,120,1662,1692,3354,7357
50,20,-150,1659,1695,3354,7657
-180,50,-80,1681,1674,3355,7484
50,40,-170,1676,1679,3355,7817
70,-40,-150,1676,1679,3355,7364
90,50,50,1671,1684,3355,7469
-20,-40,100,1668,1687,3355,7528
180,50,-80,1681,1674,3355,7484
0,-50,-100,1659,1696,3355,7762
-10,70,110,1656,1699,3355,7549
-140,70,-130,1685,1671,3356,7544
-150,80,-100,1668,1688,3356,7573
130,0,-70,1693,1663,3356,7741
150,-50,-130,1680,1678,3358,7924
-60,-70,-160,1710,1648,3358,7801
170,10,70,1706,1652,3358,7839
-80,30,180,1688,1670,3358,7463
-80,30,-180,1688,1670,3358,7463
-170,-50,-110,1697,1662,3359,7855
130,-10,-80,1660,1699,3359,7740
170,60,-60,1681,1678,3359,7605
-80,-60,50,1695,1664,3359,7584
10,-20,130,1676,1683,3359,7630
10,60,-110,1694,1665,3359,7987
140,70,-40,1679,1680,3359,7715
170,50,-80,1657,1703,3360,7890
-60,-10,90,1706,1654,3360,7829
140,20,80,1687,1673,3360,7906
0,-60,-100,1655,1705,3360,7770
-110,50,-150,1687,1673,3360,7743
-130,0,-100,1690,1671,3361,7957
10,20,-100,1656,1705,3361,7848
140,-60,40,1685,1676,3361,7573
180,70,-80,1676,1685,3361,7574
-180,70,-80,1676,1685,3361,7574
-130,-50,110,1695,1666,3361,7869
-160,60,-100,1692,1669,3361,7624
-150,-80,-50,1703,1658,3361,7631
20,40,-110,1699,1662,3361,7805
140,30,-50,1710,1651,3361,7613
-140,-80,-40,1713,1649,3362,7596
-70,60,160,1669,1693,3362,7720
-100,30,-50,1672,1690,3362,7663
-80,-80,30,1670,1692,3362,7536
-70,-20,80,1682,1680,3362,7853
-170,50,-100,1666,1696,3362,7763
-170,30,-110,1691,1672,3363,7840
-170,60,-100,1672,1691,3363,7776
-100,80,-150,1682,1681,3363,7465
170,70,-70,1683,1680,3363,7731
-100,30,-90,1729,1634,3363,7662
-70,-80,-170,1694,1669,3363,7873
-120,80,-130,1668,1696,3364,7570
140,-20,-90,1669,1695,3364,7590
-140,70,-110,1681,1684,3365,7572
180,60,-90,1687,1678,3365,7817
-140,70,-120,1663,1702,3365,7669
60,30,150,1676,1689,3365,7396
90,-60,-150,1680,1685,3365,7890
-120,20,-110,1681,1684,3365,7781
-160,-80,-60,1705,1660,3365,7632
-180,60,-90,1687,1678,3365,7817
-70,20,-120,1716,1649,3365,7819
110,-20,0,1659,1707,3366,7645
-60,10,120,1699,1668,3367,7755
-160,40,-110,1701,1666,3367,7727
60,50,80,1682,1685,3367,7470
-30,80,140,1673,1694,3367,7621
-140,-60,-50,1718,1649,3367,7825
-60,20,120,1721,1647,3368,7921
-10,60,-90,1668,1700,3368,8065
170,-10,70,1703,1665,3368,8144
-120,70,-150,1699,1669,3368,7749
-80,-20,170,1687,1681,3368,7833
-160,70,-100,1692,1677,3369,7590
-140,80,-110,1669,1700,3369,7586
40,-10,160,1718,1651,3369,7287
-60,0,-140,1709,1660,3369,7584
-90,70,180,1703,1666,3369,7822
-130,10,-110,1696,1673,3369,7950
-80,-20,110,1677,1692,3369,7897
-10,-80,-110,1667,1702,3369,7839
-20,50,110,1692,1677,3369,7695
-90,70,-180,1703,1666,3369,7822
160,50,-70,1662,1708,3370,8000
-140,30,-120,1724,1646,3370,7945
110,-10,-60,1692,1678,3370,7633
110,20,40,1687,1683,3370,7682
-120,10,-20,1729,1642,3371,7630
-90,50,-170,1706,1665,3371,7712
-160,70,-110,1658,1713,3371,7684
-60,-50,-160,1717,1654,3371,7764
-80,70,170,1703,1669,3372,7658
-80,10,180,1720,1652,3372,7933
-80,10,-180,1720,1652,3372,7933
-150,70,-120,1663,1709,3372,7531
-120,-30,70,1671,1702,3373,7712
-100,80,-10,1698,1675,3373,8070
-150,90,-110,1675,1699,3374,7695
60,90,40,1675,1699,3374,7695
170,60,-80,1667,1707,3374,7848
-140,90,-120,1675,1699,3374,7695
-10,90,110,1675,1699,3374,7695
0,90,100,1675,1699,3374,7695
-40,90,140,1675,1699,3374,7695
40,90,60,1675,1699,3374,7695
-170,90,-90,1675,1699,3374,7695
-100,90,-160,1675,1699,3374,7695
-70,90,170,1675,1699,3374,7695
-120,90,-140,1675,1699,3374,7695
-160,90,-100,1675,1699,3374,7695
10,90,90,1675,1699,3374,7695
-60,90,160,1675,1699,3374,7695
-110,90,-150,1675,1699,3374,7695
-90,90,-170,1675,1699,3374,7695
20,90,80,1675,1699,3374,7695
30,90,70,1675,1699,3374,7695
180,90,-80,1675,1699,3374,7695
-130,90,-130,1675,1699,3374,7695
-20,90,120,1675,1699,3374,7695
110,90,-10,1675,1699,3374,7695
-30,90,130,1675,1699,3374,7695
170,90,-70,1675,1699,3374,7695
140,90,-40,1675,1699,3374,7695
140,60,-40,1683,1691,3374,7697
-180,90,-80,1675,1699,3374,7695
-170,60,-90,1703,1671,3374,7545
100,90,0,1675,1699,3374,7695
-50,90,150,1675,1699,3374,7695
130,90,-30,1675,1699,3374,7695
-40,50,-70,1696,1678,3374,8064
-30,-40,90,1706,1668,3374,7800
50,90,50,1675,1699,3374,7695
160,90,-60,1675,1699,3374,7695
70,90,30,1675,1699,3374,7695
100,30,70,1699,1675,3374,7816
-80,90,180,1675,1699,3374,7695
-30,50,110,1695,1679,3374,7802
160,50,-60,1690,1684,3374,7783
-80,90,-180,1675,1699,3374,7695
140,-40,-120,1643,1731,3374,7720
120,90,-20,1675,1699,3374,7695
80,90,20,1675,1699,3374,7695
90,90,10,1675,1699,3374,7695
150,90,-50,1675,1699,3374,7695
150,20,-70,1690,1685,3375,7898
50,30,120,1691,1684,3375,7533
160,-20,-110,1676,1699,3375,7697
-40,60,130,1694,1681,3375,7621
120,10,-40,1686,1689,3375,7594
100,30,60,1692,1684,3376,7730
150,-70,-130,1706,1670,3376,7828
150,70,-50,1684,1692,3376,7805
160,30,-80,1652,1724,3376,7796
-150,50,-110,1686,1690,3376,7480
-50,60,140,1690,1687,3377,7578
-170,80,-80,1687,1691,3378,7505
-150,60,-110,1699,1679,3378,7728
130,50,-30,1687,1691,3378,7770
-100,-30,90,1651,1727,3378,7799
110,40,0,1649,1730,3379,7655
-50,30,110,1720,1659,3379,7924
110,60,0,1682,1697,3379,7945
80,-90,-20,1671,1709,3380,7828
-130,-90,130,1671,1709,3380,7828
170,-90,70,1671,1709,3380,7828
-160,20,-110,1715,1665,3380,7977
-90,-90,170,1671,1709,3380,7828
40,-90,-60,1671,1709,3380,7828
110,-90,10,1671,1709,3380,7828
-80,-90,-180,1671,1709,3380,7828
-150,-90,110,1671,1709,3380,7828
-180,-90,80,1671,1709,3380,7828
160,-90,60,1671,1709,3380,7828
-50,-90,-150,1671,1709,3380,7828
180,-90,80,1671,1709,3380,7828
70,-90,-30,1671,1709,3380,7828
30,-90,-70,1671,1709,3380,7828
90,-90,-10,1671,1709,3380,7828
-60,-90,-160,1671,1709,3380,7828
60,-90,-40,1671,1709,3380,7828
-70,-90,-170,1671,1709,3380,7828
-80,-90,180,1671,1709,3380,7828
50,-90,-50,1671,1709,3380,7828
10,-90,-90,1671,1709,3380,7828
-10,-90,-110,1671,1709,3380,7828
-150,70,-110,1700,1680,3380,7614
150,-90,50,1671,1709,3380,7828
-20,-90,-120,1671,1709,3380,7828
-170,-90,90,1671,1709,3380,7828
-40,-90,-140,1671,1709,3380,7828
-140,-90,120,1671,1709,3380,7828
100,-90,0,1671,1709,3380,7828
-100,-90,160,1671,1709,3380,7828
-30,-90,-130,1671,1709,3380,7828
10,30,-100,1702,1678,3380,7960
130,-90,30,1671,1709,3380,7828
120,-90,20,1671,1709,3380,7828
20,-90,-80,1671,1709,3380,7828
140,-90,40,1671,1709,3380,7828
-120,-90,140,1671,1709,3380,7828
-160,-90,100,1671,1709,3380,7828
-110,-90,150,1671,1709,3380,7828
0,-90,-100,1671,1709,3380,7828
-20,-10,90,1708,1673,3381,7948
70,-20,-80,1695,1686,3381,7800
100,-20,-50,1677,1704,3381,7573
130,70,-20,1676,1705,3381,7545
-60,60,-50,1678,1703,3381,8070
-50,-10,80,1695,1686,3381,7906
-10,80,-100,1721,1660,3381,8009
170,40,-90,1668,1713,3381,7752
90,-50,-140,1677,1704,3381,7810
120,-50,-130,1681,1701,3382,7856
50,50,-170,1706,1676,3382,7745
-100,-60,150,1693,1689,3382,7699
-130,-70,-30,1732,1650,3382,7695
-110,-30,70,1689,1693,3382,7502
-170,-70,-90,1704,1678,3382,7927
-110,70,-160,1711,1672,3383,7795
-110,80,0,1698,1685,3383,7959
-160,80,-90,1694,1689,3383,7537
140,-20,-100,1662,1721,3383,7809
-170,70,-90,1701,1682,3383,7598
-110,-40,30,1719,1665,3384,7624
-40,-40,80,1706,1678,3384,7872
-140,40,-120,1702,1682,3384,7774
-130,-30,-40,1709,1675,3384,7646
70,40,150,1711,1673,3384,7512
-170,70,-80,1710,1674,3384,7533
-120,20,-100,1683,1702,3385,7879
-130,70,-140,1698,1687,3385,7668
-10,0,100,1696,1689,3385,7646
-170,70,-100,1683,1702,3385,7610
70,-10,-130,1666,1720,3386,7585
90,-40,-130,1678,1708,3386,7364
0,-40,-100,1654,1733,3387,7763
-170,80,-90,1687,1700,3387,7661
110,-60,-140,1699,1688,3387,7759
150,10,-80,1714,1674,3388,7896
150,-30,60,1719,1669,3388,7865
160,-20,70,1717,1671,3388,7858
-80,80,-170,1687,1701,3388,7531
-40,50,120,1709,1679,3388,7898
-110,-30,60,1710,1679,3389,7722
-170,10,-110,1729,1660,3389,8039
50,10,160,1704,1685,3389,7532
80,-80,-170,1701,1689,3390,7673
-100,-30,80,1677,1713,3390,7650
-50,10,100,1715,1676,3391,7905
-10,50,-90,1715,1677,3392,8032
-80,0,170,1724,1668,3392,8086
-140,80,-120,1698,1694,3392,7653
150,0,-80,1692,1700,3392,7877
140,-30,-110,1667,1725,3392,7793
-20,10,90,1704,1688,3392,8019
140,50,-40,1685,1708,3393,7798
-150,80,-110,1708,1685,3393,7585
-170,20,-110,1693,1700,3393,8018
-100,70,-170,1713,1680,3393,7858
-150,60,-100,1684,1710,3394,7585
-160,0,50,1713,1681,3394,7680
170,0,-80,1706,1688,3394,7752
-80,40,160,1689,1705,3394,7849
60,70,180,1713,1681,3394,7831
-40,30,100,1723,1671,3394,8061
60,70,-180,1713,1681,3394,7831
-130,-60,-30,1731,1663,3394,7791
-80,40,-180,1693,1702,3395,7544
60,-40,-160,1673,1722,3395,7485
-80,40,180,1693,1702,3395,7544
-90,80,-160,1693,1702,3395,7532
-30,60,120,1687,1709,3396,7670
-130,80,-130,1708,1688,3396,7729
-60,-80,-160,1702,1694,3396,7966
-110,-50,130,1708,1688,3396,7860
-130,60,-120,1708,1689,3397,7745
-60,80,160,1707,1690,3397,7807
-80,50,170,1709,1689,3398,7951
100,-30,-110,1701,1697,3398,7820
80,-10,-100,1685,1713,3398,7693
90,40,120,1706,1692,3398,7777
-60,60,150,1700,1699,3399,7651
-140,0,30,1694,1705,3399,7797
-120,40,-130,1709,1691,3400,7779
170,-70,-110,1720,1680,3400,7961
120,-70,-140,1698,1702,3400,7708
-90,60,-170,1697,1703,3400,7868
-60,40,130,1707,1693,3400,7756
20,40,110,1696,1704,3400,7598
40,-70,160,1687,1713,3400,7917
-50,-60,80,1732,1669,3401,7646
-80,-10,140,1680,1721,3401,7773
160,70,-50,1709,1692,3401,7821
170,70,-60,1697,1704,3401,7663
-70,80,180,1688,1714,3402,7605
60,-20,-80,1717,1685,3402,8039
-70,80,-180,1688,1714,3402,7605
-130,10,10,1718,1684,3402,7936
140,-70,-130,1709,1693,3402,8053
130,10,-60,1710,1692,3402,7962
-180,50,-90,1706,1697,3403,7764
-150,-40,-80,1756,1647,3403,7950
90,-40,-20,1693,1710,3403,7727
180,50,-90,1706,1697,3403,7764
-40,80,150,1685,1719,3404,7648
20,60,100,1685,1719,3404,7532
-80,20,-170,1726,1678,3404,7824
-90,30,-100,1717,1687,3404,7780
-130,70,-130,1694,1710,3404,7859
-20,70,120,1691,1713,3404,7606
-100,40,-150,1704,1701,3405,7712
120,-20,30,1730,1675,3405,8100
160,40,-70,1685,1720,3405,7828
-90,70,-20,1700,1706,3406,8025
160,60,-70,1657,1749,3406,7884
-170,-60,-100,1727,1679,3406,8076
-80,80,-30,1721,1685,3406,8102
-40,-10,80,1738,1669,3407,7971
-140,-20,-90,1703,1704,3407,7871
100,-70,-150,1710,1697,3407,7822
160,-60,-130,1713,1695,3408,8140
-110,30,-130,1730,1678,3408,7880
-100,-70,20,1731,1678,3409,7795
-130,-90,-20,1728,1681,3409,7786
120,-40,-110,1697,1712,3409,7668
30,-90,140,1728,1681,3409,7786
-60,-90,50,1728,1681,3409,7786
120,-90,-130,1728,1681,3409,7786
-80,-90,30,1728,1681,3409,7786
180,-90,-70,1728,1681,3409,7786
0,-90,110,1728,1681,3409,7786
-150,10,40,1718,1691,3409,7678
-10,-90,100,1728,1681,3409,7786
-180,70,-70,1698,1711,3409,7637
-180,-90,-70,1728,1681,3409,7786
-100,60,-160,1715,1694,3409,7891
130,-90,-120,1728,1681,3409,7786
-170,-90,-60,1728,1681,3409,7786
50,-90,160,1728,1681,3409,7786
-70,-90,40,1728,1681,3409,7786
-20,-90,90,1728,1681,3409,7786
10,-90,120,1728,1681,3409,7786
80,-90,-170,1728,1681,3409,7786
100,-90,-150,1728,1681,3409,7786
170,-40,-120,1704,1705,3409,7940
30,-30,160,1722,1687,3409,7578
-160,-90,-50,1728,1681,3409,7786
-80,30,170,1697,1712,3409,7874
60,-90,170,1728,1681,3409,7786
40,-90,150,1728,1681,3409,7786
170,-90,-80,1728,1681,3409,7786
-30,-90,80,1728,1681,3409,7786
180,70,-70,1698,1711,3409,7637
-110,-90,0,1728,1681,3409,7786
-90,-90,20,1728,1681,3409,7786
140,-90,-110,1728,1681,3409,7786
110,-90,-140,1728,1681,3409,7786
-140,-90,-30,1728,1681,3409,7786
-100,-90,10,1728,1681,3409,7786
-40,-90,70,1728,1681,3409,7786
70,-90,180,1728,1681,3409,7786
150,-40,-120,1690,1719,3409,7954
160,-90,-90,1728,1681,3409,7786
-50,-90,60,1728,1681,3409,7786
-120,-90,-10,1728,1681,3409,7786
90,-90,-160,1728,1681,3409,7786
20,-90,130,1728,1681,3409,7786
-150,-90,-40,1728,1681,3409,7786
150,-90,-100,1728,1681,3409,7786
70,-90,-180,1728,1681,3409,7786
160,20,-90,1708,1702,3410,7997
90,-80,-160,1720,1690,3410,7788
150,60,-50,1717,1693,3410,8011
150,-60,-130,1724,1686,3410,8061
40,0,-100,1703,1707,3410,7817
150,-10,-90,1710,1700,3410,8136
-70,-60,60,1713,1697,3410,7693
-110,40,-140,1707,1704,3411,7773
-150,-70,-60,1731,1680,3411,7689
-60,80,170,1689,1722,3411,7694
-20,-80,-120,1682,1730,3412,7862
-110,-70,0,1733,1679,3412,7797
100,80,140,1727,1685,3412,7852
40,20,-120,1720,1692,3412,7817
40,-20,170,1681,1731,3412,7541
110,50,0,1700,1712,3412,8010
160,-40,-120,1706,1707,3413,8124
-140,-40,-60,1728,1685,3413,7760
-120,70,-140,1704,1709,3413,7876
-140,-20,-80,1709,1705,3414,8031
110,-10,-10,1698,1716,3414,7780
-20,0,90,1702,1713,3415,8012
-60,-50,70,1723,1692,3415,7799
-20,-30,100,1705,1710,3415,7778
-70,-50,60,1732,1683,3415,7914
120,10,60,1726,1689,3415,7981
-10,30,110,1705,1710,3415,7888
-120,80,-140,1709,1707,3416,7854
-90,-30,150,1713,1703,3416,7993
60,70,60,1724,1692,3416,7407
180,40,-80,1696,1720,3416,7584
-180,40,-80,1696,1720,3416,7584
70,-10,-100,1722,1694,3416,7680
-90,-60,40,1715,1701,3416,7734
-60,-40,-160,1711,1705,3416,7753
160,-70,-120,1726,1690,3416,7975
40,50,-150,1713,1704,3417,7848
-140,-40,90,1733,1684,3417,7840
-10,10,100,1705,1712,3417,7706
-70,10,-140,1706,1712,3418,7744
-170,-40,-110,1728,1691,3419,8018
-180,10,-110,1715,1704,3419,7995
180,10,-110,1715,1704,3419,7995
-90,-80,20,1700,1720,3420,7673
-50,80,150,1706,1714,3420,7805
-160,80,-100,1710,1710,3420,7573
160,10,-90,1698,1723,3421,8170
-100,70,-160,1697,1724,3421,7901
120,-40,20,1728,1693,3421,7911
100,-60,-140,1693,1728,3421,7924
-70,80,170,1714,1707,3421,7898
140,40,-40,1708,1714,3422,7852
-20,30,100,1712,1710,3422,7951
-80,30,-80,1714,1708,3422,7809
120,10,-30,1712,1710,3422,7890
-110,50,-140,1733,1689,3422,7822
-150,-60,100,1742,1681,3423,7882
100,-50,-130,1703,1720,3423,7914
-80,-10,170,1733,1690,3423,8022
160,40,-60,1717,1706,3423,7772
40,20,130,1675,1749,3424,7375
-40,80,140,1691,1733,3424,7748
-50,80,160,1708,1717,3425,7730
40,10,-110,1729,1696,3425,7849
-30,-80,-130,1707,1718,3425,7826
-50,40,120,1707,1718,3425,7825
-60,-10,-150,1728,1697,3425,7822
-110,80,-150,1706,1719,3425,7884
110,80,130,1733,1693,3426,7907
30,-10,-90,1705,1721,3426,8197
-50,50,130,1703,1723,3426,7927
-50,-50,80,1722,1704,3426,7608
180,-60,-110,1754,1673,3427,8016
-180,-60,-110,1754,1673,3427,8016
-90,40,-40,1729,1698,3427,7781
-130,10,-100,1698,1729,3427,8130
170,-50,70,1728,1700,3428,7933
170,40,-70,1710,1718,3428,7732
-140,10,-110,1719,1709,3428,8089
-70,-20,-170,1729,1699,3428,7870
110,-10,-70,1704,1724,3428,7867
-60,-60,70,1715,1714,3429,7713
170,10,-100,1715,1714,3429,8270
-90,80,-20,1735,1694,3429,8091
-40,-20,80,1738,1691,3429,7985
50,-20,-80,1696,1733,3429,7996
-70,80,-40,1720,1709,3429,8177
-170,40,-90,1710,1720,3430,7727
-110,40,-10,1768,1662,3430,8079
-170,-40,80,1726,1704,3430,7950
-120,20,-10,1756,1674,3430,7763
-180,50,-70,1729,1701,3430,7449
140,-60,-130,1730,1700,3430,7934
180,50,-70,1729,1701,3430,7449
20,70,-130,1751,1679,3430,8053
-160,10,-110,1763,1667,3430,8060
-180,-70,-100,1731,1700,3431,7980
170,30,70,1745,1686,3431,7813
0,-30,-100,1691,1740,3431,7791
160,60,80,1731,1700,3431,7808
-110,70,-150,1712,1719,3431,7916
180,-70,-100,1731,1700,3431,7980
-70,-20,90,1716,1715,3431,7784
100,-80,-150,1736,1696,3432,7903
110,20,50,1721,1711,3432,7805
130,80,110,1757,1675,3432,7907
140,70,-30,1702,1730,3432,7748
-60,-70,70,1729,1703,3432,7635
-130,30,-120,1724,1709,3433,8037
0,-70,-100,1692,1742,3434,7717
50,20,170,1718,1716,3434,7436
-160,40,-100,1722,1713,3435,7824
50,-70,170,1714,1721,3435,7963
-140,60,-120,1732,1703,3435,7855
-100,-50,30,1719,1716,3435,8061
-80,80,180,1720,1715,3435,8000
100,-20,-100,1715,1720,3435,7864
-80,80,-180,1720,1715,3435,8000
120,80,120,1751,1685,3436,7874
100,-40,-120,1702,1734,3436,7611
-170,-70,-80,1751,1685,3436,8017
30,-40,-80,1682,1755,3437,7758
-90,80,-170,1725,1712,3437,8020
-170,40,-100,1732,1705,3437,7937
-10,70,120,1714,1724,3438,7624
-110,60,-150,1719,1719,3438,8106
170,40,-80,1708,1730,3438,7800
160,-50,60,1749,1690,3439,7979
-50,-70,80,1753,1686,3439,7582
-170,0,-110,1756,1684,3440,7966
-50,-40,80,1717,1723,3440,7831
-150,20,-110,1731,1709,3440,8098
-90,80,-150,1721,1719,3440,7621
-110,30,-20,1758,1682,3440,8064
-150,-50,-70,1739,1701,3440,7972
-80,80,-160,1717,1724,3441,7580
20,20,120,1708,1733,3441,7642
60,-10,-100,1737,1704,3441,7817
-80,-40,60,1708,1734,3442,8031
130,-70,-130,1724,1718,3442,7881
170,-60,-120,1736,1706,3442,8193
-130,70,-120,1737,1705,3442,7692
-180,0,-110,1762,1680,3442,8117
160,70,80,1742,1700,3442,7925
-40,-80,-140,1710,1732,3442,7824
170,40,70,1752,1690,3442,7863
170,-70,-100,1737,1705,3442,7941
180,0,-110,1762,1680,3442,8117
-30,0,90,1725,1717,3442,8032
120,-50,-120,1716,1726,3442,7918
-80,20,-160,1714,1729,3443,7931
180,-70,-90,1750,1693,3443,8018
130,50,100,1745,1698,3443,7772
-180,-10,-110,1746,1697,3443,8015
-180,-70,-90,1750,1693,3443,8018
180,-10,-110,1746,1697,3443,8015
-110,-50,10,1717,1726,3443,7849
50,60,-170,1714,1729,3443,7902
100,-20,-30,1722,1722,3444,7762
160,0,-80,1725,1719,3444,7821
-150,-10,-110,1761,1683,3444,8124
70,-70,-170,1729,1715,3444,7954
-70,50,150,1728,1717,3445,7928
-80,30,-170,1727,1718,3445,7927
110,-30,-100,1710,1735,3445,7871
-150,40,-110,1729,1716,3445,7781
-100,80,-160,1728,1717,3445,7932
-140,-70,-40,1754,1691,3445,7811
-40,-60,90,1729,1716,3445,7710
-20,40,110,1745,1700,3445,7640
150,10,-70,1739,1706,3445,7985
-10,-70,-110,1706,1739,3445,7964
-120,60,-130,1730,1716,3446,7757
-30,50,120,1731,1715,3446,7808
20,-20,140,1727,1719,3446,7804
110,-10,-30,1720,1726,3446,7902
-100,-80,10,1713,1734,3447,7741
50,20,-180,1753,1694,3447,7514
-50,-70,-150,1723,1724,3447,7957
50,20,180,1753,1694,3447,7514
-50,-10,90,1744,1704,3448,7934
90,80,150,1747,1701,3448,7927
150,30,-60,1726,1723,3449,7820
-80,50,180,1726,1723,3449,7957
-80,50,-180,1726,1723,3449,7957
-170,10,-90,1717,1732,3449,7855
-30,80,-80,1746,1703,3449,8235
-120,50,-130,1738,1711,3449,7945
80,40,130,1712,1737,3449,7959
-80,-30,70,1700,1749,3449,7864
-160,-50,-90,1758,1693,3451,8036
20,10,-100,1698,1753,3451,7884
-140,60,-110,1697,1754,3451,7821
90,-30,-120,1740,1712,3452,7895
-10,50,120,1745,1707,3452,7774
-130,20,-110,1715,1737,3452,8078
-100,50,-150,1738,1714,3452,7846
-160,30,-110,1746,1706,3452,8114
80,60,150,1746,1706,3452,7757
-100,30,-60,1726,1726,3452,7932
-110,60,-140,1721,1731,3452,7825
140,-10,-80,1712,1740,3452,7984
-130,60,-130,1744,1709,3453,8043
170,-20,-110,1732,1721,3453,8000
140,80,100,1764,1689,3453,8005
-40,80,-70,1746,1707,3453,8318
160,0,-100,1698,1755,3453,7968
-90,70,-170,1705,1748,3453,8026
-160,-60,-80,1764,1690,3454,8027
60,0,-120,1731,1723,3454,7984
-130,20,-100,1732,1722,3454,8160
-70,80,-170,1723,1731,3454,7662
-40,-30,80,1737,1717,3454,8031
50,20,140,1695,1759,3454,7735
-80,60,-180,1713,1742,3455,8025
-10,-20,110,1710,1745,3455,7927
-80,60,180,1713,1742,3455,8025
120,0,-60,1734,1721,3455,8223
60,-70,-180,1734,1722,3456,8010
-50,-80,-150,1718,1738,3456,7946
170,-20,70,1758,1698,3456,8086
60,-70,180,1734,1722,3456,8010
-50,80,-60,1746,1711,3457,8257
-50,10,-110,1750,1707,3457,8023
70,70,50,1740,1717,3457,7468
-60,80,-50,1740,1717,3457,8257
50,30,-170,1725,1733,3458,7788
-20,80,-90,1758,1700,3458,8197
0,-10,120,1749,1709,3458,7670
160,30,-70,1722,1736,3458,7863
-160,-70,-70,1753,1705,3458,7877
170,50,-60,1720,1738,3458,7756
30,50,100,1710,1749,3459,7660
-140,-30,-60,1718,1741,3459,7930
70,-50,-40,1712,1747,3459,7961
80,70,40,1744,1715,3459,7673
110,-80,-140,1756,1703,3459,7969
150,-70,-120,1752,1707,3459,8178
-40,-80,80,1731,1728,3459,7828
-120,-30,-10,1755,1704,3459,7919
-30,30,100,1745,1714,3459,8064
160,-10,-100,1695,1765,3460,8158
160,-70,-110,1752,1708,3460,8038
150,70,-40,1712,1749,3461,7915
-80,70,-30,1726,1735,3461,8089
-70,20,150,1720,1741,3461,7942
-40,40,110,1745,1717,3462,7950
-110,-80,0,1738,1724,3462,7864
150,40,-50,1728,1735,3463,7815
-30,-70,-130,1723,1740,3463,7943
-50,80,170,1758,1705,3463,7835
150,-30,-110,1723,1741,3464,8186
160,-10,70,1738,1726,3464,7992
-40,-40,90,1732,1732,3464,8037
-100,80,-140,1732,1732,3464,7767
-50,0,100,1767,1697,3464,8042
60,30,140,1726,1738,3464,7765
-180,-20,70,1761,1704,3465,8176
140,40,90,1760,1705,3465,7973
150,-50,-120,1746,1719,3465,8053
100,-20,-40,1728,1737,3465,7964
-80,-10,150,1711,1754,3465,7888
180,-20,70,1761,1704,3465,8176
180,40,-90,1709,1757,3466,7759
140,-30,50,1748,1718,3466,7921
-180,40,-90,1709,1757,3466,7759
-80,-40,170,1759,1707,3466,8071
-150,-30,70,1755,1712,3467,7787
-90,30,-110,1755,1712,3467,8076
-120,70,-130,1763,1704,3467,7807
-50,20,110,1789,1678,3467,8159
60,0,-130,1731,1736,3467,7822
140,-70,-120,1744,1723,3467,8020
-60,-10,100,1744,1723,3467,7988
-50,-20,90,1749,1719,3468,8020
-120,-30,40,1755,1713,3468,7723
-40,-70,90,1766,1702,3468,7617
-70,-70,60,1742,1727,3469,7718
-30,70,130,1731,1739,3470,7779
-120,20,-60,1743,1727,3470,8075
-120,-30,60,1753,1717,3470,7853
160,60,-50,1729,1742,3471,7854
-50,-20,80,1741,1730,3471,8114
60,-50,-50,1720,1751,3471,8045
-40,-20,90,1751,1720,3471,8158
-170,50,-80,1743,1728,3471,7736
-140,10,-100,1734,1737,3471,8012
60,50,170,1764,1708,3472,7788
-110,80,-130,1754,1718,3472,7807
-20,-80,100,1738,1734,3472,7962
-150,30,-110,1760,1712,3472,8148
110,-10,-50,1714,1758,3472,7797
120,60,-10,1713,1759,3472,8041
-130,20,10,1755,1718,3473,8270
80,-70,-160,1735,1738,3473,7949
-40,80,160,1756,1717,3473,7825
100,50,30,1747,1726,3473,7807
-70,50,160,1726,1748,3474,8022
-140,0,-110,1756,1718,3474,8290
130,10,70,1749,1725,3474,8304
-180,30,-100,1729,1746,3475,8223
-20,60,120,1744,1731,3475,7924
80,-30,-50,1715,1760,3475,8232
180,30,-100,1729,1746,3475,8223
-160,-20,-110,1766,1710,3476,8200
-110,30,-120,1748,1728,3476,8179
170,-70,-90,1750,1726,3476,7844
-100,-30,110,1736,1740,3476,7998
-170,30,-90,1757,1719,3476,7945
-30,-20,-120,1739,1737,3476,7877
10,-10,130,1733,1743,3476,7739
-150,10,-110,1773,1704,3477,8241
-100,30,-130,1734,1743,3477,8069
-110,-40,120,1753,1724,3477,7849
130,-30,40,1736,1742,3478,7982
-160,-40,-100,1744,1734,3478,8108
130,40,-30,1732,1746,3478,8020
-60,-40,70,1754,1724,3478,8025
80,-30,-130,1731,1747,3478,7913
-130,20,-90,1766,1713,3479,8009
-160,20,-100,1739,1740,3479,8142
170,10,-90,1725,1754,3479,8154
-20,-70,-120,1743,1736,3479,7942
90,-20,-110,1734,1746,3480,7951
20,-20,-90,1693,1787,3480,8091
90,60,140,1745,1736,3481,7851
100,40,110,1755,1726,3481,7981
100,60,20,1728,1754,3482,7887
150,-50,50,1787,1695,3482,7830
100,80,20,1762,1720,3482,7953
50,0,-110,1759,1723,3482,8080
-20,10,-100,1727,1755,3482,8083
-140,20,-110,1745,1738,3483,8124
-60,50,140,1748,1735,3483,7953
80,40,90,1741,1743,3484,8005
-60,80,-180,1749,1736,3485,7780
160,-70,-100,1761,1724,3485,7978
-20,50,120,1761,1724,3485,8051
-60,80,180,1749,1736,3485,7780
-100,30,-100,1767,1718,3485,7983
-180,30,-80,1766,1720,3486,7920
-30,-80,90,1735,1751,3486,7942
180,30,-80,1766,1720,3486,7920
-170,-20,-110,1776,1711,3487,8463
-50,-80,70,1757,1730,3487,7889
-130,-50,-30,1782,1705,3487,8072
110,80,10,1753,1735,3488,7933
-110,30,-80,1773,1715,3488,7871
70,40,100,1742,1746,3488,7897
-30,40,110,1744,1745,3489,8108
-40,70,140,1753,1736,3489,7919
-160,30,-100,1762,1727,3489,8114
-120,-80,-10,1744,1746,3490,7965
-60,20,-100,1748,1742,3490,8104
-80,40,170,1726,1764,3490,8008
-140,-10,-100,1733,1757,3490,8218
-130,-80,-20,1751,1739,3490,8042
50,70,70,1750,1740,3490,7653
60,0,-140,1722,1769,3491,7931
-10,-80,110,1748,1743,3491,8077
-60,30,130,1760,1731,3491,8123
70,-30,-60,1713,1779,3492,8270
-50,-20,-140,1773,1719,3492,7984
-20,-70,110,1744,1748,3492,7724
-10,-70,120,1759,1733,3492,7847
0,-80,120,1759,1734,3493,8126
-170,-50,-100,1767,1726,3493,8115
-170,20,-90,1731,1763,3494,8030
-100,30,-80,1755,1739,3494,8048
-90,50,-160,1763,1732,3495,7952
180,-70,-80,1770,1725,3495,7910
150,-70,-110,1756,1739,3495,8106
-180,-70,-80,1770,1725,3495,7910
-60,-20,80,1762,1733,3495,8277
-70,-10,-170,1749,1746,3495,7985
-80,70,-180,1735,1761,3496,8154
-80,70,180,1735,1761,3496,8154
-70,30,150,1744,1752,3496,8169
130,-30,-90,1733,1764,3497,7815
0,60,-100,1747,1750,3497,8201
-140,0,-70,1767,1730,3497,7929
-140,-10,-80,1737,1761,3498,8167
-20,-60,110,1754,1744,3498,7999
-130,20,-80,1737,1762,3499,8021
-20,70,130,1744,1755,3499,7723
-140,0,-80,1738,1762,3500,8194
110,-70,-140,1751,1749,3500,8131
-160,-40,-90,1775,1725,3500,8331
-150,10,-100,1744,1756,3500,8234
-130,30,10,1773,1727,3500,8206
-10,-60,-110,1734,1766,3500,8043
-120,60,-140,1742,1758,3500,8122
-40,-50,90,1786,1714,3500,7866
-70,70,-40,1751,1749,3500,8272
160,0,70,1775,1726,3501,8373
-30,-60,100,1734,1767,3501,7976
160,0,-90,1724,1777,3501,8158
-30,-70,100,1773,1729,3502,7710
-150,-60,-60,1803,1700,3503,8058
170,-40,70,1779,1724,3503,8374
-40,-10,90,1784,1720,3504,7972
-40,20,100,1787,1717,3504,8313
-90,-30,80,1741,1763,3504,7871
-30,0,-110,1770,1735,3505,8327
110,-50,-120,1743,1762,3505,8136
50,-50,-60,1735,1770,3505,8126
170,-50,-120,1747,1758,3505,8137
150,80,90,1793,1713,3506,8100
-120,80,-120,1778,1728,3506,7817
120,-80,-130,1771,1736,3507,8118
180,20,-100,1758,1749,3507,8199
70,-20,-140,1736,1771,3507,7967
-180,20,-100,1758,1749,3507,8199
-30,80,150,1754,1753,3507,7830
-40,-70,-140,1752,1755,3507,7879
-180,10,-90,1760,1748,3508,8309
110,-40,-110,1721,1787,3508,7927
-110,70,-140,1776,1732,3508,7947
-80,-80,40,1765,1743,3508,8082
180,10,-90,1760,1748,3508,8309
160,20,-70,1754,1755,3509,8063
80,80,160,1778,1731,3509,8038
160,10,-80,1766,1743,3509,8071
160,50,-50,1746,1763,3509,7979
140,80,-20,1761,1748,3509,7943
-130,20,-70,1781,1728,3509,8104
170,20,-90,1764,1746,3510,8167
150,0,70,1764,1746,3510,8206
-170,90,-70,1767,1744,3511,7814
-150,-40,-70,1783,1728,3511,8281
0,90,120,1767,1744,3511,7814
-40,90,160,1767,1744,3511,7814
40,90,80,1767,1744,3511,7814
-100,90,-140,1767,1744,3511,7814
-90,90,-150,1767,1744,3511,7814
-140,90,-100,1767,1744,3511,7814
-60,90,180,1767,1744,3511,7814
60,90,60,1767,1744,3511,7814
-130,90,-110,1767,1744,3511,7814
80,90,40,1767,1744,3511,7814
-180,90,-60,1767,1744,3511,7814
-50,90,170,1767,1744,3511,7814
130,90,-10,1767,1744,3511,7814
10,90,110,1767,1744,3511,7814
150,90,-30,1767,1744,3511,7814
70,90,50,1767,1744,3511,7814
-70,90,-170,1767,1744,3511,7814
-30,90,150,1767,1744,3511,7814
-80,90,-160,1767,1744,3511,7814
170,90,-50,1767,1744,3511,7814
-60,90,-180,1767,1744,3511,7814
140,90,-20,1767,1744,3511,7814
110,90,10,1767,1744,3511,7814
-150,90,-90,1767,1744,3511,7814
180,90,-60,1767,1744,3511,7814
-20,90,140,1767,1744,3511,7814
-10,90,130,1767,1744,3511,7814
-120,90,-120,1767,1744,3511,7814
-160,90,-80,1767,1744,3511,7814
160,90,-40,1767,1744,3511,7814
120,90,0,1767,1744,3511,7814
-110,90,-130,1767,1744,3511,7814
90,90,30,1767,1744,3511,7814
30,90,90,1767,1744,3511,7814
20,90,100,1767,1744,3511,7814
100,90,20,1767,1744,3511,7814
50,90,70,1767,1744,3511,7814
170,70,70,1800,1712,3512,8092
140,0,-70,1769,1743,3512,8015
-10,-50,-110,1736,1776,3512,7915
-140,-50,-50,1770,1742,3512,8135
150,80,-30,1767,1745,3512,7865
-60,-80,60,1761,1751,3512,7963
170,30,-80,1750,1763,3513,7867
-40,30,-90,1703,1810,3513,8213
110,70,10,1766,1747,3513,7798
-90,40,-160,1753,1760,3513,7906
-60,-30,-160,1767,1746,3513,7958
-170,-10,60,1769,1744,3513,8055
10,70,-120,1794,1719,3513,8338
-70,-80,50,1764,1750,3514,7997
120,80,0,1761,1753,3514,7944
170,10,-80,1737,1777,3514,7926
80,-20,-80,1756,1758,3514,8003
80,-50,-30,1757,1757,3514,8080
-100,60,-150,1764,1750,3514,8029
-60,20,130,1784,1731,3515,8057
-130,0,10,1774,1741,3515,8172
-50,-30,80,1781,1734,3515,8101
90,80,30,1769,1747,3516,7961
-10,40,120,1775,1741,3516,7835
130,30,-30,1752,1764,3516,8246
-80,-50,170,1735,1781,3516,8013
110,-10,-40,1753,1763,3516,8127
130,60,-20,1726,1790,3516,8113
130,-50,-120,1743,1773,3516,8153
40,40,-150,1754,1762,3516,8161
120,10,-20,1732,1785,3517,8111
-60,-30,70,1762,1755,3517,8415
-160,-20,60,1781,1737,3518,7771
170,30,-90,1748,1770,3518,8111
160,-30,-110,1778,1740,3518,8187
160,20,-80,1736,1782,3518,8030
130,0,60,1772,1747,3519,8251
-150,-30,-90,1781,1738,3519,8300
160,-50,-120,1766,1754,3520,8404
70,60,160,1765,1755,3520,7796
120,-10,-70,1775,1745,3520,7977
-130,80,-110,1780,1740,3520,7872
-20,-50,110,1758,1763,3521,8013
0,-60,130,1771,1750,3521,8283
-140,-50,100,1785,1736,3521,8284
130,-60,-130,1750,1771,3521,8038
10,-80,130,1771,1750,3521,8119
140,20,-50,1774,1747,3521,8069
-70,40,150,1742,1780,3522,7863
-90,-40,150,1759,1763,3522,8139
-150,0,-110,1786,1736,3522,8454
-170,40,-80,1784,1738,3522,7796
-90,30,-90,1790,1732,3522,8109
120,-30,20,1780,1742,3522,8220
-60,10,-130,1771,1752,3523,8216
90,70,30,1752,1771,3523,7761
50,-30,-170,1740,1783,3523,7900
-40,-30,90,1796,1727,3523,8234
90,-20,-70,1748,1775,3523,8040
-20,80,140,1764,1759,3523,7845
-170,20,-100,1776,1747,3523,8407
-120,-70,-10,1781,1743,3524,7964
130,-40,-100,1742,1782,3524,7857
-130,-10,-30,1774,1750,3524,7927
120,40,100,1770,1755,3525,8315
-140,80,-100,1774,1751,3525,7878
-170,-10,-110,1775,1750,3525,8261
-110,-70,10,1781,1744,3525,8012
170,20,70,1772,1753,3525,8063
-170,-30,-110,1787,1739,3526,8255
180,-20,-110,1762,1764,3526,8284
-70,0,-160,1787,1739,3526,8178
-180,-20,-110,1762,1764,3526,8284
-40,50,130,1769,1758,3527,8041
-160,10,-100,1763,1764,3527,8253
70,80,50,1779,1748,3527,7943
160,80,-40,1766,1761,3527,7755
0,0,120,1785,1742,3527,7865
-160,0,-110,1778,1749,3527,8325
130,-10,50,1756,1771,3527,8340
90,-70,-150,1747,1781,3528,7951
-80,-10,160,1771,1757,3528,8357
150,0,-70,1782,1746,3528,7769
-150,70,-90,1783,1745,3528,7803
-100,-40,50,1755,1774,3529,8076
-140,20,-100,1772,1757,3529,8352
50,50,90,1731,1798,3529,7763
-70,-10,120,1776,1753,3529,8224
-50,30,120,1788,1741,3529,8100
-150,20,-100,1753,1776,3529,8154
50,-10,-170,1741,1788,3529,7781
-120,40,0,1801,1728,3529,8408
-180,10,-80,1779,1751,3530,7998
-30,-30,90,1754,1776,3530,8156
-140,-10,-90,1777,1753,3530,8377
160,10,-70,1772,1758,3530,8136
30,-10,150,1751,1779,3530,7815
60,80,60,1781,1749,3530,7993
170,-30,70,1797,1733,3530,8292
140,10,-60,1769,1761,3530,8165
-60,0,120,1780,1750,3530,8104
180,10,-80,1779,1751,3530,7998
-10,0,-100,1774,1757,3531,8258
-140,10,-70,1777,1754,3531,8004
100,70,20,1768,1764,3532,7822
-30,-20,90,1768,1764,3532,8230
-30,-10,90,1775,1757,3532,8200
-140,-80,-30,1764,1769,3533,8101
-120,-30,10,1774,1759,3533,8197
20,-50,150,1762,1771,3533,7989
-170,10,-80,1778,1755,3533,8145
-100,30,-140,1779,1754,3533,8155
-100,30,-70,1769,1765,3534,8136
-140,-20,-70,1773,1761,3534,8111
160,80,80,1796,1738,3534,8179
-130,50,-120,1792,1742,3534,8130
-80,40,-170,1764,1771,3535,7749
150,-20,-100,1755,1781,3536,8408
-100,70,-150,1771,1765,3536,8103
80,80,40,1764,1773,3537,7899
-60,10,130,1796,1741,3537,7961
-10,-60,120,1775,1762,3537,8105
-70,-30,70,1752,1785,3537,8471
140,-40,-110,1751,1786,3537,8188
40,80,80,1759,1778,3537,7904
130,-80,-120,1789,1748,3537,8234
-30,70,140,1777,1760,3537,7922
180,20,-90,1796,1742,3538,8272
-160,50,-90,1766,1772,3538,8011
-180,20,-90,1796,1742,3538,8272
-160,60,-80,1791,1747,3538,8090
-170,-70,-70,1786,1752,3538,7983
0,10,-100,1750,1788,3538,8319
140,-80,-110,1777,1761,3538,8244
150,30,80,1793,1745,3538,8169
120,0,40,1786,1752,3538,8241
160,-60,-120,1761,1777,3538,8188
170,50,70,1813,1726,3539,8317
10,-60,140,1780,1759,3539,8110
-120,20,-40,1772,1767,3539,7962
150,-10,-80,1770,1769,3539,8221
-140,-10,-70,1787,1752,3539,8226
10,20,120,1766,1774,3540,7989
-50,60,-60,1769,1771,3540,8238
120,-60,-130,1780,1760,3540,7990
50,80,70,1774,1766,3540,7906
-90,30,-80,1775,1765,3540,8057
110,30,30,1752,1789,3541,8233
130,80,-10,1776,1766,3542,7991
-60,-20,90,1794,1748,3542,8249
20,-80,140,1777,1765,3542,8204
-150,40,-100,1780,1762,3542,8080
-50,40,-80,1739,1803,3542,8108
-160,80,-80,1798,1745,3543,7897
140,-50,-120,1762,1781,3543,8152
-60,70,160,1766,1777,3543,8288
-10,80,130,1773,1770,3543,7881
140,30,-40,1781,1762,3543,8217
-150,-70,-50,1818,1725,3543,8107
110,-20,-90,1766,1778,3544,8187
-120,30,-120,1768,1776,3544,8359
-140,20,20,1803,1741,3544,8239
-160,-50,-80,1801,1743,3544,8424
-110,-60,10,1774,1771,3545,7940
-170,80,-70,1804,1741,3545,7867
-30,-50,100,1787,1758,3545,8104
-140,0,-90,1791,1754,3545,8370
-40,10,100,1790,1755,3545,8117
-70,40,-70,1728,1817,3545,8265
0,80,120,1770,1776,3546,7858
-50,70,150,1755,1791,3546,8169
160,0,-70,1779,1767,3546,7895
-180,10,-100,1782,1764,3546,8261
-90,-80,30,1779,1767,3546,8218
180,10,-100,1782,1764,3546,8261
-90,-60,160,1773,1773,3546,8001
-20,30,110,1781,1766,3547,7930
50,20,-160,1773,1774,3547,8184
50,0,-170,1776,1771,3547,7989
-90,-30,140,1772,1775,3547,8297
-130,-20,30,1804,1743,3547,7938
-20,-20,100,1767,1781,3548,8232
-70,70,170,1770,1778,3548,8227
30,80,90,1758,1790,3548,7971
50,-20,-170,1777,1772,3549,7811
-70,60,170,1768,1781,3549,8229
-150,80,-90,1790,1759,3549,7937
0,-70,130,1769,1780,3549,8194
150,20,-60,1781,1769,3550,8028
170,80,-50,1775,1775,3550,7796
-80,-70,50,1790,1760,3550,7947
-80,50,-40,1771,1779,3550,8390
150,-20,-90,1755,1795,3550,8276
-100,-50,140,1795,1756,3551,8096
-160,-80,-50,1782,1769,3551,8257
-50,-60,-150,1756,1795,3551,8147
-180,0,-80,1786,1766,3552,8016
-160,-10,-110,1786,1766,3552,8517
-150,50,-100,1754,1798,3552,8149
180,0,-80,1786,1766,3552,8016
-120,20,-50,1782,1771,3553,7989
30,-60,160,1762,1791,3553,8282
170,0,-90,1761,1793,3554,8372
-100,30,-120,1772,1782,3554,8213
-160,-60,-70,1823,1731,3554,8099
50,20,160,1734,1820,3554,7626
-120,-60,-10,1793,1761,3554,8212
-150,-20,-100,1763,1792,3555,8443
110,40,20,1813,1743,3556,8138
-180,80,-60,1795,1761,3556,7833
180,80,-60,1795,1761,3556,7833
-70,20,-130,1760,1797,3557,7854
170,20,-80,1774,1783,3557,8127
-160,-60,90,1807,1750,3557,8107
-140,10,-80,1791,1766,3557,8230
-90,70,-160,1772,1786,3558,8221
-180,60,-60,1802,1756,3558,8088
-170,30,-80,1781,1777,3558,8166
140,-30,-100,1762,1796,3558,8123
180,60,-60,1802,1756,3558,8088
30,60,-140,1789,1769,3558,8350
-50,-30,90,1805,1754,3559,8158
40,70,80,1782,1777,3559,7859
170,0,-100,1782,1777,3559,8436
110,40,10,1785,1774,3559,8267
-140,50,-110,1775,1784,3559,8038
-130,40,-120,1796,1763,3559,8184
-10,-40,-110,1761,1798,3559,8180
-40,30,110,1811,1748,3559,8203
-40,40,120,1805,1755,3560,8128
-160,70,-80,1794,1766,3560,7893
80,-20,-120,1787,1774,3561,8211
-150,-80,-40,1768,1793,3561,8144
150,60,-40,1752,1809,3561,8195
-180,30,-90,1772,1789,3561,8185
180,30,-90,1772,1789,3561,8185
-140,30,-110,1812,1749,3561,8420
-140,10,-90,1789,1772,3561,8212
-40,-20,-130,1786,1775,3561,7922
-10,60,120,1793,1768,3561,7935
120,-10,30,1826,1735,3561,8352
-110,30,-30,1804,1758,3562,7901
-50,10,110,1820,1742,3562,8152
-140,70,-100,1787,1775,3562,7945
20,50,-120,1819,1743,3562,8370
10,80,110,1781,1781,3562,7865
-120,-30,0,1797,1766,3563,8244
10,10,-100,1746,1817,3563,8141
-50,0,-130,1774,1789,3563,8142
-60,70,-50,1778,1785,3563,8444
-100,-80,20,1781,1783,3564,8286
170,-30,-110,1794,1770,3564,8425
180,-50,-110,1799,1765,3564,8420
140,-30,-90,1761,1803,3564,8066
20,-60,150,1778,1786,3564,8144
-180,-50,-110,1799,1765,3564,8420
0,20,-100,1759,1805,3564,8283
130,-50,30,1799,1765,3564,7919
20,80,100,1771,1794,3565,8007
140,-10,60,1811,1754,3565,8183
-90,-50,50,1798,1767,3565,8112
40,-80,160,1781,1785,3566,8352
130,20,-40,1773,1793,3566,8339
-170,10,-100,1794,1772,3566,8423
-160,40,-90,1781,1785,3566,8187
-170,30,-100,1785,1782,3567,8423
-30,-40,100,1809,1758,3567,8394
40,30,-140,1799,1769,3568,8230
-120,-40,100,1802,1766,3568,8264
30,-80,150,1782,1787,3569,8311
-80,50,-170,1801,1770,3571,8198
120,50,-10,1792,1779,3571,8369
110,-10,-20,1784,1787,3571,8133
180,0,-90,1806,1766,3572,8475
-110,30,-90,1799,1773,3572,8350
-180,0,-90,1806,1766,3572,8475
10,60,110,1777,1795,3572,7869
-50,20,-100,1770,1803,3573,8200
160,-10,-90,1795,1778,3573,8257
-60,-10,110,1796,1778,3574,8397
100,-40,-10,1761,1813,3574,8370
150,-80,-100,1788,1786,3574,8304
140,-50,40,1808,1766,3574,8246
-70,0,140,1780,1794,3574,7957
160,-40,60,1804,1770,3574,8291
120,70,0,1788,1786,3574,8032
-170,-50,80,1823,1751,3574,8360
160,10,70,1790,1784,3574,8520
110,60,120,1785,1790,3575,8390
50,-80,170,1786,1789,3575,8422
-160,-70,-60,1822,1754,3576,8032
-30,60,130,1793,1783,3576,8138
180,-60,-90,1825,1752,3577,8278
-180,-60,-90,1825,1752,3577,8278
120,-70,-130,1796,1781,3577,8188
-120,-30,50,1783,1794,3577,8103
-180,-40,-110,1792,1786,3578,8409
180,-40,-110,1792,1786,3578,8409
170,60,70,1820,1758,3578,8127
-170,-60,-90,1793,1786,3579,8370
120,-40,-100,1781,1798,3579,7972
-160,10,-90,1795,1784,3579,8344
170,-50,-110,1781,1798,3579,8452
-40,-60,-140,1784,1795,3579,8059
160,-80,-90,1805,1775,3580,8325
-150,0,40,1802,1778,3580,7996
-30,20,100,1822,1759,3581,8455
-130,10,-50,1785,1796,3581,8239
-150,-30,-80,1822,1759,3581,8530
-150,-20,50,1825,1756,3581,7898
-140,0,-100,1806,1775,3581,8570
-120,30,-10,1822,1759,3581,8327
-160,20,-90,1785,1796,3581,8104
170,-10,-100,1802,1780,3582,8410
30,20,-110,1789,1793,3582,8306
-20,20,100,1785,1797,3582,8337
100,60,130,1799,1783,3582,8212
130,0,-60,1789,1794,3583,8409
80,40,120,1804,1780,3584,8244
-20,-60,-120,1807,1777,3584,8150
70,-10,-120,1776,1809,3585,8255
-80,30,-160,1780,1805,3585,8332
160,-10,-80,1811,1775,3586,8063
170,-60,-110,1795,1791,3586,8309
-90,60,-160,1813,1773,3586,8048
-140,40,-110,1821,1766,3587,8337
-160,-30,70,1830,1758,3588,8012
130,10,-50,1779,1809,3588,8248
-70,-20,100,1800,1788,3588,8257
-150,30,-100,1809,1780,3589,8355
110,50,10,1777,1812,3589,8358
-180,-30,70,1844,1746,3590,8292
180,-30,70,1844,1746,3590,8292
-100,40,-140,1803,1787,3590,8237
-170,70,-70,1805,1786,3591,7928
150,-60,-120,1791,1800,3591,8359
50,20,-170,1779,1812,3591,8008
-140,-30,60,1827,1764,3591,8011
0,50,-100,1797,1795,3592,8372
-170,-50,-90,1824,1769,3593,8387
-20,-40,110,1793,1800,3593,8237
-90,30,-130,1789,1804,3593,8306
30,0,-100,1807,1787,3594,8302
-90,50,-30,1802,1792,3594,8528
-80,20,-140,1807,1787,3594,8475
170,80,70,1840,1755,3595,8291
-10,-50,120,1792,1803,3595,8170
-170,0,-90,1828,1767,3595,8132
0,40,120,1786,1809,3595,8047
-30,30,110,1798,1798,3596,8304
80,40,100,1806,1790,3596,8049
-170,-80,-60,1789,1807,3596,8325
-40,70,150,1783,1813,3596,8158
-150,60,-90,1799,1797,3596,8045
-70,0,-170,1797,1800,3597,8208
-170,-40,-100,1807,1790,3597,8298
-160,-40,-80,1817,1780,3597,8493
180,-30,-110,1810,1788,3598,8324
-130,-40,90,1830,1768,3598,8204
70,40,110,1783,1815,3598,8140
-180,-30,-110,1810,1788,3598,8324
120,60,110,1804,1794,3598,8452
110,40,100,1806,1793,3599,8253
-50,50,140,1810,1789,3599,8043
160,-50,-110,1821,1778,3599,8311
-100,40,-30,1802,1797,3599,8383
40,30,120,1782,1818,3600,7978
-70,10,150,1815,1785,3600,8270
-80,40,-60,1765,1835,3600,8324
170,-20,-80,1802,1798,3600,7956
0,-20,-100,1784,1817,3601,8301
-180,40,-70,1796,1805,3601,7890
180,40,-70,1796,1805,3601,7890
170,30,-70,1806,1795,3601,8008
-90,30,-120,1812,1790,3602,8518
-130,70,-110,1805,1797,3602,8020
-130,-30,60,1837,1765,3602,8197
180,20,-80,1827,1775,3602,8213
-180,20,-80,1827,1775,3602,8213
-40,60,140,1805,1797,3602,8306
-110,50,-10,1845,1758,3603,8572
60,-80,-180,1799,1804,3603,8409
60,-80,180,1799,1804,3603,8409
-60,-40,80,1800,1804,3604,8391
150,-60,-110,1810,1794,3604,8482
-100,-60,30,1818,1786,3604,8173
110,-60,-130,1799,1806,3605,8380
-170,-60,-80,1842,1764,3606,8351
130,-70,-120,1791,1815,3606,8282
70,80,170,1834,1772,3606,8220
170,-10,-80,1817,1789,3606,8070
130,-50,-110,1810,1796,3606,8488
170,-40,-110,1812,1795,3607,8323
50,10,-170,1794,1814,3608,8202
-50,60,150,1820,1788,3608,8260
-110,30,-100,1802,1806,3608,8229
-170,0,-100,1836,1772,3608,8613
80,-30,-60,1786,1822,3608,8584
180,-50,-100,1832,1776,3608,8358
-180,-50,-100,1832,1776,3608,8358
50,10,-130,1814,1794,3608,8352
-50,70,160,1792,1817,3609,8218
90,40,110,1793,1816,3609,8394
-160,-10,50,1819,1791,3610,7980
-90,40,-150,1830,1780,3610,8335
140,60,-30,1786,1824,3610,8311
120,0,-50,1800,1810,3610,8312
-150,-50,-60,1838,1772,3610,8331
-80,-20,160,1801,1809,3610,8591
-120,20,-30,1818,1792,3610,7837
-160,-30,-100,1808,1802,3610,8560
-170,60,-70,1843,1768,3611,8209
-70,-60,70,1828,1783,3611,8327
-100,30,-110,1809,1802,3611,8414
50,-10,-100,1785,1826,3611,8202
60,-40,-60,1803,1809,3612,8470
160,-40,-110,1802,1810,3612,8400
0,70,-110,1839,1773,3612,8617
20,-30,-90,1773,1839,3612,8441
180,-60,-100,1798,1814,3612,8377
-180,-60,-100,1798,1814,3612,8377
0,30,-100,1816,1796,3612,8408
-50,-50,-150,1836,1777,3613,8396
-60,70,170,1796,1818,3614,8255
160,-20,-100,1808,1806,3614,8521
30,70,90,1803,1811,3614,8058
-110,-40,40,1835,1780,3615,8178
130,70,-10,1801,1814,3615,8156
70,-80,-170,1797,1818,3615,8485
-170,20,-80,1824,1791,3615,8315
-140,20,-90,1819,1796,3615,8496
170,-80,-80,1818,1797,3615,8401
-130,-70,-20,1804,1811,3615,8239
-180,70,-60,1823,1793,3616,8036
70,60,60,1826,1790,3616,8197
-20,40,120,1826,1790,3616,8458
0,50,120,1828,1788,3616,8259
180,-10,-90,1829,1787,3616,8468
-180,-10,-90,1829,1787,3616,8468
180,70,-60,1823,1793,3616,8036
-60,-50,80,1817,1799,3616,8124
-80,70,-170,1804,1813,3617,8223
60,-30,-70,1778,1839,3617,8507
60,60,70,1817,1800,3617,8057
-60,50,150,1818,1799,3617,8194
-30,-60,-130,1804,1813,3617,8037
70,-60,-160,1794,1823,3617,8403
-10,30,120,1815,1802,3617,8280
-150,20,-90,1831,1786,3617,8442
-180,-80,-70,1819,1799,3618,8404
180,-80,-70,1819,1799,3618,8404
60,-60,-170,1786,1832,3618,8602
100,-70,-140,1787,1831,3618,8065
-70,-50,70,1822,1797,3619,8353
-80,-60,170,1810,1810,3620,8095
-60,-30,80,1821,1800,3621,8337
-30,40,120,1825,1796,3621,8487
-10,10,-100,1786,1835,3621,8290
-120,-50,-10,1817,1804,3621,8397
180,0,-100,1846,1775,3621,8528
-180,0,-100,1846,1775,3621,8528
130,-20,-80,1803,1818,3621,8179
70,40,140,1810,1811,3621,8259
-90,30,-150,1815,1808,3623,8451
-80,20,-150,1843,1780,3623,8659
-10,-10,110,1799,1824,3623,8308
-120,20,-20,1838,1785,3623,8097
140,-20,-80,1806,1818,3624,8197
-70,70,180,1802,1822,3624,8267
-70,70,-180,1802,1822,3624,8267
-130,40,10,1823,1801,3624,8295
170,-60,-100,1834,1791,3625,8439
-70,50,-50,1830,1796,3626,8523
90,40,70,1828,1798,3626,8285
20,-10,140,1813,1813,3626,8317
160,30,-60,1813,1814,3627,8171
20,-40,150,1828,1799,3627,8266
150,50,-40,1823,1806,3629,8360
90,-50,-20,1820,1809,3629,8321
-70,-40,70,1818,1812,3630,8637
140,-60,-120,1810,1821,3631,8320
110,60,10,1803,1828,3631,8372
-10,-40,120,1817,1814,3631,8365
170,-10,-90,1808,1823,3631,8395
130,-60,-120,1814,1818,3632,8338
-60,60,160,1813,1819,3632,8381
10,0,130,1810,1823,3633,8157
70,-40,-50,1823,1811,3634,8491
140,-40,-100,1793,1841,3634,8502
150,-40,-110,1782,1852,3634,8332
150,30,-50,1818,1817,3635,8150
40,-50,-70,1786,1849,3635,8377
-10,20,110,1797,1839,3636,8341
-80,-50,60,1836,1800,3636,8360
-120,-40,-10,1791,1846,3637,8590
-90,-30,90,1812,1825,3637,8384
170,20,-70,1847,1790,3637,8038
0,-50,130,1825,1812,3637,8374
180,70,60,1850,1787,3637,8402
-180,70,60,1850,1787,3637,8402
-110,-80,10,1821,1817,3638,8382
-110,40,-130,1833,1805,3638,8479
-70,30,160,1807,1831,3638,8389
90,60,40,1826,1812,3638,8072
20,70,100,1794,1845,3639,8210
-70,10,-150,1846,1793,3639,8667
-50,-40,90,1854,1785,3639,8403
50,-60,-180,1799,1840,3639,8557
50,-60,180,1799,1840,3639,8557
100,-20,-60,1791,1849,3640,8153
-80,-60,60,1859,1781,3640,8278
80,60,50,1833,1808,3641,8221
0,30,120,1809,1832,3641,8312
-100,-50,40,1853,1788,3641,8205
160,-60,-110,1831,1810,3641,8464
-130,-40,-30,1852,1789,3641,8373
-180,80,60,1867,1775,3642,8465
180,80,60,1867,1775,3642,8465
20,-70,150,1810,1832,3642,8634
-50,40,130,1835,1808,3643,8502
160,-20,-90,1801,1843,3644,8372
10,-70,140,1814,1830,3644,8451
180,-50,-90,1858,1786,3644,8401
-90,-30,100,1814,1830,3644,8363
-100,-40,130,1809,1835,3644,8544
-180,-50,-90,1858,1786,3644,8401
-160,30,-90,1826,1819,3645,8394
-90,-70,40,1826,1819,3645,8090
40,-30,-80,1786,1859,3645,8550
-110,30,-110,1805,1841,3646,8493
20,10,130,1799,1847,3646,8072
-150,10,-90,1830,1817,3647,8577
-130,-70,120,1833,1814,3647,8298
-70,10,160,1850,1797,3647,8392
10,-50,140,1832,1816,3648,8365
-150,-10,-100,1818,1830,3648,8578
80,-80,-160,1797,1851,3648,8483
-140,-60,-40,1848,1800,3648,8351
-150,-20,-90,1819,1830,3649,8639
150,-30,-90,1802,1847,3649,8190
150,-40,-100,1818,1831,3649,8504
50,30,-180,1823,1827,3650,8006
50,30,180,1823,1827,3650,8006
-140,60,-100,1821,1829,3650,8268
170,70,-50,1854,1797,3651,8090
-160,0,-100,1843,1808,3651,8666
-90,30,-140,1837,1814,3651,8578
-70,20,160,1836,1815,3651,8510
170,0,-70,1840,1812,3652,8240
0,10,120,1802,1851,3653,8383
-20,-50,-120,1817,1836,3653,8190
-30,-30,100,1844,1809,3653,8488
40,-60,170,1788,1865,3653,8519
80,-40,-40,1849,1805,3654,8642
-80,30,-110,1869,1786,3655,8304
-150,0,-100,1833,1822,3655,8652
-50,70,-60,1812,1843,3655,8652
-180,-10,-100,1836,1820,3656,8505
-170,-40,-90,1826,1830,3656,8476
170,-50,-100,1828,1828,3656,8436
-120,70,-120,1831,1825,3656,8025
120,20,-10,1839,1817,3656,8516
180,-10,-100,1836,1820,3656,8505
170,60,-50,1845,1812,3657,8349
50,70,-170,1824,1833,3657,8455
180,10,-70,1850,1808,3658,8191
-180,10,-70,1850,1808,3658,8191
140,-70,-110,1817,1841,3658,8333
-70,50,170,1834,1824,3658,8392
170,-20,-100,1840,1819,3659,8690
-180,-40,-100,1848,1811,3659,8558
180,-40,-100,1848,1811,3659,8558
-60,40,140,1843,1816,3659,8340
-70,-20,-180,1846,1814,3660,8311
90,50,130,1835,1825,3660,8501
-80,30,-90,1840,1820,3660,8457
-70,-20,180,1846,1814,3660,8311
-60,50,-60,1847,1816,3663,8677
150,-30,-100,1814,1849,3663,8808
-20,60,130,1828,1835,3663,8415
-60,0,130,1846,1817,3663,8251
-70,30,-90,1837,1828,3665,8451
150,-20,60,1856,1810,3666,8522
-160,-40,80,1853,1813,3666,8699
150,40,-40,1831,1835,3666,8362
120,-30,-90,1819,1847,3666,8305
-40,20,-100,1830,1836,3666,8528
60,40,160,1864,1802,3666,8364
-10,0,110,1820,1846,3666,8469
-80,60,-170,1844,1823,3667,8311
-140,-70,-30,1831,1836,3667,8409
50,40,180,1820,1847,3667,8320
-70,40,170,1869,1798,3667,8428
-50,-10,100,1868,1799,3667,8447
-70,10,-170,1844,1823,3667,8543
-160,-30,-90,1847,1820,3667,8645
50,40,-180,1820,1847,3667,8320
-30,10,100,1844,1824,3668,8651
-40,30,120,1827,1842,3669,8633
140,-50,-110,1850,1819,3669,8562
-140,10,20,1877,1792,3669,8534
120,-20,20,1857,1812,3669,8493
140,70,-20,1843,1826,3669,8286
140,50,90,1834,1836,3670,8564
-140,0,-60,1843,1827,3670,8463
-50,-50,90,1872,1798,3670,8340
-170,0,-80,1856,1814,3670,8514
-60,-20,100,1851,1819,3670,8540
20,-40,-90,1803,1868,3671,8403
-20,20,110,1839,1832,3671,8369
70,50,80,1860,1811,3671,8297
90,-30,-40,1818,1853,3671,8456
-110,40,-20,1848,1823,3671,8485
-140,-20,-60,1840,1831,3671,8419
-170,-30,-90,1878,1794,3672,8601
100,50,40,1822,1850,3672,8238
-30,50,130,1842,1831,3673,8494
-50,20,120,1858,1815,3673,8449
-20,-10,-110,1855,1818,3673,8569
-140,30,20,1869,1805,3674,8409
-90,-40,60,1819,1855,3674,8505
-130,0,-30,1831,1843,3674,8134
-40,0,100,1864,1811,3675,8486
140,-60,-110,1838,1837,3675,8467
80,40,110,1816,1859,3675,8631
120,20,70,1835,1840,3675,8688
0,-40,130,1858,1817,3675,8385
-20,40,-90,1832,1844,3676,8482
-120,-70,0,1851,1826,3677,8279
-140,-40,-50,1847,1830,3677,8537
-130,-20,-30,1849,1829,3678,8522
110,-70,-130,1807,1871,3678,8269
50,-40,-170,1837,1842,3679,8326
50,60,80,1825,1854,3679,8063
-130,60,-110,1833,1846,3679,8236
160,-20,-80,1849,1830,3679,8364
-80,30,-100,1868,1812,3680,8473
150,-20,-80,1828,1852,3680,8398
-10,70,-100,1873,1807,3680,8671
90,-80,-150,1808,1872,3680,8520
-110,70,-130,1848,1833,3681,8062
-40,20,110,1863,1818,3681,8664
-100,50,-20,1869,1812,3681,8845
-110,30,-40,1852,1829,3681,8189
-180,0,-70,1862,1819,3681,8333
180,0,-70,1862,1819,3681,8333
70,40,130,1844,1838,3682,8403
-150,-70,-40,1832,1850,3682,8499
-130,10,-40,1844,1838,3682,8426
180,-10,-80,1851,1833,3684,8307
-180,-10,-80,1851,1833,3684,8307
-50,0,110,1852,1832,3684,8597
-180,-20,-100,1874,1810,3684,8699
180,-20,-100,1874,1810,3684,8699
-70,-20,110,1841,1844,3685,8498
-20,-10,100,1843,1842,3685,8551
-120,-70,130,1846,1839,3685,8319
100,40,50,1846,1840,3686,8406
-20,-80,110,1836,1850,3686,8304
180,-30,-100,1877,1809,3686,8672
-80,30,-120,1844,1842,3686,8589
-180,-30,-100,1877,1809,3686,8672
-150,-30,-70,1868,1819,3687,8714
-80,-30,160,1878,1810,3688,8616
-160,10,-80,1849,1839,3688,8666
-140,-10,-60,1852,1836,3688,8590
-150,-90,-30,1840,1849,3689,8623
30,-90,150,1840,1849,3689,8623
20,-90,140,1840,1849,3689,8623
0,-90,120,1840,1849,3689,8623
-140,-90,-20,1840,1849,3689,8623
120,-90,-120,1840,1849,3689,8623
-90,-90,30,1840,1849,3689,8623
-180,-90,-60,1840,1849,3689,8623
-80,-90,40,1840,1849,3689,8623
160,-90,-80,1840,1849,3689,8623
80,-90,-160,1840,1849,3689,8623
-160,-90,-40,1840,1849,3689,8623
140,-90,-100,1840,1849,3689,8623
-30,-90,90,1840,1849,3689,8623
40,-90,160,1840,1849,3689,8623
-110,-90,10,1840,1849,3689,8623
-60,-90,60,1840,1849,3689,8623
90,-90,-150,1840,1849,3689,8623
-10,-90,110,1840,1849,3689,8623
-40,-90,80,1840,1849,3689,8623
10,-90,130,1840,1849,3689,8623
150,-90,-90,1840,1849,3689,8623
-20,-90,100,1840,1849,3689,8623
-120,-90,0,1840,1849,3689,8623
-130,-90,-10,1840,1849,3689,8623
60,-90,180,1840,1849,3689,8623
170,-60,-90,1853,1836,3689,8419
100,-90,-140,1840,1849,3689,8623
-50,-90,70,1840,1849,3689,8623
70,-90,-170,1840,1849,3689,8623
130,-90,-110,1840,1849,3689,8623
-170,-90,-50,1840,1849,3689,8623
60,-90,-180,1840,1849,3689,8623
-70,-90,50,1840,1849,3689,8623
-100,-90,20,1840,1849,3689,8623
170,-90,-70,1840,1849,3689,8623
50,-90,170,1840,1849,3689,8623
110,-90,-130,1840,1849,3689,8623
180,-90,-60,1840,1849,3689,8623
50,30,130,1815,1875,3690,8599
170,10,-70,1871,1819,3690,8234
-130,30,-110,1847,1843,3690,8675
140,10,70,1837,1853,3690,8666
-10,10,110,1842,1849,3691,8366
90,-50,-130,1838,1853,3691,8256
-180,-60,-80,1862,1829,3691,8384
150,-40,-90,1846,1845,3691,8391
10,70,110,1843,1848,3691,8179
180,-60,-80,1862,1829,3691,8384
80,-50,-140,1843,1848,3691,8295
-50,-80,80,1837,1855,3692,8315
-110,30,-70,1854,1838,3692,8451
-110,-50,20,1850,1842,3692,8527
-90,50,-150,1847,1845,3692,8540
-50,30,130,1865,1828,3693,8610
60,80,180,1866,1827,3693,8476
60,80,-180,1866,1827,3693,8476
80,-60,-30,1875,1818,3693,8666
-170,-50,-80,1896,1797,3693,8653
-80,-20,120,1844,1849,3693,8671
10,-40,140,1851,1843,3694,8297
160,-30,-80,1852,1842,3694,8455
-60,-80,70,1853,1841,3694,8344
-170,-60,80,1865,1830,3695,8339
120,30,-10,1855,1840,3695,8365
-100,70,-140,1865,1830,3695,8165
-130,-30,50,1851,1844,3695,8317
0,20,120,1821,1875,3696,8272
160,-60,-100,1855,1841,3696,8499
-40,60,-70,1849,1847,3696,8616
-10,70,130,1857,1839,3696,8162
130,20,-30,1832,1865,3697,8518
160,-30,-100,1836,1861,3697,8678
-70,-30,-180,1878,1819,3697,8594
-180,-20,-80,1849,1848,3697,8496
180,-20,-80,1849,1848,3697,8496
30,30,-120,1859,1838,3697,8631
150,-10,-70,1852,1845,3697,8323
-150,-50,90,1882,1815,3697,8564
-70,-30,180,1878,1819,3697,8594
170,-30,-80,1834,1864,3698,8316
-40,-80,90,1850,1848,3698,8317
-170,80,50,1893,1805,3698,8586
150,70,-30,1841,1857,3698,8439
-130,-30,-30,1844,1855,3699,8728
80,50,70,1891,1808,3699,8376
-130,-20,20,1844,1855,3699,8285
10,50,-110,1874,1825,3699,8586
-30,50,-80,1858,1841,3699,8876
-80,-20,150,1842,1858,3700,8583
-110,50,-130,1847,1853,3700,8293
0,70,120,1855,1845,3700,8219
20,60,-130,1874,1826,3700,8774
-120,50,0,1885,1815,3700,8536
60,-20,-90,1855,1846,3701,8481
-120,60,-120,1829,1873,3702,8102
-60,30,-90,1858,1844,3702,8656
-80,-30,80,1839,1863,3702,8663
30,40,-130,1882,1821,3703,8751
30,40,110,1850,1853,3703,8406
-180,40,60,1873,1830,3703,8508
180,40,60,1873,1830,3703,8508
70,-20,-90,1849,1854,3703,8595
50,10,-140,1866,1838,3704,8376
150,10,70,1858,1847,3705,8668
120,-50,-110,1887,1818,3705,8313
-20,0,100,1869,1836,3705,8579
-80,70,-160,1852,1853,3705,8156
100,-80,-140,1829,1877,3706,8620
-60,-60,80,1886,1820,3706,8426
150,10,-60,1868,1839,3707,8290
-60,10,-140,1862,1845,3707,8398
-180,20,-70,1871,1837,3708,8284
170,40,-60,1847,1861,3708,8452
170,-30,-100,1863,1845,3708,8671
180,20,-70,1871,1837,3708,8284
30,-70,160,1848,1861,3709,8758
-70,40,160,1842,1867,3709,8574
-30,-80,100,1856,1853,3709,8296
-150,-30,60,1884,1826,3710,8289
-70,70,-170,1846,1864,3710,8129
110,30,40,1850,1861,3711,8559
-70,60,-180,1861,1850,3711,8514
150,-50,-110,1830,1881,3711,8495
120,-60,-120,1852,1859,3711,8682
-70,60,180,1861,1850,3711,8514
-140,-70,110,1867,1844,3711,8482
150,-70,-100,1840,1871,3711,8557
-50,10,-120,1851,1861,3712,8364
0,-10,-100,1836,1876,3712,8734
-180,-40,-90,1878,1835,3713,8499
-150,-40,80,1896,1817,3713,8474
-160,0,-90,1867,1846,3713,8756
180,-40,-90,1878,1835,3713,8499
-60,30,140,1865,1848,3713,8528
130,50,-20,1840,1874,3714,8767
110,-30,0,1820,1894,3714,8696
-170,-10,-80,1880,1834,3714,8647
130,60,100,1870,1844,3714,8690
160,40,-50,1871,1843,3714,8528
130,-20,40,1862,1852,3714,8721
20,-30,150,1855,1859,3714,8250
70,-50,-150,1855,1859,3714,8533
-40,0,-120,1834,1880,3714,8538
40,40,110,1850,1864,3714,8438
180,-30,-90,1875,1840,3715,8557
-120,-80,0,1856,1859,3715,8465
-180,-30,-90,1875,1840,3715,8557
-120,30,-110,1857,1858,3715,8843
-100,50,-140,1843,1873,3716,8452
160,70,-40,1879,1837,3716,8183
-50,30,-90,1855,1861,3716,8788
140,30,80,1858,1858,3716,8702
-20,10,100,1860,1856,3716,8736
-170,-30,-100,1866,1851,3717,8758
-170,-20,-100,1878,1839,3717,8792
140,-40,-90,1839,1878,3717,8269
-160,-50,-70,1875,1842,3717,8544
-10,-30,-110,1817,1900,3717,8409
-110,-70,140,1855,1863,3718,8473
80,-60,-150,1856,1862,3718,8484
130,-10,-70,1886,1832,3718,8615
10,30,120,1849,1870,3719,8554
0,-80,130,1867,1852,3719,8472
60,40,110,1861,1858,3719,8472
100,40,100,1843,1876,3719,8664
110,-40,0,1845,1875,3720,8662
-20,70,-90,1881,1839,3720,8794
120,60,0,1878,1842,3720,8498
-80,40,-160,1866,1855,3721,8502
-70,-80,60,1864,1857,3721,8407
-10,-80,120,1849,1872,3721,8359
-90,-60,50,1870,1852,3722,8366
70,-10,-110,1876,1846,3722,8672
-160,-70,-50,1863,1859,3722,8435
50,-60,-60,1836,1886,3722,8779
70,-30,-70,1852,1870,3722,8727
120,0,-30,1857,1868,3725,8575
170,-40,-100,1861,1864,3725,8635
-150,-60,-50,1887,1839,3726,8639
-140,-40,80,1894,1832,3726,8370
170,-20,-90,1854,1872,3726,8513
150,-40,50,1889,1838,3727,8568
-170,-40,-80,1897,1830,3727,8763
-180,-20,-90,1877,1850,3727,8731
180,-20,-90,1877,1850,3727,8731
-160,80,40,1914,1813,3727,8713
-90,40,-50,1854,1874,3728,8685
-150,0,-90,1855,1873,3728,8642
-130,-10,10,1859,1869,3728,8695
160,-40,-100,1867,1861,3728,8672
60,-60,-50,1868,1860,3728,8734
-170,-30,70,1894,1835,3729,8588
-120,30,-80,1892,1837,3729,8675
-150,-10,-90,1877,1852,3729,8710
-180,30,-70,1891,1838,3729,8247
-150,30,-90,1868,1861,3729,8722
180,30,-70,1891,1838,3729,8247
140,0,-60,1886,1844,3730,8502
-50,10,120,1887,1843,3730,8510
120,40,-10,1848,1883,3731,8520
90,40,100,1826,1905,3731,8577
100,70,130,1879,1853,3732,8525
160,-30,-90,1892,1840,3732,8594
50,20,150,1844,1888,3732,8362
-160,20,-80,1867,1865,3732,8671
-70,20,170,1897,1835,3732,8569
-150,-40,-60,1878,1854,3732,8674
-10,20,-100,1837,1897,3734,8572
-150,-20,-80,1876,1858,3734,8768
-40,40,130,1881,1854,3735,8564
-140,-20,40,1873,1862,3735,8478
-120,30,-70,1900,1835,3735,8385
160,-40,-90,1876,1859,3735,8687
-140,40,20,1893,1843,3736,8586
-20,-30,110,1874,1862,3736,8721
-70,-10,180,1915,1821,3736,8614
-70,-10,-180,1915,1821,3736,8614
180,-50,70,1914,1823,3737,8679
70,40,120,1864,1873,3737,8583
70,-60,-40,1886,1851,3737,8514
-180,-50,70,1914,1823,3737,8679
100,50,120,1883,1854,3737,8768
160,-50,-100,1895,1843,3738,8816
-170,70,50,1924,1814,3738,8691
170,-40,-90,1878,1860,3738,8530
-90,70,-150,1875,1863,3738,8231
60,-50,-160,1861,1877,3738,8559
100,-50,-10,1860,1879,3739,8851
-170,-10,-90,1868,1871,3739,8807
-130,20,-60,1870,1870,3740,8634
20,30,-110,1868,1873,3741,8500
-160,-30,-80,1909,1832,3741,8937
130,-40,30,1882,1859,3741,8735
-160,0,-80,1890,1851,3741,8776
120,-70,-120,1828,1914,3742,8466
-70,10,-180,1894,1848,3742,8752
-30,20,110,1848,1894,3742,8638
-70,10,180,1894,1848,3742,8752
110,30,80,1847,1896,3743,8581
-130,10,0,1906,1837,3743,8670
-160,-10,-80,1874,1870,3744,8913
-60,20,140,1869,1875,3744,8661
-40,70,-70,1876,1868,3744,8911
-70,10,-160,1895,1849,3744,8654
160,-10,-70,1876,1869,3745,8390
170,-50,-90,1891,1854,3745,8856
-60,-30,90,1894,1851,3745,8628
-60,-20,-160,1884,1862,3746,8602
100,-30,-20,1878,1868,3746,8803
-60,70,-180,1896,1851,3747,8327
-160,70,40,1900,1847,3747,8881
-60,70,180,1896,1851,3747,8327
-50,-20,100,1890,1858,3748,8591
-70,20,-170,1886,1863,3749,8655
-170,-20,-90,1900,1849,3749,8761
-120,30,-90,1894,1855,3749,8788
180,60,60,1897,1853,3750,8755
-180,60,60,1897,1853,3750,8755
-110,60,-130,1870,1881,3751,8328
-160,-20,-100,1884,1868,3752,8890
-170,-10,-100,1901,1851,3752,8729
-70,10,170,1895,1857,3752,8608
-140,20,-80,1887,1866,3753,8783
120,0,-40,1864,1889,3753,8535
160,-70,-90,1844,1909,3753,8611
-100,-70,150,1887,1866,3753,8541
-80,40,-70,1877,1877,3754,8634
40,60,90,1862,1893,3755,8476
-20,30,120,1887,1869,3756,8809
-170,-70,-60,1880,1877,3757,8497
40,50,-160,1907,1850,3757,8802
140,-10,-70,1892,1865,3757,8657
-150,-10,40,1923,1834,3757,8570
-140,10,-60,1884,1874,3758,8514
-70,-40,-180,1902,1856,3758,8720
-60,20,-120,1911,1847,3758,8831
-70,-40,180,1902,1856,3758,8720
-60,40,150,1909,1849,3758,8634
-30,30,120,1883,1875,3758,8673
-70,-50,180,1908,1851,3759,8546
110,70,120,1885,1874,3759,8617
-130,-40,80,1911,1848,3759,8338
10,0,-100,1877,1882,3759,8737
-70,-50,-180,1908,1851,3759,8546
140,50,-30,1868,1891,3759,8637
140,-50,-100,1894,1865,3759,8603
150,40,80,1892,1867,3759,8695
-150,10,-70,1853,1907,3760,8858
80,50,140,1899,1861,3760,8631
-100,-70,30,1880,1880,3760,8372
90,40,80,1881,1879,3760,8615
-130,20,-10,1915,1845,3760,8773
-50,-40,-150,1885,1876,3761,8734
40,-70,170,1874,1887,3761,8886
0,40,-100,1872,1889,3761,8918
-120,30,-100,1888,1874,3762,8660
30,-20,160,1871,1892,3763,8274
110,-80,-130,1866,1897,3763,8701
60,60,170,1906,1857,3763,8494
-30,70,-80,1896,1867,3763,8895
-20,20,-100,1841,1922,3763,8650
0,-30,130,1907,1856,3763,8685
-40,-50,-140,1869,1894,3763,8451
30,-20,-90,1845,1919,3764,8851
-160,-40,-70,1898,1866,3764,8757
30,50,-140,1888,1876,3764,8936
120,10,50,1870,1894,3764,8774
-150,0,-70,1885,1880,3765,8625
-150,10,-80,1903,1862,3765,8779
0,60,120,1886,1880,3766,8372
-150,-70,100,1899,1867,3766,8652
-170,-60,-70,1903,1863,3766,8526
-20,-40,-120,1890,1876,3766,8470
170,-70,-80,1874,1892,3766,8678
150,-50,-100,1912,1854,3766,8776
10,-80,140,1869,1897,3766,8761
-70,-10,130,1859,1908,3767,8888
-80,-80,50,1881,1886,3767,8546
-150,-10,-80,1893,1874,3767,8937
30,-40,170,1890,1878,3768,8335
-120,40,-10,1914,1854,3768,9004
90,-60,-140,1879,1889,3768,8770
-150,-10,-70,1873,1895,3768,8750
130,40,90,1896,1873,3769,8798
-90,-30,130,1846,1923,3769,8915
110,-50,0,1891,1878,3769,8741
180,-70,-70,1881,1888,3769,8670
90,70,140,1910,1859,3769,8611
-180,-70,-70,1881,1888,3769,8670
-90,-70,160,1881,1889,3770,8533
140,-30,-80,1874,1896,3770,8312
100,60,30,1872,1898,3770,8483
90,-60,-20,1899,1871,3770,8788
50,80,-170,1901,1869,3770,8710
-100,60,-140,1910,1861,3771,8505
-60,10,140,1879,1892,3771,8774
180,-50,-80,1897,1875,3772,8632
170,-30,-90,1908,1864,3772,8655
140,20,-40,1890,1882,3772,8595
-180,-50,-80,1897,1875,3772,8632
-120,-50,110,1925,1848,3773,8719
-160,-20,-90,1921,1852,3773,8738
-120,30,-20,1912,1861,3773,8491
70,-30,-140,1905,1868,3773,8621
-30,20,-100,1873,1900,3773,8711
-110,30,-60,1887,1886,3773,8719
-70,0,180,1923,1851,3774,8769
-50,-10,-140,1924,1850,3774,8529
-70,0,-180,1923,1851,3774,8769
-60,20,-110,1931,1843,3774,8776
-30,70,150,1903,1871,3774,8431
-150,80,30,1927,1847,3774,8844
120,-50,10,1880,1895,3775,8684
0,-20,130,1875,1900,3775,8644
-70,40,-180,1881,1895,3776,8502
90,-30,-50,1879,1897,3776,8696
110,-20,-10,1878,1898,3776,8688
-70,40,180,1881,1895,3776,8502
0,0,-100,1852,1925,3777,8695
-110,-40,110,1893,1884,3777,8877
50,-40,-70,1865,1913,3778,8823
-140,-10,-50,1900,1878,3778,8683
110,40,30,1893,1885,3778,8754
-20,70,140,1889,1890,3779,8307
-70,20,180,1914,1865,3779,8658
-70,20,-180,1914,1865,3779,8658
-120,-60,120,1909,1870,3779,8285
-70,30,-170,1902,1878,3780,8629
-40,-10,100,1923,1858,3781,8806
100,-60,-10,1889,1892,3781,8966
110,50,20,1907,1875,3782,8575
20,30,120,1887,1895,3782,8577
100,-40,-110,1900,1882,3782,8296
-180,-30,-80,1903,1879,3782,8854
30,-50,-80,1853,1929,3782,8700
180,-30,-80,1903,1879,3782,8854
-160,30,-80,1874,1909,3783,8628
-160,-20,-80,1882,1902,3784,8876
150,-60,-100,1908,1876,3784,8887
-140,30,-100,1905,1880,3785,8841
-30,0,100,1927,1858,3785,8995
-180,30,60,1911,1875,3786,8692
180,30,60,1911,1875,3786,8692
-70,30,170,1896,1891,3787,8643
-80,-40,160,1876,1911,3787,8689
20,0,-100,1873,1914,3787,8632
40,-60,-70,1886,1901,3787,8946
30,20,130,1836,1952,3788,8291
-80,-30,90,1860,1928,3788,8680
130,60,-10,1909,1879,3788,8650
-160,50,-80,1911,1877,3788,8543
120,-80,-120,1879,1910,3789,8748
-90,40,-60,1884,1905,3789,8988
-70,50,-180,1891,1899,3790,8656
-40,10,-110,1916,1874,3790,9067
-70,50,180,1891,1899,3790,8656
20,50,110,1865,1926,3791,8621
-40,50,140,1901,1890,3791,8807
-120,40,-120,1915,1876,3791,8834
-70,0,170,1912,1879,3791,8915
-10,-30,120,1891,1901,3792,8920
120,70,110,1921,1871,3792,8692
120,-10,-60,1903,1891,3794,8629
-20,50,130,1891,1903,3794,8559
-170,-50,-70,1902,1892,3794,8745
-130,30,-100,1890,1904,3794,8968
-110,30,-50,1891,1904,3795,8798
-70,0,150,1891,1904,3795,8906
-150,20,-80,1913,1882,3795,8857
-50,-60,90,1916,1879,3795,8457
-150,70,30,1946,1849,3795,8930
60,50,90,1900,1895,3795,8430
-40,-50,100,1897,1899,3796,8643
140,10,-50,1908,1889,3797,8652
-180,50,60,1936,1861,3797,8694
30,10,140,1877,1920,3797,8324
180,50,60,1936,1861,3797,8694
-70,-60,-180,1893,1905,3798,8397
-70,-60,180,1893,1905,3798,8397
-120,50,-120,1914,1885,3799,8527
50,30,170,1913,1886,3799,8331
-140,-10,30,1903,1896,3799,8713
-160,-60,-60,1935,1864,3799,8541
90,-70,-20,1910,1892,3802,8727
-100,60,-20,1905,1897,3802,8949
-180,-40,-80,1939,1864,3803,8809
180,50,-60,1911,1892,3803,8510
-180,50,-60,1911,1892,3803,8510
180,-40,-80,1939,1864,3803,8809
-170,0,-70,1929,1874,3803,8779
150,-30,-80,1888,1916,3804,8446
20,0,140,1902,1902,3804,8356
150,20,-50,1905,1900,3805,8592
130,-70,-110,1876,1929,3805,8703
-130,-80,-10,1904,1901,3805,8599
120,0,30,1922,1883,3805,9046
-30,60,140,1905,1900,3805,8794
-170,10,-70,1917,1888,3805,8725
-130,-60,-20,1922,1883,3805,8655
-170,-20,-80,1911,1894,3805,8806
-180,-10,-70,1929,1876,3805,8669
-170,-30,-80,1937,1868,3805,8718
180,-10,-70,1929,1876,3805,8669
-140,-20,-50,1932,1874,3806,8743
-30,-50,-130,1912,1894,3806,8555
-140,-50,-40,1936,1870,3806,8774
-50,50,-70,1900,1906,3806,8759
-150,50,-90,1903,1903,3806,8759
-130,0,0,1922,1885,3807,8840
-130,10,-10,1925,1882,3807,8705
-40,-30,100,1917,1890,3807,8759
-130,20,0,1933,1875,3808,9024
40,20,-130,1948,1861,3809,8618
-40,-40,100,1922,1887,3809,8932
-160,-10,-100,1928,1882,3810,9216
160,60,-40,1913,1897,3810,8592
130,30,80,1921,1889,3810,8991
170,-40,-80,1935,1875,3810,8733
130,10,-40,1891,1919,3810,8698
-70,0,160,1921,1890,3811,8961
120,-20,-80,1907,1904,3811,8861
-110,-60,20,1901,1910,3811,8620
90,-80,-20,1910,1902,3812,8535
110,-60,0,1912,1900,3812,8901
-60,40,-80,1893,1920,3813,8689
50,-50,-170,1900,1913,3813,8739
-140,0,-50,1920,1894,3814,8742
-50,40,140,1926,1888,3814,8833
-170,30,50,1933,1881,3814,8648
-70,-30,80,1859,1955,3814,8914
-30,-20,100,1916,1898,3814,8990
-60,50,160,1909,1907,3816,8724
-80,50,-160,1923,1893,3816,8532
90,-20,-80,1891,1925,3816,8754
-80,-20,130,1893,1924,3817,8751
10,-30,140,1918,1899,3817,8695
-130,-60,110,1935,1882,3817,8473
170,-70,60,1928,1889,3817,8565
60,40,120,1909,1909,3818,8838
160,20,-60,1949,1869,3818,8606
40,30,-150,1928,1890,3818,8725
20,-50,160,1921,1898,3819,8534
10,90,-130,1944,1875,3819,8981
90,90,150,1944,1875,3819,8981
140,90,100,1944,1875,3819,8981
-20,90,-100,1944,1875,3819,8981
20,90,-140,1944,1875,3819,8981
-120,-60,0,1917,1902,3819,8730
-150,90,30,1944,1875,3819,8981
-110,90,-10,1944,1875,3819,8981
40,90,-160,1944,1875,3819,8981
-160,90,40,1944,1875,3819,8981
70,90,170,1944,1875,3819,8981
150,90,90,1944,1875,3819,8981
-90,90,-30,1944,1875,3819,8981
60,90,-180,1944,1875,3819,8981
-180,90,60,1944,1875,3819,8981
120,90,120,1944,1875,3819,8981
130,-70,20,1916,1903,3819,8664
-130,90,10,1944,1875,3819,8981
-60,90,-60,1944,1875,3819,8981
50,90,-170,1944,1875,3819,8981
0,90,-120,1944,1875,3819,8981
-80,90,-40,1944,1875,3819,8981
60,90,180,1944,1875,3819,8981
-100,90,-20,1944,1875,3819,8981
110,90,130,1944,1875,3819,8981
-40,90,-80,1944,1875,3819,8981
-10,90,-110,1944,1875,3819,8981
160,90,80,1944,1875,3819,8981
170,90,70,1944,1875,3819,8981
100,90,140,1944,1875,3819,8981
130,90,110,1944,1875,3819,8981
-170,90,50,1944,1875,3819,8981
80,90,160,1944,1875,3819,8981
-50,90,-70,1944,1875,3819,8981
180,90,60,1944,1875,3819,8981
-70,90,-50,1944,1875,3819,8981
-30,90,-90,1944,1875,3819,8981
30,90,-150,1944,1875,3819,8981
-140,90,20,1944,1875,3819,8981
-120,90,0,1944,1875,3819,8981
-60,30,150,1908,1912,3820,8580
-150,40,-90,1909,1911,3820,8755
-150,0,-80,1936,1884,3820,8792
-90,60,-150,1939,1881,3820,8625
180,-40,70,1955,1866,3821,8822
-90,-30,110,1909,1912,3821,8916
-180,-40,70,1955,1866,3821,8822
-90,-50,150,1915,1906,3821,8631
-160,40,-80,1931,1890,3821,8782
50,-70,-180,1891,1931,3822,9106
80,-70,-30,1900,1922,3822,8753
140,60,90,1931,1891,3822,8880
50,-70,180,1891,1931,3822,9106
-70,30,-180,1925,1898,3823,8741
-70,30,180,1925,1898,3823,8741
120,-10,20,1902,1921,3823,8885
50,40,110,1906,1917,3823,8616
-170,60,50,1937,1886,3823,8729
-70,-30,90,1877,1947,3824,8842
110,-40,-100,1899,1925,3824,8657
-90,60,-30,1952,1874,3826,9089
-50,-30,100,1948,1878,3826,8915
-60,-70,80,1941,1885,3826,8573
40,-50,-180,1897,1930,3827,8827
40,-50,180,1897,1930,3827,8827
-30,40,-90,1912,1916,3828,8652
130,-60,-110,1927,1901,3828,8804
40,-10,170,1914,1915,3829,8475
-120,-40,90,1939,1890,3829,8670
160,-50,-90,1948,1882,3830,8894
-160,-10,-90,1933,1898,3831,8983
60,-10,-150,1876,1955,3831,8862
160,-70,50,1928,1903,3831,8549
-140,30,-90,1934,1897,3831,8900
-50,20,130,1916,1916,3832,8942
40,60,-160,1934,1899,3833,8877
160,-60,-90,1927,1906,3833,8947
30,30,120,1902,1931,3833,8645
-160,-70,90,1919,1915,3834,8821
100,-80,-10,1938,1897,3835,8478
180,-70,70,1945,1890,3835,8634
-180,-70,70,1945,1890,3835,8634
-70,-70,70,1935,1900,3835,8729
-50,-70,90,1942,1894,3836,8543
90,-40,-120,1912,1924,3836,8627
70,-70,-40,1911,1925,3836,8817
140,-20,50,1925,1911,3836,8951
-50,70,170,1924,1913,3837,8582
-60,60,170,1933,1904,3837,8827
50,-20,-90,1925,1913,3838,9104
-140,40,-100,1945,1893,3838,8683
-100,40,-40,1946,1892,3838,8773
130,-40,-90,1899,1940,3839,8594
-170,20,-70,1927,1913,3840,8560
110,50,110,1926,1914,3840,9092
-10,20,120,1905,1936,3841,8746
-40,10,110,1952,1889,3841,9026
-40,20,120,1922,1919,3841,9019
-20,-70,120,1931,1910,3841,8658
-140,-30,-50,1923,1918,3841,8811
-60,0,-150,1917,1925,3842,8673
40,-20,-90,1918,1924,3842,8963
-90,-80,40,1908,1934,3842,8702
-10,-20,-110,1908,1935,3843,8932
80,70,150,1939,1904,3843,8665
-90,40,-140,1912,1932,3844,8940
-130,50,-110,1922,1922,3844,8924
120,30,80,1912,1932,3844,8954
130,-80,-110,1916,1928,3844,8829
50,30,140,1907,1937,3844,8662
100,-50,-120,1931,1913,3844,8579
-140,-80,-20,1913,1932,3845,8618
90,-20,-100,1898,1947,3845,9031
180,10,60,1943,1902,3845,8830
-180,10,60,1943,1902,3845,8830
180,-60,70,1963,1883,3846,8716
-180,-60,70,1963,1883,3846,8716
-60,-10,120,1931,1915,3846,8924
130,70,100,1947,1899,3846,8795
160,20,70,1925,1921,3846,8936
-140,50,20,1964,1882,3846,9212
-130,40,-10,1953,1894,3847,8662
120,-70,10,1953,1894,3847,8596
-130,30,-10,1958,1890,3848,8777
-130,-50,100,1959,1889,3848,8902
-180,20,60,1944,1905,3849,9073
180,20,60,1944,1905,3849,9073
150,60,-30,1944,1905,3849,8742
40,80,-160,1939,1910,3849,9040
-10,-20,120,1922,1928,3850,8894
40,50,100,1912,1938,3850,8721
-150,-20,-70,1940,1911,3851,9047
-120,40,-20,1951,1900,3851,8607
-160,-10,-70,1932,1920,3852,8882
-130,-70,-10,1929,1924,3853,8886
-40,-20,100,1942,1911,3853,8921
-30,-70,110,1941,1912,3853,8569
140,40,-30,1927,1926,3853,8911
-110,60,-10,1965,1889,3854,8884
-130,50,10,1962,1892,3854,8908
-130,30,-70,1928,1926,3854,8879
-20,40,130,1921,1934,3855,8896
-20,10,110,1933,1922,3855,9062
-50,0,120,1939,1916,3855,8768
-80,60,-160,1925,1930,3855,8616
180,0,60,1952,1904,3856,9109
-170,-80,80,1932,1924,3856,8876
-140,50,-100,1923,1933,3856,8805
-80,30,-150,1951,1905,3856,8989
-180,0,60,1952,1904,3856,9109
-20,-20,110,1908,1948,3856,9039
-30,-10,100,1955,1902,3857,9010
150,-50,-90,1922,1935,3857,8787
110,-80,0,1926,1931,3857,8445
-140,-30,50,1949,1908,3857,8658
180,90,-50,1950,1909,3859,8527
-160,90,-70,1950,1909,3859,8527
20,90,110,1950,1909,3859,8527
10,90,120,1950,1909,3859,8527
-90,90,-140,1950,1909,3859,8527
-100,90,-130,1950,1909,3859,8527
-170,50,-70,1935,1924,3859,8617
80,90,50,1950,1909,3859,8527
30,90,100,1950,1909,3859,8527
-70,90,-160,1950,1909,3859,8527
-80,90,-150,1950,1909,3859,8527
-60,90,-170,1950,1909,3859,8527
150,50,80,1945,1914,3859,9012
0,90,130,1950,1909,3859,8527
-50,90,-180,1950,1909,3859,8527
150,90,-20,1950,1909,3859,8527
-40,70,160,1933,1926,3859,8561
-110,90,-120,1950,1909,3859,8527
-40,90,170,1950,1909,3859,8527
160,90,-30,1950,1909,3859,8527
60,90,70,1950,1909,3859,8527
130,90,0,1950,1909,3859,8527
-10,90,140,1950,1909,3859,8527
100,90,30,1950,1909,3859,8527
-120,90,-110,1950,1909,3859,8527
-150,90,-80,1950,1909,3859,8527
50,90,80,1950,1909,3859,8527
170,90,-40,1950,1909,3859,8527
-180,90,-50,1950,1909,3859,8527
140,90,-10,1950,1909,3859,8527
130,-30,-80,1912,1947,3859,8580
40,90,90,1950,1909,3859,8527
-20,90,150,1950,1909,3859,8527
-170,90,-60,1950,1909,3859,8527
120,90,10,1950,1909,3859,8527
70,90,60,1950,1909,3859,8527
-50,90,180,1950,1909,3859,8527
90,90,40,1950,1909,3859,8527
110,90,20,1950,1909,3859,8527
-140,90,-90,1950,1909,3859,8527
-130,90,-100,1950,1909,3859,8527
-30,90,160,1950,1909,3859,8527
40,70,-160,1944,1916,3860,9086
100,-60,-130,1917,1943,3860,9074
-70,-30,170,1961,1899,3860,8909
-170,-70,80,1929,1931,3860,8718
160,-30,60,1938,1922,3860,9047
170,50,-50,1918,1942,3860,8761
170,-10,-70,1921,1940,3861,8765
20,-80,150,1929,1933,3862,9047
30,0,150,1955,1907,3862,8798
-110,-60,130,1949,1913,3862,8510
-50,-30,-150,1938,1924,3862,8846
120,0,-20,1897,1965,3862,8791
120,-80,10,1929,1934,3863,8538
160,-40,-80,1942,1921,3863,8751
170,-50,-80,1970,1894,3864,8942
-120,-40,20,1961,1903,3864,8847
-100,50,-30,1944,1920,3864,9049
-130,-10,-20,1946,1918,3864,9128
130,-50,-100,1932,1933,3865,8784
90,40,90,1940,1925,3865,8828
-30,-10,-120,1945,1921,3866,8989
-130,40,-110,1956,1910,3866,9059
-160,0,-70,1927,1940,3867,8870
-140,0,20,1959,1908,3867,8919
-130,30,-90,1949,1918,3867,8828
-150,50,30,1974,1894,3868,9096
-40,-70,100,1944,1924,3868,8601
150,-70,40,1934,1934,3868,8670
-120,-40,0,1925,1944,3869,8930
-180,-80,70,1925,1944,3869,8975
180,-80,70,1925,1944,3869,8975
-140,80,20,1981,1889,3870,9088
120,10,40,1972,1900,3872,9093
-10,-10,120,1939,1933,3872,9038
-160,60,40,1972,1900,3872,8963
90,50,60,1964,1908,3872,8733
-160,-50,-60,1958,1915,3873,8944
60,-70,-170,1915,1958,3873,9210
-50,30,140,1963,1910,3873,8843
40,-40,180,1940,1934,3874,8585
40,-40,-180,1940,1934,3874,8585
100,-70,-10,1948,1927,3875,8807
130,-80,20,1939,1936,3875,8701
-30,40,130,1953,1923,3876,9077
100,-20,-90,1976,1900,3876,9076
-80,-20,140,1942,1934,3876,8943
120,10,-10,1928,1948,3876,8993
-130,0,-10,1954,1923,3877,8692
-50,-10,110,1945,1932,3877,9252
30,-50,170,1935,1942,3877,8780
-10,30,-100,1926,1951,3877,8933
0,-10,130,1944,1933,3877,8882
-40,-10,-130,1940,1937,3877,8908
-80,-70,60,1945,1933,3878,8984
140,-80,-100,1925,1953,3878,8811
110,-70,0,1945,1933,3878,8781
120,-40,10,1941,1937,3878,8932
40,-10,-100,1928,1951,3879,8880
-160,-50,80,1963,1916,3879,8787
70,-80,-40,1938,1942,3880,8764
-170,-40,-70,1966,1914,3880,8967
60,-70,-50,1946,1934,3880,8926
-10,10,120,1936,1945,3881,8918
80,-80,-30,1946,1935,3881,8686
-80,60,-40,1989,1892,3881,9306
-130,10,-30,1923,1958,3881,8643
100,-20,-70,1931,1950,3881,8784
-100,-60,40,1956,1925,3881,8730
-40,30,130,1942,1940,3882,8954
140,60,-20,1961,1922,3883,8775
-60,-40,90,1959,1924,3883,8888
-110,-50,120,1944,1939,3883,9008
-110,-70,20,1941,1942,3883,8680
-100,40,-130,1931,1952,3883,9049
20,-60,160,1933,1951,3884,9005
-70,-10,170,1973,1912,3885,9006
-110,50,-20,1972,1913,3885,9170
90,-40,-30,1947,1938,3885,9172
70,50,150,1973,1913,3886,8993
-50,60,160,1932,1955,3887,9024
60,40,150,1954,1933,3887,8818
-10,-60,130,1976,1912,3888,8919
40,0,-110,1955,1933,3888,8910
20,-40,160,1947,1942,3889,8583
120,20,0,1940,1949,3889,9275
-160,-80,90,1947,1942,3889,8905
-10,60,130,1963,1927,3890,8931
-170,-20,60,1992,1898,3890,9143
-130,50,-10,1972,1919,3891,8939
30,-80,160,1942,1950,3892,9128
130,-30,30,1924,1969,3893,9231
120,50,0,1942,1951,3893,9034
40,10,-120,1947,1947,3894,9042
-110,-50,30,1948,1946,3894,8917
-30,20,120,1947,1947,3894,9109
120,0,20,1928,1967,3895,9034
-170,-10,-70,1948,1947,3895,8933
170,-20,-70,1933,1963,3896,8678
90,-30,-60,1951,1946,3897,8969
140,-70,-100,1940,1957,3897,8839
10,-20,140,1971,1927,3898,9053
40,40,-160,1953,1945,3898,9050
90,70,40,1945,1953,3898,9110
-150,40,30,1992,1906,3898,9012
-70,-20,170,2005,1893,3898,9020
-80,-30,100,1970,1928,3898,9002
110,30,70,1966,1932,3898,9130
-150,-80,-30,1937,1962,3899,8833
50,50,-180,1959,1940,3899,8924
50,50,180,1959,1940,3899,8924
150,60,80,1997,1903,3900,9043
-70,-10,140,1940,1960,3900,9091
50,0,-120,1982,1918,3900,9040
170,-60,60,1985,1915,3900,8823
130,10,-30,1905,1996,3901,8816
0,-60,140,1941,1960,3901,9022
10,10,130,1930,1972,3902,8801
140,-80,30,1960,1942,3902,8848
30,80,-150,1965,1937,3902,9221
-110,40,-30,1974,1928,3902,8849
110,50,30,1952,1950,3902,8793
170,-80,60,1944,1958,3902,8918
-80,-40,70,1938,1965,3903,9181
-30,-40,-130,1948,1955,3903,8876
60,-20,-150,1942,1962,3904,8820
-100,-60,140,1962,1942,3904,8930
-10,-70,130,1965,1939,3904,8869
-150,60,30,1990,1914,3904,9105
110,30,50,1968,1937,3905,8836
60,40,140,1965,1940,3905,8815
10,-60,150,1960,1945,3905,8823
70,-40,-140,1969,1936,3905,8862
-150,-80,100,1957,1948,3905,8938
-180,-20,-70,1938,1968,3906,8663
-30,60,-80,1976,1930,3906,9013
180,-20,-70,1938,1968,3906,8663
-70,40,-170,1987,1920,3907,8710
-70,50,-170,1966,1941,3907,8657
60,-80,-50,1938,1969,3907,8891
10,-30,-100,1944,1963,3907,9084
30,60,100,1966,1942,3908,8928
-30,-60,110,1988,1920,3908,8888
120,-10,-50,1923,1985,3908,8771
-90,-30,120,1944,1964,3908,9247
-60,-20,110,1959,1949,3908,9079
150,0,-60,2013,1895,3908,8907
30,10,-110,1974,1935,3909,9083
-40,60,150,1951,1958,3909,8868
-100,-80,30,1940,1969,3909,8872
-170,20,50,1954,1955,3909,8739
70,-70,-160,1925,1985,3910,9263
-140,20,-70,1981,1929,3910,9021
50,-30,-80,1910,2000,3910,9222
60,40,130,1942,1968,3910,8970
40,0,160,1973,1938,3911,8982
50,-70,-60,1949,1962,3911,8971
-150,-30,-60,1969,1943,3912,8975
-140,70,20,1995,1917,3912,9124
170,30,-60,1970,1942,3912,8943
-170,40,50,1965,1947,3912,9103
-20,-60,120,1991,1921,3912,8932
-120,-80,130,1952,1960,3912,8850
-80,-70,170,1954,1959,3913,8926
-150,30,30,2006,1907,3913,9097
-30,10,110,1962,1952,3914,9277
-50,50,150,1955,1959,3914,9002
140,70,90,1987,1927,3914,8936
150,20,70,1964,1950,3914,9114
-120,-50,0,1959,1956,3915,9137
140,-70,30,1950,1965,3915,8789
-20,0,-110,1971,1944,3915,9176
140,-40,40,1962,1953,3915,9077
80,60,60,1977,1938,3915,8996
-20,-30,-120,1951,1965,3916,8897
-80,30,-130,1957,1959,3916,8963
130,0,-50,1956,1960,3916,9243
120,40,90,1947,1970,3917,9129
120,-60,10,1950,1967,3917,9058
-120,50,-20,1997,1920,3917,8890
-150,-50,-50,1986,1931,3917,9022
120,10,10,1932,1986,3918,8820
80,-30,-70,1962,1957,3919,9202
-140,-40,70,1967,1952,3919,8777
160,-60,50,1975,1944,3919,8933
150,30,-40,1976,1943,3919,9001
-160,-30,-70,1995,1925,3920,9282
20,-20,150,1941,1979,3920,8549
10,60,-120,2010,1910,3920,9307
-160,-20,50,1997,1925,3922,8756
50,10,-160,1933,1989,3922,8866
-140,-80,110,1961,1962,3923,8859
150,-80,40,1975,1948,3923,8909
30,-60,-80,1952,1971,3923,9171
-120,50,-10,1970,1953,3923,9276
10,40,120,1945,1978,3923,9189
40,-70,-70,1949,1974,3923,8972
-130,-80,120,1965,1959,3924,8808
-120,60,0,1987,1937,3924,9302
-50,10,130,1972,1952,3924,9075
-70,20,-160,1953,1972,3925,8946
-130,-20,10,1967,1959,3926,9036
110,-20,-80,1977,1949,3926,9046
-180,-10,60,1998,1929,3927,9287
-130,0,-20,1983,1944,3927,8903
80,70,50,1958,1969,3927,9064
60,-30,-150,1965,1962,3927,8885
180,-10,60,1998,1929,3927,9287
-170,30,-70,1954,1974,3928,8625
-60,-10,-160,1967,1962,3929,8965
-90,-40,140,1960,1969,3929,9123
-40,10,120,1985,1944,3929,9224
-180,-30,-70,1969,1961,3930,8917
-130,-20,-20,1984,1946,3930,8952
180,-30,-70,1969,1961,3930,8917
90,-30,-110,1957,1973,3930,9164
-100,-40,60,1968,1962,3930,8938
-60,-30,100,1966,1965,3931,9158
120,10,0,1974,1957,3931,9097
60,-30,-80,1939,1993,3932,9246
-120,-40,80,1967,1965,3932,8998
-10,0,120,1938,1994,3932,9056
10,-50,150,1994,1939,3933,8781
-50,20,140,1959,1974,3933,9011
80,-40,-130,1997,1937,3934,8799
-160,10,-70,1934,2000,3934,9203
150,-80,-90,1947,1987,3934,9015
130,40,-20,1970,1965,3935,9419
-40,-60,100,1997,1938,3935,8759
-140,60,20,2009,1926,3935,9144
-70,20,-140,1959,1977,3936,8938
70,60,70,1967,1969,3936,8923
-130,-10,0,1992,1945,3937,9093
-20,-10,110,1974,1963,3937,9349
-130,80,10,2019,1918,3937,9226
70,70,160,1965,1973,3938,8785
-110,40,-120,1977,1961,3938,9145
-30,-50,110,1973,1965,3938,8892
-140,-10,-40,1977,1961,3938,9010
110,80,20,1967,1972,3939,8886
-60,20,150,1984,1957,3941,8852
-140,-60,100,1983,1959,3942,8860
-110,-80,140,1964,1978,3942,8912
-130,20,-50,1981,1961,3942,9087
40,-80,170,1969,1973,3942,9275
60,-10,-110,2032,1911,3943,9391
-90,50,-40,1984,1959,3943,9224
80,-20,-90,1975,1968,3943,9199
-130,10,-20,1986,1957,3943,8880
-80,-50,160,1952,1992,3944,9096
140,30,-30,1960,1984,3944,9198
160,30,-50,1977,1968,3945,9199
-70,60,-170,1974,1971,3945,8798
-160,-80,-40,1944,2001,3945,8977
80,-20,-110,1983,1963,3946,9276
-110,-40,100,1951,1996,3947,9094
-170,-40,70,2036,1911,3947,9212
40,10,150,1979,1969,3948,8935
110,-50,-110,1991,1957,3948,8699
-70,30,-100,1973,1976,3949,9067
160,10,-60,2006,1943,3949,8914
160,50,-40,1996,1953,3949,9107
-80,30,-140,1975,1975,3950,9081
160,-80,50,1986,1964,3950,8896
100,80,30,1964,1987,3951,8892
140,-60,-100,1974,1977,3951,9131
10,40,-110,1990,1961,3951,9223
50,30,160,1975,1976,3951,8683
20,80,-140,1986,1966,3952,9386
-170,80,-60,2005,1948,3953,8839
-120,-40,10,1987,1966,3953,9283
120,10,20,1967,1987,3954,9120
110,-20,-40,1972,1982,3954,9039
50,-80,-60,1969,1985,3954,9046
-30,80,160,1983,1972,3955,9027
40,80,90,1991,1964,3955,9102
120,10,30,1984,1971,3955,9127
-170,40,-70,1973,1982,3955,8840
50,10,-150,1960,1996,3956,9276
20,-50,-90,1940,2016,3956,9111
180,-50,-70,1983,1973,3956,9155
20,80,110,1995,1961,3956,8904
-130,60,10,1990,1966,3956,9329
-20,0,110,1977,1979,3956,9392
-180,-50,-70,1983,1973,3956,9155
-180,-40,-70,1996,1961,3957,9123
-70,60,-50,2014,1943,3957,9318
-70,20,-150,1986,1971,3957,9231
130,80,0,1971,1986,3957,9063
180,-40,-70,1996,1961,3957,9123
100,-20,-80,1961,1997,3958,9107
-140,-50,90,2017,1941,3958,9092
0,80,130,2012,1946,3958,8942
10,80,120,2005,1954,3959,8893
130,30,-20,1983,1977,3960,9468
30,80,100,1986,1974,3960,8953
170,-60,-80,1992,1968,3960,9178
-10,80,140,2007,1954,3961,8971
100,-30,-100,1981,1980,3961,9092
150,-60,40,1967,1994,3961,9078
-60,50,170,1976,1986,3962,9156
0,-70,140,1983,1979,3962,9159
120,0,10,1972,1992,3964,8986
-20,30,130,1990,1975,3965,9273
60,80,70,1979,1987,3966,9100
-150,20,30,2022,1944,3966,9262
90,80,40,1985,1981,3966,8975
140,0,60,1989,1978,3967,9327
-130,30,-80,1965,2002,3967,9117
-140,40,0,2020,1947,3967,8926
-30,30,130,1992,1975,3967,9198
70,80,60,1972,1996,3968,9021
10,-10,-100,1960,2008,3968,9208
120,80,10,1994,1974,3968,8993
-160,80,-70,2009,1960,3969,8792
-10,50,130,1982,1987,3969,8991
-70,-40,80,1977,1992,3969,9298
130,-10,-60,1957,2013,3970,8841
-30,0,110,1994,1977,3971,9490
-130,30,0,2027,1944,3971,9479
-140,-40,-40,2001,1970,3971,9326
80,80,50,1984,1988,3972,9019
-20,20,120,2006,1966,3972,9335
-170,-30,-70,2015,1957,3972,9291
-120,40,-110,1993,1979,3972,9202
110,-20,-50,1948,2025,3973,8846
100,50,110,2021,1952,3973,9319
-150,80,-80,2015,1958,3973,8850
-70,50,-60,1998,1976,3974,9218
-150,30,-80,2006,1968,3974,9039
30,-30,-90,1988,1987,3975,9524
-170,-20,-70,2008,1967,3975,9186
30,70,-150,2008,1967,3975,9333
30,-70,-80,1977,1998,3975,9027
130,20,-20,1977,1999,3976,9461
-20,60,-90,2034,1942,3976,9385
-110,60,-20,2016,1960,3976,9246
-110,-40,80,1984,1992,3976,8980
-20,80,150,2000,1977,3977,8977
-100,-80,150,1971,2006,3977,9039
-10,40,130,1970,2008,3978,9165
-60,40,160,2016,1962,3978,9070
170,80,-40,1982,1997,3979,9129
160,-80,-80,1955,2024,3979,9173
-140,0,-40,1982,1997,3979,9217
-170,50,50,2020,1960,3980,9377
130,-60,20,2011,1969,3980,9086
50,-80,-180,1983,1999,3982,9321
50,-80,180,1983,1999,3982,9321
90,50,120,2007,1975,3982,9283
-40,0,120,2003,1979,3982,9356
-150,-40,70,2047,1935,3982,9094
-30,10,120,2005,1978,3983,9392
10,-10,140,1968,2015,3983,8992
-140,-60,-30,2016,1968,3984,9064
-90,70,-30,2010,1974,3984,9302
120,30,0,1994,1991,3985,9261
100,70,30,1993,1992,3985,9204
170,-50,60,2044,1941,3985,9009
-100,60,-30,2021,1964,3985,9327
140,80,-10,1988,1997,3985,9061
-90,-70,50,2002,1984,3986,9180
50,80,80,2000,1986,3986,9137
-40,80,170,1996,1990,3986,9128
-80,40,-150,2009,1978,3987,9300
-70,-40,170,1989,1998,3987,8986
-120,-40,70,2029,1958,3987,9093
120,-30,10,1979,2009,3988,9241
110,-20,-30,1978,2010,3988,9170
-80,-30,110,2009,1979,3988,9237
-140,-20,-40,1995,1993,3988,9174
0,0,130,2013,1975,3988,9224
40,-80,-70,1992,1996,3988,9165
150,70,80,2016,1973,3989,9381
-170,0,50,1993,1996,3989,8713
-70,30,-120,2024,1965,3989,9157
10,80,-130,2013,1977,3990,9580
-40,0,110,2009,1981,3990,9306
-120,30,-60,1979,2011,3990,9362
-140,80,-90,2017,1973,3990,9001
-130,-30,40,1992,1999,3991,8898
150,-40,-80,1983,2008,3991,8954
-80,50,-50,2013,1978,3991,9200
-130,50,0,2007,1985,3992,9431
120,-50,-100,2001,1992,3993,8730
-130,-40,70,2006,1987,3993,9157
120,50,100,2012,1981,3993,9404
-60,10,150,2010,1984,3994,9222
40,-30,180,1975,2020,3995,8793
40,-30,-180,1975,2020,3995,8793
-60,20,160,2020,1975,3995,9196
-150,0,-60,1998,1997,3995,9097
110,40,90,2005,1990,3995,9401
-70,-10,160,2024,1972,3996,9299
-30,-40,110,2013,1984,3997,9081
60,60,80,1991,2007,3998,9035
-40,-10,110,2018,1981,3999,9450
-40,20,130,2004,1995,3999,9345
110,30,60,2002,1997,3999,9250
-130,80,-100,2030,1970,4000,9123
110,60,20,2000,2000,4000,9074
80,-70,-150,1958,2042,4000,9256
-20,-50,120,1990,2010,4000,9203
70,-40,-60,1986,2015,4001,9631
160,80,-30,2003,1998,4001,9168
90,60,50,2006,1995,4001,8995
-110,80,-10,2057,1944,4001,9361
70,70,60,2006,1995,4001,9220
-120,80,0,2046,1956,4002,9365
-130,20,-20,2009,1993,4002,9082
-130,-10,-10,2030,1974,4004,9197
-120,-40,30,2005,1999,4004,9138
-180,80,-50,2007,1997,4004,9005
180,80,-50,2007,1997,4004,9005
-130,70,10,2014,1992,4006,9380
-120,80,-110,2017,1989,4006,9147
-170,-80,-50,1975,2031,4006,9129
-170,10,50,1983,2024,4007,9021
180,-60,-70,2014,1994,4008,9199
20,40,-120,2045,1963,4008,9274
-180,-60,-70,2014,1994,4008,9199
-50,-20,110,1990,2018,4008,9344
160,30,70,2023,1985,4008,9291
30,-10,-100,1999,2010,4009,9199
-80,70,-40,2023,1986,4009,9318
-140,-70,-20,2002,2007,4009,9159
-30,50,140,1984,2025,4009,9379
160,-20,60,2021,1989,4010,9560
-160,-20,-70,2014,1996,4010,9209
-60,50,-70,2015,1995,4010,9209
50,30,150,1987,2023,4010,9083
130,10,60,1999,2011,4010,9569
90,-20,-90,2043,1969,4012,9376
-30,-30,110,2014,1998,4012,9333
30,-60,170,2013,1999,4012,9387
150,80,-20,2013,1999,4012,9091
160,60,70,2038,1974,4012,9338
170,-80,-70,1970,2043,4013,9208
160,0,-60,2037,1977,4014,9221
130,0,50,1988,2026,4014,9583
120,20,20,2000,2015,4015,9231
150,-10,60,2027,1988,4015,9479
-40,40,140,2010,2005,4015,9366
-180,40,-60,2028,1987,4015,8972
180,40,-60,2028,1987,4015,8972
120,-10,10,1986,2030,4016,9293
140,-60,30,2026,1990,4016,9152
-60,20,-130,2025,1991,4016,9201
40,-40,-80,1974,2042,4016,9378
60,70,70,1994,2023,4017,9332
30,-80,-80,2006,2011,4017,9137
-70,30,-110,2023,1995,4018,9148
-80,-30,150,2008,2010,4018,9417
30,40,-140,2022,1997,4019,9360
-110,-40,50,2026,1993,4019,9096
50,50,100,2017,2002,4019,8968
-60,40,170,2008,2012,4020,9033
-70,40,-80,2015,2005,4020,9311
30,60,-150,2027,1994,4021,9531
-160,20,-70,1992,2029,4021,9092
-140,-30,-40,2028,1994,4022,9251
-40,40,-90,1990,2032,4022,9330
40,20,-140,2032,1990,4022,9224
160,40,70,2028,1995,4023,9220
-160,-30,60,2040,1983,4023,9128
180,-80,-60,1974,2050,4024,9191
-110,-80,20,1998,2026,4024,9202
-70,30,-160,2015,2009,4024,9432
-130,40,0,2052,1972,4024,9409
-100,-50,130,1998,2026,4024,9356
-180,-80,-60,1974,2050,4024,9191
-100,-50,50,2026,1998,4024,9163
170,-40,60,2037,1988,4025,9346
150,-70,-90,2018,2007,4025,9128
-100,40,-100,2054,1971,4025,9323
-50,80,-180,2036,1989,4025,9212
-50,80,180,2036,1989,4025,9212
-10,-50,130,2001,2025,4026,9240
130,-20,30,2024,2002,4026,9456
-80,80,-40,2039,1987,4026,9643
-40,-20,110,1995,2031,4026,9606
-50,-40,100,2028,2000,4028,9232
140,20,70,2035,1993,4028,9419
-100,40,-50,1994,2035,4029,9437
-110,40,-90,2046,1983,4029,9338
-140,30,0,2037,1992,4029,9162
120,20,60,2027,2002,4029,9407
100,60,40,1990,2041,4031,9104
130,-10,40,2006,2025,4031,9436
100,50,50,2026,2006,4032,9151
-40,-40,-140,2026,2006,4032,9201
-50,0,-140,2024,2009,4033,8914
100,-30,-40,2029,2004,4033,9441
20,-70,-90,2015,2018,4033,9144
170,-30,-70,2029,2004,4033,8980
10,-70,150,2010,2023,4033,9516
-70,80,-50,2038,1995,4033,9624
-130,-50,-20,2023,2010,4033,9532
-100,40,-90,2063,1971,4034,9279
-60,80,-170,2042,1993,4035,9250
-150,-10,-60,2022,2013,4035,9203
60,50,160,2041,1995,4036,9147
-60,-40,-170,2034,2002,4036,9350
130,20,70,2000,2036,4036,9308
-110,40,-100,2028,2008,4036,9289
-110,80,-120,2029,2007,4036,9194
160,50,70,2069,1968,4037,9466
140,-10,-60,2037,2000,4037,9352
120,70,10,2031,2006,4037,9256
-160,-40,-60,2022,2016,4038,9358
150,-30,50,2037,2001,4038,9204
-60,-50,-170,2038,2001,4039,9286
50,40,170,2030,2009,4039,9148
-90,80,-30,2050,1989,4039,9681
-160,50,40,2062,1977,4039,9356
-70,-10,150,2005,2034,4039,9441
-170,-60,-60,2056,1983,4039,9421
-150,-30,50,2075,1965,4040,9040
120,-40,-90,1994,2046,4040,9070
110,70,20,2014,2026,4040,9266
-100,80,-20,2062,1978,4040,9570
-60,30,160,2029,2011,4040,9291
40,-20,180,2017,2024,4041,8999
40,-20,-180,2017,2024,4041,8999
-140,30,10,2081,1960,4041,9386
170,20,-60,2018,2024,4042,9224
120,20,10,2015,2027,4042,9279
140,-50,-90,2035,2007,4042,9085
100,60,120,2035,2008,4043,9507
-120,30,-30,2030,2013,4043,9067
-100,70,-20,2050,1993,4043,9441
20,-60,-90,2021,2022,4043,9421
-30,10,-110,2029,2015,4044,9625
60,-80,-170,1997,2047,4044,9414
120,0,0,1996,2048,4044,9316
-60,30,-100,2028,2016,4044,9320
-140,40,-90,2029,2015,4044,9525
-90,-60,150,2029,2015,4044,9308
-90,-90,160,2022,2023,4045,9314
-130,-90,120,2022,2023,4045,9314
30,-90,-80,2022,2023,4045,9314
70,-90,-40,2022,2023,4045,9314
-80,-90,170,2022,2023,4045,9314
100,-90,-10,2022,2023,4045,9314
20,-90,-90,2022,2023,4045,9314
10,-90,-100,2022,2023,4045,9314
170,-90,60,2022,2023,4045,9314
-110,-90,140,2022,2023,4045,9314
-20,-90,-130,2022,2023,4045,9314
-170,-90,80,2022,2023,4045,9314
160,-90,50,2022,2023,4045,9314
40,-90,-70,2022,2023,4045,9314
50,-90,-60,2022,2023,4045,9314
-40,-90,-150,2022,2023,4045,9314
-150,-90,100,2022,2023,4045,9314
140,-90,30,2022,2023,4045,9314
-160,-90,90,2022,2023,4045,9314
-70,-90,180,2022,2023,4045,9314
180,-90,70,2022,2023,4045,9314
90,-90,-20,2022,2023,4045,9314
0,-90,-110,2022,2023,4045,9314
-180,-90,70,2022,2023,4045,9314
80,-90,-30,2022,2023,4045,9314
130,-90,20,2022,2023,4045,9314
-60,-90,-170,2022,2023,4045,9314
120,-90,10,2022,2023,4045,9314
150,-90,40,2022,2023,4045,9314
60,-90,-50,2022,2023,4045,9314
-100,-90,150,2022,2023,4045,9314
-120,-90,130,2022,2023,4045,9314
-70,-90,-180,2022,2023,4045,9314
-140,-90,110,2022,2023,4045,9314
110,-90,0,2022,2023,4045,9314
-30,-90,-140,2022,2023,4045,9314
-10,-90,-120,2022,2023,4045,9314
-50,-90,-160,2022,2023,4045,9314
-120,60,-10,2049,1997,4046,9267
0,-50,140,2021,2025,4046,9199
160,-20,-70,2042,2005,4047,9161
100,-30,-30,2013,2034,4047,9512
-150,-60,90,2037,2011,4048,9283
-130,40,-100,2040,2009,4049,9389
-20,60,140,2024,2026,4050,9258
-140,20,-60,2034,2016,4050,9163
-20,50,-90,2015,2035,4050,9630
-110,70,-10,2057,1994,4051,9677
-70,50,-70,2010,2041,4051,9256
50,60,180,2049,2002,4051,9323
50,60,-180,2049,2002,4051,9323
-160,20,40,2058,1993,4051,9324
160,-50,-80,2054,1998,4052,9148
-40,10,130,2032,2020,4052,9363
-90,40,-100,2075,1978,4053,9377
-110,50,-30,2050,2004,4054,9205
0,60,-110,2075,1979,4054,9585
-30,40,140,2022,2032,4054,9381
-20,-40,120,2031,2024,4055,9375
-140,20,10,2070,1985,4055,9564
-150,10,-60,2024,2031,4055,9209
-160,70,-70,2056,1999,4055,9144
110,-20,-20,2033,2022,4055,9461
-140,30,-80,2037,2019,4056,9290
70,-20,-130,2016,2040,4056,9323
-20,30,-100,2017,2039,4056,9572
40,20,140,1986,2070,4056,9336
0,80,-120,2057,1999,4056,9621
110,60,110,2028,2028,4056,9416
-90,-50,60,2042,2014,4056,9242
-140,10,-50,2023,2034,4057,9238
-140,-10,20,2055,2002,4057,9376
-60,60,-180,2019,2038,4057,9168
-60,60,180,2019,2038,4057,9168
40,-60,-180,2034,2023,4057,9308
-70,-30,100,2013,2044,4057,9443
40,-60,180,2034,2023,4057,9308
-30,80,-90,2059,1999,4058,9730
-90,40,-70,2031,2027,4058,9505
-120,70,0,2049,2009,4058,9651
-50,-10,120,2028,2031,4059,9496
-70,70,-50,2059,2001,4060,9577
-150,70,-80,2054,2006,4060,9309
60,-40,-150,2041,2020,4061,8884
80,50,130,2055,2007,4062,9472
140,40,80,2051,2013,4064,9475
-50,80,-70,2043,2021,4064,9701
-70,-20,120,2038,2026,4064,9544
-70,80,-160,2054,2010,4064,9315
-20,80,-100,2061,2004,4065,9717
-170,-10,50,2069,1996,4065,9012
-110,-40,90,2041,2024,4065,9328
-30,-30,-130,2011,2055,4066,9217
-40,80,-80,2047,2020,4067,9715
150,-60,-90,2039,2028,4067,9312
-60,80,-60,2051,2017,4068,9660
30,-30,170,2042,2026,4068,9062
-30,-10,110,2033,2035,4068,9610
-110,40,-80,2051,2018,4069,9499
-60,40,-180,2073,1996,4069,8866
-10,60,-100,2084,1985,4069,9520
-10,40,-100,2039,2030,4069,9369
20,-80,-90,2036,2033,4069,9320
100,40,60,2026,2043,4069,9466
-60,40,180,2073,1996,4069,8866
170,10,-60,2047,2023,4070,9099
10,-40,-100,2016,2055,4071,9507
-90,-80,160,2030,2041,4071,9324
-160,-40,70,2082,1989,4071,9397
60,-60,-160,2031,2040,4071,9485
-130,30,-60,2052,2020,4072,9218
-60,-60,-170,2046,2026,4072,9308
90,60,130,2058,2014,4072,9493
-110,-60,30,2055,2018,4073,9341
10,-40,150,2049,2025,4074,9198
100,40,90,2021,2053,4074,9203
-80,80,-150,2055,2019,4074,9411
-60,50,-180,2064,2011,4075,9011
-60,50,180,2064,2011,4075,9011
-10,80,-110,2059,2016,4075,9596
130,-40,20,2045,2030,4075,9321
130,50,-10,2044,2032,4076,9460
-160,40,40,2077,1999,4076,9270
-160,30,40,2066,2010,4076,9352
-70,-70,180,2036,2040,4076,9388
-70,-70,-180,2036,2040,4076,9388
70,-30,-80,2035,2042,4077,9536
150,30,70,2061,2017,4078,9575
130,70,0,2051,2027,4078,9395
-100,-40,120,2038,2041,4079,9596
-30,0,120,2053,2026,4079,9615
170,40,-50,2045,2034,4079,9374
-60,-10,130,2043,2036,4079,9451
-80,50,-60,2028,2051,4079,9545
90,-70,-140,2006,2074,4080,9421
70,-60,-150,2034,2046,4080,9470
-160,60,-70,2044,2036,4080,9399
-150,20,-70,2045,2035,4080,9571
-50,-20,-150,2055,2025,4080,9332
20,-10,150,2061,2020,4081,9292
120,30,10,2022,2059,4081,9239
-140,50,0,2071,2010,4081,9124
110,-60,-120,2001,2080,4081,9534
80,-40,-50,2029,2053,4082,9583
130,-50,20,2062,2021,4083,9300
-150,-20,-60,2053,2031,4084,9483
-120,-40,60,2075,2010,4085,9092
-130,-30,30,2038,2047,4085,9249
-100,50,-40,2084,2002,4086,9266
-50,0,130,2053,2033,4086,9471
-50,40,150,2053,2033,4086,9392
-110,70,-20,2071,2015,4086,9414
60,-50,-60,2033,2054,4087,9472
50,70,80,2032,2055,4087,9531
-180,-20,60,2100,1988,4088,9324
110,40,40,2036,2052,4088,9319
180,-20,60,2100,1988,4088,9324
-170,70,-60,2048,2040,4088,9138
20,20,-110,2044,2044,4088,9638
150,10,-50,2058,2031,4089,9432
50,-20,-160,2053,2036,4089,9417
110,-20,-60,2045,2044,4089,9240
50,60,90,2048,2042,4090,9493
-20,10,120,2027,2063,4090,9758
140,20,-30,2025,2065,4090,9342
-150,-60,-40,2043,2048,4091,9422
120,40,0,2044,2047,4091,9646
-130,-40,-20,2056,2035,4091,9715
-160,10,40,2059,2032,4091,9457
-120,40,-100,2047,2045,4092,9559
-130,-90,0,2049,2043,4092,9347
-50,-90,80,2049,2043,4092,9347
-80,-90,50,2049,2043,4092,9347
-10,-90,120,2049,2043,4092,9347
170,-90,-60,2049,2043,4092,9347
20,-90,150,2049,2043,4092,9347
70,-80,-160,2020,2072,4092,9532
40,-90,170,2049,2043,4092,9347
100,-90,-130,2049,2043,4092,9347
70,-90,-160,2049,2043,4092,9347
60,-90,-170,2049,2043,4092,9347
30,-90,160,2049,2043,4092,9347
90,-90,-140,2049,2043,4092,9347
-40,-90,90,2049,2043,4092,9347
130,-90,-100,2049,2043,4092,9347
180,-90,-50,2049,2043,4092,9347
-180,-90,-50,2049,2043,4092,9347
-170,-90,-40,2049,2043,4092,9347
120,-90,-110,2049,2043,4092,9347
-30,-90,100,2049,2043,4092,9347
110,-90,-120,2049,2043,4092,9347
-90,-90,40,2049,2043,4092,9347
50,-90,-180,2049,2043,4092,9347
-110,-90,20,2049,2043,4092,9347
150,-90,-80,2049,2043,4092,9347
140,-90,-90,2049,2043,4092,9347
-20,-90,110,2049,2043,4092,9347
10,-90,140,2049,2043,4092,9347
-70,-90,60,2049,2043,4092,9347
0,-90,130,2049,2043,4092,9347
-140,-90,-10,2049,2043,4092,9347
80,-90,-150,2049,2043,4092,9347
160,-90,-70,2049,2043,4092,9347
50,-90,180,2049,2043,4092,9347
-60,-90,70,2049,2043,4092,9347
-100,-90,30,2049,2043,4092,9347
-150,-90,-20,2049,2043,4092,9347
-120,-90,10,2049,2043,4092,9347
-160,-90,-30,2049,2043,4092,9347
-60,0,140,2042,2051,4093,9612
-90,50,-140,2058,2035,4093,9240
50,-30,-160,2041,2054,4095,9284
30,50,-150,2077,2018,4095,9560
150,-20,-70,2056,2040,4096,9263
-90,80,-140,2056,2040,4096,9291
-160,-10,-60,2052,2045,4097,9476
-40,50,-80,2054,2043,4097,9547
140,70,-10,2083,2015,4098,9454
-40,30,140,2069,2030,4099,9543
-90,-40,70,2020,2080,4100,9531
160,-50,50,2076,2024,4100,9501
20,50,-130,2058,2043,4101,9454
-120,40,-90,2059,2042,4101,9401
-70,40,-160,2050,2053,4103,9238
140,-20,-70,2054,2049,4103,9481
70,-50,-50,2033,2070,4103,9484
-100,-70,40,2031,2072,4103,9490
-140,70,-90,2095,2009,4104,9433
120,20,30,2054,2050,4104,9389
-50,10,140,2078,2027,4105,9469
-170,-50,-60,2047,2058,4105,9647
120,-10,-30,2053,2053,4106,9322
10,-20,-100,2030,2076,4106,9599
170,0,-60,2117,1990,4107,9150
120,-20,10,2027,2080,4107,9719
50,-10,-110,2062,2046,4108,9505
-160,-60,-50,2059,2049,4108,9511
100,-30,-50,2074,2034,4108,9695
-150,-40,-50,2061,2047,4108,9459
50,40,120,2046,2063,4109,9375
-120,-80,10,2033,2077,4110,9464
110,60,30,2044,2066,4110,9323
-100,40,-60,2038,2072,4110,9559
40,30,-160,2064,2047,4111,9417
-60,70,-60,2085,2026,4111,9728
20,70,-140,2071,2040,4111,9664
140,-40,-80,2060,2052,4112,9211
-100,80,-130,2076,2036,4112,9251
-60,30,180,2070,2043,4113,9200
110,-30,-90,2047,2066,4113,9453
-60,30,-180,2070,2043,4113,9200
-130,-30,20,2088,2026,4114,9328
-50,50,160,2071,2043,4114,9488
120,60,100,2059,2055,4114,9411
-160,-30,-60,2085,2030,4115,9459
-130,-30,-20,2078,2037,4115,9610
-140,40,-10,2073,2043,4116,9301
-100,70,-30,2090,2026,4116,9538
-60,20,170,2080,2037,4117,9292
-90,50,-50,2057,2061,4118,9523
10,-60,-100,2041,2077,4118,9515
-20,-10,120,2061,2058,4119,9757
-100,40,-110,2047,2072,4119,9573
-60,30,170,2052,2068,4120,9398
170,-20,60,2076,2044,4120,9563
80,-80,-150,2032,2089,4121,9555
-10,30,130,2057,2064,4121,9541
50,-60,-170,2064,2057,4121,9396
120,0,-10,2030,2091,4121,9486
-70,-20,160,2101,2021,4122,9715
-150,-20,40,2075,2047,4122,9491
-70,-50,80,2066,2056,4122,9676
70,50,140,2088,2035,4123,9523
-40,-30,110,2089,2034,4123,9711
-60,-30,-170,2105,2018,4123,9404
-70,-50,170,2048,2075,4123,9535
-130,-20,0,2097,2026,4123,9505
-130,40,-90,2084,2040,4124,9699
-40,-10,120,2056,2068,4124,9551
-110,40,-110,2073,2052,4125,9472
160,70,70,2072,2053,4125,9572
10,-80,-100,2058,2067,4125,9390
-30,-10,120,2070,2055,4125,9591
-50,-80,90,2071,2054,4125,9269
80,-40,-60,2062,2063,4125,9528
-110,-40,70,2059,2067,4126,9255
-30,20,130,2077,2049,4126,9701
-60,10,160,2082,2045,4127,9588
-140,50,10,2108,2022,4130,9565
-90,40,-130,2069,2062,4131,9226
30,20,-120,2082,2049,4131,9532
-130,60,-10,2087,2045,4132,9331
160,40,-40,2044,2088,4132,9692
170,-30,60,2098,2034,4132,9548
20,60,110,2056,2076,4132,9650
-90,40,-110,2086,2047,4133,9175
-130,30,-20,2097,2036,4133,9301
-120,30,-50,2063,2070,4133,9517
-20,-20,-120,2046,2088,4134,9545
-40,20,140,2075,2059,4134,9617
-100,50,-130,2062,2072,4134,9364
80,-30,-120,2077,2058,4135,9613
-120,60,-20,2094,2041,4135,9377
150,50,-30,2068,2067,4135,9378
-180,70,-50,2073,2063,4136,9330
180,70,-50,2073,2063,4136,9330
40,0,170,2056,2080,4136,9273
-40,50,150,2075,2061,4136,9701
-30,-20,110,2071,2065,4136,9860
80,-20,-100,2105,2032,4137,9736
110,50,100,2084,2053,4137,9729
-170,-20,-60,2077,2062,4139,9345
-60,60,-60,2099,2040,4139,9862
120,40,10,2046,2093,4139,9554
-160,-20,-60,2100,2040,4140,9567
-30,30,140,2069,2072,4141,9596
-100,40,-120,2068,2074,4142,9421
-130,-40,60,2104,2039,4143,9375
140,0,-50,2084,2059,4143,9613
-60,-80,80,2068,2076,4144,9410
-140,50,-90,2063,2081,4144,9472
140,50,-20,2086,2058,4144,9568
60,-40,-70,2073,2071,4144,9826
-20,20,130,2098,2046,4144,9547
-110,-50,40,2066,2078,4144,9505
-160,0,-60,2087,2058,4145,9453
-40,-80,100,2067,2078,4145,9364
150,-10,-60,2090,2055,4145,9500
20,40,120,2051,2094,4145,9583
130,50,90,2096,2050,4146,9694
-130,40,-20,2122,2024,4146,9385
-120,40,-30,2102,2044,4146,9330
-130,60,0,2089,2058,4147,9505
-30,30,-100,2068,2079,4147,9601
130,60,90,2104,2043,4147,9507
-80,50,-150,2091,2056,4147,9439
-50,70,-70,2101,2046,4147,9752
30,30,-130,2114,2034,4148,9738
100,40,80,2067,2082,4149,9683
-140,30,-10,2098,2052,4150,9564
-140,30,-70,2073,2077,4150,9692
120,30,20,2050,2100,4150,9375
60,-20,-100,2070,2080,4150,9707
0,-80,-110,2068,2082,4150,9454
100,-70,-130,2046,2105,4151,9651
130,0,-40,2060,2091,4151,9450
110,-30,-10,2047,2104,4151,9621
-120,-70,10,2076,2076,4152,9313
-120,-50,100,2083,2069,4152,9401
-150,10,30,2119,2033,4152,9482
-10,-80,-120,2059,2093,4152,9579
-10,-30,130,2069,2083,4152,9550
-130,20,-40,2082,2070,4152,9538
160,-70,-80,2088,2065,4153,9506
60,70,170,2080,2073,4153,9305
130,40,80,2084,2069,4153,9787
60,-10,-120,2108,2045,4153,9827
170,-40,-70,2089,2065,4154,9699
-120,-50,10,2060,2094,4154,9825
120,60,10,2081,2073,4154,9427
-30,-80,110,2066,2088,4154,9404
40,70,90,2064,2091,4155,9582
110,-20,-70,2070,2085,4155,9536
140,-30,40,2088,2067,4155,9796
80,50,120,2100,2055,4155,9481
10,-50,-100,2063,2093,4156,9602
10,-30,150,2084,2072,4156,9358
-170,60,-60,2066,2090,4156,9442
70,50,130,2123,2033,4156,9233
-30,60,150,2093,2063,4156,9361
-80,-80,170,2085,2071,4156,9539
-10,-20,130,2082,2074,4156,9518
-90,60,-40,2114,2042,4156,9788
80,60,140,2105,2052,4157,9598
40,-10,180,2105,2052,4157,9212
10,70,120,2091,2066,4157,9661
-140,10,10,2122,2035,4157,9879
40,-10,-180,2105,2052,4157,9212
-130,70,-100,2102,2055,4157,9539
10,-70,-100,2082,2075,4157,9426
0,-40,140,2092,2065,4157,9265
-80,-50,70,2090,2068,4158,9664
20,-70,160,2085,2073,4158,9887
-140,20,0,2129,2029,4158,9607
160,-10,60,2086,2072,4158,9789
-50,60,170,2095,2064,4159,9578
-150,60,-80,2060,2099,4159,9469
-160,50,-70,2067,2093,4160,9275
-80,40,-80,2086,2074,4160,9791
-150,-70,-30,2070,2090,4160,9421
0,-30,140,2086,2074,4160,9329
-140,20,-10,2122,2039,4161,9588
-50,30,150,2096,2065,4161,9455
100,40,70,2098,2064,4162,9725
120,50,10,2051,2111,4162,9572
-130,50,-100,2058,2105,4163,9557
80,-60,-140,2063,2101,4164,9588
-60,-60,90,2089,2075,4164,9255
30,70,100,2094,2070,4164,9564
20,-10,-100,2082,2082,4164,9765
-130,-50,90,2113,2052,4165,9257
-140,10,0,2114,2051,4165,9498
150,70,-20,2098,2068,4166,9625
170,-10,60,2088,2078,4166,9710
-140,-20,30,2102,2064,4166,9573
-60,-50,90,2091,2076,4167,9302
-100,-40,70,2066,2101,4167,9333
-140,40,10,2103,2064,4167,9743
70,-20,-100,2100,2067,4167,9982
-10,-10,130,2080,2087,4167,9438
-20,-80,120,2069,2098,4167,9526
160,70,-30,2111,2056,4167,9480
-70,30,-130,2107,2061,4168,9467
170,0,60,2100,2068,4168,9568
170,50,60,2116,2053,4169,9697
-60,0,-160,2107,2062,4169,9562
-130,20,-30,2093,2077,4170,9496
-70,50,-160,2125,2045,4170,9291
-70,-60,80,2132,2038,4170,9293
-90,50,-60,2087,2084,4171,9549
170,60,60,2108,2063,4171,9572
100,-40,-20,2061,2111,4172,9854
50,0,-160,2077,2095,4172,9635
-150,40,-80,2066,2106,4172,9699
-130,-60,-10,2097,2075,4172,9448
-160,0,40,2099,2073,4172,9531
-50,-30,110,2067,2105,4172,9737
50,-10,-160,2072,2101,4173,9644
-160,30,-70,2069,2104,4173,9412
20,70,110,2116,2058,4174,9592
160,-30,-70,2086,2089,4175,9338
-90,70,-40,2107,2069,4176,9721
10,50,120,2073,2103,4176,9746
-20,0,120,2085,2091,4176,9908
-120,-60,10,2100,2076,4176,9478
90,-60,-130,2094,2082,4176,9622
80,60,70,2102,2075,4177,9421
-50,10,-130,2105,2073,4178,9518
90,-80,-140,2061,2117,4178,9691
0,10,130,2088,2090,4178,9362
80,-50,-40,2093,2085,4178,9763
-120,70,-110,2102,2077,4179,9612
-170,-30,-60,2096,2083,4179,9522
-40,60,160,2094,2086,4180,9535
140,-50,30,2083,2097,4180,9693
0,-60,-110,2084,2096,4180,9592
-60,0,-170,2098,2082,4180,9421
60,-10,-130,2094,2087,4181,9519
-70,-80,180,2089,2092,4181,9657
-20,-20,120,2106,2075,4181,9850
-70,-80,-180,2089,2092,4181,9657
90,50,110,2103,2079,4182,9574
-110,70,-120,2096,2086,4182,9611
-50,20,-110,2107,2075,4182,9745
160,-10,-60,2085,2097,4182,9580
120,80,110,2104,2078,4182,9693
-110,50,-120,2061,2121,4182,9678
-150,-50,80,2140,2042,4182,9601
180,30,-60,2099,2084,4183,9450
-50,50,-80,2096,2087,4183,9696
-180,30,-60,2099,2084,4183,9450
-70,-80,70,2097,2086,4183,9606
170,20,60,2110,2074,4184,9604
-60,10,170,2114,2070,4184,9473
-90,40,-90,2109,2075,4184,9878
-160,-30,50,2130,2055,4185,9348
-110,-40,60,2064,2121,4185,9419
50,-50,-70,2078,2108,4186,9770
-20,-30,120,2086,2101,4187,9515
-40,70,-80,2133,2054,4187,9856
90,-50,-120,2136,2051,4187,9178
110,80,120,2094,2094,4188,9644
50,40,130,2102,2086,4188,9552
-150,50,-80,2087,2102,4189,9364
-120,70,-10,2109,2080,4189,9591
-20,-80,-130,2069,2120,4189,9642
-150,0,30,2131,2059,4190,9551
-100,-40,90,2068,2122,4190,9501
140,30,70,2124,2066,4190,9814
-30,10,130,2095,2096,4191,9742
170,40,60,2131,2060,4191,9816
-140,60,-90,2088,2103,4191,9650
140,60,80,2120,2072,4192,9707
-120,30,-40,2071,2121,4192,9845
130,-30,20,2078,2115,4193,9587
0,-20,140,2102,2092,4194,9494
70,50,90,2116,2079,4195,9777
-170,-10,-60,2119,2076,4195,9490
120,-60,-110,2072,2125,4197,9810
40,20,-150,2125,2072,4197,9610
-110,60,-30,2140,2058,4198,9707
-100,-40,110,2092,2106,4198,9576
70,-40,-70,2107,2091,4198,9788
140,10,-40,2076,2123,4199,9735
-120,50,-110,2087,2113,4200,9816
-130,-80,0,2084,2116,4200,9676
170,70,-40,2095,2105,4200,9442
-150,40,10,2107,2093,4200,9636
-10,-80,130,2097,2103,4200,9688
120,20,40,2119,2082,4201,9857
-10,-40,130,2091,2110,4201,9743
60,-30,-90,2084,2118,4202,10073
-140,-40,60,2126,2076,4202,9358
-120,40,-80,2117,2086,4203,9755
20,-30,160,2106,2097,4203,9500
130,80,100,2115,2088,4203,9692
-140,-30,40,2128,2076,4204,9543
-70,-30,110,2100,2105,4205,9748
170,70,60,2122,2083,4205,9946
-160,-60,80,2137,2068,4205,9549
-170,50,-60,2093,2112,4205,9658
-60,-10,-170,2102,2103,4205,9529
-50,-50,100,2105,2100,4205,9510
30,-10,160,2100,2107,4207,9467
-60,10,180,2176,2031,4207,9615
-60,10,-180,2176,2031,4207,9615
-170,-30,60,2172,2035,4207,9570
-40,0,130,2104,2104,4208,9622
-90,-40,130,2127,2081,4208,9823
-140,60,10,2146,2063,4209,9691
100,80,130,2103,2106,4209,9781
-110,40,-50,2112,2098,4210,9814
170,30,60,2126,2084,4210,9703
-60,0,150,2104,2107,4211,9890
-60,50,-80,2122,2089,4211,9734
-80,-30,140,2120,2092,4212,9926
-130,-20,-10,2136,2076,4212,9752
-50,20,150,2096,2117,4213,9845
150,-50,40,2106,2107,4213,9797
-110,40,-40,2131,2082,4213,9704
20,20,130,2071,2142,4213,9554
-80,-60,70,2133,2081,4214,9642
0,70,130,2117,2097,4214,9606
-100,70,-130,2120,2094,4214,9543
60,-10,-140,2073,2141,4214,9958
-100,50,-50,2108,2107,4215,9531
-140,60,0,2132,2083,4215,9734
-40,-40,110,2118,2097,4215,9766
160,-60,-80,2133,2083,4216,9653
160,20,-50,2127,2090,4217,9712
-50,20,-120,2105,2112,4217,9975
120,-10,-40,2064,2153,4217,9560
120,-10,0,2072,2146,4218,9803
-160,-70,-40,2100,2119,4219,9611
-10,20,130,2086,2133,4219,9817
-170,-50,70,2140,2081,4221,9413
130,-50,-90,2101,2120,4221,9520
-60,-80,-170,2117,2104,4221,9822
140,50,80,2126,2096,4222,9992
50,-20,-100,2082,2140,4222,9873
-60,0,180,2150,2073,4223,9635
-60,0,-180,2150,2073,4223,9635
-150,-30,-50,2118,2107,4225,9614
70,60,80,2123,2102,4225,9595
-30,70,-90,2170,2056,4226,10005
130,60,0,2130,2097,4227,9810
-60,20,-140,2104,2123,4227,9467
-50,40,160,2147,2080,4227,9714
-60,-20,-170,2142,2085,4227,9652
140,-10,50,2122,2105,4227,9909
120,30,30,2087,2141,4228,9612
-90,70,-140,2126,2102,4228,9612
-30,-80,-140,2104,2124,4228,9786
-80,70,-50,2119,2110,4229,9822
90,80,140,2103,2126,4229,9786
40,30,130,2113,2116,4229,9560
-140,40,-80,2132,2098,4230,9953
-100,-40,100,2093,2137,4230,9787
30,50,110,2108,2123,4231,9918
-60,10,-150,2098,2133,4231,9831
-150,-40,60,2166,2065,4231,9546
-10,-10,-110,2125,2106,4231,10027
170,10,60,2125,2107,4232,9899
150,-50,-80,2106,2126,4232,9732
-130,70,0,2144,2089,4233,9784
-100,-40,80,2062,2172,4234,9705
-30,-60,120,2143,2091,4234,9461
-130,60,-100,2114,2122,4236,9754
30,-40,-90,2074,2162,4236,9805
140,80,90,2122,2114,4236,9826
-50,-60,100,2087,2149,4236,9442
-150,-10,-50,2104,2133,4237,9929
120,-10,-20,2119,2118,4237,9853
-170,0,-60,2145,2092,4237,9753
-170,-20,50,2150,2087,4237,9388
-140,0,10,2134,2103,4237,10006
-120,50,-30,2162,2076,4238,9822
50,0,-130,2127,2112,4239,9782
0,-80,140,2113,2126,4239,9849
-30,-20,120,2124,2115,4239,9712
-120,40,-70,2138,2101,4239,9913
70,60,150,2171,2069,4240,9907
-30,-20,-130,2090,2150,4240,9672
120,20,50,2113,2127,4240,9980
40,-30,-90,2108,2133,4241,10010
-180,10,-60,2148,2093,4241,9436
-180,-30,60,2165,2076,4241,9951
180,-30,60,2165,2076,4241,9951
180,10,-60,2148,2093,4241,9436
-50,30,-100,2125,2117,4242,9933
-10,70,140,2120,2123,4243,9522
-180,30,50,2163,2080,4243,9960
180,30,50,2163,2080,4243,9960
-80,70,-150,2119,2124,4243,9588
-80,-80,60,2124,2120,4244,9704
-140,30,-60,2148,2096,4244,9415
-60,20,-180,2145,2100,4245,9759
-150,40,0,2156,2089,4245,9457
-40,0,-130,2108,2137,4245,9563
-60,20,180,2145,2100,4245,9759
170,-70,-70,2113,2133,4246,9775
-50,-80,-160,2136,2110,4246,9884
100,-50,-110,2158,2088,4246,9524
110,-70,-120,2110,2136,4246,10029
-170,-40,-60,2117,2129,4246,9665
-170,-70,-50,2114,2133,4247,9607
90,70,50,2123,2124,4247,9750
40,50,-170,2143,2104,4247,9934
0,70,-120,2160,2087,4247,10055
-120,60,-110,2102,2146,4248,10045
-80,40,-140,2119,2130,4249,9466
-140,-50,-30,2153,2096,4249,9971
-140,50,-10,2143,2106,4249,9365
180,0,-60,2173,2076,4249,9674
-180,0,-60,2173,2076,4249,9674
-30,-40,120,2109,2141,4250,9683
-70,-20,150,2142,2108,4250,9840
50,-40,-160,2130,2120,4250,9521
30,-70,170,2129,2122,4251,9964
150,-30,-70,2131,2120,4251,9579
100,-80,-130,2093,2158,4251,9850
130,10,-20,2106,2146,4252,9850
-50,60,-70,2143,2109,4252,10375
-40,-60,110,2115,2138,4253,9474
-80,-40,150,2131,2123,4254,10116
-40,-80,-150,2128,2126,4254,9817
-40,10,-120,2133,2121,4254,10062
-80,-40,80,2103,2153,4256,9890
150,0,60,2149,2107,4256,10067
-110,-50,110,2136,2120,4256,9653
-20,50,140,2148,2109,4257,9822
90,-40,-40,2127,2131,4258,10002
-80,60,-150,2149,2109,4258,9733
-150,60,20,2181,2078,4259,9931
-60,-20,-180,2158,2101,4259,9873
-60,-20,180,2158,2101,4259,9873
-80,-60,160,2146,2113,4259,9570
-50,50,170,2168,2091,4259,9823
-40,40,150,2156,2104,4260,10001
-70,-40,90,2117,2144,4261,9858
-50,-20,120,2147,2114,4261,10039
-130,40,-80,2145,2116,4261,9897
-90,-50,140,2145,2117,4262,9928
50,40,160,2142,2121,4263,9717
-140,-80,-10,2100,2163,4263,9747
-140,-20,20,2150,2114,4264,9949
150,20,-40,2130,2134,4264,9749
-10,-60,140,2173,2091,4264,9631
180,-70,-60,2135,2130,4265,9726
-40,20,-110,2134,2131,4265,9776
-180,-70,-60,2135,2130,4265,9726
70,70,70,2143,2122,4265,9959
-70,30,-150,2174,2092,4266,9886
0,-70,-110,2151,2116,4267,9817
-110,50,-40,2148,2119,4267,9794
10,70,-130,2139,2128,4267,10119
80,-50,-130,2146,2122,4268,9738
-130,-50,80,2146,2122,4268,9644
-120,-40,40,2143,2126,4269,9818
180,50,50,2179,2091,4270,9986
-180,50,50,2179,2091,4270,9986
-150,-20,-50,2129,2142,4271,9981
-20,70,-100,2172,2099,4271,10179
90,-30,-70,2128,2143,4271,10030
120,40,20,2122,2150,4272,9697
40,0,-180,2149,2123,4272,9444
40,0,180,2149,2123,4272,9444
-140,10,-10,2190,2082,4272,9689
80,50,110,2133,2141,4274,9823
100,50,100,2174,2100,4274,9909
120,50,20,2121,2153,4274,9814
10,0,140,2125,2149,4274,9551
-80,50,-70,2136,2138,4274,9923
-150,50,10,2161,2113,4274,9814
50,-30,-90,2133,2142,4275,9832
-150,30,-70,2127,2148,4275,9974
-60,-40,100,2124,2151,4275,9983
-180,60,-50,2132,2143,4275,9781
160,50,60,2160,2115,4275,9938
-70,70,-160,2144,2131,4275,9620
180,60,-50,2132,2143,4275,9781
160,40,60,2138,2138,4276,9817
-140,0,0,2167,2109,4276,9731
-60,-20,120,2151,2125,4276,9949
150,40,-30,2167,2109,4276,10118
-30,0,130,2151,2125,4276,9807
50,70,-180,2151,2125,4276,9911
-150,30,0,2169,2107,4276,9578
50,70,180,2151,2125,4276,9911
180,-10,-60,2161,2116,4277,9758
-130,50,-20,2160,2117,4277,9804
-80,60,-50,2164,2113,4277,10154
80,80,150,2148,2129,4277,9846
-180,-10,-60,2161,2116,4277,9758
-70,60,-160,2172,2105,4277,9669
-30,0,-120,2103,2175,4278,10039
70,-20,-120,2150,2128,4278,9989
130,-40,-80,2150,2128,4278,9559
-40,30,-100,2129,2150,4279,9960
-180,40,50,2178,2101,4279,9959
-140,-10,10,2154,2125,4279,9933
180,40,50,2178,2101,4279,9959
80,-30,-80,2127,2153,4280,10153
-90,60,-50,2184,2096,4280,9817
-100,80,-30,2203,2077,4280,10152
40,10,170,2150,2131,4281,9408
-110,-70,30,2127,2154,4281,9823
-40,-20,120,2139,2142,4281,9937
-100,60,-130,2149,2133,4282,9995
150,40,70,2149,2133,4282,10128
-110,80,-20,2185,2097,4282,10129
160,30,60,2150,2132,4282,10120
50,40,140,2162,2120,4282,9590
40,10,160,2119,2164,4283,9623
90,-40,-50,2139,2145,4284,10024
-150,-80,-20,2119,2165,4284,9878
10,30,-110,2135,2150,4285,10144
10,20,130,2124,2161,4285,9864
-50,40,-90,2136,2150,4286,10077
130,-20,-70,2148,2138,4286,9855
0,-50,-110,2118,2168,4286,10129
-140,10,-40,2135,2151,4286,9677
-90,80,-40,2201,2086,4287,10204
-10,70,-110,2175,2112,4287,10160
-60,0,170,2193,2094,4287,9951
20,10,140,2158,2130,4288,9410
-100,60,-40,2204,2084,4288,9755
80,50,80,2149,2139,4288,9922
150,50,70,2151,2138,4289,9871
-50,40,170,2185,2104,4289,9711
-60,-10,180,2180,2110,4290,9635
-20,40,-100,2146,2144,4290,9979
-20,-60,130,2148,2142,4290,9546
-180,60,50,2163,2127,4290,10061
180,60,50,2163,2127,4290,10061
-60,-10,-180,2180,2110,4290,9635
-60,-30,110,2136,2154,4290,9955
-150,40,20,2174,2117,4291,9985
-40,-50,110,2161,2130,4291,9787
-180,20,-60,2156,2135,4291,9689
180,20,-60,2156,2135,4291,9689
-40,-30,-140,2169,2123,4292,9916
80,70,60,2142,2150,4292,9702
150,80,80,2168,2125,4293,9971
110,50,40,2150,2144,4294,9932
-70,-30,160,2169,2125,4294,9971
-50,-70,100,2153,2141,4294,9738
-140,-50,80,2170,2125,4295,9636
150,60,70,2163,2132,4295,9940
-60,-30,-180,2169,2126,4295,9870
-60,-30,180,2169,2126,4295,9870
90,60,60,2156,2140,4296,9525
-90,-40,80,2103,2193,4296,9820
-120,80,-10,2182,2115,4297,10207
10,-80,150,2151,2147,4298,10067
30,40,-150,2160,2138,4298,9683
-100,40,-80,2147,2151,4298,10146
-70,60,-60,2159,2139,4298,10108
-90,60,-140,2164,2135,4299,9777
40,60,100,2152,2148,4300,9926
-60,70,-170,2146,2154,4300,9806
110,-80,-120,2118,2182,4300,10011
-40,-70,110,2154,2147,4301,9734
-110,60,-120,2132,2169,4301,10095
-30,-30,120,2140,2162,4302,9780
40,60,-170,2186,2117,4303,9917
-20,70,150,2158,2145,4303,9727
-140,70,10,2164,2139,4303,10124
40,40,-170,2152,2152,4304,9913
-90,-80,50,2160,2144,4304,9892
-140,20,-50,2146,2158,4304,10096
-10,50,-100,2155,2149,4304,10167
-60,0,160,2177,2127,4304,10147
0,30,130,2122,2183,4305,9955
-90,40,-80,2134,2171,4305,10107
-70,40,-90,2160,2146,4306,9934
-180,70,50,2186,2121,4307,10178
180,70,50,2186,2121,4307,10178
100,-60,-120,2168,2139,4307,9850
10,60,120,2151,2156,4307,10063
-60,-70,-170,2149,2159,4308,10012
-30,-70,120,2154,2154,4308,9668
-70,-20,130,2154,2154,4308,9975
-160,-50,-50,2161,2147,4308,9965
70,50,120,2166,2143,4309,9710
140,-80,-90,2137,2172,4309,10016
-10,0,130,2150,2159,4309,9842
-130,-30,10,2174,2135,4309,9873
-130,70,-10,2181,2128,4309,9903
-80,40,-100,2178,2132,4310,10111
20,-80,160,2154,2156,4310,10212
-60,-70,90,2156,2154,4310,9762
90,-50,-30,2169,2142,4311,10016
-40,10,140,2144,2170,4314,10031
-40,70,170,2140,2174,4314,9959
100,70,40,2159,2156,4315,9911
-80,-30,120,2163,2153,4316,10167
-150,70,20,2186,2131,4317,10118
-70,70,-60,2189,2128,4317,10094
-110,60,-40,2194,2123,4317,10151
-130,40,-70,2187,2130,4317,10085
-60,10,-170,2202,2116,4318,10127
-90,40,-120,2141,2178,4319,10145
-140,0,-30,2149,2170,4319,9832
-50,70,-180,2148,2173,4321,9987
0,20,130,2149,2172,4321,9979
-150,50,20,2194,2127,4321,10095
-50,70,180,2148,2173,4321,9987
0,-40,-110,2132,2189,4321,10085
140,10,60,2143,2178,4321,9999
160,-40,-70,2170,2151,4321,10151
120,-80,-110,2117,2204,4321,10180
-150,30,10,2188,2134,4322,9954
-150,30,20,2175,2148,4323,10089
-20,-50,130,2173,2151,4324,9825
-40,30,150,2162,2163,4325,10042
20,60,-140,2180,2145,4325,10165
-130,-40,50,2188,2137,4325,9860
60,60,90,2166,2159,4325,10060
-120,60,-30,2195,2130,4325,10138
-80,80,-50,2221,2105,4326,10104
-160,-80,-30,2133,2193,4326,9904
-120,-50,90,2179,2147,4326,9776
-120,-50,20,2165,2161,4326,10074
170,-10,-60,2176,2150,4326,9828
-80,40,-110,2187,2140,4327,9931
180,-20,-60,2171,2157,4328,9781
-60,40,-90,2154,2174,4328,9976
-90,-60,60,2173,2155,4328,9851
-180,-20,-60,2171,2157,4328,9781
150,-80,-80,2143,2185,4328,10038
-40,60,-80,2177,2152,4329,10395
120,-30,-80,2171,2158,4329,9846
40,-70,180,2154,2176,4330,9977
0,-10,140,2201,2129,4330,9818
60,50,140,2225,2105,4330,9572
70,-50,-140,2203,2127,4330,9691
40,-70,-180,2154,2176,4330,9977
130,10,50,2167,2164,4331,10446
130,-60,-100,2155,2176,4331,10116
170,-50,-70,2173,2158,4331,9959
130,-80,-100,2130,2202,4332,10105
-60,-40,-180,2177,2155,4332,9927
-60,-40,180,2177,2155,4332,9927
50,40,150,2178,2154,4332,9640
-130,-70,0,2184,2149,4333,10016
-20,-70,130,2181,2152,4333,9713
-170,20,-60,2186,2148,4334,9690
120,60,20,2137,2197,4334,9984
50,50,170,2189,2145,4334,10012
60,-40,-80,2213,2122,4335,10049
-70,30,-140,2151,2184,4335,9779
-20,10,-110,2179,2156,4335,10208
130,0,-30,2154,2182,4336,10211
-80,60,-60,2200,2136,4336,9979
-80,40,-90,2166,2170,4336,9979
-130,30,-30,2189,2148,4337,9986
70,80,160,2182,2155,4337,10026
10,-20,150,2184,2154,4338,9649
160,80,70,2190,2148,4338,10113
160,-40,50,2190,2149,4339,10164
40,50,110,2165,2174,4339,9984
-80,-50,150,2149,2191,4340,9874
-150,0,-50,2209,2131,4340,10023
-150,-50,-40,2191,2150,4341,10069
120,30,70,2162,2179,4341,10356
-60,80,-70,2216,2125,4341,10155
-120,70,-20,2193,2148,4341,10039
-120,-60,110,2177,2164,4341,9605
60,50,150,2219,2124,4343,9955
-160,40,-70,2186,2157,4343,9811
-150,20,20,2188,2156,4344,10050
-140,50,-80,2176,2169,4345,10050
-160,-10,40,2206,2139,4345,9805
-150,10,20,2204,2142,4346,10048
-70,80,-60,2230,2117,4347,10052
-160,70,30,2209,2138,4347,10167
140,10,-30,2162,2185,4347,9955
-120,-40,50,2189,2159,4348,9912
-180,-40,60,2186,2162,4348,10010
180,-40,60,2186,2162,4348,10010
-70,-70,80,2198,2151,4349,9846
-50,-40,110,2155,2194,4349,9938
80,-40,-70,2228,2121,4349,9939
-150,80,20,2179,2170,4349,10321
-100,40,-70,2163,2186,4349,10270
-50,30,160,2175,2175,4350,10264
-60,50,-170,2227,2124,4351,9718
-10,-70,-120,2192,2159,4351,10122
-30,-50,120,2178,2174,4352,9863
-30,70,160,2202,2151,4353,9862
-60,30,-110,2174,2179,4353,10062
110,70,110,2188,2165,4353,9733
-170,-80,-40,2150,2204,4354,10008
-180,50,-50,2175,2179,4354,9898
-160,60,30,2200,2154,4354,10406
180,50,-50,2175,2179,4354,9898
-130,80,0,2202,2153,4355,10382
50,-70,-170,2173,2182,4355,10058
-130,50,-70,2202,2154,4356,10016
30,-80,170,2164,2192,4356,10224
60,70,80,2193,2163,4356,10246
30,60,-160,2223,2133,4356,10044
-100,-80,40,2169,2187,4356,9950
-160,10,-60,2177,2180,4357,9905
50,-40,-80,2162,2195,4357,10288
10,20,-110,2148,2209,4357,10117
40,-80,180,2172,2186,4358,10223
40,-80,-180,2172,2186,4358,10223
-100,-50,120,2187,2171,4358,9885
120,50,90,2203,2155,4358,10276
-10,0,-110,2185,2174,4359,10342
170,60,-40,2178,2181,4359,9940
-50,10,-140,2172,2187,4359,9782
-20,10,130,2174,2185,4359,10163
120,-20,-70,2197,2163,4360,10359
20,10,-110,2184,2176,4360,10307
140,-40,30,2166,2194,4360,10328
-120,40,-40,2191,2170,4361,10162
100,70,120,2209,2152,4361,9750
-10,-50,140,2212,2149,4361,9791
80,80,60,2179,2183,4362,9855
110,-60,-110,2183,2179,4362,9988
140,60,-10,2174,2188,4362,10276
0,50,-110,2227,2136,4363,10543
-100,50,-60,2186,2177,4363,10057
40,70,-170,2210,2154,4364,10063
60,50,100,2190,2174,4364,10173
-10,-50,-120,2149,2216,4365,10429
110,70,30,2185,2180,4365,10269
-50,80,-80,2239,2126,4365,10276
-100,70,-40,2233,2133,4366,10224
-110,70,-30,2217,2149,4366,10110
-140,80,10,2200,2167,4367,10362
-110,-60,120,2192,2175,4367,9784
160,-80,-70,2164,2203,4367,10093
130,-10,30,2181,2186,4367,10303
70,50,110,2173,2194,4367,10001
-20,-40,130,2210,2158,4368,9868
170,-60,-70,2186,2182,4368,10087
120,-10,-10,2184,2185,4369,10147
-140,0,-10,2222,2147,4369,9955
-20,40,140,2193,2176,4369,10123
170,-80,-60,2164,2206,4370,10171
120,70,100,2214,2156,4370,9771
160,0,60,2185,2185,4370,10274
-160,80,30,2193,2178,4371,10331
-30,20,140,2192,2179,4371,10165
-120,-60,20,2219,2153,4372,10035
20,0,150,2193,2179,4372,9492
-150,20,-60,2198,2174,4372,10014
170,80,60,2208,2165,4373,10338
20,-20,-100,2153,2220,4373,10278
130,40,-10,2173,2200,4373,10301
-120,50,-80,2215,2159,4374,10073
120,-20,0,2140,2234,4374,10126
-90,-40,90,2150,2224,4374,10219
-130,-30,-10,2214,2160,4374,10049
160,20,60,2207,2168,4375,10248
-60,20,-170,2203,2173,4376,10222
-60,-10,170,2241,2136,4377,10234
130,70,90,2204,2174,4378,9996
140,50,70,2191,2187,4378,10183
140,-30,-70,2178,2200,4378,10041
0,-30,-110,2156,2222,4378,10334
60,80,80,2204,2174,4378,9894
-60,60,-70,2197,2182,4379,10137
-170,10,-60,2223,2156,4379,9904
-90,-40,100,2186,2193,4379,10348
110,-40,-10,2172,2207,4379,10139
60,80,170,2197,2183,4380,10082
140,-20,40,2194,2186,4380,10416
60,-50,-150,2191,2190,4381,9908
130,-10,-50,2181,2200,4381,10025
100,-30,-60,2196,2185,4381,10172
-90,60,-60,2209,2172,4381,10169
50,80,90,2205,2177,4382,9937
70,80,70,2207,2175,4382,9871
-130,50,-90,2207,2176,4383,10242
-100,60,-50,2192,2191,4383,10188
-130,-50,-10,2185,2198,4383,10251
0,-60,150,2204,2180,4384,10095
-150,50,0,2211,2175,4386,9959
-180,20,50,2236,2150,4386,10221
-10,-20,140,2216,2170,4386,9829
-150,20,0,2231,2155,4386,9879
180,20,50,2236,2150,4386,10221
170,50,50,2211,2177,4388,10225
-10,-70,140,2189,2199,4388,9992
-140,50,-60,2223,2165,4388,10098
110,80,30,2211,2178,4389,9854
-10,-60,-120,2175,2214,4389,10086
40,-20,-100,2199,2191,4390,10405
130,50,0,2205,2185,4390,10259
120,40,80,2198,2192,4390,10252
-60,30,-120,2218,2172,4390,10129
-120,50,-90,2205,2186,4391,9923
100,80,40,2195,2196,4391,9927
-50,-10,130,2193,2198,4391,10180
-40,-70,-150,2182,2210,4392,10348
-110,50,-90,2221,2171,4392,10037
140,40,-20,2215,2177,4392,10356
-20,-10,130,2198,2194,4392,10180
160,60,-30,2212,2181,4393,9945
180,-80,-50,2181,2212,4393,10081
-110,-50,90,2183,2210,4393,10052
70,-40,-80,2230,2163,4393,9870
-180,-80,-50,2181,2212,4393,10081
-130,-60,100,2222,2172,4394,9948
40,40,120,2192,2202,4394,10196
170,30,50,2226,2168,4394,10214
-170,70,40,2232,2163,4395,10403
40,20,150,2186,2210,4396,10207
-180,80,50,2208,2188,4396,10305
180,80,50,2208,2188,4396,10305
10,-50,160,2217,2179,4396,10056
-170,80,40,2212,2184,4396,10336
130,-20,20,2179,2217,4396,10307
10,-10,150,2208,2189,4397,9847
-130,30,-50,2212,2186,4398,10252
40,10,180,2184,2214,4398,9676
130,50,80,2212,2186,4398,10465
130,30,-10,2194,2204,4398,10305
40,10,-180,2184,2214,4398,9676
70,-20,-110,2211,2188,4399,10162
140,40,70,2221,2178,4399,10495
-10,-30,140,2223,2176,4399,9856
-140,-60,-20,2208,2191,4399,10421
110,-50,-100,2207,2193,4400,9881
-50,10,150,2181,2219,4400,10180
90,80,50,2204,2196,4400,9915
-60,60,-170,2219,2182,4401,10087
-100,-60,50,2197,2205,4402,9997
30,40,120,2182,2220,4402,10070
-80,-40,140,2222,2180,4402,10236
130,0,40,2194,2209,4403,10498
-160,-50,70,2205,2198,4403,9985
-40,40,160,2236,2167,4403,9939
-150,30,-10,2213,2191,4404,9851
-110,50,-50,2194,2210,4404,10189
-140,-10,-30,2220,2184,4404,10113
-50,-70,-160,2185,2219,4404,10358
60,-70,-160,2173,2231,4404,10057
-70,-40,160,2198,2206,4404,10104
40,10,-130,2224,2181,4405,10058
0,-50,150,2218,2188,4406,9953
50,80,-180,2229,2178,4407,10171
130,30,70,2198,2209,4407,10407
-150,-10,20,2241,2166,4407,10148
50,80,180,2229,2178,4407,10171
-30,-10,-130,2171,2237,4408,10024
120,-70,-110,2194,2214,4408,10334
40,-50,-80,2214,2194,4408,10468
-40,50,160,2223,2185,4408,10090
160,60,60,2224,2185,4409,10351
-150,-10,30,2236,2173,4409,10231
-40,80,-90,2266,2144,4410,10433
-170,-60,70,2208,2202,4410,10050
-160,20,-60,2191,2219,4410,10123
170,40,50,2198,2212,4410,10132
-20,-30,130,2193,2218,4411,9901
130,20,60,2206,2205,4411,10382
60,60,160,2250,2161,4411,10280
-50,0,140,2212,2199,4411,10184
110,40,50,2218,2194,4412,10434
-20,-70,-130,2193,2219,4412,10387
30,0,-110,2203,2210,4413,10248
50,-80,-170,2203,2210,4413,10291
90,60,120,2239,2174,4413,10243
-140,20,-40,2193,2220,4413,10106
-110,-80,30,2192,2221,4413,10169
-60,40,-170,2195,2218,4413,9919
-130,60,-20,2247,2167,4414,10027
120,70,20,2219,2195,4414,10255
-70,-30,150,2236,2178,4414,10080
40,30,-170,2219,2196,4415,10131
-80,-70,70,2220,2195,4415,10038
-150,50,-70,2225,2190,4415,10107
-130,40,-60,2217,2198,4415,10242
50,70,90,2239,2177,4416,10377
40,80,100,2218,2198,4416,10089
20,-50,170,2218,2199,4417,9875
-60,30,-170,2219,2198,4417,10051
-60,-10,140,2216,2203,4419,10522
30,10,150,2210,2209,4419,9895
-130,-70,110,2197,2222,4419,10216
-120,50,-40,2222,2197,4419,10100
90,70,130,2248,2171,4419,9937
-140,40,-70,2243,2176,4419,10273
-130,40,-30,2228,2192,4420,10350
-140,60,-80,2193,2227,4420,10109
150,60,-20,2215,2206,4421,10255
-140,-40,50,2245,2177,4422,10222
-60,-10,160,2247,2176,4423,10426
-120,-50,80,2217,2207,4424,9910
-30,-70,-140,2201,2223,4424,10334
-160,-20,40,2244,2180,4424,10005
-30,50,150,2214,2211,4425,10180
120,80,20,2229,2196,4425,9924
-130,50,-30,2219,2207,4426,10272
-10,10,130,2202,2225,4427,10219
-60,10,-160,2222,2205,4427,10452
-140,20,-20,2221,2206,4427,10292
-160,-40,-50,2216,2211,4427,10159
70,-30,-90,2225,2202,4427,10435
150,10,60,2199,2228,4427,10454
-180,10,50,2239,2189,4428,9901
180,10,50,2239,2189,4428,9901
-150,-30,40,2262,2166,4428,10085
-10,80,-120,2263,2165,4428,10511
100,60,50,2202,2227,4429,9997
-80,40,-120,2228,2202,4430,10280
110,50,90,2245,2186,4431,10419
-50,-60,-160,2207,2224,4431,10438
90,-40,-60,2262,2169,4431,10071
-50,-10,-150,2244,2187,4431,10215
150,-20,50,2244,2187,4431,10332
100,-50,-20,2221,2211,4432,10367
-140,70,0,2253,2179,4432,10335
80,50,100,2204,2228,4432,10154
-180,-60,-60,2219,2214,4433,10293
180,-60,-60,2219,2214,4433,10293
0,30,-110,2211,2222,4433,10320
10,50,-120,2264,2169,4433,10516
-30,80,-100,2278,2156,4434,10468
80,60,130,2240,2194,4434,10188
-150,60,10,2225,2209,4434,10492
30,80,-160,2246,2189,4435,10375
-10,-40,140,2216,2219,4435,9821
170,30,-50,2225,2211,4436,9979
-60,70,-70,2243,2193,4436,10334
-180,-40,-60,2238,2198,4436,10272
180,-40,-60,2238,2198,4436,10272
-50,-50,-160,2231,2206,4437,10293
120,40,30,2198,2240,4438,10234
150,0,-50,2238,2201,4439,10370
-90,50,-70,2248,2191,4439,10304
0,60,130,2234,2205,4439,10433
-20,0,130,2209,2230,4439,10364
140,-50,-80,2226,2215,4441,10098
150,-40,-70,2231,2210,4441,10146
-40,-30,120,2194,2247,4441,10396
-70,50,-80,2245,2197,4442,10292
-150,40,-70,2217,2225,4442,10393
-130,50,-80,2237,2205,4442,10154
30,20,140,2203,2239,4442,10023
-30,50,-90,2238,2205,4443,10660
-170,40,-60,2222,2222,4444,10289
-130,-30,0,2253,2192,4445,10652
50,90,-180,2240,2205,4445,10541
140,90,90,2240,2205,4445,10541
-80,90,-50,2240,2205,4445,10541
90,90,140,2240,2205,4445,10541
60,90,170,2240,2205,4445,10541
40,-20,-170,2219,2226,4445,9998
70,90,160,2240,2205,4445,10541
110,-50,-10,2226,2219,4445,10309
160,90,70,2240,2205,4445,10541
-20,90,-110,2240,2205,4445,10541
0,90,-130,2240,2205,4445,10541
150,90,80,2240,2205,4445,10541
110,90,120,2240,2205,4445,10541
-50,90,-80,2240,2205,4445,10541
100,90,130,2240,2205,4445,10541
80,90,150,2240,2205,4445,10541
-30,90,-100,2240,2205,4445,10541
-130,90,0,2240,2205,4445,10541
120,90,110,2240,2205,4445,10541
130,90,100,2240,2205,4445,10541
10,90,-140,2240,2205,4445,10541
180,90,50,2240,2205,4445,10541
-100,90,-30,2240,2205,4445,10541
30,90,-160,2240,2205,4445,10541
-10,90,-120,2240,2205,4445,10541
-70,90,-60,2240,2205,4445,10541
40,90,-170,2240,2205,4445,10541
-150,90,20,2240,2205,4445,10541
-140,90,10,2240,2205,4445,10541
-40,90,-90,2240,2205,4445,10541
50,90,180,2240,2205,4445,10541
20,90,-150,2240,2205,4445,10541
0,40,130,2203,2242,4445,10446
-60,90,-70,2240,2205,4445,10541
-170,90,40,2240,2205,4445,10541
-180,90,50,2240,2205,4445,10541
-160,90,30,2240,2205,4445,10541
170,90,60,2240,2205,4445,10541
-90,90,-40,2240,2205,4445,10541
-120,90,-10,2240,2205,4445,10541
-110,90,-20,2240,2205,4445,10541
-140,-40,-30,2219,2226,4445,10215
-80,40,-130,2216,2229,4445,10318
40,0,-120,2223,2223,4446,10249
-140,20,-30,2223,2223,4446,10269
-110,40,-70,2221,2226,4447,10435
0,-70,150,2230,2217,4447,10123
0,80,-130,2265,2182,4447,10510
-140,-10,0,2228,2219,4447,10237
-150,60,-70,2231,2216,4447,10212
-20,80,-110,2275,2173,4448,10523
-110,-50,100,2263,2185,4448,10036
-140,-70,100,2219,2229,4448,10204
-40,50,-90,2203,2246,4449,10250
30,80,110,2251,2198,4449,10236
-140,10,-30,2206,2243,4449,9936
-50,20,-130,2216,2233,4449,10258
70,50,100,2219,2231,4450,10407
20,80,-150,2239,2211,4450,10418
50,-50,-160,2224,2226,4450,10256
-110,40,-60,2239,2211,4450,10444
40,-30,-170,2223,2227,4450,9999
-120,-70,120,2226,2225,4451,10262
-100,-70,140,2218,2233,4451,10139
-70,60,-70,2244,2208,4452,10316
-170,60,40,2274,2178,4452,10588
-90,70,-50,2286,2166,4452,10478
50,0,-140,2224,2229,4453,10324
-120,50,-100,2241,2212,4453,10460
-130,30,-40,2227,2227,4454,10399
-80,60,-70,2256,2199,4455,10290
0,-20,-110,2206,2249,4455,10638
-150,0,20,2255,2201,4456,10358
-30,60,-90,2277,2179,4456,10690
-180,-30,-60,2236,2221,4457,10135
60,50,120,2234,2223,4457,10145
180,-30,-60,2236,2221,4457,10135
30,70,-160,2267,2190,4457,10377
-70,-20,140,2231,2227,4458,10441
-50,-40,-160,2240,2218,4458,10403
40,20,-160,2205,2254,4459,10123
10,80,-140,2255,2204,4459,10528
40,80,-170,2256,2203,4459,10255
20,-30,-100,2191,2269,4460,10520
110,-30,-30,2210,2250,4460,10412
20,30,-120,2259,2201,4460,10579
-90,-40,120,2236,2224,4460,10581
90,50,100,2246,2215,4461,10533
-150,10,0,2280,2181,4461,10161
30,60,110,2231,2231,4462,10473
-130,-60,0,2250,2212,4462,10340
150,50,60,2244,2219,4463,9995
130,80,10,2254,2209,4463,9974
-80,-30,130,2213,2252,4465,10605
-130,-50,70,2263,2202,4465,10020
150,40,60,2246,2219,4465,10352
70,-70,-150,2229,2237,4466,10358
140,-60,-90,2230,2236,4466,10487
90,50,70,2226,2240,4466,10560
-140,60,-10,2261,2205,4466,10238
150,20,60,2234,2232,4466,10535
150,-40,40,2240,2226,4466,10428
120,-20,-40,2217,2251,4468,10013
30,30,130,2243,2225,4468,10184
100,-40,-40,2245,2223,4468,10441
-70,-60,170,2222,2247,4469,10262
-40,-20,-140,2256,2213,4469,10293
160,30,-40,2230,2240,4470,10564
120,-20,-60,2223,2247,4470,10138
100,60,110,2274,2197,4471,10424
-140,30,-20,2246,2225,4471,10130
30,-20,170,2220,2252,4472,9970
-60,-20,170,2291,2181,4472,10414
-140,10,-20,2258,2214,4472,10007
-140,-70,-10,2243,2230,4473,10392
170,20,50,2250,2224,4474,10028
40,-10,-110,2240,2234,4474,10466
-150,20,10,2247,2228,4475,10165
-30,-10,130,2238,2237,4475,10241
-160,-40,60,2283,2193,4476,10218
-140,40,-60,2268,2208,4476,10332
-80,-40,90,2197,2279,4476,10511
30,30,-140,2266,2211,4477,10427
-110,-70,130,2229,2248,4477,10309
-150,50,-60,2246,2232,4478,10076
-140,-30,30,2244,2234,4478,10171
160,10,60,2224,2254,4478,10554
-110,50,-100,2245,2233,4478,10287
-60,30,-130,2278,2200,4478,10297
140,80,0,2251,2228,4479,10200
-20,-10,-120,2239,2240,4479,10693
150,30,60,2251,2228,4479,10615
60,-80,-160,2218,2262,4480,10438
-20,-20,130,2224,2256,4480,10234
80,70,140,2247,2233,4480,10152
170,50,-40,2234,2247,4481,10224
-30,10,140,2240,2241,4481,10353
-170,-40,60,2254,2229,4483,10376
60,50,130,2242,2242,4484,10054
160,10,-50,2264,2220,4484,10286
-150,-40,50,2260,2225,4485,10104
-120,40,-50,2225,2262,4487,10342
-140,-50,70,2293,2194,4487,9926
-50,30,170,2277,2211,4488,10131
-140,0,-20,2235,2254,4489,10048
80,-60,-40,2256,2233,4489,10697
-50,30,-110,2245,2245,4490,10395
-170,20,40,2264,2227,4491,10287
-60,-20,160,2282,2209,4491,10527
-100,-60,130,2256,2235,4491,10027
-150,-20,30,2279,2213,4492,10407
-90,-40,110,2252,2240,4492,10487
90,-40,-110,2264,2228,4492,10385
-140,-20,-30,2258,2234,4492,10430
-110,50,-110,2256,2237,4493,10470
-180,-60,60,2234,2260,4494,10453
180,-60,60,2234,2260,4494,10453
120,50,30,2240,2254,4494,10394
150,80,-10,2263,2232,4495,10252
-120,-80,20,2228,2267,4495,10347
-80,70,-60,2301,2195,4496,10669
-70,-30,120,2271,2225,4496,10737
20,50,-140,2267,2229,4496,10423
110,40,80,2241,2255,4496,10681
-150,-50,70,2276,2220,4496,10305
30,50,-160,2271,2226,4497,10490
110,-30,-40,2263,2234,4497,10529
130,70,10,2269,2228,4497,10369
-50,60,-80,2257,2241,4498,10607
20,70,-150,2263,2235,4498,10614
90,70,60,2232,2266,4498,10170
140,0,50,2246,2253,4499,10727
10,-60,160,2240,2261,4501,10427
70,-50,-60,2246,2255,4501,10368
-170,-80,70,2257,2244,4501,10264
-70,40,-150,2267,2234,4501,10188
-140,50,-70,2235,2267,4502,10181
40,70,100,2266,2236,4502,10480
-50,20,160,2262,2240,4502,10338
-140,50,-20,2284,2219,4503,10268
-150,-70,90,2240,2264,4504,10338
-170,30,40,2262,2242,4504,10525
50,-30,-100,2250,2255,4505,10395
120,-50,0,2244,2262,4506,10377
-50,60,180,2253,2253,4506,10321
-170,50,40,2296,2210,4506,10639
70,70,80,2256,2250,4506,10297
-50,60,-180,2253,2253,4506,10321
-130,60,-90,2249,2258,4507,10536
-50,-50,110,2257,2250,4507,10254
30,-20,-100,2246,2261,4507,10499
-70,-50,160,2213,2294,4507,10075
140,70,80,2263,2244,4507,10458
-40,-10,130,2242,2266,4508,10288
-160,-80,80,2277,2231,4508,10404
-40,-60,-150,2249,2259,4508,10654
-140,-60,90,2264,2244,4508,10310
-150,-40,-40,2259,2250,4509,10486
-160,50,30,2284,2225,4509,10682
-160,50,-60,2242,2267,4509,10320
0,50,130,2237,2273,4510,10537
130,20,-10,2224,2286,4510,10430
50,60,100,2260,2250,4510,10492
40,20,170,2272,2238,4510,10038
180,-50,60,2257,2254,4511,10471
-180,-50,60,2257,2254,4511,10471
100,-40,-30,2258,2253,4511,10799
120,-60,-100,2256,2256,4512,10461
-150,30,-60,2266,2246,4512,10047
170,-70,50,2242,2271,4513,10357
80,50,90,2255,2258,4513,10573
-180,-80,60,2245,2268,4513,10258
-50,50,-90,2252,2261,4513,10277
180,-80,60,2245,2268,4513,10258
130,0,-20,2222,2292,4514,10476
80,-70,-140,2232,2282,4514,10658
110,40,70,2282,2232,4514,10574
-60,-30,170,2281,2233,4514,10389
70,-60,-50,2243,2271,4514,10562
40,30,140,2253,2261,4514,10524
-160,-70,80,2248,2267,4515,10411
50,0,-150,2259,2257,4516,10719
-140,-20,10,2289,2227,4516,10281
40,-90,180,2228,2289,4517,10503
-160,-90,-20,2228,2289,4517,10503
10,-90,150,2228,2289,4517,10503
-100,-90,40,2228,2289,4517,10503
-140,40,-20,2274,2243,4517,10459
160,-90,-60,2228,2289,4517,10503
-70,-90,70,2228,2289,4517,10503
60,-90,-160,2228,2289,4517,10503
-160,-20,-50,2258,2259,4517,10377
0,-90,140,2228,2289,4517,10503
170,-90,-50,2228,2289,4517,10503
140,-30,30,2256,2261,4517,10544
150,-90,-70,2228,2289,4517,10503
20,-90,160,2228,2289,4517,10503
30,-90,170,2228,2289,4517,10503
110,-90,-110,2228,2289,4517,10503
-120,-90,20,2228,2289,4517,10503
90,-90,-130,2228,2289,4517,10503
130,-90,-90,2228,2289,4517,10503
-80,-90,60,2228,2289,4517,10503
-30,-90,110,2228,2289,4517,10503
40,-90,-180,2228,2289,4517,10503
-40,-90,100,2228,2289,4517,10503
-150,-90,-10,2228,2289,4517,10503
100,-90,-120,2228,2289,4517,10503
60,50,110,2259,2258,4517,10546
-90,-90,50,2228,2289,4517,10503
-110,-90,30,2228,2289,4517,10503
80,-90,-140,2228,2289,4517,10503
70,-90,-150,2228,2289,4517,10503
-50,-90,90,2228,2289,4517,10503
-20,-90,120,2228,2289,4517,10503
180,-90,-40,2228,2289,4517,10503
-130,-90,10,2228,2289,4517,10503
80,70,70,2262,2255,4517,10181
50,-90,-170,2228,2289,4517,10503
140,-90,-80,2228,2289,4517,10503
-140,-90,0,2228,2289,4517,10503
-170,-90,-30,2228,2289,4517,10503
120,-90,-100,2228,2289,4517,10503
-180,-90,-40,2228,2289,4517,10503
-60,-90,80,2228,2289,4517,10503
-10,-90,130,2228,2289,4517,10503
-170,30,-60,2256,2262,4518,10287
120,-20,-50,2222,2297,4519,10143
-130,-40,20,2263,2256,4519,10545
120,30,40,2257,2262,4519,10486
-30,40,150,2275,2244,4519,10431
80,-50,-50,2241,2279,4520,10542
70,-30,-130,2270,2250,4520,10706
120,-50,-90,2256,2265,4521,10257
-110,50,-80,2261,2260,4521,10543
-160,-30,-50,2266,2256,4522,10232
-70,40,-100,2274,2248,4522,10529
-130,-80,10,2244,2278,4522,10426
-180,-10,50,2277,2245,4522,10169
180,-10,50,2277,2245,4522,10169
160,40,50,2282,2240,4522,10205
0,-40,150,2278,2245,4523,10173
20,80,120,2282,2241,4523,10397
10,10,-110,2233,2290,4523,10730
110,-30,-20,2266,2258,4524,10613
-130,60,-30,2287,2237,4524,10451
-170,10,40,2271,2254,4525,10239
-10,60,140,2256,2269,4525,10457
120,30,60,2253,2273,4526,10818
130,-70,-100,2242,2284,4526,10806
40,-40,-170,2259,2267,4526,10201
-90,-70,150,2267,2260,4527,10194
-170,-70,70,2240,2287,4527,10532
-170,40,40,2299,2229,4528,10677
90,-30,-80,2264,2264,4528,10429
-150,10,-50,2269,2259,4528,10588
110,60,100,2289,2239,4528,10714
-40,10,-130,2260,2268,4528,10439
140,20,60,2260,2269,4529,10740
40,30,-180,2260,2270,4530,10225
40,30,180,2260,2270,4530,10225
-180,0,50,2288,2243,4531,10448
180,0,50,2288,2243,4531,10448
20,50,120,2276,2255,4531,10619
120,-20,-30,2254,2277,4531,10608
-140,30,-50,2276,2256,4532,10379
-90,-70,60,2268,2264,4532,10360
100,-30,-90,2259,2274,4533,10721
10,60,-130,2296,2237,4533,10718
-40,-40,120,2232,2301,4533,10213
-60,40,-100,2289,2244,4533,10527
-120,50,-70,2288,2246,4534,10571
-50,50,-180,2279,2255,4534,10259
-50,50,180,2279,2255,4534,10259
-150,-80,90,2269,2266,4535,10308
-60,20,-150,2289,2246,4535,10397
-60,-50,180,2276,2260,4536,10290
-10,-40,-120,2253,2283,4536,10695
-60,-50,-180,2276,2260,4536,10290
40,20,160,2267,2270,4537,10307
-20,-60,-130,2288,2249,4537,10646
-170,50,-50,2260,2278,4538,10478
-80,50,-80,2304,2234,4538,10408
-160,60,-60,2259,2280,4539,10351
-140,30,-30,2283,2257,4540,10633
120,50,80,2301,2239,4540,10674
-130,-40,-10,2278,2262,4540,10526
-110,-50,70,2270,2271,4541,10518
70,-80,-150,2232,2309,4541,10564
-140,-30,-30,2240,2303,4543,10744
40,40,-180,2281,2262,4543,10294
100,-40,-100,2283,2260,4543,10273
40,40,180,2281,2262,4543,10294
-60,-10,150,2271,2274,4545,10574
-50,70,-80,2311,2235,4546,10772
-50,-30,120,2283,2263,4546,10433
120,-30,0,2269,2277,4546,10551
-170,-60,-50,2272,2275,4547,10574
-60,60,-80,2273,2275,4548,10658
40,20,-180,2259,2289,4548,10275
-130,-40,40,2281,2267,4548,10525
40,20,180,2259,2289,4548,10275
90,-70,-130,2253,2296,4549,10748
160,20,50,2262,2287,4549,10620
-20,30,140,2272,2277,4549,10700
-10,10,-110,2276,2273,4549,10562
-150,0,0,2302,2247,4549,10583
130,40,0,2274,2276,4550,10654
-90,-60,140,2277,2273,4550,10206
-150,40,-10,2280,2271,4551,10118
150,-20,-60,2320,2231,4551,10402
-120,-70,20,2267,2285,4552,10346
-40,-10,-140,2271,2281,4552,10406
-30,20,-110,2308,2244,4552,10791
-90,-50,130,2302,2251,4553,10283
-100,50,-110,2296,2257,4553,10496
0,20,-110,2244,2309,4553,10572
180,-50,-60,2278,2276,4554,10608
-60,-50,100,2278,2276,4554,10600
-100,50,-100,2267,2287,4554,10487
-180,-50,-60,2278,2276,4554,10608
-90,50,-130,2246,2309,4555,10408
30,-50,180,2297,2258,4555,10324
50,-40,-90,2325,2230,4555,10789
30,-50,-180,2297,2258,4555,10324
20,-60,170,2305,2251,4556,10451
-150,10,10,2311,2245,4556,10583
20,60,-150,2318,2238,4556,10558
130,60,10,2265,2291,4556,10552
160,80,-20,2289,2267,4556,10431
-120,-50,30,2295,2262,4557,10338
90,-30,-100,2306,2251,4557,10822
30,70,110,2286,2271,4557,10710
110,60,40,2259,2298,4557,10335
-100,50,-120,2265,2293,4558,10528
-70,40,-110,2292,2267,4559,10560
-160,50,-50,2298,2262,4560,10100
20,-20,160,2292,2270,4562,10396
-20,60,150,2276,2286,4562,10510
-150,50,-50,2303,2260,4563,10495
-40,20,150,2277,2287,4564,10623
170,-80,50,2274,2291,4565,10419
10,-70,160,2290,2275,4565,10398
160,-50,-70,2263,2302,4565,10565
-70,60,-80,2299,2266,4565,10373
170,10,50,2302,2264,4566,10555
-20,20,140,2287,2279,4566,10391
-160,40,30,2334,2232,4566,10697
70,70,150,2295,2271,4566,10465
100,-40,-50,2336,2230,4566,10528
70,90,70,2298,2269,4567,10415
-90,90,-130,2298,2269,4567,10415
110,90,30,2298,2269,4567,10415
-160,90,-60,2298,2269,4567,10415
40,90,100,2298,2269,4567,10415
-140,90,-80,2298,2269,4567,10415
80,90,60,2298,2269,4567,10415
170,90,-30,2298,2269,4567,10415
-10,90,150,2298,2269,4567,10415
20,90,120,2298,2269,4567,10415
-130,90,-90,2298,2269,4567,10415
50,90,90,2298,2269,4567,10415
10,90,130,2298,2269,4567,10415
-150,90,-70,2298,2269,4567,10415
90,90,50,2298,2269,4567,10415
160,90,-20,2298,2269,4567,10415
0,90,140,2298,2269,4567,10415
120,90,20,2298,2269,4567,10415
-50,90,-170,2298,2269,4567,10415
-30,90,170,2298,2269,4567,10415
130,90,10,2298,2269,4567,10415
-80,90,-140,2298,2269,4567,10415
140,90,0,2298,2269,4567,10415
-70,90,-150,2298,2269,4567,10415
-60,90,-160,2298,2269,4567,10415
-110,90,-110,2298,2269,4567,10415
60,90,80,2298,2269,4567,10415
180,90,-40,2298,2269,4567,10415
-120,90,-100,2298,2269,4567,10415
-180,90,-40,2298,2269,4567,10415
-40,90,-180,2298,2269,4567,10415
-40,90,180,2298,2269,4567,10415
-170,90,-50,2298,2269,4567,10415
100,90,40,2298,2269,4567,10415
-100,90,-120,2298,2269,4567,10415
-20,90,160,2298,2269,4567,10415
30,90,110,2298,2269,4567,10415
150,90,-10,2298,2269,4567,10415
-150,-20,-40,2309,2259,4568,10695
-150,-60,-30,2257,2311,4568,10766
-40,60,170,2272,2297,4569,10423
140,0,-40,2271,2298,4569,10633
-100,-50,100,2282,2287,4569,10242
-40,-50,120,2285,2284,4569,10336
-60,-20,130,2287,2282,4569,10751
170,80,-30,2294,2275,4569,10555
-150,20,-10,2303,2267,4570,10356
-140,-30,20,2302,2268,4570,10605
-120,60,-40,2310,2260,4570,10643
0,-30,150,2316,2254,4570,10197
-60,-40,170,2270,2301,4571,10493
-130,40,-40,2280,2291,4571,10705
160,-70,40,2274,2298,4572,10633
0,0,140,2297,2275,4572,10555
100,70,50,2269,2303,4572,10166
60,-40,-90,2306,2266,4572,10394
60,-60,-60,2266,2306,4572,10685
-160,40,10,2319,2253,4572,10177
-30,40,-100,2280,2292,4572,10633
160,50,-30,2289,2284,4573,10545
180,-70,60,2269,2305,4574,10611
-180,-70,60,2269,2305,4574,10611
-180,40,-50,2289,2286,4575,10564
70,-50,-70,2316,2259,4575,10576
180,40,-50,2289,2286,4575,10564
10,80,130,2302,2274,4576,10578
-140,-40,40,2330,2247,4577,10378
-140,80,-80,2305,2272,4577,10832
-140,-80,100,2292,2285,4577,10389
60,70,90,2276,2302,4578,10361
-120,70,-30,2312,2267,4579,10696
90,50,90,2296,2283,4579,10645
140,50,-10,2267,2312,4579,10842
170,-20,-60,2321,2260,4581,10474
-30,60,160,2298,2283,4581,10549
140,-10,-50,2303,2278,4581,10547
-80,-40,100,2300,2282,4582,10742
120,-40,0,2280,2303,4583,10800
-30,-60,-140,2310,2273,4583,10718
-50,30,-120,2304,2279,4583,10503
-120,40,-60,2294,2289,4583,10716
-150,-30,-40,2289,2294,4583,10605
50,50,160,2321,2263,4584,10528
-100,50,-90,2285,2299,4584,10661
-140,60,-20,2315,2270,4585,10736
30,10,-120,2291,2294,4585,10431
-120,60,-100,2313,2272,4585,10835
-20,60,-100,2331,2254,4585,11137
-50,-30,-160,2319,2266,4585,10681
170,60,50,2315,2270,4585,10893
-180,-20,50,2311,2275,4586,10238
180,-20,50,2311,2275,4586,10238
-60,50,-90,2284,2303,4587,10754
-80,-70,160,2280,2307,4587,10546
-150,-20,20,2324,2263,4587,10319
110,-30,-50,2289,2298,4587,10603
-180,80,-40,2292,2296,4588,10668
180,80,-40,2292,2296,4588,10668
150,30,-30,2297,2291,4588,10849
10,70,-140,2330,2259,4589,10735
-150,80,-70,2301,2288,4589,10923
-150,40,-60,2341,2249,4590,10679
-170,-30,50,2341,2249,4590,10293
0,70,-130,2359,2232,4591,10728
-10,-10,140,2300,2291,4591,10318
30,-50,-90,2298,2293,4591,10953
140,-10,40,2291,2301,4592,10684
130,-50,10,2305,2287,4592,10627
-100,-50,110,2296,2296,4592,10419
40,-10,-170,2290,2302,4592,10402
-110,60,-50,2307,2285,4592,10812
-110,70,-40,2307,2285,4592,10804
-40,-60,120,2321,2271,4592,10351
130,50,10,2301,2292,4593,10476
-70,-40,150,2300,2293,4593,10431
90,-60,-30,2314,2279,4593,10777
40,-50,-170,2311,2283,4594,10474
-30,-50,130,2309,2285,4594,10365
130,60,80,2288,2307,4595,10535
120,60,90,2309,2286,4595,10816
-160,30,10,2339,2256,4595,10535
150,70,70,2304,2291,4595,10907
140,70,0,2299,2296,4595,10677
130,0,30,2317,2279,4596,11051
160,-20,-60,2301,2295,4596,10463
-150,60,0,2284,2312,4596,10617
-160,30,-60,2325,2272,4597,10592
-160,50,20,2318,2279,4597,10815
-160,30,30,2331,2267,4598,10651
-150,70,-70,2296,2302,4598,10749
0,40,-110,2307,2291,4598,11124
-50,20,170,2325,2273,4598,10612
-160,40,20,2325,2274,4599,10675
20,60,120,2330,2269,4599,10874
-10,20,-110,2284,2316,4600,10632
100,-30,-70,2310,2290,4600,10626
-170,-10,40,2308,2292,4600,10566
-140,-80,0,2282,2319,4601,10612
-130,-40,10,2324,2277,4601,10739
-130,80,-90,2308,2293,4601,10804
180,50,40,2335,2266,4601,10530
-180,50,40,2335,2266,4601,10530
-140,30,-40,2307,2294,4601,10546
110,40,60,2321,2281,4602,10845
-60,60,-90,2339,2263,4602,10699
-70,70,-70,2359,2245,4604,10864
-100,60,-60,2334,2270,4604,10853
-10,-30,-120,2284,2320,4604,10664
60,-20,-110,2321,2283,4604,10755
-140,60,-60,2315,2289,4604,10462
-130,60,-70,2296,2309,4605,10471
-110,-50,80,2300,2306,4606,10526
-70,-50,90,2317,2289,4606,10795
-60,20,-160,2322,2285,4607,10713
110,70,40,2272,2336,4608,10227
-30,-20,130,2274,2334,4608,10596
90,-60,-120,2332,2277,4609,10398
-140,40,-30,2314,2295,4609,10762
-160,80,-60,2305,2304,4609,10886
-160,-60,-40,2300,2309,4609,10792
180,40,40,2352,2259,4611,10672
-50,20,-140,2322,2289,4611,10364
-120,80,-100,2306,2305,4611,10831
-30,-80,120,2309,2302,4611,10700
-180,40,40,2352,2259,4611,10672
-70,-40,100,2270,2342,4612,10654
-90,-50,70,2293,2319,4612,10804
-170,0,40,2326,2287,4613,10394
160,-80,40,2297,2316,4613,10562
-20,-50,140,2351,2262,4613,10425
-150,-70,-20,2278,2335,4613,10653
-160,-30,40,2348,2265,4613,10436
80,-40,-120,2298,2315,4613,10639
-40,20,-120,2311,2303,4614,10710
70,60,140,2323,2291,4614,10621
-150,10,-10,2362,2253,4615,10528
50,-10,-120,2328,2288,4616,10830
40,10,-140,2325,2291,4616,10669
50,-60,-70,2292,2324,4616,10798
40,-30,-100,2349,2267,4616,10725
160,30,50,2331,2285,4616,10462
10,30,130,2281,2336,4617,10771
-100,80,-40,2350,2267,4617,10870
50,50,110,2322,2295,4617,10677
-100,-50,60,2281,2336,4617,10834
160,-30,50,2313,2304,4617,11081
140,60,70,2325,2293,4618,10667
-40,30,160,2320,2298,4618,10556
150,-70,30,2288,2331,4619,10820
20,70,120,2342,2277,4619,10832
-160,70,-60,2308,2311,4619,10679
60,-50,-70,2283,2336,4619,10768
150,50,-20,2316,2303,4619,10536
-110,80,-30,2333,2288,4621,10920
80,-80,-140,2266,2355,4621,10739
-30,-60,130,2341,2280,4621,10509
-130,50,-40,2321,2300,4621,10791
-120,-50,70,2343,2279,4622,10563
-130,-80,110,2320,2303,4623,10522
170,-60,50,2296,2328,4624,10706
130,-40,10,2327,2297,4624,10768
-20,-50,-130,2278,2346,4624,10844
0,10,-110,2281,2344,4625,10927
130,40,70,2308,2317,4625,10851
40,50,-180,2325,2301,4626,10655
40,50,180,2325,2301,4626,10655
-40,40,-100,2293,2333,4626,10968
-160,60,20,2347,2279,4626,10902
-160,40,-60,2331,2296,4627,10661
20,40,-130,2344,2283,4627,10710
150,-60,-80,2310,2317,4627,10812
140,-20,30,2315,2312,4627,10838
-60,-80,90,2291,2337,4628,10661
130,30,0,2292,2336,4628,10723
50,-60,-160,2330,2298,4628,10689
80,-50,-60,2344,2284,4628,10891
40,-40,-90,2307,2321,4628,10727
-100,70,-50,2334,2294,4628,10908
120,30,50,2365,2264,4629,10874
170,-30,-60,2333,2296,4629,10642
-180,70,-40,2288,2342,4630,10621
170,20,-50,2328,2302,4630,10627
-150,70,10,2325,2305,4630,10989
180,70,-40,2288,2342,4630,10621
-110,-60,40,2301,2329,4630,10542
-40,50,170,2344,2287,4631,10664
20,0,-110,2303,2328,4631,10830
140,-70,20,2316,2316,4632,10785
90,-50,-40,2323,2309,4632,10983
140,-70,-90,2295,2337,4632,11085
-130,70,-20,2346,2286,4632,10929
-150,-10,-40,2327,2306,4633,10795
-30,-40,130,2300,2333,4633,10425
50,50,150,2353,2280,4633,10408
-130,50,-60,2331,2302,4633,10836
80,-30,-110,2331,2303,4634,10909
0,-20,150,2329,2305,4634,10230
20,-70,170,2327,2307,4634,10690
-120,-50,60,2346,2288,4634,10741
-80,-50,80,2333,2301,4634,10839
100,-60,-20,2323,2312,4635,10711
-50,40,-100,2309,2327,4636,10727
-20,70,-110,2362,2274,4636,11106
-170,80,-50,2325,2312,4637,10881
120,-20,-10,2289,2348,4637,10800
0,0,-110,2309,2328,4637,10675
-140,40,-50,2324,2313,4637,10820
50,60,170,2341,2297,4638,10916
130,10,40,2321,2317,4638,11079
40,30,170,2348,2291,4639,10537
10,-40,160,2339,2300,4639,10496
40,-70,-170,2331,2308,4639,10757
170,70,-30,2294,2345,4639,10696
-110,80,-110,2312,2328,4640,10892
-30,10,-120,2322,2318,4640,10837
-50,10,160,2308,2332,4640,10720
-90,80,-50,2357,2283,4640,10868
0,60,-120,2349,2291,4640,11082
20,-40,-100,2312,2329,4641,11082
40,30,160,2340,2301,4641,10376
-50,0,-150,2347,2294,4641,10433
-120,-80,120,2336,2305,4641,10659
-50,-80,100,2290,2352,4642,10659
-40,-80,110,2302,2341,4643,10731
-150,0,10,2347,2296,4643,10896
-10,30,-110,2303,2340,4643,10852
-150,20,-30,2321,2322,4643,10472
-140,70,-80,2333,2310,4643,10679
80,-60,-130,2342,2301,4643,10436
-160,-40,50,2375,2269,4644,10292
-150,60,-60,2320,2324,4644,10259
150,-80,30,2322,2322,4644,10724
-150,-20,10,2374,2270,4644,10599
140,30,-20,2316,2328,4644,11070
-50,-60,110,2339,2305,4644,10388
-180,20,40,2395,2250,4645,10680
-60,-30,120,2321,2324,4645,10858
-80,50,-140,2325,2320,4645,10518
180,20,40,2395,2250,4645,10680
-10,60,-110,2360,2285,4645,11101
-100,-70,50,2320,2326,4646,10806
50,70,100,2328,2318,4646,10664
30,-70,-180,2350,2297,4647,10764
40,20,-170,2325,2322,4647,10528
-130,40,-50,2302,2345,4647,11000
30,-70,180,2350,2297,4647,10764
-170,70,-50,2314,2333,4647,10614
-100,50,-70,2370,2278,4648,10921
150,0,50,2320,2328,4648,10867
-120,80,-20,2346,2303,4649,10970
130,-10,20,2311,2338,4649,10957
-60,-30,160,2332,2318,4650,10816
-40,70,-90,2378,2273,4651,11100
-90,50,-80,2356,2295,4651,10832
-30,30,150,2324,2327,4651,10658
-50,0,150,2342,2309,4651,10854
-10,70,-120,2369,2283,4652,10951
100,50,60,2330,2322,4652,10798
-50,70,-90,2354,2298,4652,11169
60,-20,-140,2301,2352,4653,10973
-40,30,-110,2340,2313,4653,10942
0,80,140,2338,2315,4653,10704
-60,70,-80,2360,2294,4654,11137
-150,0,-40,2327,2328,4655,10863
-180,30,40,2359,2297,4656,10772
150,70,-10,2317,2339,4656,10645
180,30,40,2359,2297,4656,10772
-80,80,-60,2370,2286,4656,10906
-10,50,140,2312,2344,4656,10842
-130,-40,30,2321,2335,4656,10619
-110,50,-60,2353,2304,4657,10727
-130,60,-80,2317,2341,4658,10492
130,-60,-90,2331,2327,4658,10794
-140,-10,-20,2367,2292,4659,10817
-120,50,-50,2332,2328,4660,10855
170,40,-40,2336,2325,4661,10971
150,10,-40,2315,2346,4661,10883
-60,-20,150,2367,2294,4661,11123
30,40,-160,2366,2295,4661,10567
30,-30,-100,2329,2332,4661,10997
40,-60,-170,2341,2320,4661,10628
-150,-80,-10,2310,2352,4662,10806
-30,0,-130,2341,2321,4662,10952
-90,50,-100,2340,2323,4663,10910
-20,20,-110,2322,2341,4663,10784
-140,-10,-10,2387,2276,4663,10826
-150,-10,10,2363,2300,4663,10866
10,10,140,2323,2340,4663,10476
140,30,60,2316,2347,4663,10929
120,60,30,2313,2350,4663,10682
-50,-20,130,2338,2326,4664,11142
-80,-40,110,2353,2312,4665,10960
-20,-80,130,2344,2322,4666,10817
-170,-50,60,2348,2319,4667,10723
-30,70,-100,2368,2299,4667,11146
-40,0,140,2326,2341,4667,10748
-90,70,-60,2367,2300,4667,11044
-20,50,-100,2345,2323,4668,11164
-150,-30,30,2369,2300,4669,10702
40,40,130,2324,2347,4671,10785
160,10,50,2338,2334,4672,10849
40,-60,-80,2328,2345,4673,11071
-140,60,-70,2304,2369,4673,10351
-40,-20,130,2358,2315,4673,10819
30,-40,-180,2319,2354,4673,10504
30,-40,180,2319,2354,4673,10504
-70,-80,80,2317,2357,4674,10791
60,70,160,2348,2326,4674,10844
30,20,-130,2391,2283,4674,11107
-100,-50,90,2340,2335,4675,10855
-60,-60,100,2362,2313,4675,10492
150,-10,50,2326,2349,4675,11011
-70,80,-70,2371,2305,4676,10904
-160,-10,-50,2363,2314,4677,10759
110,-60,-10,2313,2364,4677,10798
-50,40,180,2353,2326,4679,10424
-50,40,-180,2353,2326,4679,10424
-10,-80,140,2345,2334,4679,10809
-90,80,-130,2356,2323,4679,10944
-100,-50,80,2322,2357,4679,10571
-90,60,-70,2367,2312,4679,11203
-140,-20,0,2367,2312,4679,10811
-180,10,40,2382,2298,4680,10677
180,10,40,2382,2298,4680,10677
-110,-50,50,2335,2346,4681,10937
-120,60,-90,2339,2342,4681,10489
-100,80,-120,2347,2334,4681,10954
170,-50,50,2331,2350,4681,10667
-70,50,-90,2384,2298,4682,10908
100,-70,-120,2313,2369,4682,10931
160,-60,40,2323,2360,4683,11030
90,60,110,2351,2333,4684,10836
30,-60,180,2369,2315,4684,10517
-130,-50,0,2371,2313,4684,11022
30,-60,-180,2369,2315,4684,10517
-110,-80,130,2362,2322,4684,10774
60,-50,-80,2353,2332,4685,10791
80,80,70,2318,2368,4686,10541
-140,-50,60,2379,2307,4686,10503
-40,60,-90,2345,2341,4686,11115
-80,-50,140,2351,2335,4686,10465
160,70,-20,2335,2352,4687,10782
-150,50,-10,2362,2325,4687,10661
40,60,110,2360,2328,4688,10921
-50,10,170,2359,2329,4688,10942
20,30,130,2343,2345,4688,10938
-150,30,-20,2366,2322,4688,10666
90,50,80,2373,2315,4688,10956
160,0,-50,2351,2338,4689,11004
130,-70,10,2350,2339,4689,10764
-130,-40,0,2375,2314,4689,11192
140,10,50,2340,2349,4689,11173
30,30,-150,2339,2350,4689,10566
40,0,-170,2327,2363,4690,10658
-140,50,-30,2367,2324,4691,10862
60,-30,-100,2333,2358,4691,11038
-30,-30,130,2363,2328,4691,10758
140,60,0,2348,2344,4692,10894
130,-10,-30,2309,2383,4692,10839
-130,70,-90,2359,2334,4693,10788
110,-40,-90,2341,2352,4693,10703
-100,-50,70,2340,2353,4693,10643
30,0,160,2351,2342,4693,10776
150,20,-30,2357,2336,4693,10906
-160,20,30,2363,2330,4693,10983
20,-40,170,2353,2340,4693,10662
120,70,30,2317,2377,4694,10433
50,-20,-110,2323,2372,4695,11160
100,50,90,2368,2327,4695,11225
-110,60,-110,2349,2347,4696,10965
-140,-60,-10,2336,2360,4696,10902
140,-60,20,2332,2365,4697,10895
-60,-40,110,2346,2351,4697,10991
20,50,-150,2388,2310,4698,10714
80,-30,-90,2384,2314,4698,11111
170,-40,-60,2357,2341,4698,10992
70,80,80,2333,2365,4698,10589
-40,-50,-150,2364,2335,4699,11144
-30,50,160,2388,2311,4699,10846
60,80,90,2335,2365,4700,10624
150,-70,-80,2342,2358,4700,11078
-150,20,-50,2381,2320,4701,10853
-50,0,160,2366,2335,4701,11011
0,-10,-110,2357,2344,4701,11267
-160,50,-40,2360,2342,4702,10624
130,20,50,2344,2358,4702,11184
-150,40,-50,2394,2309,4703,10902
130,-20,-60,2309,2394,4703,10641
50,-70,-160,2359,2345,4704,10755
140,-20,-60,2318,2387,4705,10945
-120,70,-100,2357,2348,4705,10900
-170,-20,40,2357,2348,4705,10564
-60,80,-80,2390,2316,4706,11028
90,-50,-60,2383,2323,4706,10698
120,-20,-20,2331,2376,4707,10730
-150,-30,20,2372,2335,4707,10834
140,20,-20,2345,2362,4707,10800
100,60,100,2361,2347,4708,10939
80,60,120,2356,2352,4708,11004
-40,0,-140,2345,2364,4709,10826
-160,40,-50,2411,2299,4710,10932
-150,-10,0,2400,2310,4710,10702
160,-10,50,2358,2353,4711,11012
-50,-20,-160,2371,2340,4711,10860
-170,60,-50,2365,2347,4712,10790
-30,50,-100,2349,2363,4712,10920
90,-80,-130,2339,2373,4712,10990
60,60,150,2361,2351,4712,11082
-50,60,-90,2345,2368,4713,11007
60,-60,-150,2385,2328,4713,10976
-80,-80,70,2326,2387,4713,10962
-160,10,30,2405,2309,4714,10897
-130,80,-10,2372,2342,4714,11224
-140,-50,-20,2380,2334,4714,11327
40,-20,-110,2370,2345,4715,11019
-20,-30,140,2363,2352,4715,10547
50,80,100,2359,2357,4716,10665
-150,0,-10,2409,2307,4716,10687
160,40,-30,2371,2345,4716,10868
-150,-60,80,2367,2349,4716,10733
-120,60,-70,2403,2314,4717,10938
130,-80,10,2375,2343,4718,10933
140,-80,20,2370,2348,4718,10897
-160,-70,-30,2317,2401,4718,10873
-40,10,150,2348,2370,4718,10996
120,-80,0,2380,2339,4719,11064
150,10,50,2378,2341,4719,10763
-170,50,-40,2392,2328,4720,10695
-160,30,0,2370,2351,4721,10697
-120,-60,100,2366,2355,4721,10779
-150,-40,40,2400,2322,4722,11022
-40,70,-100,2389,2333,4722,11176
0,-80,150,2362,2360,4722,10815
-40,60,-100,2364,2358,4722,11085
-20,50,150,2357,2365,4722,10936
-20,0,-120,2355,2368,4723,10933
70,-60,-140,2389,2334,4723,10681
-170,50,30,2373,2350,4723,11301
-160,-80,-20,2352,2372,4724,10921
-100,-80,140,2372,2353,4725,10847
160,70,60,2409,2316,4725,11284
-80,70,-70,2363,2362,4725,11019
120,-60,0,2333,2392,4725,10924
-120,60,-80,2359,2367,4726,10849
-20,-20,140,2363,2363,4726,10707
-140,40,-40,2382,2344,4726,11016
140,0,40,2378,2349,4727,11260
-180,50,-40,2358,2369,4727,10880
40,10,-170,2362,2365,4727,10789
180,50,-40,2358,2369,4727,10880
-80,80,-140,2372,2355,4727,11061
-90,-50,120,2349,2379,4728,10941
-150,20,-40,2370,2358,4728,10582
150,-30,40,2347,2381,4728,11030
-70,40,-120,2383,2345,4728,10780
-50,80,-90,2403,2325,4728,10937
-70,-60,90,2356,2373,4729,10793
160,50,50,2378,2351,4729,10938
50,50,120,2376,2353,4729,10899
-150,40,-40,2388,2341,4729,11033
-10,80,150,2378,2352,4730,10872
130,-60,10,2345,2386,4731,10962
90,80,60,2353,2378,4731,10580
90,-50,-50,2390,2342,4732,11022
140,0,-30,2351,2381,4732,10809
160,20,-40,2361,2371,4732,11162
-170,-40,-50,2379,2354,4733,11048
-20,-40,140,2383,2351,4734,10575
-30,0,140,2379,2355,4734,11088
130,20,0,2346,2389,4735,10810
150,-60,30,2382,2353,4735,11048
-160,0,-50,2378,2358,4736,11086
160,0,40,2363,2373,4736,10719
-140,-30,10,2385,2352,4737,11124
110,-40,-20,2384,2353,4737,11143
110,60,90,2377,2360,4737,10865
10,70,130,2390,2348,4738,10925
170,30,40,2395,2344,4739,10813
10,0,150,2387,2352,4739,10555
-20,-40,-130,2366,2374,4740,10984
160,-20,50,2384,2356,4740,10975
-60,30,-160,2396,2345,4741,11074
-20,10,140,2365,2376,4741,10927
-160,0,30,2405,2336,4741,11055
-170,40,-50,2366,2375,4741,11034
-160,50,10,2406,2335,4741,10798
150,20,50,2356,2385,4741,11180
160,-70,-70,2374,2368,4742,11187
-90,-80,60,2345,2397,4742,10916
-40,50,-100,2366,2377,4743,11018
120,-70,0,2359,2384,4743,11194
-30,20,150,2404,2339,4743,10929
60,-70,-150,2380,2364,4744,10963
-60,-60,180,2380,2364,4744,10822
-50,30,-180,2392,2352,4744,10774
-50,30,180,2392,2352,4744,10774
-60,-60,-180,2380,2364,4744,10822
-90,50,-90,2375,2370,4745,11226
-70,50,-150,2388,2357,4745,10700
-110,50,-70,2384,2362,4746,11330
30,-60,-90,2379,2368,4747,11164
30,50,120,2384,2363,4747,10993
140,-40,20,2360,2387,4747,10948
150,-10,-50,2358,2390,4748,11121
130,10,30,2406,2343,4749,11155
140,-40,-70,2399,2350,4749,10853
140,40,-10,2373,2376,4749,11304
170,20,40,2395,2355,4750,10638
-160,20,0,2383,2368,4751,10711
100,80,50,2378,2374,4752,10603
10,0,-110,2340,2412,4752,11154
130,-10,-40,2344,2409,4753,10543
-150,10,-40,2362,2392,4754,10867
-70,80,-150,2385,2369,4754,11139
-160,40,0,2389,2365,4754,10940
-150,40,-20,2402,2352,4754,10883
10,-80,160,2381,2374,4755,11055
-130,-70,10,2369,2386,4755,10864
-80,-60,150,2373,2382,4755,10609
-90,-50,110,2377,2378,4755,11001
-130,-60,90,2408,2349,4757,10775
140,50,0,2369,2388,4757,10914
-20,-30,-130,2361,2397,4758,11042
10,60,-140,2415,2343,4758,11318
-70,70,-80,2387,2371,4758,11108
40,30,150,2381,2377,4758,10776
80,60,80,2405,2354,4759,11197
-150,30,-50,2401,2358,4759,10747
100,50,80,2387,2373,4760,11140
-110,-60,110,2388,2372,4760,10860
-40,10,-140,2365,2395,4760,10917
-50,80,-170,2376,2385,4761,11250
110,-80,-10,2394,2367,4761,11093
140,-50,20,2365,2396,4761,11028
-160,60,-50,2397,2365,4762,10686
100,-60,-110,2410,2352,4762,10689
170,0,50,2382,2380,4762,10803
-140,80,0,2395,2367,4762,11338
130,-50,-80,2392,2370,4762,10559
-90,-80,150,2395,2367,4762,10995
-90,-50,80,2379,2384,4763,10833
-110,60,-80,2412,2351,4763,10995
-60,80,-160,2390,2373,4763,11180
-170,-50,-50,2350,2413,4763,11118
-110,-50,60,2374,2389,4763,11034
90,-40,-70,2372,2391,4763,11018
-100,60,-120,2367,2399,4766,11311
-140,70,-10,2412,2354,4766,11225
-100,50,-80,2398,2368,4766,11490
150,60,60,2402,2365,4767,10965
110,-40,-40,2403,2364,4767,10983
-130,-60,10,2417,2350,4767,10926
-160,-50,60,2402,2366,4768,10899
130,50,70,2391,2377,4768,11195
140,-30,20,2392,2376,4768,10910
-170,-30,-50,2411,2358,4769,11076
-50,60,-100,2432,2337,4769,11292
-40,80,-100,2404,2365,4769,11105
-150,-30,10,2428,2342,4770,10786
170,10,40,2388,2382,4770,10778
-130,-50,60,2414,2356,4770,10946
100,-80,-20,2395,2375,4770,11188
-150,60,-50,2400,2371,4771,10866
-180,60,40,2411,2360,4771,11308
50,-50,-80,2366,2405,4771,11247
180,60,40,2411,2360,4771,11308
150,0,40,2378,2394,4772,11108
160,-30,-60,2380,2392,4772,10999
-160,70,20,2395,2377,4772,11339
0,-10,150,2378,2394,4772,10695
130,0,20,2383,2389,4772,11142
-90,-50,90,2376,2397,4773,11040
-110,60,-100,2390,2383,4773,10934
-90,-50,100,2398,2375,4773,11022
-130,60,-60,2432,2341,4773,11047
40,70,110,2379,2395,4774,11040
-150,-20,0,2456,2318,4774,10689
-140,-20,-20,2428,2347,4775,11149
-60,40,-110,2425,2350,4775,11223
-30,-70,130,2406,2370,4776,10979
-50,-10,140,2376,2400,4776,11032
-150,70,-60,2380,2396,4776,10865
-150,20,-20,2404,2372,4776,10926
110,80,40,2387,2390,4777,10714
150,-50,-70,2409,2368,4777,10806
170,-20,50,2372,2405,4777,11038
80,60,110,2404,2374,4778,11037
100,-30,-80,2381,2397,4778,11193
-100,-80,50,2366,2412,4778,11015
-70,-70,170,2380,2398,4778,11068
-150,50,-20,2429,2350,4779,11086
-170,-80,-30,2395,2385,4780,11033
-80,50,-90,2421,2359,4780,11102
-130,60,-40,2412,2368,4780,11108
70,60,130,2402,2378,4780,11203
-10,40,140,2390,2390,4780,10864
-20,30,-110,2387,2394,4781,11089
-50,0,170,2417,2364,4781,11145
-40,40,170,2408,2375,4783,10911
-150,30,-30,2389,2394,4783,11207
110,-40,-30,2421,2362,4783,11042
-50,-70,110,2393,2390,4783,10876
150,60,-10,2384,2400,4784,11030
-50,-40,120,2391,2393,4784,10973
-110,70,-110,2407,2377,4784,11117
-20,80,160,2400,2385,4785,11113
-60,30,-140,2409,2376,4785,10813
-90,80,-60,2405,2380,4785,11127
-140,70,-70,2388,2398,4786,10894
150,-50,30,2375,2411,4786,11195
50,50,130,2390,2396,4786,10684
80,-40,-80,2385,2401,4786,11041
180,0,40,2430,2357,4787,10778
170,0,40,2399,2388,4787,10886
0,70,140,2411,2376,4787,11079
20,-50,-100,2400,2387,4787,11348
-80,-60,80,2420,2367,4787,10878
-180,0,40,2430,2357,4787,10778
40,-80,-170,2376,2412,4788,11197
10,60,130,2415,2373,4788,11131
-170,60,30,2410,2378,4788,11369
10,-80,-110,2412,2376,4788,11104
-50,20,-180,2420,2369,4789,10959
-40,-70,120,2405,2384,4789,10873
-90,50,-110,2417,2372,4789,11093
-50,20,180,2420,2369,4789,10959
110,-70,-110,2354,2436,4790,11276
-100,80,-50,2402,2388,4790,11164
90,-30,-90,2396,2394,4790,11295
100,-80,-120,2390,2401,4791,11205
-170,-70,-40,2389,2402,4791,11096
140,-10,30,2391,2401,4792,11136
170,-40,50,2408,2384,4792,11242
-30,60,-100,2381,2411,4792,11360
80,-50,-70,2440,2352,4792,10871
160,10,40,2406,2386,4792,10946
-150,-50,60,2442,2351,4793,10845
130,10,-10,2363,2430,4793,11114
-150,60,-10,2421,2372,4793,11317
20,-80,170,2397,2397,4794,11090
130,-10,-20,2380,2414,4794,11027
-50,50,-100,2411,2383,4794,11400
100,-40,-60,2449,2346,4795,11079
-10,40,-110,2384,2411,4795,11400
-10,0,140,2418,2377,4795,10935
10,40,130,2390,2405,4795,11030
20,20,140,2402,2393,4795,10822
160,-50,40,2413,2382,4795,11385
-80,80,-70,2408,2388,4796,11265
-90,50,-120,2417,2379,4796,11159
90,60,100,2428,2368,4796,11019
-70,-30,140,2418,2379,4797,11477
-20,-60,140,2443,2354,4797,10962
-40,80,-180,2405,2392,4797,11337
-40,80,180,2405,2392,4797,11337
170,10,-50,2408,2389,4797,10969
-50,30,-130,2391,2407,4798,11229
60,-80,-60,2424,2374,4798,11091
20,-80,-100,2416,2382,4798,11099
120,40,40,2376,2423,4799,11195
50,-70,-70,2420,2379,4799,11516
-70,-40,110,2396,2404,4800,11218
40,40,170,2420,2380,4800,10860
-50,40,-110,2434,2366,4800,11424
-150,10,-20,2425,2375,4800,10988
30,-80,-180,2382,2418,4800,11136
30,-80,180,2382,2418,4800,11136
-80,-80,160,2416,2385,4801,11103
30,-80,-90,2419,2383,4802,11111
-140,50,-50,2437,2365,4802,11333
-110,-70,40,2389,2413,4802,11173
160,0,50,2403,2399,4802,11232
80,-70,-40,2397,2406,4803,11246
90,-80,-30,2421,2382,4803,11157
70,-70,-50,2409,2394,4803,11190
40,80,110,2403,2401,4804,10818
20,20,-120,2398,2406,4804,11253
-80,-40,130,2398,2406,4804,11402
20,10,150,2435,2369,4804,10912
100,-50,-30,2419,2385,4804,11223
-80,-40,120,2394,2411,4805,11261
-80,50,-100,2420,2385,4805,11358
170,-30,50,2419,2386,4805,11162
-120,80,-30,2423,2383,4806,11179
-160,20,-10,2424,2382,4806,10859
-80,60,-80,2435,2371,4806,11448
30,-10,-110,2381,2426,4807,11647
160,-60,-70,2383,2424,4807,11300
40,40,140,2422,2387,4809,10959
120,-30,-10,2404,2405,4809,11298
-30,60,-110,2422,2387,4809,11272
170,-10,50,2387,2422,4809,11145
20,-10,160,2413,2397,4810,10790
-110,80,-40,2411,2399,4810,11154
-100,60,-90,2408,2402,4810,11246
0,-90,-120,2424,2387,4811,11106
-10,-90,-130,2424,2387,4811,11106
-90,-90,150,2424,2387,4811,11106
130,70,20,2384,2427,4811,10842
-150,-90,90,2424,2387,4811,11106
-60,-90,-180,2424,2387,4811,11106
110,-90,-10,2424,2387,4811,11106
10,-90,-110,2424,2387,4811,11106
-140,-90,100,2424,2387,4811,11106
30,-90,-90,2424,2387,4811,11106
-60,-90,180,2424,2387,4811,11106
-110,-90,130,2424,2387,4811,11106
-70,-90,170,2424,2387,4811,11106
70,-90,-50,2424,2387,4811,11106
-160,-90,80,2424,2387,4811,11106
-80,-90,160,2424,2387,4811,11106
-50,-90,-170,2424,2387,4811,11106
-40,-90,-160,2424,2387,4811,11106
20,-90,-100,2424,2387,4811,11106
180,-90,60,2424,2387,4811,11106
150,-90,30,2424,2387,4811,11106
130,-90,10,2424,2387,4811,11106
-180,-90,60,2424,2387,4811,11106
-20,-90,-140,2424,2387,4811,11106
-120,-90,120,2424,2387,4811,11106
120,-90,0,2424,2387,4811,11106
80,-90,-40,2424,2387,4811,11106
-30,-90,-150,2424,2387,4811,11106
60,-90,-60,2424,2387,4811,11106
90,-90,-30,2424,2387,4811,11106
-100,-90,140,2424,2387,4811,11106
-70,40,-130,2433,2378,4811,11300
140,-90,20,2424,2387,4811,11106
-170,-90,70,2424,2387,4811,11106
170,-90,50,2424,2387,4811,11106
160,-90,40,2424,2387,4811,11106
50,-90,-70,2424,2387,4811,11106
-130,-90,110,2424,2387,4811,11106
40,-90,-80,2424,2387,4811,11106
100,-90,-20,2424,2387,4811,11106
120,40,70,2406,2406,4812,11706
80,-30,-100,2414,2399,4813,11313
-170,-30,40,2437,2376,4813,10880
130,-30,-70,2403,2410,4813,11133
70,-70,-140,2432,2381,4813,11177
40,-80,-80,2415,2398,4813,11141
20,-60,-100,2412,2402,4814,11307
-60,70,-90,2399,2416,4815,11222
-160,-60,70,2406,2409,4815,10962
-30,80,170,2421,2394,4815,11168
-10,-40,150,2420,2395,4815,10719
130,-30,10,2387,2429,4816,11272
-160,30,20,2431,2385,4816,11156
-50,-10,-160,2421,2395,4816,11085
-140,-40,30,2454,2362,4816,10847
50,50,140,2396,2421,4817,10765
-60,-30,130,2418,2399,4817,11176
-120,60,-50,2420,2397,4817,11428
-130,80,-20,2416,2401,4817,11350
-30,70,-110,2427,2391,4818,11498
-100,70,-120,2415,2403,4818,11275
50,-40,-150,2433,2385,4818,10964
50,-80,-70,2419,2399,4818,11106
60,-70,-60,2438,2381,4819,11462
150,-40,30,2375,2444,4819,11043
-180,-80,-40,2398,2421,4819,11171
180,-80,-40,2398,2421,4819,11171
-40,20,-130,2401,2419,4820,11133
90,-70,-30,2385,2435,4820,11450
180,-30,50,2416,2404,4820,11024
150,10,40,2406,2414,4820,11156
140,40,60,2422,2398,4820,11380
-150,30,-40,2456,2364,4820,11261
-180,-30,50,2416,2404,4820,11024
-180,40,-40,2421,2400,4821,11101
-150,80,10,2421,2400,4821,11542
180,40,-40,2421,2400,4821,11101
170,40,40,2440,2381,4821,11259
40,-70,-80,2425,2396,4821,11511
50,70,170,2442,2379,4821,11216
-120,50,-60,2441,2381,4822,11276
40,10,-150,2426,2397,4823,11218
170,-70,-60,2409,2414,4823,11281
110,50,80,2430,2394,4824,11294
-50,10,-180,2478,2346,4824,11349
-50,10,180,2478,2346,4824,11349
-150,40,-30,2430,2395,4825,11260
-70,-30,130,2440,2385,4825,11477
70,-40,-90,2401,2424,4825,10973
-110,60,-90,2430,2395,4825,11055
-120,-60,90,2483,2342,4825,10959
-50,70,-100,2398,2428,4826,11299
-40,-30,130,2415,2411,4826,11294
180,60,-40,2411,2415,4826,11085
-180,60,-40,2411,2415,4826,11085
120,80,30,2405,2421,4826,10801
-180,30,-50,2427,2401,4828,11226
180,30,-50,2427,2401,4828,11226
70,-80,-50,2431,2397,4828,11177
70,60,120,2421,2408,4829,11182
70,-40,-130,2415,2414,4829,10984
-60,-70,100,2425,2405,4830,11003
80,-80,-40,2434,2396,4830,11167
130,50,20,2388,2443,4831,11229
130,60,20,2398,2433,4831,11142
100,-70,-20,2393,2438,4831,11464
-20,-20,-130,2403,2428,4831,11132
130,30,60,2402,2430,4832,11400
-90,-60,70,2439,2393,4832,11130
-20,0,140,2410,2422,4832,11255
-130,-50,50,2438,2395,4833,11267
-110,-60,100,2443,2390,4833,10976
150,30,50,2438,2395,4833,11075
-140,-60,80,2427,2406,4833,11045
-30,80,-110,2435,2399,4834,11271
110,-70,-10,2392,2442,4834,11358
-50,-10,160,2450,2384,4834,11254
-160,80,20,2418,2416,4834,11546
-30,30,-110,2390,2444,4834,11158
90,60,70,2436,2399,4835,11280
-60,-30,150,2455,2380,4835,11314
-170,-20,-50,2432,2403,4835,11207
130,40,10,2429,2407,4836,10992
70,60,90,2437,2400,4837,11150
-10,30,140,2416,2421,4837,10984
-50,10,-150,2436,2401,4837,11128
-130,70,-80,2427,2410,4837,10982
-20,-10,140,2436,2402,4838,11032
-70,80,-80,2427,2412,4839,11346
-100,-60,120,2422,2417,4839,11020
-160,30,-50,2424,2415,4839,10805
-10,-80,150,2424,2415,4839,11040
100,50,70,2410,2429,4839,11452
0,-80,-120,2437,2403,4840,11158
50,-40,-100,2442,2398,4840,11126
110,-80,-110,2405,2435,4840,11471
30,80,120,2436,2404,4840,11030
-10,-20,-120,2395,2446,4841,11347
100,-50,-40,2459,2382,4841,11221
-120,-50,40,2380,2461,4841,11244
120,80,100,2454,2387,4841,11219
-80,50,-110,2423,2419,4842,11299
-40,30,-120,2434,2409,4843,11358
100,-50,-50,2438,2408,4846,10979
150,-20,40,2423,2423,4846,11491
140,-60,-80,2436,2411,4847,11346
130,80,90,2454,2393,4847,11159
-180,-70,-50,2414,2433,4847,11273
-10,-10,150,2420,2427,4847,10887
-10,70,150,2438,2409,4847,11209
120,60,80,2419,2428,4847,11184
180,-70,-50,2414,2433,4847,11273
-70,-50,150,2405,2443,4848,11077
-110,-80,40,2415,2433,4848,11124
-110,70,-50,2443,2406,4849,11383
0,10,140,2420,2430,4850,11204
-80,-50,100,2421,2429,4850,11212
110,80,110,2451,2400,4851,11315
-160,60,10,2414,2438,4852,11245
-170,70,30,2426,2427,4853,11533
-90,60,-130,2405,2448,4853,11396
-140,-50,50,2460,2394,4854,11019
-60,-50,170,2409,2446,4855,11028
50,-10,-150,2401,2454,4855,11537
-10,-30,150,2452,2403,4855,10802
-20,80,-120,2449,2407,4856,11480
130,80,20,2423,2434,4857,10966
110,-30,-80,2422,2437,4859,11478
-80,-50,90,2443,2417,4860,11246
170,70,50,2434,2426,4860,11622
-150,-10,-10,2476,2384,4860,11076
-10,60,-130,2472,2388,4860,11434
-20,60,-120,2490,2371,4861,11325
140,20,50,2422,2439,4861,11497
50,90,170,2468,2394,4862,11409
160,90,60,2468,2394,4862,11409
20,90,-160,2468,2394,4862,11409
-30,90,-110,2468,2394,4862,11409
80,90,140,2468,2394,4862,11409
180,90,40,2468,2394,4862,11409
60,90,160,2468,2394,4862,11409
150,90,70,2468,2394,4862,11409
40,90,180,2468,2394,4862,11409
30,90,-170,2468,2394,4862,11409
90,90,130,2468,2394,4862,11409
0,90,-140,2468,2394,4862,11409
-70,90,-70,2468,2394,4862,11409
-20,90,-120,2468,2394,4862,11409
130,90,90,2468,2394,4862,11409
0,80,-140,2459,2403,4862,11547
140,90,80,2468,2394,4862,11409
110,90,110,2468,2394,4862,11409
40,90,-180,2468,2394,4862,11409
-140,90,0,2468,2394,4862,11409
-150,-40,30,2470,2392,4862,11055
-160,90,20,2468,2394,4862,11409
10,90,-150,2468,2394,4862,11409
-10,90,-130,2468,2394,4862,11409
100,90,120,2468,2394,4862,11409
-120,90,-20,2468,2394,4862,11409
-110,90,-30,2468,2394,4862,11409
-130,90,-10,2468,2394,4862,11409
50,-80,-160,2405,2457,4862,11295
170,90,50,2468,2394,4862,11409
-50,90,-90,2468,2394,4862,11409
-170,90,30,2468,2394,4862,11409
120,90,100,2468,2394,4862,11409
-80,90,-60,2468,2394,4862,11409
-150,90,10,2468,2394,4862,11409
-40,90,-100,2468,2394,4862,11409
-90,90,-50,2468,2394,4862,11409
-60,90,-80,2468,2394,4862,11409
0,-80,160,2441,2421,4862,11017
-100,90,-40,2468,2394,4862,11409
-180,90,40,2468,2394,4862,11409
70,90,150,2468,2394,4862,11409
160,60,-20,2428,2435,4863,11261
-60,80,-90,2436,2429,4865,11484
30,-70,-90,2470,2395,4865,11371
-20,-80,140,2437,2428,4865,11142
-10,80,-130,2448,2417,4865,11494
-150,-50,-30,2444,2421,4865,11399
-120,-60,30,2419,2447,4866,11303
-160,-20,30,2436,2430,4866,11338
-160,-50,-40,2428,2439,4867,11430
-130,70,-30,2424,2443,4867,11270
70,-50,-80,2483,2384,4867,11232
170,-80,-50,2421,2446,4867,11284
-130,-60,80,2470,2397,4867,11072
-30,40,160,2439,2428,4867,11186
-70,-60,160,2415,2453,4868,11015
-150,10,-30,2411,2457,4868,10962
130,10,20,2422,2446,4868,11262
-80,-90,70,2438,2431,4869,11275
30,-90,180,2438,2431,4869,11275
10,-90,160,2438,2431,4869,11275
-180,-90,-30,2438,2431,4869,11275
-140,-90,10,2438,2431,4869,11275
-110,-90,40,2438,2431,4869,11275
140,-90,-70,2438,2431,4869,11275
70,-90,-140,2438,2431,4869,11275
-60,-90,90,2438,2431,4869,11275
-70,-90,80,2438,2431,4869,11275
30,-90,-180,2438,2431,4869,11275
110,-90,-100,2438,2431,4869,11275
20,-90,170,2438,2431,4869,11275
150,-90,-60,2438,2431,4869,11275
-30,-90,120,2438,2431,4869,11275
-20,-90,130,2438,2431,4869,11275
40,-90,-170,2438,2431,4869,11275
-70,-80,170,2457,2412,4869,11253
-150,-90,0,2438,2431,4869,11275
-130,-90,20,2438,2431,4869,11275
120,-90,-90,2438,2431,4869,11275
90,-90,-120,2438,2431,4869,11275
-50,-90,100,2438,2431,4869,11275
180,-90,-30,2438,2431,4869,11275
60,-90,-150,2438,2431,4869,11275
100,-90,-110,2438,2431,4869,11275
130,-90,-80,2438,2431,4869,11275
-160,-90,-10,2438,2431,4869,11275
-100,-90,50,2438,2431,4869,11275
80,-90,-130,2438,2431,4869,11275
170,-90,-40,2438,2431,4869,11275
50,-90,-160,2438,2431,4869,11275
-120,-90,30,2438,2431,4869,11275
-40,-90,110,2438,2431,4869,11275
-90,-90,60,2438,2431,4869,11275
-10,-90,140,2438,2431,4869,11275
-170,-90,-20,2438,2431,4869,11275
160,-90,-50,2438,2431,4869,11275
140,80,10,2427,2442,4869,11198
0,-90,150,2438,2431,4869,11275
-60,-20,140,2446,2424,4870,11784
90,80,130,2456,2414,4870,11394
140,70,10,2458,2412,4870,11082
110,70,100,2442,2428,4870,11401
-160,20,-50,2462,2408,4870,11207
-140,-70,0,2436,2435,4871,11194
-100,70,-60,2455,2416,4871,11461
-70,40,-140,2427,2444,4871,11241
-70,-70,90,2421,2450,4871,11179
-150,70,0,2439,2433,4872,11384
90,60,90,2434,2438,4872,11232
10,-30,160,2475,2397,4872,11107
120,-30,-30,2447,2426,4873,11135
40,-40,-100,2459,2414,4873,11390
-140,80,-10,2441,2433,4874,11492
-140,60,-30,2445,2429,4874,11388
-130,-50,10,2446,2428,4874,11381
10,-30,-110,2422,2453,4875,11596
-30,-50,-140,2446,2429,4875,11625
40,40,160,2470,2405,4875,11139
150,40,-20,2415,2460,4875,11408
-70,-50,100,2451,2425,4876,11250
-160,70,-50,2428,2448,4876,11018
80,60,100,2417,2460,4877,11121
-140,60,-50,2461,2416,4877,11331
160,-40,-60,2430,2447,4877,11253
-170,80,30,2437,2441,4878,11545
-120,-50,50,2433,2445,4878,11220
10,40,-120,2459,2419,4878,11800
-140,-40,-20,2443,2435,4878,11409
-60,50,-160,2446,2433,4879,11118
-70,60,-90,2453,2426,4879,11645
40,60,-180,2435,2444,4879,11358
40,60,180,2435,2444,4879,11358
-50,-10,150,2469,2411,4880,11367
60,60,140,2440,2440,4880,11284
-120,70,-40,2456,2424,4880,11380
0,60,-130,2480,2401,4881,11651
-60,50,-100,2475,2406,4881,11838
100,80,120,2462,2419,4881,11377
-150,-50,50,2480,2401,4881,11039
10,-70,-110,2487,2395,4882,11279
-160,-40,40,2490,2392,4882,10900
80,80,140,2475,2407,4882,11404
-20,70,-120,2474,2409,4883,11667
150,-10,40,2456,2427,4883,11609
-170,40,30,2442,2441,4883,11456
160,-80,-60,2430,2454,4884,11504
-160,-10,30,2467,2417,4884,11270
100,70,110,2439,2446,4885,11477
-10,20,140,2432,2453,4885,11245
150,80,0,2443,2442,4885,11339
-30,-80,130,2449,2437,4886,11104
-170,40,-40,2489,2397,4886,11300
-120,70,-90,2418,2468,4886,11133
-130,50,-50,2461,2426,4887,11488
160,80,-10,2449,2439,4888,11356
-10,10,140,2442,2446,4888,11472
-180,70,40,2445,2444,4889,11609
180,70,40,2445,2444,4889,11609
-40,-80,120,2446,2443,4889,11043
-40,40,-110,2472,2417,4889,11387
40,10,-160,2431,2459,4890,11141
120,-40,-80,2421,2469,4890,11183
130,10,0,2409,2481,4890,11454
130,20,40,2471,2420,4891,11643
100,60,90,2454,2437,4891,11340
-160,40,-30,2464,2427,4891,11298
-50,-80,110,2443,2449,4892,11149
40,70,180,2505,2387,4892,11399
40,70,-180,2505,2387,4892,11399
-160,10,0,2475,2417,4892,11122
20,-70,-100,2483,2410,4893,11440
-160,30,-10,2489,2404,4893,11171
-90,70,-130,2450,2444,4894,11453
110,-30,-60,2437,2457,4894,11113
30,90,120,2475,2420,4895,11057
-160,90,-50,2475,2420,4895,11057
-120,90,-90,2475,2420,4895,11057
20,90,130,2475,2420,4895,11057
-140,90,-70,2475,2420,4895,11057
-90,90,-120,2475,2420,4895,11057
-170,90,-40,2475,2420,4895,11057
180,90,-30,2475,2420,4895,11057
-180,90,-30,2475,2420,4895,11057
80,90,70,2475,2420,4895,11057
90,90,60,2475,2420,4895,11057
-80,90,-130,2475,2420,4895,11057
50,90,100,2475,2420,4895,11057
40,90,110,2475,2420,4895,11057
150,90,0,2475,2420,4895,11057
130,90,20,2475,2420,4895,11057
60,90,90,2475,2420,4895,11057
-110,90,-100,2475,2420,4895,11057
170,90,-20,2475,2420,4895,11057
110,90,40,2475,2420,4895,11057
-10,90,160,2475,2420,4895,11057
100,90,50,2475,2420,4895,11057
-130,90,-80,2475,2420,4895,11057
140,90,10,2475,2420,4895,11057
-100,90,-110,2475,2420,4895,11057
10,90,140,2475,2420,4895,11057
-40,90,-170,2475,2420,4895,11057
120,90,30,2475,2420,4895,11057
160,90,-10,2475,2420,4895,11057
-60,90,-150,2475,2420,4895,11057
-30,90,-180,2475,2420,4895,11057
0,90,150,2475,2420,4895,11057
-30,90,180,2475,2420,4895,11057
-20,90,170,2475,2420,4895,11057
-70,90,-140,2475,2420,4895,11057
-50,90,-160,2475,2420,4895,11057
-150,90,-60,2475,2420,4895,11057
70,90,80,2475,2420,4895,11057
60,-20,-120,2463,2433,4896,11306
-60,40,-160,2454,2442,4896,11219
20,40,-140,2462,2435,4897,11549
10,80,-150,2476,2421,4897,11557
60,-40,-100,2483,2415,4898,11234
-180,-40,50,2478,2420,4898,11113
180,-40,50,2478,2420,4898,11113
120,-80,-100,2427,2471,4898,11660
-10,-80,-130,2460,2439,4899,11194
-160,10,-50,2445,2454,4899,11521
-20,-70,140,2463,2436,4899,11247
-180,-10,40,2473,2426,4899,11054
60,60,100,2486,2413,4899,11388
180,-10,40,2473,2426,4899,11054
-160,20,10,2500,2399,4899,11193
90,70,120,2471,2429,4900,11464
-30,20,-120,2472,2428,4900,11339
-110,60,-60,2472,2429,4901,11657
170,0,-50,2463,2438,4901,11699
-40,60,-110,2473,2428,4901,11393
-170,60,-40,2450,2452,4902,11108
-30,-10,140,2478,2424,4902,11360
130,30,10,2429,2474,4903,11392
-100,-60,60,2462,2441,4903,11418
-140,-20,-10,2500,2403,4903,11505
-160,40,-40,2503,2401,4904,11381
0,0,150,2456,2449,4905,10928
-60,-40,160,2475,2430,4905,11159
40,-30,-110,2458,2447,4905,11342
40,50,120,2468,2437,4905,11226
10,-10,-110,2437,2468,4905,11573
150,0,-40,2449,2456,4905,11479
10,50,130,2474,2432,4906,11426
10,-80,170,2447,2459,4906,11138
120,70,90,2454,2453,4907,11415
10,-60,-110,2451,2456,4907,11381
170,-50,-60,2435,2473,4908,11647
-140,70,-20,2472,2436,4908,11370
130,20,10,2434,2474,4908,11193
-150,80,-60,2455,2453,4908,11047
-70,-40,120,2467,2442,4909,11594
-150,-60,-20,2449,2460,4909,11432
130,20,30,2454,2455,4909,11475
-100,-60,110,2483,2426,4909,11309
-110,80,-100,2450,2460,4910,11119
-100,60,-110,2462,2448,4910,11438
150,-80,-70,2444,2466,4910,11576
-130,80,-80,2437,2473,4910,11084
70,80,150,2485,2425,4910,11455
-120,-80,30,2456,2455,4911,11265
20,80,-160,2509,2402,4911,11528
110,-60,-100,2466,2445,4911,11173
-60,-80,100,2453,2458,4911,11235
150,40,50,2454,2457,4911,11399
-170,-40,50,2491,2421,4912,11279
-50,-50,120,2463,2451,4914,11425
-40,70,-110,2463,2451,4914,11464
40,50,170,2468,2446,4914,11619
-160,20,-30,2493,2421,4914,11371
-170,80,-40,2450,2464,4914,11247
170,80,-20,2464,2451,4915,11393
-160,50,0,2449,2466,4915,11492
-50,0,180,2477,2438,4915,11320
-50,0,-180,2477,2438,4915,11320
160,-40,40,2446,2470,4916,11468
150,50,-10,2459,2457,4916,11371
170,-10,40,2447,2469,4916,11085
70,60,110,2435,2482,4917,11292
-60,40,-120,2478,2439,4917,11561
60,-30,-140,2490,2427,4917,11536
-90,80,-120,2452,2466,4918,11221
-60,-70,180,2467,2451,4918,11324
-60,-70,-180,2467,2451,4918,11324
-50,-30,130,2475,2443,4918,11480
-10,50,-110,2491,2427,4918,11986
-150,0,-20,2497,2422,4919,11185
-40,-40,130,2460,2459,4919,11327
-170,70,-40,2454,2465,4919,11219
120,-70,-100,2437,2483,4920,11661
-140,50,-40,2485,2435,4920,11472
140,80,80,2476,2444,4920,11382
-160,80,-50,2464,2456,4920,11165
10,-20,-110,2449,2472,4921,11751
160,-10,40,2433,2488,4921,11116
20,80,130,2466,2455,4921,11206
-20,50,-110,2447,2474,4921,11703
-170,40,-30,2467,2454,4921,11415
80,70,130,2485,2436,4921,11667
140,-80,-80,2438,2484,4922,11575
60,-80,-150,2448,2474,4922,11462
-140,80,-70,2453,2469,4922,11043
-80,70,-140,2471,2452,4923,11497
30,80,-170,2504,2419,4923,11570
130,-80,-90,2447,2476,4923,11692
70,-80,-140,2462,2461,4923,11473
30,20,-140,2472,2452,4924,11660
-40,20,160,2468,2456,4924,11551
180,80,-30,2467,2457,4924,11394
-180,80,-30,2467,2457,4924,11394
130,-20,10,2449,2476,4925,11520
-150,-50,40,2503,2422,4925,11344
-160,-30,30,2478,2448,4926,11361
-90,70,-70,2481,2445,4926,11661
-50,-30,-170,2493,2434,4927,11768
-10,-20,150,2452,2475,4927,10834
-110,-60,90,2492,2435,4927,11122
50,60,160,2473,2455,4928,11490
60,-40,-140,2516,2412,4928,11469
-70,70,-150,2458,2470,4928,11402
-170,50,-30,2452,2476,4928,11249
180,80,40,2459,2470,4929,11668
-180,80,40,2459,2470,4929,11668
110,50,50,2457,2473,4930,11515
150,-30,-60,2467,2464,4931,11368
-20,70,160,2453,2479,4932,11361
-150,50,-40,2483,2449,4932,11560
40,40,150,2492,2440,4932,10932
140,10,40,2436,2496,4932,11586
-60,-80,-180,2488,2446,4934,11551
70,-30,-120,2465,2469,4934,11622
-60,-80,180,2488,2446,4934,11551
-160,60,-40,2459,2477,4936,11431
40,0,-130,2496,2441,4937,11845
-50,-40,-170,2492,2445,4937,11500
10,-40,-110,2449,2488,4937,11737
-50,-10,170,2480,2458,4938,11507
30,70,120,2471,2467,4938,11333
80,-70,-130,2459,2479,4938,11478
60,80,160,2508,2430,4938,11554
-80,60,-140,2465,2473,4938,11487
-80,-50,130,2478,2460,4938,11372
-120,80,-90,2459,2480,4939,11147
-140,-30,-20,2488,2451,4939,11540
130,0,-10,2452,2487,4939,11430
-140,-50,40,2517,2423,4940,11416
140,-20,20,2456,2484,4940,11576
160,20,40,2475,2466,4941,11224
-160,20,20,2496,2445,4941,11491
-170,-60,60,2496,2445,4941,11438
10,50,-130,2504,2438,4942,11898
170,60,-30,2469,2473,4942,11415
-20,40,150,2498,2444,4942,11242
-20,-80,-140,2487,2456,4943,11367
-100,60,-70,2503,2440,4943,11722
-100,80,-110,2474,2469,4943,11277
-150,50,-30,2458,2485,4943,11651
-30,70,170,2452,2491,4943,11547
-80,-50,110,2473,2471,4944,11484
120,-40,-10,2454,2492,4946,11574
170,30,-40,2490,2456,4946,11614
-60,40,-130,2478,2469,4947,11365
130,60,70,2476,2472,4948,11537
-70,-80,90,2468,2480,4948,11374
10,-50,-110,2466,2482,4948,11743
140,50,60,2471,2478,4949,11572
150,70,0,2486,2463,4949,11305
130,40,60,2470,2479,4949,11747
-160,40,-10,2500,2449,4949,11355
-10,70,-130,2500,2449,4949,11597
-20,30,150,2488,2462,4950,11353
-60,-50,110,2484,2466,4950,11363
50,80,170,2530,2421,4951,11521
-40,0,150,2503,2448,4951,11420
40,80,180,2519,2432,4951,11576
-160,10,-10,2501,2450,4951,11190
40,80,-180,2519,2432,4951,11576
-150,-40,20,2510,2442,4952,11210
-180,10,-50,2477,2475,4952,11595
30,-30,180,2484,2468,4952,11185
30,-30,-180,2484,2468,4952,11185
-40,20,-140,2481,2471,4952,11486
180,10,-50,2477,2475,4952,11595
30,-20,-110,2502,2450,4952,11542
-140,-50,-10,2493,2461,4954,11752
-130,-50,20,2489,2465,4954,11369
-20,60,-110,2477,2477,4954,11729
50,-50,-90,2527,2427,4954,11564
60,-20,-130,2493,2461,4954,11698
130,10,10,2448,2507,4955,11426
-160,30,-30,2527,2429,4956,11577
30,70,-170,2512,2444,4956,11562
50,-30,-150,2534,2422,4956,11481
170,-60,-60,2463,2493,4956,11799
-160,20,-20,2503,2453,4956,11091
150,80,70,2472,2485,4957,11467
-130,-80,20,2480,2478,4958,11258
-80,-80,80,2471,2487,4958,11369
140,60,10,2482,2476,4958,11450
-10,-50,150,2501,2457,4958,11287
-50,0,-170,2502,2457,4959,11469
-160,40,-20,2500,2460,4960,11537
-50,80,-100,2487,2474,4961,11622
-30,50,-110,2493,2468,4961,11832
-20,40,-110,2456,2505,4961,11692
130,40,20,2462,2499,4961,11555
-50,-20,170,2486,2476,4962,11378
120,-30,-20,2496,2466,4962,11646
-60,30,-150,2513,2449,4962,11574
120,50,70,2500,2462,4962,11642
-150,80,0,2483,2479,4962,11730
180,20,-50,2468,2495,4963,11471
-80,80,-130,2466,2497,4963,11362
-160,70,10,2485,2478,4963,11712
70,80,90,2480,2483,4963,11045
-180,20,-50,2468,2495,4963,11471
-30,60,-120,2498,2466,4964,11317
130,70,80,2487,2477,4964,11493
150,-30,30,2483,2481,4964,11349
0,70,-140,2531,2433,4964,11557
-10,60,-120,2517,2447,4964,11997
50,-10,-130,2515,2449,4964,11320
20,-80,-180,2471,2493,4964,11195
20,-80,180,2471,2493,4964,11195
-30,-10,-140,2486,2479,4965,11221
-120,-70,30,2490,2475,4965,11466
-150,-70,-10,2495,2470,4965,11590
20,-10,-110,2495,2470,4965,11692
-140,-70,90,2494,2472,4966,11265
80,80,80,2468,2498,4966,11081
-120,-60,80,2520,2447,4967,11265
40,-40,-160,2534,2433,4967,11314
-100,60,-100,2483,2484,4967,11430
0,-70,-120,2516,2451,4967,11543
-80,-70,80,2472,2496,4968,11490
110,-30,-70,2476,2492,4968,11514
-40,50,-110,2539,2429,4968,11622
-40,-10,140,2463,2505,4968,11426
30,60,120,2501,2467,4968,11520
130,20,20,2464,2504,4968,11277
160,-10,-50,2507,2462,4969,11676
70,-30,-100,2496,2473,4969,11950
170,50,40,2492,2477,4969,11637
150,20,40,2485,2485,4970,11545
10,80,140,2494,2476,4970,11235
110,-50,-20,2487,2483,4970,11598
120,40,60,2493,2477,4970,11608
-70,60,-150,2491,2480,4971,11372
110,-40,-50,2523,2448,4971,11482
30,-30,-110,2495,2477,4972,11574
150,10,-30,2482,2490,4972,11284
-50,-20,-170,2504,2469,4973,11415
-70,-50,110,2494,2479,4973,11424
-20,50,-120,2503,2471,4974,11634
160,80,60,2471,2504,4975,11601
-140,-80,10,2483,2492,4975,11440
-60,-40,120,2499,2476,4975,11865
-160,30,-40,2518,2458,4976,11621
-170,-10,-50,2489,2487,4976,11584
-60,70,-160,2459,2517,4976,11578
160,70,-10,2480,2496,4976,11268
-140,-60,70,2509,2468,4977,11352
-30,40,-110,2481,2496,4977,11675
-110,70,-100,2474,2503,4977,11277
70,-50,-130,2518,2460,4978,11395
0,60,-140,2520,2458,4978,11701
130,-20,-30,2486,2493,4979,11254
90,-50,-110,2491,2489,4980,11398
130,-10,10,2444,2536,4980,11522
90,80,70,2469,2511,4980,11162
-140,-30,0,2496,2484,4980,11781
60,-50,-140,2537,2444,4981,11240
20,70,-160,2504,2477,4981,11535
160,60,50,2504,2477,4981,11626
80,-50,-120,2501,2480,4981,11524
-70,50,-110,2529,2453,4982,11848
170,80,50,2482,2500,4982,11703
-50,-20,160,2547,2436,4983,11426
-50,-50,-170,2519,2464,4983,11803
-90,60,-100,2492,2492,4984,11456
-60,80,-150,2496,2490,4986,11248
-120,-70,110,2488,2498,4986,11332
60,60,130,2496,2490,4986,11435
-50,-10,180,2513,2474,4987,11596
40,-10,-120,2494,2493,4987,11851
170,70,-20,2490,2497,4987,11391
-50,-10,-180,2513,2474,4987,11596
-30,10,-130,2509,2479,4988,11729
0,-50,-120,2511,2477,4988,11788
-170,30,-50,2504,2484,4988,11488
-70,-40,140,2500,2488,4988,11643
20,-20,-110,2510,2479,4989,11890
-90,-60,130,2483,2506,4989,11352
-110,-70,120,2479,2511,4990,11389
180,70,-30,2483,2507,4990,11272
-40,30,170,2543,2447,4990,11330
100,60,60,2486,2504,4990,11594
-120,60,-60,2514,2476,4990,11433
-180,70,-30,2483,2507,4990,11272
30,30,-160,2524,2467,4991,11262
-150,-40,10,2522,2469,4991,11444
0,60,140,2520,2472,4992,11469
-80,70,-80,2507,2485,4992,11721
40,-20,-160,2527,2465,4992,11316
-60,60,-160,2504,2489,4993,11460
-130,-70,100,2502,2491,4993,11363
10,70,-150,2533,2461,4994,11589
120,-30,-40,2498,2496,4994,11570
-30,-80,-150,2506,2489,4995,11500
-180,-20,40,2507,2488,4995,11557
100,80,60,2485,2510,4995,11350
60,70,100,2524,2471,4995,11320
180,-20,40,2507,2488,4995,11557
50,-50,-150,2529,2467,4996,11472
130,-70,-90,2490,2506,4996,11882
20,30,-130,2527,2469,4996,11762
-40,-20,140,2499,2498,4997,11574
90,60,80,2484,2514,4998,11697
-70,80,-140,2506,2492,4998,11333
30,-80,-170,2509,2489,4998,11298
50,-20,-150,2495,2503,4998,11555
-50,80,-160,2493,2506,4999,11239
-160,-60,-30,2507,2492,4999,11684
-40,70,-180,2489,2510,4999,11801
-50,40,-120,2560,2439,4999,11648
-150,-60,70,2495,2504,4999,11591
-90,-80,70,2484,2515,4999,11459
-40,70,180,2489,2510,4999,11801
160,30,-30,2507,2493,5000,11581
-40,-40,-150,2530,2470,5000,11691
160,30,40,2523,2477,5000,11558
-100,-60,100,2522,2479,5001,11348
30,0,-120,2495,2506,5001,11802
20,-30,170,2504,2499,5003,11522
-150,0,-30,2512,2491,5003,11401
-160,10,10,2533,2470,5003,11544
-10,-70,-130,2506,2497,5003,11540
-30,-40,140,2533,2470,5003,11301
30,60,-170,2506,2497,5003,11502
-50,-80,-170,2497,2506,5003,11620
80,-80,-130,2499,2504,5003,11690
-50,-10,-170,2551,2454,5005,11215
60,80,100,2514,2491,5005,11111
-180,-60,-50,2494,2512,5006,11864
-60,-40,150,2516,2490,5006,11368
110,80,50,2484,2522,5006,11445
180,-60,-50,2494,2512,5006,11864
-140,-40,20,2504,2502,5006,11514
140,10,-20,2498,2508,5006,11729
-60,60,-100,2507,2499,5006,11951
0,80,150,2523,2484,5007,11357
-180,-50,50,2505,2502,5007,11327
-150,-70,80,2494,2513,5007,11404
40,50,130,2490,2517,5007,11578
-80,-50,120,2518,2489,5007,11557
180,-50,50,2505,2502,5007,11327
-170,-60,-40,2491,2516,5007,11842
-160,30,-20,2541,2467,5008,11496
70,60,100,2498,2510,5008,11578
130,30,20,2477,2532,5009,11664
100,70,60,2490,2520,5010,11311
-70,50,-100,2543,2467,5010,11789
-130,60,-50,2504,2507,5011,11577
120,-60,-90,2534,2477,5011,11525
150,-20,30,2499,2512,5011,11537
60,-50,-90,2537,2474,5011,11428
30,20,150,2515,2496,5011,11431
-130,-50,40,2528,2483,5011,11677
40,-30,-160,2542,2470,5012,11615
-50,0,-160,2525,2487,5012,11606
-170,60,20,2517,2496,5013,11799
-30,-20,-140,2517,2497,5014,11630
-20,-10,-130,2500,2514,5014,11518
-140,60,-40,2518,2496,5014,11571
50,-30,-110,2479,2536,5015,11744
-160,50,-30,2511,2505,5016,11477
30,50,-170,2517,2499,5016,11645
-50,50,-110,2550,2466,5016,11712
30,-10,170,2509,2508,5017,11696
-150,-80,0,2521,2497,5018,11543
-160,-70,70,2528,2491,5019,11410
-60,-40,130,2550,2470,5020,11730
-150,60,-20,2523,2497,5020,11717
-170,50,20,2532,2488,5020,11644
-10,-60,150,2531,2489,5020,11523
-50,20,-170,2507,2514,5021,11673
-30,70,-120,2517,2504,5021,11957
80,-60,-50,2504,2517,5021,11630
30,-20,-120,2519,2503,5022,11729
-170,20,-50,2523,2499,5022,11610
-130,70,-70,2519,2504,5023,11503
-150,-10,-30,2527,2496,5023,11413
-10,0,150,2558,2465,5023,11362
80,60,90,2502,2522,5024,11615
-10,-70,150,2530,2494,5024,11275
-160,-40,30,2552,2472,5024,11430
10,-20,160,2554,2470,5024,11241
-110,60,-70,2534,2491,5025,11484
-50,10,-170,2544,2481,5025,11911
-30,0,-140,2501,2524,5025,11400
140,-10,-40,2519,2507,5026,11380
130,0,10,2468,2558,5026,11499
-30,80,-180,2519,2507,5026,11433
-30,30,-120,2536,2490,5026,11843
-30,80,180,2519,2507,5026,11433
-30,10,150,2526,2501,5027,11502
-160,0,0,2543,2485,5028,11550
-170,-70,60,2499,2529,5028,11459
-60,-30,140,2555,2475,5030,11964
-180,60,-30,2518,2512,5030,11589
60,60,120,2517,2513,5030,11404
180,60,-30,2518,2512,5030,11589
160,50,-20,2508,2522,5030,11883
80,90,80,2528,2503,5031,11240
70,90,90,2528,2503,5031,11240
-50,90,-150,2528,2503,5031,11240
-90,90,-110,2528,2503,5031,11240
-20,90,-180,2528,2503,5031,11240
170,90,-10,2528,2503,5031,11240
-80,90,-120,2528,2503,5031,11240
-10,90,170,2528,2503,5031,11240
-40,90,-160,2528,2503,5031,11240
130,90,30,2528,2503,5031,11240
150,90,10,2528,2503,5031,11240
-20,90,180,2528,2503,5031,11240
90,90,70,2528,2503,5031,11240
110,90,50,2528,2503,5031,11240
100,90,60,2528,2503,5031,11240
-70,90,-130,2528,2503,5031,11240
140,90,20,2528,2503,5031,11240
60,90,100,2528,2503,5031,11240
-30,90,-170,2528,2503,5031,11240
160,90,0,2528,2503,5031,11240
180,90,-20,2528,2503,5031,11240
-150,90,-50,2528,2503,5031,11240
-170,90,-30,2528,2503,5031,11240
-110,90,-90,2528,2503,5031,11240
-100,90,-100,2528,2503,5031,11240
70,70,90,2523,2508,5031,11414
0,90,160,2528,2503,5031,11240
-120,90,-80,2528,2503,5031,11240
-180,90,-20,2528,2503,5031,11240
120,90,40,2528,2503,5031,11240
20,90,140,2528,2503,5031,11240
10,90,150,2528,2503,5031,11240
-160,90,-40,2528,2503,5031,11240
-10,50,-130,2533,2498,5031,11741
-140,90,-60,2528,2503,5031,11240
30,90,130,2528,2503,5031,11240
-130,90,-70,2528,2503,5031,11240
50,90,110,2528,2503,5031,11240
40,90,120,2528,2503,5031,11240
-60,90,-140,2528,2503,5031,11240
30,-70,-170,2549,2483,5032,11432
50,80,110,2518,2514,5032,11287
-150,60,-40,2541,2491,5032,11714
-40,-50,130,2535,2498,5033,11488
-160,-70,-20,2503,2530,5033,11819
-160,10,-20,2532,2501,5033,11506
-40,-80,-160,2528,2506,5034,11657
-160,-20,-40,2535,2500,5035,11778
-20,-70,-140,2506,2529,5035,11500
-30,40,-120,2543,2492,5035,11805
-170,30,30,2521,2515,5036,11800
180,-60,50,2542,2494,5036,11605
-180,-60,50,2542,2494,5036,11605
-10,80,160,2543,2493,5036,11462
-30,10,-140,2513,2523,5036,11677
-140,-40,10,2530,2506,5036,11716
-30,30,160,2543,2494,5037,11627
120,-40,-20,2575,2462,5037,11684
-20,-20,150,2532,2505,5037,11374
130,30,50,2516,2521,5037,11975
100,-50,-100,2543,2495,5038,11826
-140,70,-60,2526,2512,5038,11601
-50,-30,180,2517,2521,5038,11508
-50,-30,-180,2517,2521,5038,11508
10,50,-140,2548,2490,5038,11822
-100,-70,130,2503,2536,5039,11644
170,40,-30,2512,2527,5039,11831
40,-50,-90,2519,2521,5040,11931
-150,-50,30,2540,2500,5040,11567
-10,-10,-120,2520,2520,5040,11946
50,60,110,2559,2481,5040,11552
-70,-40,130,2537,2503,5040,12089
140,70,70,2530,2511,5041,11764
-20,10,-120,2552,2489,5041,12080
-100,-80,60,2526,2515,5041,11462
70,-60,-60,2506,2537,5043,11821
40,-80,-160,2561,2482,5043,11424
-160,-10,20,2546,2497,5043,11710
60,60,110,2530,2513,5043,11571
-70,-60,100,2514,2529,5043,11647
-40,80,-170,2516,2528,5044,11362
-150,-30,0,2553,2491,5044,11502
-90,-70,70,2514,2530,5044,11628
120,80,40,2518,2526,5044,11471
90,-70,-120,2507,2537,5044,11647
110,-50,-30,2526,2518,5044,11561
-50,70,-170,2527,2517,5044,11894
-160,-20,10,2543,2502,5045,11687
80,70,80,2517,2529,5046,11503
-20,-10,150,2509,2538,5047,11406
-180,40,-30,2555,2492,5047,11654
100,60,80,2523,2524,5047,11785
-160,60,0,2572,2475,5047,11832
110,70,50,2493,2554,5047,11390
70,70,140,2556,2491,5047,11757
180,40,-30,2555,2492,5047,11654
-90,60,-80,2549,2499,5048,12019
130,80,30,2540,2508,5048,11501
140,0,30,2499,2549,5048,11852
-20,80,170,2555,2493,5048,11484
110,50,70,2492,2557,5049,11887
30,40,130,2537,2512,5049,11791
10,60,-150,2543,2506,5049,11753
-130,-60,70,2573,2476,5049,11332
90,70,70,2526,2524,5050,11496
120,40,50,2536,2514,5050,11869
-40,80,-110,2515,2536,5051,11765
-50,-20,-180,2564,2488,5052,11415
-100,70,-110,2520,2532,5052,11412
-70,-50,140,2533,2519,5052,11467
-50,-20,180,2564,2488,5052,11415
-40,20,170,2573,2480,5053,11500
-90,-70,140,2532,2521,5053,11601
-30,-40,-140,2523,2530,5053,12057
150,-10,30,2525,2529,5054,11706
-170,-70,-30,2496,2558,5054,11936
-50,50,-170,2567,2487,5054,11716
140,-70,-80,2513,2541,5054,11983
-50,30,-140,2553,2501,5054,11697
20,60,-160,2567,2487,5054,11611
130,0,0,2477,2577,5054,11889
0,20,140,2538,2517,5055,11681
-90,-60,120,2539,2516,5055,11553
-30,50,-120,2541,2515,5056,11862
-100,60,-80,2546,2510,5056,11680
110,60,80,2541,2516,5057,11819
-90,70,-120,2531,2526,5057,11551
0,30,140,2556,2503,5059,11923
-60,-50,120,2561,2498,5059,11693
140,30,-10,2535,2524,5059,11933
-70,70,-90,2533,2527,5060,12025
-130,-50,30,2525,2535,5060,11852
160,-50,-60,2536,2524,5060,11672
-150,70,-10,2546,2514,5060,11624
-160,80,10,2533,2528,5061,11969
90,-60,-40,2533,2528,5061,11827
110,60,50,2497,2564,5061,11653
-50,40,-170,2545,2517,5062,11737
-160,-30,-40,2556,2507,5063,11772
-80,-60,90,2519,2544,5063,11742
-160,50,-10,2560,2503,5063,11651
-170,10,-50,2527,2537,5064,11916
-160,-80,-10,2531,2533,5064,11697
160,-20,40,2529,2535,5064,11732
150,60,0,2524,2540,5064,11531
-160,-10,0,2563,2501,5064,11703
-90,-60,110,2569,2496,5065,11745
110,50,60,2533,2532,5065,11969
-30,-70,-150,2548,2517,5065,11754
-170,30,-30,2548,2517,5065,11603
-30,-30,-140,2526,2539,5065,11646
-50,-70,-170,2526,2540,5066,11930
30,30,140,2532,2535,5067,11857
150,80,10,2536,2531,5067,11632
170,50,-30,2517,2550,5067,11834
110,-50,-40,2537,2530,5067,11764
20,40,-150,2555,2512,5067,11417
10,30,-120,2531,2537,5068,12185
140,80,20,2536,2532,5068,11622
40,50,160,2557,2512,5069,11678
-70,50,-120,2531,2538,5069,11498
30,20,-150,2526,2544,5070,11823
160,-30,40,2528,2542,5070,11780
-150,-40,-30,2512,2558,5070,11917
90,-80,-120,2530,2541,5071,11781
60,-60,-70,2531,2540,5071,11854
160,80,0,2524,2547,5071,11645
0,-60,-120,2516,2555,5071,11657
30,-30,-120,2546,2527,5073,11709
-110,-80,50,2538,2535,5073,11556
10,20,140,2546,2528,5074,11568
-10,50,-120,2549,2525,5074,12019
-170,70,20,2537,2539,5076,12027
30,-20,-180,2523,2553,5076,11535
30,-20,180,2523,2553,5076,11535
140,40,0,2541,2535,5076,11682
-50,-20,150,2586,2490,5076,12145
160,10,-40,2560,2517,5077,11874
40,-40,-110,2549,2529,5078,11800
-160,-20,0,2582,2496,5078,11734
140,60,60,2515,2563,5078,11867
-160,-30,10,2556,2523,5079,11396
-80,70,-130,2534,2545,5079,11671
10,-70,170,2544,2535,5079,11464
-80,50,-130,2544,2536,5080,11904
-160,-40,-40,2545,2535,5080,11758
20,70,130,2543,2537,5080,11642
20,-30,-110,2543,2537,5080,12109
-50,-40,130,2556,2524,5080,11738
-10,-90,150,2533,2548,5081,11720
70,-90,-130,2533,2548,5081,11720
-130,-90,30,2533,2548,5081,11720
-60,-90,100,2533,2548,5081,11720
140,-90,-60,2533,2548,5081,11720
120,-90,-80,2533,2548,5081,11720
90,-90,-110,2533,2548,5081,11720
170,-90,-30,2533,2548,5081,11720
-150,-90,10,2533,2548,5081,11720
-80,-90,80,2533,2548,5081,11720
-90,-90,70,2533,2548,5081,11720
-110,-90,50,2533,2548,5081,11720
30,-90,-170,2533,2548,5081,11720
40,-90,-160,2533,2548,5081,11720
100,-90,-100,2533,2548,5081,11720
20,-70,-180,2546,2535,5081,11357
-180,-90,-20,2533,2548,5081,11720
20,-90,-180,2533,2548,5081,11720
50,60,150,2564,2517,5081,11780
0,-90,160,2533,2548,5081,11720
150,-90,-50,2533,2548,5081,11720
-170,-90,-10,2533,2548,5081,11720
-100,-90,60,2533,2548,5081,11720
20,-90,180,2533,2548,5081,11720
80,-90,-120,2533,2548,5081,11720
-50,-90,110,2533,2548,5081,11720
20,-70,180,2546,2535,5081,11357
-160,-90,0,2533,2548,5081,11720
-140,-90,20,2533,2548,5081,11720
50,-90,-150,2533,2548,5081,11720
60,-90,-140,2533,2548,5081,11720
110,-90,-90,2533,2548,5081,11720
-20,-90,140,2533,2548,5081,11720
-70,-90,90,2533,2548,5081,11720
160,-90,-40,2533,2548,5081,11720
-40,-90,120,2533,2548,5081,11720
180,-90,-20,2533,2548,5081,11720
-120,-90,40,2533,2548,5081,11720
-30,-90,130,2533,2548,5081,11720
10,-90,170,2533,2548,5081,11720
130,-90,-70,2533,2548,5081,11720
-170,0,-50,2531,2551,5082,11970
50,-10,-140,2591,2491,5082,12199
-170,40,20,2559,2524,5083,11811
-160,-30,0,2611,2472,5083,11597
-50,-20,140,2562,2521,5083,12185
0,-70,160,2553,2530,5083,11518
30,40,-170,2545,2538,5083,11574
-170,20,30,2555,2528,5083,11815
150,50,50,2524,2559,5083,11712
-40,-70,-160,2554,2529,5083,11931
-130,-60,20,2520,2564,5084,11838
20,-60,180,2600,2484,5084,11382
20,-60,-180,2600,2484,5084,11382
0,-40,-120,2538,2546,5084,11870
-160,-50,30,2581,2504,5085,11653
0,50,-120,2549,2536,5085,12264
-160,-40,10,2567,2518,5085,11470
30,10,160,2541,2545,5086,11572
-120,-60,70,2564,2522,5086,11791
170,60,-20,2539,2548,5087,11727
-120,70,-80,2531,2556,5087,11498
-150,-60,40,2566,2522,5088,11584
-20,60,-130,2546,2542,5088,11583
-60,-60,110,2545,2543,5088,11740
130,-10,-10,2546,2542,5088,11869
-180,0,-50,2569,2520,5089,11987
180,0,-50,2569,2520,5089,11987
-40,10,160,2547,2543,5090,11672
-20,70,-130,2556,2534,5090,12169
-50,-60,-170,2549,2542,5091,11941
20,40,130,2557,2534,5091,11709
40,80,120,2559,2532,5091,11426
-170,80,20,2559,2532,5091,12087
180,-30,-50,2573,2519,5092,11937
30,10,-130,2580,2512,5092,12109
-110,-60,50,2537,2555,5092,11868
-180,-30,-50,2573,2519,5092,11937
30,-40,-100,2570,2523,5093,12086
-130,-70,20,2545,2548,5093,11700
-150,-10,-20,2569,2524,5093,11774
180,-70,50,2543,2551,5094,11860
-180,-70,50,2543,2551,5094,11860
-160,-20,20,2565,2530,5095,11798
-160,0,20,2575,2520,5095,11858
50,70,110,2564,2532,5096,11508
30,-10,-120,2547,2549,5096,11994
40,-50,-160,2570,2526,5096,11520
-20,40,-120,2552,2544,5096,11902
-40,30,-130,2558,2539,5097,11818
150,-60,-70,2539,2558,5097,11932
140,20,40,2536,2561,5097,12103
160,60,-10,2550,2548,5098,11747
-50,30,-170,2553,2546,5099,11695
-110,70,-90,2549,2550,5099,11539
-50,20,-150,2548,2551,5099,11664
-160,10,20,2578,2521,5099,11955
-160,-40,20,2582,2518,5100,11862
-80,-60,140,2545,2556,5101,11842
130,-20,-50,2519,2582,5101,11603
20,10,-120,2558,2543,5101,12043
-30,-30,140,2556,2546,5102,11703
-40,40,-120,2608,2494,5102,12266
-100,-60,90,2575,2529,5104,11787
-150,-50,20,2568,2536,5104,11774
100,-80,-110,2556,2548,5104,11816
-60,-60,170,2511,2594,5105,11863
40,-10,-160,2560,2545,5105,11823
-90,-60,80,2535,2571,5106,12059
-90,60,-90,2586,2521,5107,12014
-150,60,-30,2567,2540,5107,11634
-30,80,-120,2541,2568,5109,12026
-150,-20,-30,2575,2534,5109,11978
-140,-40,0,2565,2544,5109,12009
80,-60,-60,2532,2577,5109,11713
160,-20,-50,2552,2558,5110,11965
120,-40,-30,2548,2562,5110,11891
-40,0,-150,2595,2517,5112,11999
-10,80,170,2557,2555,5112,11429
30,-60,-170,2584,2528,5112,11398
-160,0,-10,2597,2515,5112,11733
-40,50,-120,2581,2531,5112,12120
-50,40,-130,2567,2545,5112,11877
40,-70,-160,2585,2527,5112,11699
180,-50,-50,2552,2562,5114,12021
-180,-50,-50,2552,2562,5114,12021
-120,-80,40,2547,2567,5114,11833
-80,80,-120,2520,2594,5114,11472
-100,80,-100,2521,2593,5114,11544
-90,60,-120,2559,2556,5115,11859
-160,-50,20,2605,2510,5115,11836
50,-40,-110,2595,2521,5116,11691
-40,50,180,2576,2540,5116,11761
-160,-50,40,2604,2512,5116,11335
-60,70,-150,2555,2561,5116,11822
-40,50,-180,2576,2540,5116,11761
120,50,40,2531,2585,5116,11934
-50,60,-110,2573,2544,5117,12073
150,70,10,2551,2566,5117,11763
-150,-20,-10,2637,2480,5117,11791
170,-60,40,2589,2528,5117,12024
140,30,50,2545,2573,5118,12028
-60,-50,160,2565,2553,5118,11923
140,-30,-60,2566,2552,5118,11871
-80,50,-120,2588,2530,5118,11859
180,-70,-40,2538,2581,5119,11873
-180,-70,-40,2538,2581,5119,11873
50,-80,-150,2602,2517,5119,11546
-10,70,-140,2579,2540,5119,12162
140,-50,-70,2551,2569,5120,11586
-110,80,-90,2518,2602,5120,11649
-170,80,-30,2536,2584,5120,11613
170,80,-10,2547,2573,5120,11565
-50,-30,170,2570,2550,5120,11560
-120,80,-80,2513,2608,5121,11594
-160,10,-40,2563,2558,5121,11945
140,70,20,2554,2568,5122,11737
50,60,120,2591,2532,5123,11706
-70,-50,120,2576,2547,5123,12120
-50,-30,140,2612,2511,5123,12007
170,-70,-50,2533,2590,5123,11823
-80,-70,150,2556,2567,5123,11704
-10,60,150,2577,2547,5124,11816
-130,-60,60,2572,2552,5124,11718
130,30,30,2535,2589,5124,11748
-110,-60,80,2583,2542,5125,11791
-180,-40,-50,2568,2557,5125,12039
60,70,150,2578,2547,5125,11955
180,-40,-50,2568,2557,5125,12039
-70,80,-130,2561,2565,5126,11560
-140,-70,10,2553,2573,5126,11902
-170,30,-40,2578,2548,5126,11868
30,-50,-170,2587,2540,5127,11708
180,80,-20,2545,2582,5127,11558
-160,-10,10,2594,2533,5127,11997
-180,80,-20,2545,2582,5127,11558
-70,70,-140,2553,2574,5127,11764
-40,-30,140,2588,2539,5127,11869
100,-50,-60,2608,2520,5128,11892
-40,60,180,2575,2553,5128,11797
-130,80,-70,2509,2619,5128,11654
150,30,-20,2576,2552,5128,12105
-40,60,-180,2575,2553,5128,11797
170,80,0,2603,2525,5128,11702
10,10,150,2579,2549,5128,11385
100,-70,-110,2552,2576,5128,11957
-170,-80,-20,2572,2557,5129,11873
-170,10,30,2583,2546,5129,11949
130,50,60,2570,2560,5130,11888
-160,0,10,2598,2532,5130,12083
-20,20,-120,2577,2554,5131,12160
130,-40,0,2559,2572,5131,11602
160,80,10,2607,2524,5131,11775
70,-60,-70,2557,2574,5131,11906
10,20,-120,2569,2562,5131,12194
180,-80,-30,2563,2569,5132,12048
0,50,140,2581,2551,5132,11871
-180,-80,-30,2563,2569,5132,12048
120,-50,-10,2535,2598,5133,11992
-140,-50,30,2604,2529,5133,12034
-90,80,-110,2533,2601,5134,11514
-160,60,-30,2581,2553,5134,12125
150,-40,-60,2582,2552,5134,12001
-170,40,-20,2581,2553,5134,11832
-80,60,-110,2539,2595,5134,11805
-10,40,-120,2544,2590,5134,12188
-20,0,-130,2584,2551,5135,11999
40,50,140,2574,2562,5136,11775
-90,60,-110,2589,2547,5136,11821
40,-20,-120,2561,2575,5136,11893
130,-20,-20,2593,2544,5137,11894
-180,50,30,2574,2563,5137,12094
180,50,30,2574,2563,5137,12094
40,-60,-160,2604,2533,5137,11557
-40,-10,-150,2585,2552,5137,12074
90,-50,-70,2598,2540,5138,11980
-160,-30,20,2583,2556,5139,11786
-60,80,-130,2579,2560,5139,11874
-170,60,-30,2564,2575,5139,11942
-60,80,-140,2570,2570,5140,11441
20,80,140,2565,2576,5141,11498
-140,-60,50,2599,2542,5141,11761
150,80,20,2591,2550,5141,11927
30,-40,-170,2592,2549,5141,11598
40,0,-140,2592,2550,5142,11830
-140,-60,0,2567,2575,5142,12002
-30,-20,140,2566,2576,5142,11794
0,50,-130,2596,2547,5143,12037
-20,20,150,2565,2578,5143,11660
-170,-40,40,2607,2536,5143,11610
-150,70,-50,2581,2562,5143,11836
-180,80,-10,2612,2532,5144,11798
180,80,-10,2612,2532,5144,11798
-160,-50,50,2612,2533,5145,11774
60,-80,-140,2619,2526,5145,11749
-80,60,-90,2585,2560,5145,12259
-60,70,-100,2588,2557,5145,12190
-180,40,30,2596,2549,5145,11848
-40,-30,-150,2609,2536,5145,12081
-50,80,-140,2577,2568,5145,11857
-160,50,-20,2590,2555,5145,11911
180,40,30,2596,2549,5145,11848
-20,80,-130,2571,2575,5146,12098
30,80,130,2557,2591,5148,11525
-50,-60,120,2601,2547,5148,11859
-20,30,-120,2596,2553,5149,11997
-180,30,-40,2601,2548,5149,12146
0,80,160,2577,2572,5149,11480
180,30,-40,2601,2548,5149,12146
-140,80,-60,2518,2632,5150,11778
-100,70,-100,2589,2561,5150,11700
-160,-10,-10,2625,2525,5150,11810
-160,20,-40,2589,2563,5152,12070
40,0,-160,2551,2602,5153,12054
110,-80,-100,2589,2564,5153,11921
-30,20,-130,2595,2558,5153,11933
-150,80,-50,2540,2614,5154,11812
-50,10,-160,2572,2582,5154,11869
-160,80,-40,2552,2602,5154,11777
-170,30,-20,2613,2542,5155,11812
0,40,-120,2587,2569,5156,12364
0,-60,160,2580,2577,5157,11767
110,-60,-20,2583,2574,5157,12145
-150,-60,60,2596,2562,5158,11843
-120,80,-40,2550,2608,5158,12073
100,-60,-30,2582,2576,5158,12152
-90,80,-100,2571,2587,5158,11876
-80,80,-110,2570,2589,5159,11807
120,-30,-70,2568,2591,5159,12074
10,-10,160,2607,2553,5160,11507
-40,60,-120,2579,2581,5160,12280
120,70,40,2541,2619,5160,11650
150,-70,-70,2560,2600,5160,12041
-130,-80,30,2572,2589,5161,11898
40,70,120,2580,2581,5161,11834
180,-20,-50,2607,2554,5161,12163
-180,-20,-50,2607,2554,5161,12163
180,80,30,2603,2559,5162,12199
-150,-60,30,2588,2574,5162,11573
-180,80,30,2603,2559,5162,12199
-50,70,-160,2590,2572,5162,11996
150,70,60,2588,2574,5162,12054
-170,30,10,2596,2567,5163,11669
20,-20,-120,2619,2544,5163,12038
130,-20,-40,2557,2607,5164,11593
-160,-10,-40,2582,2582,5164,12232
0,50,-140,2625,2539,5164,12097
-20,10,150,2590,2575,5165,11803
-20,80,-180,2580,2585,5165,11523
130,-10,0,2542,2623,5165,12318
-90,-60,100,2598,2567,5165,11969
-20,80,180,2580,2585,5165,11523
0,-50,160,2638,2528,5166,12217
10,-60,170,2624,2542,5166,11930
-110,70,-60,2588,2578,5166,12038
-100,-70,60,2572,2594,5166,11877
-140,-60,60,2607,2560,5167,11614
160,0,30,2615,2552,5167,11770
-160,10,-30,2596,2571,5167,11645
120,60,40,2575,2593,5168,11851
170,-70,40,2594,2574,5168,11975
-40,10,170,2636,2532,5168,11984
0,20,-120,2586,2583,5169,12042
-60,50,-110,2620,2549,5169,12096
40,-30,-120,2604,2565,5169,11680
-100,80,-90,2571,2599,5170,11872
-150,-50,-20,2598,2572,5170,12199
-110,80,-50,2551,2619,5170,12100
-80,60,-100,2617,2553,5170,12118
-50,90,-100,2599,2572,5171,12331
20,90,-170,2599,2572,5171,12331
-100,90,-50,2599,2572,5171,12331
140,90,70,2599,2572,5171,12331
150,90,60,2599,2572,5171,12331
10,90,-160,2599,2572,5171,12331
0,90,-150,2599,2572,5171,12331
70,70,110,2600,2571,5171,11858
40,90,170,2599,2572,5171,12331
130,90,80,2599,2572,5171,12331
30,90,-180,2599,2572,5171,12331
70,90,140,2599,2572,5171,12331
90,90,120,2599,2572,5171,12331
50,90,160,2599,2572,5171,12331
60,90,150,2599,2572,5171,12331
-70,90,-80,2599,2572,5171,12331
-20,90,-130,2599,2572,5171,12331
140,50,10,2547,2624,5171,12174
120,90,90,2599,2572,5171,12331
-90,90,-60,2599,2572,5171,12331
-130,90,-20,2599,2572,5171,12331
100,90,110,2599,2572,5171,12331
-140,90,-10,2599,2572,5171,12331
110,90,100,2599,2572,5171,12331
-110,90,-40,2599,2572,5171,12331
80,90,130,2599,2572,5171,12331
50,-50,-100,2604,2567,5171,11974
-160,90,10,2599,2572,5171,12331
50,-60,-80,2587,2584,5171,12121
-120,90,-30,2599,2572,5171,12331
130,70,30,2555,2616,5171,11836
-30,90,-120,2599,2572,5171,12331
-10,90,-140,2599,2572,5171,12331
30,90,180,2599,2572,5171,12331
180,90,30,2599,2572,5171,12331
170,90,40,2599,2572,5171,12331
-130,70,-40,2596,2575,5171,12194
160,90,50,2599,2572,5171,12331
-80,90,-70,2599,2572,5171,12331
-170,90,20,2599,2572,5171,12331
-40,90,-110,2599,2572,5171,12331
-180,90,30,2599,2572,5171,12331
-150,90,0,2599,2572,5171,12331
-60,90,-90,2599,2572,5171,12331
170,60,40,2607,2564,5171,12090
-10,90,-180,2594,2578,5172,11696
-180,90,-10,2594,2578,5172,11696
100,90,70,2594,2578,5172,11696
-130,90,-60,2594,2578,5172,11696
80,90,90,2594,2578,5172,11696
160,90,10,2594,2578,5172,11696
30,90,140,2594,2578,5172,11696
-60,90,-130,2594,2578,5172,11696
-150,90,-40,2594,2578,5172,11696
10,90,160,2594,2578,5172,11696
-50,90,-140,2594,2578,5172,11696
-10,90,180,2594,2578,5172,11696
-90,90,-100,2594,2578,5172,11696
-170,90,-20,2594,2578,5172,11696
70,90,100,2594,2578,5172,11696
-20,90,-170,2594,2578,5172,11696
90,90,80,2594,2578,5172,11696
-140,90,-50,2594,2578,5172,11696
-100,90,-90,2594,2578,5172,11696
120,90,50,2594,2578,5172,11696
170,90,0,2594,2578,5172,11696
-110,90,-80,2594,2578,5172,11696
-70,90,-120,2594,2578,5172,11696
110,90,60,2594,2578,5172,11696
-30,90,-160,2594,2578,5172,11696
-40,90,-150,2594,2578,5172,11696
40,90,130,2594,2578,5172,11696
180,90,-10,2594,2578,5172,11696
-160,90,-30,2594,2578,5172,11696
0,90,170,2594,2578,5172,11696
50,90,120,2594,2578,5172,11696
-120,90,-70,2594,2578,5172,11696
150,90,20,2594,2578,5172,11696
60,90,110,2594,2578,5172,11696
130,90,40,2594,2578,5172,11696
20,90,150,2594,2578,5172,11696
-80,90,-110,2594,2578,5172,11696
140,90,30,2594,2578,5172,11696
180,50,-20,2597,2576,5173,12183
-180,50,-20,2597,2576,5173,12183
-30,60,170,2558,2615,5173,11909
-170,-50,50,2603,2571,5174,12117
50,-60,-150,2617,2557,5174,11828
20,60,130,2621,2554,5175,11935
-180,-10,-50,2601,2574,5175,12114
180,-10,-50,2601,2574,5175,12114
130,30,40,2602,2574,5176,12130
-50,-30,160,2627,2549,5176,11955
60,70,120,2604,2572,5176,11847
90,-60,-60,2617,2560,5177,11824
-170,0,30,2641,2537,5178,11798
50,60,130,2587,2591,5178,11713
100,-60,-50,2619,2559,5178,11861
90,70,110,2594,2585,5179,12295
-90,80,-70,2563,2616,5179,12123
160,70,0,2588,2591,5179,11915
10,50,-150,2592,2588,5180,12190
-70,-50,130,2610,2570,5180,12023
-140,-80,90,2605,2576,5181,12014
120,60,70,2587,2594,5181,12065
140,-10,-30,2586,2595,5181,11691
-20,10,-130,2601,2581,5182,12225
-110,70,-80,2592,2590,5182,11968
70,-80,-130,2628,2554,5182,11902
110,70,90,2582,2601,5183,12238
-160,-50,10,2613,2570,5183,11696
-160,60,-20,2622,2562,5184,11914
-140,-80,20,2555,2629,5184,12015
-70,80,-120,2575,2609,5184,11908
-170,70,-30,2581,2604,5185,11914
160,-10,30,2599,2586,5185,11924
-130,80,-30,2559,2626,5185,12089
10,10,-120,2605,2580,5185,12233
-120,70,-50,2602,2583,5185,12050
-10,80,-140,2591,2594,5185,12209
-50,70,-110,2595,2591,5186,12213
-50,80,-150,2582,2604,5186,11541
120,-80,-90,2601,2585,5186,12111
110,60,70,2584,2602,5186,12034
110,-70,-100,2609,2577,5186,12014
-70,-70,160,2558,2629,5187,11943
-50,-40,180,2592,2595,5187,11710
-50,-40,-180,2592,2595,5187,11710
140,80,30,2619,2569,5188,11921
-150,-30,-30,2599,2589,5188,12161
-180,50,-30,2605,2583,5188,11896
-30,-20,150,2607,2581,5188,11945
90,-60,-50,2585,2603,5188,11936
10,80,150,2589,2599,5188,11535
180,50,-30,2605,2583,5188,11896
-40,10,-150,2617,2572,5189,12188
-140,-30,-10,2609,2580,5189,12378
-100,80,-60,2565,2624,5189,12189
-110,-70,50,2595,2596,5191,12035
-120,70,-70,2597,2594,5191,11983
-50,20,-160,2591,2600,5191,11913
-160,-60,30,2612,2580,5192,12013
-20,-30,150,2648,2544,5192,11827
140,-10,20,2597,2595,5192,12353
-110,80,-80,2592,2601,5193,11923
40,-50,-100,2636,2557,5193,12157
100,-60,-40,2601,2592,5193,12057
-40,-20,-150,2611,2582,5193,12295
180,-30,40,2604,2590,5194,11840
120,-40,-40,2624,2570,5194,11877
-180,-30,40,2604,2590,5194,11840
-50,60,-170,2616,2578,5194,12172
-40,30,-140,2628,2566,5194,12071
160,-20,30,2610,2584,5194,11969
-10,30,-130,2603,2591,5194,12112
50,60,140,2606,2589,5195,11865
-10,-60,-130,2609,2586,5195,12110
-140,-50,20,2579,2616,5195,11985
100,70,100,2595,2600,5195,12165
160,40,40,2607,2588,5195,11705
-20,0,150,2593,2602,5195,11912
30,20,160,2598,2598,5196,11729
-120,-60,60,2614,2582,5196,12330
-140,-40,-10,2592,2604,5196,12358
-100,-60,70,2579,2617,5196,12139
80,-50,-80,2615,2582,5197,11836
-150,-50,10,2602,2596,5198,12063
0,-30,-120,2594,2605,5199,12229
70,-50,-90,2605,2594,5199,12022
-40,80,-150,2593,2607,5200,11869
80,70,100,2593,2607,5200,12037
-150,-80,80,2610,2590,5200,12056
-170,40,10,2620,2581,5201,12034
-10,40,-130,2591,2610,5201,12370
150,-20,-50,2586,2616,5202,12057
-100,70,-90,2594,2608,5202,12100
-10,30,-120,2611,2591,5202,12281
-170,50,10,2621,2581,5202,12170
70,70,120,2622,2581,5203,11909
-10,-40,-130,2601,2602,5203,12336
70,80,100,2619,2584,5203,11788
170,70,-10,2578,2626,5204,12022
-160,0,-40,2604,2601,5205,12049
-130,-80,100,2629,2577,5206,12065
80,80,90,2584,2623,5207,11816
-90,70,-110,2609,2598,5207,11905
90,80,80,2584,2623,5207,11858
-170,80,-20,2622,2585,5207,11949
130,-30,0,2608,2599,5207,12402
-30,20,-140,2637,2570,5207,12266
170,-20,40,2564,2643,5207,11806
-170,50,-20,2622,2585,5207,12106
-30,80,-170,2592,2616,5208,11482
20,0,-120,2597,2611,5208,12349
-20,60,160,2620,2588,5208,12071
130,-20,0,2578,2630,5208,12278
-80,80,-80,2572,2636,5208,12157
160,-70,-60,2560,2649,5209,12186
-140,80,-20,2583,2626,5209,12149
150,0,30,2629,2580,5209,12166
-150,-70,0,2592,2618,5210,12161
80,70,110,2618,2592,5210,11943
-160,70,-40,2599,2611,5210,11938
-10,0,-120,2609,2601,5210,12211
-180,70,-20,2587,2623,5210,11965
100,60,70,2596,2614,5210,11992
180,70,-20,2587,2623,5210,11965
-60,40,-140,2622,2588,5210,12164
130,80,40,2617,2593,5210,11931
-180,60,30,2607,2604,5211,12293
-160,70,0,2609,2602,5211,12048
-40,-40,140,2628,2583,5211,11994
180,60,30,2607,2604,5211,12293
90,70,100,2614,2597,5211,11968
20,50,-160,2615,2596,5211,11831
0,30,-120,2565,2647,5212,12205
110,80,60,2583,2629,5212,11858
-80,70,-120,2575,2637,5212,11996
20,50,130,2638,2575,5213,12132
-20,-10,-140,2611,2602,5213,12253
30,-30,-170,2624,2589,5213,11925
30,50,130,2618,2595,5213,12017
-70,60,-100,2632,2581,5213,12165
-40,70,-170,2602,2612,5214,12104
20,-30,-120,2608,2606,5214,12028
-30,30,-130,2635,2580,5215,12072
60,-60,-140,2648,2567,5215,11996
-50,-40,140,2637,2578,5215,12221
130,-80,-80,2628,2588,5216,12171
170,-80,-40,2615,2602,5217,12248
-120,-60,40,2584,2633,5217,12360
-30,20,160,2607,2610,5217,12104
-70,70,-120,2621,2596,5217,11897
60,80,110,2627,2591,5218,11862
30,-40,-110,2635,2583,5218,12223
-30,0,150,2605,2613,5218,12037
80,-80,-120,2657,2561,5218,11984
-60,40,-150,2599,2619,5218,12264
30,0,170,2632,2587,5219,11983
120,-30,-50,2607,2612,5219,11949
90,-40,-80,2634,2585,5219,12187
-150,-80,10,2576,2644,5220,12102
-60,-50,130,2680,2540,5220,12347
160,-80,-50,2607,2614,5221,12159
170,30,-30,2615,2607,5222,12154
-80,60,-130,2593,2629,5222,12272
-160,-60,60,2608,2614,5222,11879
0,80,-150,2616,2606,5222,12391
170,-50,40,2611,2611,5222,12103
120,80,50,2602,2620,5222,11880
-160,80,-30,2630,2593,5223,11892
-40,80,-160,2600,2623,5223,11591
-20,50,-130,2594,2629,5223,12043
60,70,110,2584,2639,5223,12035
-20,40,-130,2624,2600,5224,12334
-140,-50,10,2620,2604,5224,12137
150,30,40,2607,2617,5224,12137
70,70,100,2578,2646,5224,12019
-100,70,-70,2615,2610,5225,12242
150,70,20,2624,2601,5225,11819
150,-80,-60,2613,2612,5225,12237
120,50,60,2598,2627,5225,12148
140,-80,-70,2617,2608,5225,12141
-130,70,-60,2615,2610,5225,12045
-150,80,-40,2627,2598,5225,11887
150,0,-30,2621,2605,5226,11780
-120,-80,110,2625,2601,5226,12067
120,70,80,2599,2628,5227,12364
-60,50,-130,2616,2611,5227,12055
-170,-10,30,2647,2580,5227,12024
-80,-60,130,2649,2578,5227,12021
-130,-60,50,2610,2617,5227,11974
-140,-50,0,2600,2627,5227,12215
80,-60,-120,2662,2566,5228,11934
20,-20,-130,2632,2596,5228,11997
80,70,120,2617,2612,5229,12390
130,-40,-70,2638,2592,5230,12229
-170,-50,-40,2608,2622,5230,12314
-30,-10,150,2607,2623,5230,12216
160,70,10,2629,2602,5231,11907
100,80,70,2590,2641,5231,11776
-10,-30,-130,2610,2621,5231,12404
-90,70,-100,2620,2611,5231,12112
40,60,130,2625,2607,5232,11806
-180,70,30,2630,2602,5232,12388
-110,-60,70,2623,2609,5232,12263
180,70,30,2630,2602,5232,12388
-160,-40,0,2665,2567,5232,12095
-160,-80,70,2615,2617,5232,12173
-30,-50,140,2663,2570,5233,11858
-80,-60,120,2647,2586,5233,12181
20,-50,-180,2637,2596,5233,11745
40,0,-150,2629,2604,5233,12129
-100,-60,80,2623,2610,5233,12171
20,-50,180,2637,2596,5233,11745
-170,20,-30,2648,2586,5234,12146
130,-60,-80,2646,2589,5235,11960
50,70,120,2590,2645,5235,12060
50,-70,-150,2642,2593,5235,11958
160,-50,30,2609,2626,5235,12290
-170,-50,20,2641,2595,5236,12040
-60,-40,140,2645,2591,5236,12358
140,40,50,2592,2644,5236,12280
10,80,-160,2628,2608,5236,12511
100,-40,-70,2639,2598,5237,12167
-90,-60,90,2640,2597,5237,12071
-30,70,-180,2622,2616,5238,12206
170,-10,-50,2616,2622,5238,12376
-30,70,180,2622,2616,5238,12206
-40,-60,130,2659,2580,5239,12071
90,-80,-110,2655,2584,5239,12003
170,80,40,2647,2592,5239,12360
90,70,90,2632,2608,5240,12161
-160,60,-10,2607,2633,5240,12067
-140,-60,40,2640,2600,5240,11956
170,20,-40,2627,2613,5240,12235
-70,80,-90,2592,2649,5241,12162
110,-50,-50,2641,2600,5241,12008
-170,20,-20,2672,2569,5241,11959
-50,-50,-180,2609,2633,5242,12037
10,70,140,2629,2613,5242,11864
-50,-50,180,2609,2633,5242,12037
20,30,140,2616,2627,5243,12300
70,-30,-110,2641,2602,5243,12661
-170,20,0,2661,2582,5243,12250
50,70,130,2628,2616,5244,11878
140,20,-10,2569,2675,5244,12179
-170,30,20,2650,2594,5244,12103
40,60,170,2623,2622,5245,12217
20,20,-130,2632,2613,5245,12351
100,70,90,2613,2632,5245,12158
-130,80,-60,2626,2619,5245,11889
-170,-80,60,2636,2610,5246,12324
-140,80,-50,2633,2613,5246,11875
-150,80,-10,2597,2650,5247,12366
-160,-50,-30,2628,2620,5248,12218
160,70,50,2648,2600,5248,12348
-60,70,-130,2621,2627,5248,11921
130,-50,0,2603,2646,5249,11951
-20,-20,-140,2623,2626,5249,12293
20,-10,-120,2640,2610,5250,12354
-120,80,-70,2616,2635,5251,11961
-160,-60,20,2658,2593,5251,11742
-80,70,-90,2629,2622,5251,12363
-170,60,10,2668,2584,5252,12239
40,50,150,2605,2647,5252,11872
-60,60,-110,2643,2609,5252,12014
130,-30,-20,2681,2572,5253,12239
70,-60,-130,2666,2587,5253,12050
100,-80,-100,2660,2594,5254,12094
160,-60,30,2646,2608,5254,12377
150,-50,20,2615,2639,5254,12385
-140,70,-40,2652,2602,5254,12285
110,-80,-90,2651,2603,5254,12169
-40,-60,-160,2624,2630,5254,12145
140,10,30,2572,2683,5255,12420
130,-40,-10,2632,2623,5255,12400
-170,30,-10,2631,2625,5256,11993
140,0,-20,2630,2626,5256,12186
-160,-30,-10,2698,2558,5256,11998
160,-40,30,2605,2651,5256,12135
0,-40,160,2651,2605,5256,11883
170,-40,40,2611,2646,5257,12280
-110,-60,60,2638,2619,5257,12445
-130,70,-50,2666,2591,5257,12320
-20,30,-130,2639,2619,5258,12279
40,60,120,2656,2602,5258,12109
170,-30,-50,2648,2611,5259,12385
140,60,20,2603,2656,5259,12196
-10,10,150,2647,2613,5260,11825
60,-30,-110,2620,2640,5260,12416
-90,70,-80,2632,2629,5261,12358
-110,-80,120,2641,2620,5261,12255
-80,-60,110,2646,2615,5261,12255
110,-60,-30,2647,2614,5261,12184
-170,-40,20,2628,2633,5261,11993
170,-30,40,2627,2635,5262,12143
-30,80,-160,2645,2617,5262,11810
-80,60,-120,2630,2632,5262,12246
110,-50,-90,2666,2596,5262,12210
-50,-30,150,2649,2614,5263,12348
30,-50,-100,2637,2627,5264,12594
-20,-60,-140,2631,2633,5264,12225
70,70,130,2655,2609,5264,12495
150,50,0,2622,2643,5265,12134
20,0,160,2639,2627,5266,12038
-40,0,160,2653,2613,5266,12084
130,-20,-10,2646,2620,5266,12319
120,-50,-20,2640,2627,5267,12151
-120,70,-60,2676,2591,5267,12364
-150,-60,-10,2637,2630,5267,12386
-140,70,-50,2646,2621,5267,12152
-70,70,-130,2609,2658,5267,11929
20,-40,-110,2625,2643,5268,12635
-160,-70,-10,2644,2624,5268,12210
0,10,150,2654,2615,5269,12236
30,-20,-130,2647,2622,5269,11994
0,40,140,2629,2640,5269,12550
-30,70,-170,2625,2644,5269,11713
50,-20,-120,2628,2641,5269,12439
180,40,-20,2626,2644,5270,12113
150,40,-10,2641,2629,5270,12349
30,-40,-120,2662,2608,5270,12316
-180,40,-20,2626,2644,5270,12113
110,70,60,2599,2671,5270,12037
-160,-80,0,2611,2660,5271,12204
-160,80,0,2620,2651,5271,12536
110,60,60,2626,2645,5271,12228
20,80,-170,2646,2626,5272,12593
-150,-40,0,2672,2600,5272,12101
180,-80,50,2661,2611,5272,12580
-60,80,-100,2599,2673,5272,12187
-180,-80,50,2661,2611,5272,12580
-40,20,-150,2666,2607,5273,12240
-180,30,30,2682,2591,5273,12253
-40,-10,150,2631,2642,5273,12324
-60,-50,150,2681,2592,5273,12058
180,30,30,2682,2591,5273,12253
-70,60,-140,2623,2650,5273,12251
120,-70,-90,2653,2620,5273,12192
160,50,-10,2618,2655,5273,11868
-60,50,-120,2646,2628,5274,12272
90,-40,-100,2669,2605,5274,12592
40,-60,-90,2622,2652,5274,12476
-100,-80,130,2639,2636,5275,12370
-50,60,-160,2639,2636,5275,12090
-80,70,-110,2637,2639,5276,12109
50,80,120,2647,2629,5276,12085
170,-40,-50,2645,2631,5276,12052
80,70,90,2605,2671,5276,12175
160,-60,-60,2646,2631,5277,12415
-170,30,0,2639,2638,5277,12305
-30,-60,-150,2629,2648,5277,12231
-40,70,-120,2646,2631,5277,12247
160,0,-40,2643,2635,5278,12368
-140,-60,10,2626,2653,5279,12297
120,50,50,2613,2666,5279,12340
-150,-70,30,2683,2596,5279,11890
-140,70,-30,2653,2627,5280,12352
60,-70,-140,2659,2621,5280,12009
20,30,-140,2658,2622,5280,12407
-10,-50,-130,2653,2628,5281,12311
150,-40,20,2640,2641,5281,12333
-140,-70,40,2688,2595,5283,11899
10,-10,-130,2659,2624,5283,12418
100,-40,-90,2655,2628,5283,12435
140,-40,10,2617,2666,5283,12227
30,0,-130,2650,2634,5284,12281
170,50,-20,2647,2637,5284,12162
130,-30,-10,2644,2641,5285,12567
170,-60,-50,2644,2641,5285,12430
-20,10,-140,2678,2607,5285,12270
-150,70,-40,2659,2627,5286,12273
-50,70,-140,2614,2672,5286,11841
80,-60,-70,2671,2615,5286,12164
150,60,50,2655,2631,5286,12473
-170,-30,30,2696,2590,5286,12122
0,70,-150,2632,2654,5286,12600
-40,-50,-160,2659,2628,5287,12585
-170,-60,20,2667,2620,5287,12071
-50,70,-150,2645,2642,5287,11817
-80,-60,100,2659,2628,5287,12157
110,-40,-60,2651,2636,5287,12080
30,10,-140,2656,2632,5288,12385
-70,70,-100,2666,2622,5288,12528
120,-80,-80,2660,2628,5288,12327
-50,-50,130,2690,2598,5288,12020
-10,-20,-140,2681,2608,5289,12509
0,20,-130,2643,2646,5289,12419
-40,40,180,2665,2624,5289,12096
10,30,140,2632,2657,5289,12364
120,60,60,2661,2628,5289,12196
-40,40,-180,2665,2624,5289,12096
0,-20,-120,2659,2631,5290,12563
30,70,130,2652,2638,5290,12140
-70,-70,100,2663,2628,5291,12311
130,40,30,2633,2658,5291,12256
-100,70,-80,2669,2623,5292,12405
130,40,50,2651,2641,5292,12334
130,-30,-30,2657,2636,5293,12183
30,-10,-130,2640,2653,5293,12229
-160,0,-20,2672,2621,5293,12198
10,-20,-120,2658,2635,5293,12694
-50,30,-160,2640,2653,5293,12342
-20,20,-140,2669,2625,5294,12509
10,-50,170,2663,2631,5294,12266
-170,80,10,2650,2644,5294,12569
170,0,30,2682,2613,5295,11962
100,70,80,2639,2656,5295,12372
160,-30,30,2636,2659,5295,12173
150,-30,20,2635,2660,5295,12165
-60,70,-140,2637,2658,5295,11886
-170,-20,30,2706,2589,5295,12359
40,-40,-120,2692,2604,5296,12374
-80,-80,90,2671,2625,5296,12180
-120,-70,40,2656,2640,5296,12162
-50,40,-140,2665,2631,5296,12361
120,-50,-30,2644,2653,5297,12280
-10,20,-120,2650,2647,5297,12283
130,70,70,2642,2655,5297,12677
60,-60,-80,2637,2660,5297,12219
150,-20,20,2687,2610,5297,12265
160,80,50,2669,2628,5297,12340
-10,0,-130,2672,2625,5297,12293
-160,-20,-10,2671,2627,5298,11875
-70,-80,100,2674,2624,5298,12196
-50,80,-110,2606,2692,5298,12329
-170,-80,-10,2638,2661,5299,12296
-170,-50,10,2669,2631,5300,12230
-100,-80,70,2678,2622,5300,12144
0,40,-130,2686,2614,5300,12507
130,60,60,2635,2665,5300,12319
160,-70,30,2669,2631,5300,12414
-70,60,-110,2662,2639,5301,12506
30,30,150,2679,2622,5301,12106
-180,-40,40,2665,2636,5301,12262
180,-40,40,2665,2636,5301,12262
180,60,-20,2609,2693,5302,12270
-40,70,-160,2637,2665,5302,11757
140,-10,-20,2657,2645,5302,11847
-180,60,-20,2609,2693,5302,12270
-40,80,-120,2610,2693,5303,12436
-20,70,170,2665,2638,5303,12219
100,70,70,2627,2676,5303,12040
130,60,30,2625,2678,5303,12418
160,10,30,2673,2631,5304,12091
120,-60,-10,2641,2663,5304,12393
40,70,130,2624,2680,5304,12133
-90,-80,80,2667,2637,5304,12190
-60,50,-150,2650,2655,5305,12346
70,-70,-130,2676,2629,5305,12167
-30,-30,150,2697,2608,5305,12334
-50,50,-120,2688,2618,5306,12425
-170,20,-10,2682,2625,5307,12143
-60,60,-150,2660,2647,5307,12011
-20,-40,150,2695,2612,5307,11887
30,-10,180,2675,2633,5308,12229
30,-10,-180,2675,2633,5308,12229
140,-20,-50,2629,2679,5308,12221
0,10,-120,2665,2643,5308,12603
-170,20,-40,2671,2638,5309,12526
160,20,-30,2656,2653,5309,12464
-20,70,-180,2663,2647,5310,11854
-70,60,-120,2656,2654,5310,12214
-20,-30,-140,2652,2658,5310,12371
30,40,140,2655,2655,5310,12346
-20,70,180,2663,2647,5310,11854
-90,-80,140,2661,2649,5310,12491
-170,20,10,2682,2629,5311,12257
-30,40,-130,2664,2648,5312,12361
40,80,130,2647,2665,5312,12171
-90,70,-90,2685,2628,5313,12462
-110,70,-70,2691,2622,5313,12466
-50,-80,120,2677,2636,5313,12224
-20,80,-170,2650,2663,5313,11884
-40,50,-170,2655,2659,5314,12097
-50,-40,170,2642,2672,5314,12414
-110,-70,110,2662,2652,5314,12275
130,-80,-70,2687,2627,5314,12360
60,70,130,2677,2637,5314,12178
20,-30,-130,2638,2676,5314,12331
-20,40,160,2702,2613,5315,12360
170,10,-40,2659,2657,5316,12447
-10,-20,-130,2677,2639,5316,12845
-150,-60,50,2679,2637,5316,12041
40,60,160,2678,2638,5316,12437
-70,50,-130,2692,2624,5316,12544
-40,-80,-170,2639,2678,5317,12314
-180,-60,-40,2654,2663,5317,12484
170,70,40,2676,2641,5317,12532
180,-80,-20,2675,2642,5317,12230
180,-60,-40,2654,2663,5317,12484
-70,50,-140,2647,2670,5317,12552
90,70,80,2629,2688,5317,12210
140,40,10,2646,2671,5317,12587
-160,-70,30,2670,2647,5317,12191
-180,-80,-20,2675,2642,5317,12230
170,70,0,2682,2636,5318,12338
110,-60,-40,2674,2644,5318,12061
90,-60,-110,2676,2642,5318,12335
-70,-60,150,2679,2639,5318,12247
-50,60,-120,2698,2620,5318,12347
-80,-70,90,2667,2652,5319,12358
-10,20,-130,2697,2622,5319,12566
-30,-80,-160,2640,2679,5319,12296
-170,10,0,2688,2631,5319,12307
-10,60,-140,2663,2657,5320,12478
-150,70,-30,2673,2647,5320,12318
-160,0,-30,2699,2622,5321,12348
-40,-40,-160,2661,2660,5321,12550
-170,50,-10,2677,2644,5321,12270
-170,-70,-20,2681,2640,5321,12423
-40,0,170,2691,2631,5322,12325
170,-80,40,2673,2649,5322,12670
150,60,10,2654,2668,5322,12269
-20,20,-130,2693,2631,5324,12207
10,60,140,2661,2664,5325,12154
180,20,-40,2675,2650,5325,12544
-180,20,-40,2675,2650,5325,12544
120,60,50,2647,2679,5326,12206
-170,10,-40,2666,2660,5326,12708
140,-30,10,2678,2648,5326,12367
-40,-20,150,2668,2658,5326,12542
80,-40,-110,2675,2652,5327,12808
-60,-70,110,2687,2640,5327,12469
-130,-70,50,2733,2594,5327,12164
-180,30,-30,2676,2652,5328,12523
120,70,50,2652,2676,5328,12288
-20,-40,-140,2666,2662,5328,12117
140,-80,-60,2686,2642,5328,12398
-170,40,0,2678,2650,5328,12410
170,-50,-50,2659,2669,5328,12381
-60,-80,110,2693,2635,5328,12174
-10,50,150,2657,2671,5328,12451
180,30,-30,2676,2652,5328,12523
-150,-60,20,2679,2650,5329,12116
-60,70,-110,2675,2655,5330,12628
-120,-60,50,2659,2671,5330,12678
-170,-40,30,2712,2618,5330,11929
-60,80,-120,2701,2630,5331,12150
10,80,160,2660,2671,5331,12101
20,-10,-130,2697,2634,5331,12147
10,40,-130,2684,2647,5331,12792
10,0,-120,2650,2681,5331,12414
0,30,-130,2671,2660,5331,12476
-60,-80,170,2652,2680,5332,12411
-130,-60,30,2689,2643,5332,12560
-110,-80,60,2688,2644,5332,12172
110,70,80,2651,2681,5332,12310
120,-60,-20,2669,2664,5333,12365
120,70,60,2694,2639,5333,12163
-120,-70,100,2647,2686,5333,12331
-160,-60,-20,2684,2649,5333,12356
30,50,-180,2674,2659,5333,12428
30,80,140,2660,2673,5333,12237
30,50,180,2674,2659,5333,12428
10,40,-140,2668,2665,5333,12338
0,70,150,2684,2650,5334,12102
30,30,-170,2664,2670,5334,12343
-20,0,-140,2694,2641,5335,12223
-170,60,-20,2661,2674,5335,12216
-30,50,170,2699,2636,5335,12375
-40,-10,160,2693,2643,5336,12416
-160,-70,20,2706,2630,5336,12132
-90,80,-90,2707,2630,5337,12363
-160,-50,0,2662,2676,5338,12418
140,10,-10,2631,2707,5338,12623
-10,70,160,2647,2691,5338,12113
150,-50,-60,2690,2648,5338,12407
-30,50,-130,2685,2653,5338,12352
-30,60,-130,2664,2674,5338,12360
0,80,170,2677,2663,5340,12053
-60,-50,140,2705,2635,5340,12524
40,70,140,2667,2673,5340,12144
-170,-60,10,2715,2626,5341,12168
20,80,150,2664,2678,5342,12191
-30,80,-130,2637,2705,5342,12591
170,60,-10,2665,2677,5342,12430
30,80,-180,2676,2667,5343,12676
-150,-70,40,2695,2648,5343,12225
-50,-40,160,2695,2648,5343,12238
30,80,180,2676,2667,5343,12676
-160,-60,10,2689,2654,5343,12090
-170,-40,0,2724,2620,5344,12237
-80,70,-100,2696,2649,5345,12496
-10,-10,-140,2707,2639,5346,12427
40,-50,-110,2704,2642,5346,12508
20,10,-130,2666,2681,5347,12906
-170,-40,-40,2654,2693,5347,12637
-30,40,170,2703,2645,5348,12175
-150,70,-20,2667,2681,5348,12543
170,-10,30,2697,2651,5348,12247
140,30,0,2670,2678,5348,12728
-50,-80,-180,2658,2691,5349,12434
-40,-80,130,2694,2655,5349,12269
-50,-80,180,2658,2691,5349,12434
140,30,40,2655,2694,5349,12555
-50,50,-160,2672,2678,5350,12277
-100,80,-80,2712,2638,5350,12287
-50,60,-140,2690,2661,5351,12418
150,80,60,2698,2654,5352,12500
-10,10,-120,2687,2665,5352,12659
150,10,30,2666,2686,5352,12493
-70,-60,110,2714,2638,5352,12414
-170,40,-10,2700,2653,5353,12517
0,-30,160,2714,2639,5353,12265
170,-20,-50,2688,2665,5353,12598
-70,80,-110,2713,2640,5353,12255
-130,-70,90,2690,2664,5354,12588
20,20,150,2709,2646,5355,12159
-180,20,30,2703,2652,5355,12309
30,40,180,2691,2664,5355,12169
-30,30,170,2698,2657,5355,12236
30,40,-180,2691,2664,5355,12169
180,20,30,2703,2652,5355,12309
-160,-60,50,2687,2669,5356,12385
-30,10,-150,2720,2636,5356,12306
10,0,-130,2684,2672,5356,12375
-130,-70,30,2661,2696,5357,12343
30,-60,-100,2650,2707,5357,12720
-20,50,160,2706,2652,5358,12296
30,20,170,2737,2621,5358,12038
-50,80,-130,2704,2654,5358,12244
-60,-70,170,2659,2699,5358,12200
170,20,30,2710,2649,5359,12372
90,80,120,2684,2675,5359,12723
80,-70,-120,2722,2637,5359,12490
-30,-80,140,2683,2676,5359,12277
-40,80,-140,2717,2643,5360,12320
40,-10,-130,2665,2695,5360,12469
-40,70,-150,2664,2696,5360,11997
-60,60,-130,2699,2662,5361,12313
180,-70,-30,2726,2635,5361,12635
-50,-60,180,2663,2698,5361,12614
-180,-70,-30,2726,2635,5361,12635
160,60,0,2695,2666,5361,12419
-120,80,-60,2721,2640,5361,12316
-50,-60,-180,2663,2698,5361,12614
20,40,-160,2673,2688,5361,12201
-150,-20,-20,2708,2654,5362,12510
20,-50,-110,2668,2695,5363,12795
140,80,70,2700,2663,5363,12614
30,-50,-110,2720,2643,5363,12503
-20,-80,150,2695,2668,5363,12269
-150,-70,10,2696,2668,5364,12568
-110,80,-70,2727,2637,5364,12312
-10,-30,-140,2699,2665,5364,12468
150,-60,20,2657,2707,5364,12737
-80,-80,150,2680,2685,5365,12495
-50,70,-120,2669,2696,5365,12451
50,70,160,2678,2687,5365,12572
110,80,100,2681,2684,5365,12701
80,-40,-90,2683,2682,5365,12669
120,-50,-40,2708,2657,5365,12675
-90,-70,80,2677,2689,5366,12542
-80,80,-100,2719,2647,5366,12322
-70,-80,160,2671,2695,5366,12471
160,40,-20,2676,2691,5367,12535
-10,20,150,2694,2673,5367,12233
-170,-30,-40,2671,2696,5367,12540
10,-20,-130,2697,2670,5367,12530
60,70,140,2702,2665,5367,12792
40,-80,-90,2680,2688,5368,12349
100,80,110,2691,2677,5368,12676
140,0,20,2667,2701,5368,12652
-50,-40,150,2732,2636,5368,12629
-30,70,-130,2653,2715,5368,12375
-140,-70,20,2691,2677,5368,12430
20,30,-150,2699,2669,5368,12239
30,30,180,2705,2664,5369,12120
110,70,70,2716,2653,5369,12108
-100,-70,120,2694,2675,5369,12412
30,30,-180,2705,2664,5369,12120
-170,-40,10,2705,2664,5369,12326
170,-80,-30,2691,2678,5369,12275
20,-40,180,2717,2653,5370,12275
20,-40,-180,2717,2653,5370,12275
0,-10,-120,2693,2678,5371,12824
-40,60,-170,2670,2701,5371,12191
-160,-60,40,2727,2645,5372,12156
160,-80,-40,2691,2683,5374,12334
160,-80,30,2696,2678,5374,12759
-10,80,-180,2672,2703,5375,11970
-10,80,180,2672,2703,5375,11970
-170,-60,-30,2688,2687,5375,12423
-50,40,-160,2674,2701,5375,12678
160,50,40,2703,2673,5376,12560
-150,80,-30,2697,2679,5376,12475
40,60,140,2693,2684,5377,12127
90,-70,-110,2735,2642,5377,12429
180,80,20,2711,2666,5377,12678
-180,80,20,2711,2666,5377,12678
-130,80,-50,2715,2662,5377,12396
140,-50,10,2639,2738,5377,12471
30,70,140,2665,2712,5377,12278
-140,-70,50,2713,2664,5377,12237
140,30,10,2650,2728,5378,12702
10,70,-160,2675,2703,5378,12880
-170,50,0,2694,2685,5379,12547
180,10,30,2689,2690,5379,12344
130,-40,-20,2716,2663,5379,12525
-180,10,30,2689,2690,5379,12344
30,-80,-100,2690,2689,5379,12419
-20,-90,-150,2682,2698,5380,12556
40,-90,-90,2682,2698,5380,12556
20,-90,-110,2682,2698,5380,12556
150,-90,20,2682,2698,5380,12556
-150,-90,80,2682,2698,5380,12556
-50,-90,180,2682,2698,5380,12556
50,-90,-80,2682,2698,5380,12556
160,-90,30,2682,2698,5380,12556
130,-90,0,2682,2698,5380,12556
-40,-90,-170,2682,2698,5380,12556
30,-90,-100,2682,2698,5380,12556
-130,-90,100,2682,2698,5380,12556
-170,-90,60,2682,2698,5380,12556
-10,-90,-140,2682,2698,5380,12556
-160,-90,70,2682,2698,5380,12556
10,-90,-120,2682,2698,5380,12556
-30,-90,-160,2682,2698,5380,12556
100,-90,-30,2682,2698,5380,12556
-70,-90,160,2682,2698,5380,12556
-90,-90,140,2682,2698,5380,12556
-180,-90,50,2682,2698,5380,12556
180,-90,50,2682,2698,5380,12556
70,-90,-60,2682,2698,5380,12556
0,-90,-130,2682,2698,5380,12556
-80,-90,150,2682,2698,5380,12556
-100,-90,130,2682,2698,5380,12556
170,-90,40,2682,2698,5380,12556
80,-90,-50,2682,2698,5380,12556
-110,-90,120,2682,2698,5380,12556
60,-90,-70,2682,2698,5380,12556
-140,-90,90,2682,2698,5380,12556
-60,-90,170,2682,2698,5380,12556
140,-90,10,2682,2698,5380,12556
-50,-90,-180,2682,2698,5380,12556
110,-90,-20,2682,2698,5380,12556
120,-90,-10,2682,2698,5380,12556
-120,-90,110,2682,2698,5380,12556
90,-90,-40,2682,2698,5380,12556
50,-80,-80,2687,2693,5380,12456
-40,-30,-160,2710,2671,5381,12411
20,70,140,2689,2692,5381,12301
-50,-70,120,2702,2679,5381,12642
30,10,170,2697,2685,5382,12151
20,-80,-110,2677,2705,5382,12480
120,80,90,2696,2687,5383,12681
0,0,-120,2701,2682,5383,12764
-120,-80,50,2693,2691,5384,12378
70,-70,-60,2690,2694,5384,12763
20,0,-130,2670,2714,5384,12497
-170,70,-20,2685,2700,5385,12645
0,-80,170,2690,2695,5385,12317
30,50,140,2688,2699,5387,12174
170,-20,30,2709,2678,5387,12243
-10,30,150,2709,2678,5387,12483
-150,-50,0,2705,2682,5387,12355
60,-30,-130,2696,2692,5388,12925
180,70,-10,2713,2676,5389,12552
-180,70,-10,2713,2676,5389,12552
-170,70,10,2675,2714,5389,12493
130,50,30,2656,2733,5389,12582
60,-80,-70,2696,2694,5390,12553
-170,-50,40,2699,2691,5390,12433
40,60,150,2701,2690,5391,12486
10,-10,-120,2711,2680,5391,13043
30,0,-180,2708,2684,5392,12317
-140,-60,30,2696,2696,5392,12444
-40,40,-130,2731,2661,5392,12622
-160,-10,-20,2761,2631,5392,12409
150,-80,20,2714,2678,5392,12781
-160,-80,20,2731,2661,5392,12382
130,-70,-80,2705,2687,5392,12594
0,-30,-130,2753,2639,5392,12673
-160,80,-20,2712,2680,5392,12525
30,0,180,2708,2684,5392,12317
30,-90,-160,2741,2652,5393,12420
-60,-90,110,2741,2652,5393,12420
50,-90,-140,2741,2652,5393,12420
130,-90,-60,2741,2652,5393,12420
-30,-90,140,2741,2652,5393,12420
-130,-90,40,2741,2652,5393,12420
160,-90,-30,2741,2652,5393,12420
170,-90,-20,2741,2652,5393,12420
-70,-90,100,2741,2652,5393,12420
150,-90,-40,2741,2652,5393,12420
-90,-90,80,2741,2652,5393,12420
0,-90,170,2741,2652,5393,12420
-50,-90,120,2741,2652,5393,12420
80,-90,-110,2741,2652,5393,12420
180,-90,-10,2741,2652,5393,12420
-20,-90,150,2741,2652,5393,12420
-110,-90,60,2741,2652,5393,12420
150,-80,-50,2707,2686,5393,12380
10,-90,-180,2741,2652,5393,12420
-100,-90,70,2741,2652,5393,12420
-80,-90,90,2741,2652,5393,12420
140,-90,-50,2741,2652,5393,12420
-180,-90,-10,2741,2652,5393,12420
-170,10,-10,2720,2673,5393,12027
-140,-90,30,2741,2652,5393,12420
-150,-90,20,2741,2652,5393,12420
40,-90,-150,2741,2652,5393,12420
120,-90,-70,2741,2652,5393,12420
-10,-90,160,2741,2652,5393,12420
10,-90,180,2741,2652,5393,12420
100,-90,-90,2741,2652,5393,12420
90,-90,-100,2741,2652,5393,12420
-160,-90,10,2741,2652,5393,12420
60,-90,-130,2741,2652,5393,12420
20,-90,-170,2741,2652,5393,12420
-40,-90,130,2741,2652,5393,12420
-170,-90,0,2741,2652,5393,12420
70,-90,-120,2741,2652,5393,12420
-10,-80,160,2710,2683,5393,12329
-120,-90,50,2741,2652,5393,12420
110,-90,-80,2741,2652,5393,12420
-40,-20,-160,2719,2676,5395,12578
140,50,50,2685,2710,5395,12493
90,-70,-40,2683,2712,5395,12839
-180,0,30,2695,2701,5396,12587
180,0,30,2695,2701,5396,12587
80,-70,-50,2680,2716,5396,12891
60,80,120,2706,2690,5396,12095
120,-30,-60,2680,2716,5396,12567
50,-60,-90,2707,2690,5397,12595
80,-80,-50,2693,2704,5397,12630
50,-70,-80,2672,2725,5397,12740
-160,-70,0,2711,2686,5397,12594
-30,80,-150,2723,2675,5398,12358
-180,30,-20,2702,2696,5398,12405
40,80,140,2700,2698,5398,12275
180,30,-20,2702,2696,5398,12405
-140,-80,40,2749,2650,5399,12243
-170,-50,30,2739,2660,5399,12326
140,70,30,2704,2696,5400,12199
-160,70,-20,2723,2677,5400,12405
-60,60,-120,2687,2713,5400,12747
150,20,-20,2698,2702,5400,12621
-150,-80,30,2749,2652,5401,12295
130,80,80,2698,2703,5401,12672
70,-60,-80,2744,2657,5401,12333
-160,70,-30,2714,2687,5401,12637
100,-60,-100,2729,2672,5401,12519
170,10,30,2721,2681,5402,12401
-130,-80,50,2725,2678,5403,12226
40,-70,-90,2665,2738,5403,12837
-70,-60,140,2738,2665,5403,12404
20,-40,-120,2716,2687,5403,12725
100,-70,-30,2674,2729,5403,12725
80,80,130,2693,2711,5404,12860
-10,-80,-140,2667,2738,5405,12468
-10,80,-150,2680,2725,5405,12691
130,-80,0,2727,2678,5405,12824
180,-50,40,2737,2668,5405,12339
-180,-50,40,2737,2668,5405,12339
-180,10,-40,2691,2714,5405,12854
60,-70,-70,2688,2717,5405,12698
180,10,-40,2691,2714,5405,12854
-120,-80,60,2735,2670,5405,12238
30,20,-160,2681,2725,5406,12441
-70,70,-110,2734,2672,5406,12558
-170,10,-20,2727,2679,5406,12285
130,-60,0,2676,2730,5406,12450
0,-20,-140,2731,2675,5406,12547
-10,40,150,2738,2669,5407,12657
50,80,130,2705,2702,5407,12191
-170,-60,50,2713,2694,5407,12365
-10,-10,-150,2715,2692,5407,12482
0,0,-130,2749,2658,5407,12589
70,-40,-120,2678,2730,5408,12782
130,70,40,2704,2704,5408,12396
90,-80,-40,2707,2701,5408,12711
30,-70,-160,2758,2651,5409,12221
10,-30,-120,2728,2681,5409,12982
30,60,130,2721,2688,5409,12615
130,-50,-10,2707,2702,5409,12345
-40,-30,150,2761,2649,5410,12943
-140,80,-40,2718,2692,5410,12490
-130,-60,40,2706,2705,5411,12851
20,70,150,2681,2731,5412,12430
-20,30,160,2709,2703,5412,12272
30,70,150,2707,2705,5412,12379
150,-70,20,2695,2718,5413,12698
40,80,170,2692,2721,5413,12789
-170,60,-10,2737,2676,5413,12664
20,-80,-170,2750,2663,5413,12544
-50,-70,180,2677,2736,5413,12501
-50,-70,-180,2677,2736,5413,12501
60,-50,-100,2739,2675,5414,12252
-10,50,-140,2707,2707,5414,12675
10,-50,-120,2747,2668,5415,12661
140,70,60,2688,2727,5415,13099
10,20,150,2715,2700,5415,12402
110,-70,-20,2698,2718,5416,12818
30,80,150,2697,2719,5416,12372
0,-20,-130,2768,2648,5416,12829
-170,-30,20,2717,2699,5416,12378
130,-50,-30,2747,2670,5417,12542
30,10,-180,2748,2669,5417,12494
-150,-60,10,2719,2698,5417,12503
-40,-10,-160,2718,2699,5417,12766
140,-70,10,2693,2724,5417,12844
20,-70,-110,2715,2702,5417,12745
30,10,180,2748,2669,5417,12494
30,-80,-160,2743,2674,5417,12551
30,-20,-170,2728,2690,5418,12506
-50,-50,170,2732,2686,5418,12710
150,-10,-40,2698,2720,5418,12549
-20,80,-140,2689,2729,5418,12738
20,90,160,2716,2703,5419,12568
10,90,170,2716,2703,5419,12568
180,90,0,2716,2703,5419,12568
160,90,20,2716,2703,5419,12568
60,90,120,2716,2703,5419,12568
140,90,40,2716,2703,5419,12568
40,90,140,2716,2703,5419,12568
70,90,110,2716,2703,5419,12568
0,90,-180,2716,2703,5419,12568
-130,90,-50,2716,2703,5419,12568
0,90,180,2716,2703,5419,12568
150,90,30,2716,2703,5419,12568
30,90,150,2716,2703,5419,12568
-170,90,-10,2716,2703,5419,12568
-160,90,-20,2716,2703,5419,12568
-80,90,-100,2716,2703,5419,12568
50,90,130,2716,2703,5419,12568
-30,90,-150,2716,2703,5419,12568
-150,90,-30,2716,2703,5419,12568
-180,90,0,2716,2703,5419,12568
-120,90,-60,2716,2703,5419,12568
-40,90,-140,2716,2703,5419,12568
80,90,100,2716,2703,5419,12568
-100,90,-80,2716,2703,5419,12568
-110,90,-70,2716,2703,5419,12568
-60,90,-120,2716,2703,5419,12568
110,90,70,2716,2703,5419,12568
-10,90,-170,2716,2703,5419,12568
-160,-40,-30,2735,2684,5419,12551
-140,90,-40,2716,2703,5419,12568
120,90,60,2716,2703,5419,12568
-20,90,-160,2716,2703,5419,12568
90,90,90,2716,2703,5419,12568
-70,90,-110,2716,2703,5419,12568
-50,90,-130,2716,2703,5419,12568
170,90,10,2716,2703,5419,12568
-90,90,-90,2716,2703,5419,12568
100,90,80,2716,2703,5419,12568
130,90,50,2716,2703,5419,12568
-40,50,-130,2728,2692,5420,12714
-140,-70,80,2724,2696,5420,12692
130,60,40,2694,2727,5421,12671
-30,10,160,2718,2703,5421,12555
170,30,30,2709,2712,5421,12584
-120,-70,60,2767,2654,5421,12490
-100,-70,70,2711,2711,5422,12749
70,80,110,2704,2718,5422,12185
-150,-60,0,2700,2722,5422,12592
10,70,150,2705,2717,5422,12173
120,-80,-70,2765,2657,5422,12677
-50,30,-150,2706,2717,5423,12493
-20,-80,-150,2679,2745,5424,12451
-160,-20,-30,2715,2709,5424,12726
120,70,70,2715,2709,5424,12700
20,-20,170,2731,2694,5425,12426
10,-80,-180,2725,2700,5425,12477
10,-80,180,2725,2700,5425,12477
10,-70,-120,2726,2700,5426,12803
-170,80,-10,2740,2686,5426,12619
130,70,50,2742,2684,5426,12572
150,60,20,2718,2708,5426,12418
-100,80,-70,2717,2710,5427,12938
140,40,20,2676,2752,5428,12382
130,-80,-60,2778,2650,5428,12633
10,-80,-120,2678,2750,5428,12532
140,10,20,2738,2690,5428,12834
-10,70,170,2730,2698,5428,11996
-170,20,20,2736,2692,5428,12825
0,40,-140,2713,2715,5428,12902
-60,-60,120,2758,2670,5428,12576
90,80,90,2717,2712,5429,12267
140,-80,-50,2773,2656,5429,12765
50,70,140,2711,2719,5430,12636
-170,-30,0,2727,2703,5430,12459
10,-30,-130,2758,2672,5430,12840
-30,30,-140,2780,2650,5430,12596
-30,-10,-150,2754,2676,5430,12761
-70,80,-100,2725,2705,5430,12695
100,80,80,2715,2716,5431,12494
20,20,-140,2725,2706,5431,12640
0,-20,160,2749,2683,5432,12308
-130,-80,40,2720,2712,5432,12433
120,-50,-80,2738,2694,5432,12600
140,-80,10,2740,2692,5432,12852
170,80,30,2731,2702,5433,12807
0,-50,-130,2747,2686,5433,12756
-10,10,-130,2725,2708,5433,12639
-60,70,-120,2734,2700,5434,12611
-50,70,-130,2738,2696,5434,12499
170,40,-20,2718,2716,5434,12481
0,-40,-130,2748,2686,5434,12620
-20,70,-140,2701,2734,5435,12737
-170,-80,10,2762,2673,5435,12369
-140,-60,20,2745,2691,5436,12793
-130,-70,60,2721,2715,5436,12316
150,20,30,2722,2715,5437,12720
130,40,40,2714,2723,5437,12758
-160,-10,-30,2763,2675,5438,12201
30,-30,-130,2731,2707,5438,12590
-140,80,-30,2748,2690,5438,12658
-30,0,-150,2752,2687,5439,12650
-90,80,-80,2734,2705,5439,12882
10,-40,-120,2755,2684,5439,12940
70,-80,-60,2720,2720,5440,12616
130,60,50,2725,2715,5440,12446
-90,-70,130,2724,2716,5440,12652
50,-80,-140,2763,2677,5440,12636
40,-60,-100,2749,2692,5441,12783
-10,-10,-130,2742,2699,5441,12782
80,80,100,2724,2717,5441,12255
-50,-50,140,2776,2665,5441,12635
-10,10,-140,2756,2685,5441,12676
-80,80,-90,2736,2705,5441,12794
140,50,20,2674,2768,5442,12368
160,30,-20,2710,2732,5442,12745
70,-40,-100,2708,2734,5442,12834
-170,-70,10,2747,2696,5443,12221
-150,-30,-20,2750,2693,5443,13032
-60,80,-110,2737,2706,5443,12766
-170,-30,10,2745,2698,5443,12694
-110,-80,70,2763,2680,5443,12369
30,-70,-100,2712,2732,5444,12869
0,-10,-140,2770,2675,5445,12737
-160,70,-10,2732,2713,5445,12525
-180,20,-30,2730,2715,5445,12637
140,-60,-70,2767,2678,5445,12638
180,20,-30,2730,2715,5445,12637
10,40,-150,2745,2701,5446,12439
70,80,140,2721,2725,5446,12974
-150,-30,-10,2763,2683,5446,12622
50,80,160,2703,2743,5446,12918
-70,60,-130,2708,2738,5446,12708
150,-10,20,2740,2707,5447,12768
-10,0,-140,2749,2698,5447,12588
90,-60,-70,2764,2683,5447,12367
110,-40,-80,2701,2746,5447,13062
-110,80,-60,2723,2724,5447,12903
170,20,-30,2711,2736,5447,12568
0,80,-160,2714,2734,5448,12662
-20,80,-160,2749,2699,5448,12411
-30,70,-160,2685,2764,5449,12176
60,-60,-90,2755,2694,5449,12507
10,20,-130,2708,2741,5449,12716
-40,60,-130,2730,2720,5450,12661
-30,-60,140,2770,2680,5450,12828
140,-60,10,2711,2739,5450,12652
180,-10,30,2759,2692,5451,12425
-100,-80,80,2777,2674,5451,12447
-160,-20,-20,2786,2665,5451,12258
-180,-10,30,2759,2692,5451,12425
60,-30,-120,2719,2732,5451,13023
-70,-60,120,2765,2686,5451,12700
30,20,-170,2719,2733,5452,12589
30,40,170,2746,2706,5452,12413
-140,-80,30,2739,2713,5452,12611
-20,60,-140,2721,2731,5452,12667
140,20,30,2713,2740,5453,12803
-30,-50,-150,2716,2737,5453,12851
30,60,140,2714,2739,5453,12502
140,-30,0,2735,2718,5453,12645
120,-80,-10,2725,2728,5453,12839
0,60,-150,2728,2726,5454,12906
-150,-50,-10,2742,2712,5454,12726
140,0,-10,2727,2727,5454,12782
0,-10,160,2765,2689,5454,12692
-170,-50,0,2769,2686,5455,12273
-40,60,-160,2730,2725,5455,12628
30,30,170,2761,2694,5455,12493
140,-40,0,2715,2740,5455,12570
40,70,150,2721,2735,5456,12899
-170,-70,20,2763,2693,5456,12201
40,-70,-150,2763,2694,5457,12260
0,-70,170,2771,2686,5457,12492
20,-60,-110,2708,2749,5457,12829
50,-20,-140,2764,2693,5457,13027
-40,0,-160,2760,2697,5457,12704
-30,60,-180,2722,2736,5458,12569
120,-70,-10,2714,2744,5458,12900
-30,60,180,2722,2736,5458,12569
50,-60,-100,2763,2695,5458,12557
10,-20,-140,2756,2702,5458,12565
0,0,-140,2753,2706,5459,12364
40,-80,-150,2769,2691,5460,12546
30,10,-150,2734,2726,5460,12606
-40,60,-150,2713,2747,5460,12536
170,80,10,2753,2708,5461,12532
-160,-30,-30,2733,2728,5461,12770
110,80,70,2733,2728,5461,12630
0,-10,-150,2701,2760,5461,12323
10,-70,-180,2793,2669,5462,12527
10,-70,180,2793,2669,5462,12527
170,-70,-40,2777,2685,5462,12680
110,-80,-80,2791,2672,5463,12736
140,-10,-10,2733,2730,5463,12714
-70,-60,130,2745,2718,5463,12670
180,60,-10,2735,2729,5464,12554
-20,50,-140,2716,2748,5464,12616
-180,60,-10,2735,2729,5464,12554
0,70,160,2731,2733,5464,12265
-40,70,-140,2735,2730,5465,12595
20,-70,-170,2774,2691,5465,12280
-150,-70,70,2742,2723,5465,12942
30,50,170,2742,2723,5465,12530
180,80,0,2766,2700,5466,12611
-40,-70,130,2758,2708,5466,12985
-180,80,0,2766,2700,5466,12611
-130,80,-40,2732,2734,5466,12849
30,-50,-120,2770,2697,5467,12787
130,50,50,2723,2744,5467,12868
-40,40,-140,2775,2692,5467,12640
0,10,-140,2742,2725,5467,12685
50,-20,-130,2730,2737,5467,12897
150,40,40,2748,2720,5468,12812
30,60,-180,2726,2742,5468,12885
30,60,180,2726,2742,5468,12885
60,-40,-110,2775,2693,5468,12728
180,-60,10,2770,2699,5469,12430
-170,10,-30,2752,2717,5469,12586
-20,-50,-140,2747,2722,5469,12715
-10,20,-140,2770,2699,5469,12729
160,70,20,2757,2712,5469,12582
-180,-60,10,2770,2699,5469,12430
20,-40,-130,2766,2704,5470,12728
10,30,-140,2734,2736,5470,12647
-150,-40,-20,2765,2705,5470,12971
-170,-20,-40,2753,2717,5470,12966
100,-80,-30,2738,2732,5470,12798
-150,-80,20,2750,2721,5471,12602
0,-10,-130,2786,2685,5471,12849
150,-80,-40,2792,2679,5471,12638
100,-80,-90,2797,2674,5471,12606
140,60,30,2715,2757,5472,12741
-170,0,0,2775,2697,5472,12583
-170,-20,10,2763,2710,5473,12657
0,-30,-140,2775,2698,5473,12683
0,10,-130,2755,2718,5473,12977
-10,80,-170,2749,2724,5473,12653
110,-80,-20,2727,2747,5474,12849
-50,60,-130,2755,2720,5475,12818
150,40,0,2722,2753,5475,12665
160,-30,-50,2770,2705,5475,12816
-160,-60,0,2742,2733,5475,12547
-170,-10,-40,2729,2748,5477,12982
10,10,-130,2739,2738,5477,12911
160,-80,-30,2775,2703,5478,12551
140,-20,10,2734,2744,5478,12963
100,-70,-100,2800,2680,5480,12630
0,-80,-130,2686,2794,5480,12516
160,80,40,2759,2721,5480,12939
10,-60,-120,2723,2757,5480,12816
160,20,30,2751,2729,5480,12659
170,30,-20,2749,2732,5481,12758
-120,80,-50,2733,2748,5481,12966
130,50,40,2707,2774,5481,12639
80,-40,-100,2736,2746,5482,12730
60,80,150,2725,2757,5482,12892
-150,80,-20,2771,2711,5482,12673
-170,-70,-10,2753,2729,5482,12589
130,-30,-60,2684,2798,5482,12585
-170,60,0,2749,2733,5482,12664
0,20,150,2767,2715,5482,12491
-10,-40,-140,2744,2739,5483,12592
-50,50,-140,2736,2747,5483,12473
130,-50,-20,2741,2742,5483,12695
170,-30,30,2753,2730,5483,12556
170,50,-10,2726,2758,5484,12848
0,-70,-130,2748,2736,5484,12906
10,30,-130,2777,2707,5484,13219
-40,70,-130,2737,2747,5484,12535
-20,70,-170,2709,2775,5484,12156
150,50,10,2731,2754,5485,12918
-30,-70,-160,2714,2771,5485,12585
10,80,170,2737,2748,5485,12686
170,0,-40,2762,2724,5486,13061
90,-70,-50,2748,2738,5486,12629
-160,-80,10,2762,2724,5486,12510
100,-60,-60,2794,2692,5486,12401
-10,-80,-150,2738,2749,5487,12768
170,-80,-20,2769,2718,5487,12437
-40,30,-180,2750,2737,5487,12611
-40,30,180,2750,2737,5487,12611
20,80,160,2736,2751,5487,12641
-60,-60,160,2772,2715,5487,12632
-90,-80,90,2799,2689,5488,12501
-10,-70,160,2771,2717,5488,12618
30,-50,-160,2794,2694,5488,12433
10,-40,170,2773,2716,5489,12660
140,-40,-60,2778,2711,5489,12733
-20,-50,150,2781,2709,5490,12621
20,70,-170,2736,2754,5490,12951
-160,80,-10,2766,2724,5490,12765
-10,0,-150,2797,2693,5490,12599
-170,0,-40,2752,2738,5490,13092
-10,40,-140,2752,2739,5491,12772
160,10,-30,2738,2753,5491,12833
-180,-80,0,2791,2701,5492,12393
0,80,180,2733,2759,5492,12660
180,-80,0,2791,2701,5492,12393
0,80,-180,2733,2759,5492,12660
30,70,160,2754,2739,5493,12858
160,-30,20,2760,2734,5494,12580
180,-80,-10,2761,2734,5495,12362
-150,-80,40,2774,2721,5495,12724
60,-80,-130,2792,2703,5495,12687
10,80,-170,2741,2754,5495,12817
-180,-80,-10,2761,2734,5495,12362
100,-40,-80,2737,2758,5495,12874
-20,30,-140,2757,2738,5495,12916
-160,-70,60,2766,2730,5496,12619
0,-80,-140,2748,2748,5496,12816
-40,40,-170,2766,2730,5496,12835
30,40,150,2749,2747,5496,12442
-40,20,180,2768,2729,5497,12686
10,-10,-140,2741,2756,5497,12614
50,70,150,2755,2742,5497,13011
-130,-80,90,2760,2737,5497,12656
-100,-70,110,2776,2721,5497,12513
140,70,40,2781,2716,5497,12677
-40,20,-180,2768,2729,5497,12686
-140,-80,80,2765,2733,5498,12527
10,-30,-140,2770,2728,5498,12664
-120,-70,80,2755,2743,5498,12437
50,-30,-120,2747,2751,5498,12770
100,-70,-40,2745,2753,5498,12547
-30,20,-150,2779,2719,5498,12646
-180,70,20,2737,2762,5499,12900
-110,-70,100,2782,2717,5499,12514
10,-40,-130,2776,2723,5499,12701
-10,-20,-150,2763,2736,5499,12576
180,70,20,2737,2762,5499,12900
-140,-80,50,2781,2719,5500,12872
90,-80,-100,2807,2694,5501,12647
130,70,60,2757,2744,5501,12829
-50,50,-130,2768,2733,5501,13034
40,70,170,2731,2770,5501,13143
-40,-70,-170,2723,2778,5501,12760
130,-70,0,2727,2774,5501,12858
0,30,-140,2735,2767,5502,13077
-110,-80,110,2772,2731,5503,12777
-160,-80,30,2771,2732,5503,12688
-40,10,-160,2755,2748,5503,12874
-130,-70,80,2757,2746,5503,12900
10,90,-170,2736,2768,5504,12962
90,90,110,2736,2768,5504,12962
-20,90,-140,2736,2768,5504,12962
170,90,30,2736,2768,5504,12962
-90,90,-70,2736,2768,5504,12962
50,90,150,2736,2768,5504,12962
-70,90,-90,2736,2768,5504,12962
20,90,180,2736,2768,5504,12962
-30,-20,-150,2744,2760,5504,12884
20,90,-180,2736,2768,5504,12962
-160,90,0,2736,2768,5504,12962
-120,-80,100,2761,2743,5504,12763
0,90,-160,2736,2768,5504,12962
40,90,160,2736,2768,5504,12962
120,90,80,2736,2768,5504,12962
100,90,100,2736,2768,5504,12962
-170,90,10,2736,2768,5504,12962
60,90,140,2736,2768,5504,12962
70,90,130,2736,2768,5504,12962
-110,90,-50,2736,2768,5504,12962
180,90,20,2736,2768,5504,12962
-140,90,-20,2736,2768,5504,12962
80,90,120,2736,2768,5504,12962
-100,90,-60,2736,2768,5504,12962
-120,90,-40,2736,2768,5504,12962
130,90,70,2736,2768,5504,12962
-80,90,-80,2736,2768,5504,12962
160,90,40,2736,2768,5504,12962
30,90,170,2736,2768,5504,12962
-180,90,20,2736,2768,5504,12962
-130,90,-30,2736,2768,5504,12962
30,30,160,2795,2709,5504,12662
-40,90,-120,2736,2768,5504,12962
-60,90,-100,2736,2768,5504,12962
10,40,140,2768,2736,5504,12779
-150,90,-10,2736,2768,5504,12962
0,60,150,2761,2743,5504,12807
140,90,60,2736,2768,5504,12962
150,90,50,2736,2768,5504,12962
-10,90,-150,2736,2768,5504,12962
-50,90,-110,2736,2768,5504,12962
110,90,90,2736,2768,5504,12962
-30,90,-130,2736,2768,5504,12962
-120,-70,90,2777,2728,5505,12686
-180,50,-10,2774,2731,5505,12727
180,50,-10,2774,2731,5505,12727
-50,80,-120,2757,2748,5505,12894
10,60,-160,2729,2776,5505,13067
-170,-60,30,2746,2760,5506,12440
10,50,140,2793,2713,5506,12988
20,-50,-120,2772,2735,5507,13098
170,40,30,2742,2765,5507,13105
150,10,-20,2737,2770,5507,12797
-180,-60,40,2756,2752,5508,12820
-170,80,0,2781,2727,5508,12742
140,60,50,2724,2784,5508,12981
30,-40,-160,2782,2726,5508,12736
120,80,60,2766,2742,5508,12752
180,-60,40,2756,2752,5508,12820
140,20,10,2723,2786,5509,12893
20,20,-150,2781,2728,5509,12675
-170,-20,20,2737,2772,5509,12830
-110,-70,60,2745,2764,5509,13109
180,-70,10,2796,2714,5510,12486
-10,70,-150,2740,2770,5510,12803
170,-80,-10,2793,2717,5510,12542
-180,-70,10,2796,2714,5510,12486
70,-80,-120,2808,2702,5510,12687
160,-10,-40,2770,2740,5510,12570
140,20,0,2726,2785,5511,12988
140,80,40,2778,2733,5511,12777
140,10,10,2737,2774,5511,12921
140,-70,-70,2747,2764,5511,12845
10,20,-140,2732,2780,5512,12650
150,-60,-60,2795,2717,5512,12769
30,80,160,2785,2728,5513,12728
-10,70,-180,2742,2772,5514,12360
150,70,30,2783,2731,5514,12807
-10,70,180,2742,2772,5514,12360
-40,10,-180,2775,2739,5514,13157
-40,10,180,2775,2739,5514,13157
50,-50,-140,2780,2735,5515,12720
-30,70,-150,2754,2761,5515,12721
-170,-80,0,2768,2747,5515,12456
-60,50,-140,2761,2755,5516,12929
130,80,50,2776,2741,5517,12778
-10,-70,-140,2742,2775,5517,12667
170,70,10,2792,2725,5517,12600
-30,60,-170,2769,2749,5518,12502
160,80,20,2782,2736,5518,12604
80,-80,-110,2811,2707,5518,12695
30,70,-180,2732,2786,5518,13031
90,-40,-90,2769,2749,5518,12869
-120,-70,70,2768,2750,5518,12557
30,70,180,2732,2786,5518,13031
160,60,40,2775,2744,5519,12969
80,-60,-80,2783,2736,5519,12541
50,-50,-110,2782,2737,5519,12760
-90,-70,120,2788,2731,5519,12681
30,-10,-170,2808,2711,5519,12731
130,-60,-10,2732,2788,5520,12931
160,-70,-50,2784,2736,5520,12879
-20,20,160,2762,2758,5520,12410
140,-30,-10,2797,2724,5521,12714
-40,-10,170,2780,2741,5521,12670
-30,20,170,2775,2746,5521,12637
140,30,20,2760,2762,5522,12680
-170,-70,50,2780,2742,5522,12692
110,-60,-90,2784,2738,5522,12676
-30,-40,150,2828,2694,5522,12839
20,10,-140,2776,2746,5522,12916
30,20,-180,2814,2709,5523,12785
30,20,180,2814,2709,5523,12785
30,-40,-130,2802,2722,5524,12770
-180,-30,30,2796,2728,5524,12755
180,-30,30,2796,2728,5524,12755
-150,-80,70,2791,2734,5525,12612
10,30,-150,2779,2746,5525,12865
130,-40,-30,2769,2756,5525,12642
180,80,10,2768,2758,5526,12855
-20,10,-150,2820,2706,5526,12812
-180,80,10,2768,2758,5526,12855
-40,-50,140,2804,2722,5526,12591
80,-70,-60,2783,2744,5527,12708
-180,-50,10,2783,2744,5527,12601
40,-50,-150,2811,2716,5527,12668
180,-50,10,2783,2744,5527,12601
-160,-60,-10,2781,2747,5528,12690
-80,-70,140,2772,2756,5528,12775
160,50,0,2751,2778,5529,12747
120,-40,-50,2785,2744,5529,12560
30,0,-170,2791,2738,5529,12720
-50,60,-150,2757,2773,5530,12900
-30,70,-140,2765,2765,5530,12834
150,80,30,2791,2739,5530,12573
60,-70,-80,2780,2750,5530,12674
30,-60,-110,2802,2728,5530,13046
180,-70,0,2791,2740,5531,12249
-180,-70,0,2791,2740,5531,12249
150,80,50,2773,2758,5531,13113
0,0,-150,2762,2769,5531,12637
110,-60,-50,2812,2719,5531,12749
90,-90,-50,2763,2769,5532,12898
140,-90,0,2763,2769,5532,12898
100,-90,-40,2763,2769,5532,12898
-100,-90,120,2763,2769,5532,12898
-70,-90,150,2763,2769,5532,12898
-140,-90,80,2763,2769,5532,12898
20,-90,-120,2763,2769,5532,12898
-60,-90,160,2763,2769,5532,12898
-50,-90,170,2763,2769,5532,12898
120,-90,-20,2763,2769,5532,12898
130,-90,-10,2763,2769,5532,12898
40,-90,-100,2763,2769,5532,12898
-10,-90,-150,2763,2769,5532,12898
-170,-90,50,2763,2769,5532,12898
150,0,20,2751,2781,5532,12912
50,-90,-90,2763,2769,5532,12898
30,-90,-110,2763,2769,5532,12898
-130,-90,90,2763,2769,5532,12898
-80,-90,140,2763,2769,5532,12898
0,-90,-140,2763,2769,5532,12898
-20,-90,-160,2763,2769,5532,12898
-40,-90,180,2763,2769,5532,12898
70,-90,-70,2763,2769,5532,12898
60,-90,-80,2763,2769,5532,12898
80,-90,-60,2763,2769,5532,12898
-30,-90,-170,2763,2769,5532,12898
-40,-90,-180,2763,2769,5532,12898
10,-90,-130,2763,2769,5532,12898
110,-90,-30,2763,2769,5532,12898
-150,-90,70,2763,2769,5532,12898
-180,-90,40,2763,2769,5532,12898
-160,-90,60,2763,2769,5532,12898
150,-90,10,2763,2769,5532,12898
160,-90,20,2763,2769,5532,12898
180,-90,40,2763,2769,5532,12898
-120,-90,100,2763,2769,5532,12898
-90,-90,130,2763,2769,5532,12898
170,-90,30,2763,2769,5532,12898
-110,-90,110,2763,2769,5532,12898
20,80,170,2794,2739,5533,12703
140,40,40,2746,2788,5534,12782
80,90,110,2763,2771,5534,12948
40,90,150,2763,2771,5534,12948
20,90,170,2763,2771,5534,12948
-10,90,-160,2763,2771,5534,12948
30,90,160,2763,2771,5534,12948
-60,90,-110,2763,2771,5534,12948
10,90,180,2763,2771,5534,12948
60,90,130,2763,2771,5534,12948
-110,90,-60,2763,2771,5534,12948
-50,90,-120,2763,2771,5534,12948
100,90,90,2763,2771,5534,12948
-120,90,-50,2763,2771,5534,12948
50,90,140,2763,2771,5534,12948
10,90,-180,2763,2771,5534,12948
-160,90,-10,2763,2771,5534,12948
170,90,20,2763,2771,5534,12948
-70,90,-100,2763,2771,5534,12948
0,20,-140,2777,2757,5534,12951
90,90,100,2763,2771,5534,12948
-170,90,0,2763,2771,5534,12948
-20,90,-150,2763,2771,5534,12948
110,90,80,2763,2771,5534,12948
120,90,70,2763,2771,5534,12948
-180,90,10,2763,2771,5534,12948
180,90,10,2763,2771,5534,12948
-80,90,-90,2763,2771,5534,12948
-90,90,-80,2763,2771,5534,12948
-30,90,-140,2763,2771,5534,12948
150,90,40,2763,2771,5534,12948
0,90,-170,2763,2771,5534,12948
140,90,50,2763,2771,5534,12948
-130,90,-40,2763,2771,5534,12948
-150,90,-20,2763,2771,5534,12948
70,90,120,2763,2771,5534,12948
-140,90,-30,2763,2771,5534,12948
160,90,30,2763,2771,5534,12948
130,90,60,2763,2771,5534,12948
-100,90,-70,2763,2771,5534,12948
-10,-20,160,2783,2751,5534,12634
-40,90,-130,2763,2771,5534,12948
-40,30,-150,2776,2759,5535,12959
30,10,-170,2801,2734,5535,12854
0,-60,-130,2776,2759,5535,12622
20,70,160,2783,2752,5535,12736
120,-60,-30,2773,2762,5535,12749
100,80,90,2794,2741,5535,12669
-20,-70,-150,2747,2789,5536,12595
50,-70,-140,2832,2704,5536,12511
-110,-70,70,2807,2730,5537,12846
150,-70,-60,2782,2755,5537,12825
160,70,40,2784,2753,5537,13251
-170,70,-10,2797,2741,5538,12839
10,-80,-130,2779,2759,5538,13026
-160,-40,-10,2812,2726,5538,12820
-180,50,20,2764,2774,5538,13026
180,50,20,2764,2774,5538,13026
130,-30,-40,2799,2740,5539,12527
90,80,100,2784,2756,5540,12652
180,-70,-20,2778,2762,5540,12858
-180,-70,-20,2778,2762,5540,12858
-160,-80,60,2802,2739,5541,12817
160,-40,20,2778,2764,5542,12692
10,70,160,2766,2776,5542,12684
90,-50,-100,2754,2788,5542,12849
-110,-70,90,2783,2759,5542,12640
-50,-60,170,2772,2771,5543,12652
-30,-70,140,2800,2743,5543,13061
-100,-80,120,2791,2753,5544,12802
140,-50,0,2739,2805,5544,12844
40,-20,-130,2779,2765,5544,12844
140,-20,-20,2810,2735,5545,12661
-40,-40,150,2822,2723,5545,12795
-40,60,-140,2766,2779,5545,12721
-20,-70,150,2796,2749,5545,12910
-130,-70,70,2770,2776,5546,12579
180,40,-10,2793,2753,5546,12692
-180,40,-10,2793,2753,5546,12692
-110,-70,80,2778,2769,5547,12850
-20,0,-150,2794,2753,5547,12952
30,-60,-160,2822,2725,5547,12526
-10,-50,-140,2776,2771,5547,12671
60,-40,-130,2791,2756,5547,13082
40,-40,-150,2820,2728,5548,12841
-180,-30,-40,2783,2765,5548,12963
70,-70,-70,2785,2763,5548,12649
-30,50,-180,2776,2772,5548,12851
180,-30,-40,2783,2765,5548,12963
140,10,0,2765,2783,5548,12878
-30,50,180,2776,2772,5548,12851
-170,-10,0,2791,2758,5549,12831
180,60,20,2778,2771,5549,13087
-180,60,20,2778,2771,5549,13087
120,80,70,2807,2742,5549,12695
20,30,150,2795,2755,5550,12708
-120,-70,50,2777,2773,5550,13106
40,-80,-100,2796,2754,5550,13096
-40,-20,160,2801,2749,5550,12803
180,-50,-40,2792,2758,5550,12877
-180,-50,-40,2792,2758,5550,12877
110,-70,-30,2765,2786,5551,12901
-170,-60,40,2794,2757,5551,12650
-170,-80,20,2826,2725,5551,12700
-30,60,-140,2754,2798,5552,12716
-170,-60,-20,2817,2735,5552,12886
-30,-30,-150,2754,2798,5552,12981
-170,-20,0,2815,2738,5553,12916
50,-40,-140,2842,2711,5553,12883
180,70,0,2798,2756,5554,12941
30,-80,-110,2809,2745,5554,13154
50,-40,-120,2784,2770,5554,12956
-180,70,0,2798,2756,5554,12941
-40,80,-130,2784,2770,5554,12936
20,-60,-170,2851,2703,5554,12562
-170,10,10,2821,2734,5555,13102
10,-40,-140,2800,2755,5555,12718
-170,-80,50,2830,2725,5555,12940
-170,-50,-30,2816,2740,5556,12947
50,80,140,2788,2768,5556,12824
-60,60,-140,2751,2805,5556,12821
-80,-80,100,2823,2733,5556,12722
10,80,180,2816,2741,5557,12956
10,80,-180,2816,2741,5557,12956
110,80,80,2818,2739,5557,12771
-80,-70,130,2808,2750,5558,12793
-170,-60,0,2797,2761,5558,12723
40,-10,-150,2801,2757,5558,12967
180,-40,-40,2807,2752,5559,12908
-130,-80,60,2822,2737,5559,12818
-180,-40,-40,2807,2752,5559,12908
140,-20,-30,2794,2766,5560,12598
20,80,-180,2772,2788,5560,13003
20,80,180,2772,2788,5560,13003
130,80,60,2813,2747,5560,12862
160,-20,20,2763,2797,5560,12894
20,-80,-120,2804,2757,5561,13135
0,80,-170,2807,2754,5561,13081
170,60,0,2778,2783,5561,12799
-10,30,-140,2785,2777,5562,12999
160,60,10,2794,2768,5562,12723
0,70,170,2774,2788,5562,12618
140,60,40,2825,2737,5562,12747
170,70,30,2790,2772,5562,13173
110,-70,-90,2825,2737,5562,12847
-180,40,20,2770,2793,5563,13177
180,-20,30,2816,2747,5563,12618
30,0,-140,2813,2750,5563,12829
80,80,110,2798,2765,5563,12700
-180,-20,30,2816,2747,5563,12618
40,80,150,2799,2764,5563,12755
180,40,20,2770,2793,5563,13177
-20,70,-150,2780,2784,5564,12834
-170,-40,-10,2832,2732,5564,12797
30,60,170,2782,2783,5565,12987
150,70,50,2772,2794,5566,13212
-30,-60,-160,2789,2777,5566,13001
170,50,30,2785,2782,5567,13243
140,-20,-10,2788,2779,5567,12740
-170,0,-10,2831,2736,5567,12743
110,-40,-70,2753,2814,5567,12878
-130,-70,40,2768,2799,5567,13096
60,-80,-80,2816,2752,5568,13306
-100,-70,100,2806,2762,5568,12976
40,-60,-110,2838,2731,5569,12755
130,80,70,2807,2762,5569,13209
-20,70,-160,2782,2788,5570,12774
170,80,20,2777,2793,5570,12979
40,-10,-140,2815,2756,5571,13052
20,50,-170,2798,2773,5571,12957
170,-40,30,2782,2789,5571,12702
160,-40,-50,2802,2769,5571,12951
-90,-80,130,2810,2762,5572,12889
170,70,20,2808,2764,5572,13083
40,-60,-150,2822,2751,5573,12749
10,0,160,2784,2789,5573,12724
-10,-10,160,2774,2799,5573,12614
-180,-70,40,2796,2778,5574,12982
-140,-70,70,2823,2751,5574,13040
180,-70,40,2796,2778,5574,12982
-30,40,-140,2820,2755,5575,13044
140,50,30,2785,2790,5575,12973
20,40,140,2808,2768,5576,13204
30,80,170,2759,2817,5576,13130
50,-80,-90,2813,2763,5576,13169
-170,-60,-10,2813,2764,5577,12798
-20,-80,-160,2792,2785,5577,12812
-10,20,-150,2795,2782,5577,12711
170,-70,-10,2818,2759,5577,12610
-70,-80,110,2829,2749,5578,12711
-160,-50,-20,2809,2769,5578,13013
110,80,90,2797,2782,5579,13327
0,-20,-150,2814,2765,5579,12612
90,80,110,2798,2781,5579,13217
-30,-40,-150,2773,2807,5580,13144
140,-20,0,2821,2759,5580,13071
70,-80,-70,2816,2765,5581,13219
160,40,-10,2778,2803,5581,12752
120,80,80,2806,2775,5581,13238
20,70,170,2814,2768,5582,12838
-20,20,-150,2870,2712,5582,12588
20,30,-160,2815,2767,5582,12727
-50,-50,160,2832,2750,5582,12750
70,80,120,2791,2791,5582,12717
-10,10,-150,2854,2729,5583,12776
-20,-20,-150,2784,2799,5583,12989
90,-50,-80,2798,2785,5583,12820
170,-70,-30,2778,2805,5583,13066
-180,-60,20,2771,2813,5584,12541
-150,-70,20,2773,2811,5584,12960
80,-80,-60,2807,2777,5584,13120
10,0,-140,2758,2826,5584,13024
140,-10,10,2777,2807,5584,13292
180,-60,20,2771,2813,5584,12541
-20,60,-150,2796,2789,5585,12809
-10,70,-170,2778,2807,5585,12785
20,-50,-170,2860,2725,5585,12609
-40,-50,-170,2769,2817,5586,13170
170,60,30,2786,2800,5586,13123
170,-60,30,2762,2824,5586,12981
-140,-70,60,2776,2810,5586,12762
160,60,20,2816,2770,5586,13075
150,50,20,2782,2805,5587,12745
-160,-70,40,2791,2796,5587,12649
140,20,20,2804,2784,5588,13050
150,-80,10,2795,2793,5588,13013
30,50,150,2766,2822,5588,12706
-170,70,0,2779,2809,5588,12980
90,-80,-50,2804,2784,5588,13145
20,-30,-180,2820,2768,5588,12786
20,-30,180,2820,2768,5588,12786
0,-40,-140,2809,2780,5589,12644
-170,-70,0,2763,2827,5590,13050
10,-50,-130,2837,2753,5590,13000
-40,50,-150,2842,2748,5590,12882
-180,-60,0,2805,2786,5591,12641
60,80,130,2798,2793,5591,12801
180,-60,0,2805,2786,5591,12641
80,80,120,2797,2795,5592,13235
-20,-10,-150,2799,2793,5592,13019
-20,60,-180,2785,2808,5593,12789
-20,60,180,2785,2808,5593,12789
-40,-30,-170,2833,2761,5594,13103
170,-80,30,2835,2759,5594,13067
150,30,-10,2801,2793,5594,13029
-10,-30,-150,2816,2778,5594,12761
-170,10,20,2820,2774,5594,13127
40,70,160,2796,2799,5595,13272
40,-30,-130,2806,2789,5595,13021
-180,20,-20,2827,2768,5595,12890
-10,80,-160,2821,2774,5595,13198
180,20,-20,2827,2768,5595,12890
160,80,30,2798,2797,5595,13106
140,-40,-10,2797,2798,5595,12986
140,80,60,2798,2798,5596,13210
140,-10,0,2804,2792,5596,13224
20,-10,-140,2813,2783,5596,13184
-170,0,-20,2816,2780,5596,13087
150,-40,10,2789,2809,5598,13029
-150,-40,-10,2838,2761,5599,13052
100,80,100,2809,2790,5599,13266
160,-80,-20,2850,2749,5599,12703
160,70,30,2838,2763,5601,13076
-80,-80,140,2817,2784,5601,12923
-40,20,-160,2804,2798,5602,12803
50,-70,-90,2833,2769,5602,12925
-10,70,-160,2822,2781,5603,13122
-150,-70,50,2784,2819,5603,12671
-30,-80,-170,2787,2816,5603,12874
-150,-70,60,2810,2793,5603,13164
-40,-60,-170,2782,2821,5603,13079
-180,-40,30,2824,2780,5604,12933
140,70,50,2801,2803,5604,13052
-180,70,10,2799,2805,5604,13194
180,-40,30,2824,2780,5604,12933
180,70,10,2799,2805,5604,13194
-170,-10,10,2807,2798,5605,13072
-40,50,-160,2801,2804,5605,13206
-30,50,-140,2816,2789,5605,13214
150,-30,-50,2816,2789,5605,12948
140,80,50,2828,2778,5606,12968
160,-50,-50,2835,2771,5606,12847
-150,-90,30,2837,2770,5607,12764
-70,-90,110,2837,2770,5607,12764
-120,-90,60,2837,2770,5607,12764
-40,-90,140,2837,2770,5607,12764
-60,-90,120,2837,2770,5607,12764
60,-70,-130,2881,2726,5607,12760
120,-90,-60,2837,2770,5607,12764
90,-90,-90,2837,2770,5607,12764
-80,-90,100,2837,2770,5607,12764
150,40,10,2775,2832,5607,13003
-170,-90,10,2837,2770,5607,12764
-100,-90,80,2837,2770,5607,12764
70,80,130,2802,2805,5607,13296
-180,-90,0,2837,2770,5607,12764
10,-90,-170,2837,2770,5607,12764
150,-90,-30,2837,2770,5607,12764
160,-90,-20,2837,2770,5607,12764
-50,40,-150,2783,2824,5607,13037
180,-90,0,2837,2770,5607,12764
170,-90,-10,2837,2770,5607,12764
110,-90,-70,2837,2770,5607,12764
-30,-90,150,2837,2770,5607,12764
0,-90,180,2837,2770,5607,12764
-160,-90,20,2837,2770,5607,12764
0,70,-160,2773,2834,5607,13115
80,-90,-100,2837,2770,5607,12764
-20,-90,160,2837,2770,5607,12764
0,-90,-180,2837,2770,5607,12764
70,-90,-110,2837,2770,5607,12764
140,-90,-40,2837,2770,5607,12764
50,-90,-130,2837,2770,5607,12764
-110,-90,70,2837,2770,5607,12764
-90,-90,90,2837,2770,5607,12764
130,-90,-50,2837,2770,5607,12764
-140,-90,40,2837,2770,5607,12764
100,-90,-80,2837,2770,5607,12764
-10,-90,170,2837,2770,5607,12764
40,-90,-140,2837,2770,5607,12764
-30,80,-140,2787,2820,5607,13014
60,-90,-120,2837,2770,5607,12764
30,-90,-150,2837,2770,5607,12764
-50,-90,130,2837,2770,5607,12764
20,-90,-160,2837,2770,5607,12764
-130,-90,50,2837,2770,5607,12764
70,-50,-120,2831,2777,5608,13085
60,-50,-130,2846,2762,5608,12988
180,-80,40,2824,2785,5609,13015
-140,-70,30,2796,2813,5609,13039
-20,-30,-150,2815,2794,5609,12992
-180,-80,40,2824,2785,5609,13015
-40,50,-140,2826,2783,5609,13044
140,-80,0,2809,2801,5610,12959
20,60,140,2833,2777,5610,12886
180,0,-40,2825,2785,5610,13362
-20,80,-150,2821,2789,5610,13077
-20,50,-150,2821,2789,5610,13052
-180,0,-40,2825,2785,5610,13362
140,0,10,2811,2800,5611,13380
-180,-80,10,2868,2744,5612,12847
180,-80,10,2868,2744,5612,12847
140,-20,-40,2761,2851,5612,12767
140,0,0,2806,2807,5613,13063
0,-30,-150,2821,2792,5613,12858
20,50,140,2834,2779,5613,12906
0,30,150,2838,2776,5614,13137
160,20,-20,2776,2838,5614,13001
150,50,40,2838,2777,5615,13144
20,-40,-140,2858,2757,5615,13090
170,-70,30,2824,2791,5615,13117
-40,-80,-180,2817,2798,5615,12803
20,-70,-120,2849,2766,5615,13181
-40,-80,180,2817,2798,5615,12803
-100,-70,80,2827,2789,5616,13160
-20,40,-150,2829,2787,5616,13028
140,-50,-10,2834,2783,5617,12918
160,-80,20,2836,2781,5617,13060
150,80,40,2823,2794,5617,13133
120,-70,-80,2865,2752,5617,13118
-40,-20,-180,2804,2813,5617,12925
20,-60,-120,2852,2765,5617,13186
-40,-20,180,2804,2813,5617,12925
10,70,170,2800,2818,5618,12987
-180,30,20,2801,2817,5618,13023
180,30,20,2801,2817,5618,13023
20,60,-170,2795,2823,5618,13465
-120,-80,70,2840,2778,5618,12836
-100,-70,90,2818,2800,5618,13227
-160,-70,10,2780,2839,5619,12961
140,30,30,2820,2799,5619,13188
40,80,160,2801,2819,5620,13206
10,70,-180,2825,2795,5620,12968
10,70,180,2825,2795,5620,12968
-70,-80,150,2798,2822,5620,12988
-50,50,-150,2803,2818,5621,13339
50,80,150,2818,2803,5621,13307
80,-60,-110,2862,2759,5621,12903
140,50,40,2845,2776,5621,13068
-160,-50,-10,2860,2762,5622,12957
150,70,40,2846,2776,5622,13202
30,-70,-110,2854,2768,5622,13200
80,-50,-110,2810,2813,5623,13101
150,-30,10,2803,2821,5624,13114
100,-50,-70,2814,2810,5624,12851
130,-80,-10,2807,2817,5624,12970
70,-60,-90,2829,2795,5624,12928
160,-10,20,2846,2778,5624,13033
-170,-70,30,2794,2830,5624,12676
40,-30,-150,2866,2759,5625,13238
0,70,180,2817,2808,5625,12820
150,-10,-30,2798,2827,5625,12576
0,70,-180,2817,2808,5625,12820
0,10,-150,2802,2825,5627,13026
110,-80,-30,2794,2833,5627,13094
180,-60,-30,2859,2769,5628,13096
-180,-60,-30,2859,2769,5628,13096
-30,60,-150,2820,2809,5629,12967
-50,-80,170,2810,2819,5629,12900
-20,60,170,2816,2814,5630,12884
170,-60,0,2865,2766,5631,12872
-10,-60,-140,2819,2812,5631,12943
10,-60,-180,2897,2734,5631,12683
10,-60,180,2897,2734,5631,12683
-10,-70,-150,2822,2810,5632,13310
140,40,30,2816,2816,5632,12850
30,-60,-120,2869,2764,5633,13048
120,-60,-40,2844,2789,5633,12978
-20,40,-140,2834,2800,5634,13102
-170,-10,20,2816,2818,5634,13228
130,-50,-70,2852,2782,5634,13247
150,0,-20,2822,2812,5634,12787
120,-80,-20,2822,2813,5635,12966
60,80,140,2829,2807,5636,13367
30,-30,-160,2838,2798,5636,13098
-180,-50,0,2853,2783,5636,12920
-60,-80,160,2796,2840,5636,12957
180,-50,0,2853,2783,5636,12920
140,-70,-60,2842,2795,5637,13199
160,-60,-50,2846,2791,5637,12972
160,30,30,2805,2833,5638,13272
-60,-60,150,2844,2794,5638,13028
180,-90,10,2855,2786,5641,12676
-80,-90,110,2855,2786,5641,12676
-180,-90,10,2855,2786,5641,12676
-70,-90,120,2855,2786,5641,12676
-130,-90,60,2855,2786,5641,12676
60,-90,-110,2855,2786,5641,12676
-90,-90,100,2855,2786,5641,12676
120,-90,-50,2855,2786,5641,12676
-40,-90,150,2855,2786,5641,12676
-120,-90,70,2855,2786,5641,12676
130,-90,-40,2855,2786,5641,12676
-60,-90,130,2855,2786,5641,12676
20,-90,-150,2855,2786,5641,12676
-110,-90,80,2855,2786,5641,12676
150,-90,-20,2855,2786,5641,12676
140,-90,-30,2855,2786,5641,12676
-140,-90,50,2855,2786,5641,12676
80,-90,-90,2855,2786,5641,12676
100,-90,-70,2855,2786,5641,12676
100,-80,-40,2819,2822,5641,13198
10,-90,-160,2855,2786,5641,12676
-20,-90,170,2855,2786,5641,12676
-30,-90,160,2855,2786,5641,12676
-10,-90,-180,2855,2786,5641,12676
-170,-90,20,2855,2786,5641,12676
-160,-90,30,2855,2786,5641,12676
40,-90,-130,2855,2786,5641,12676
70,-90,-100,2855,2786,5641,12676
160,-90,-10,2855,2786,5641,12676
30,-90,-140,2855,2786,5641,12676
90,-90,-80,2855,2786,5641,12676
-150,-90,40,2855,2786,5641,12676
170,-90,0,2855,2786,5641,12676
-50,-90,140,2855,2786,5641,12676
0,-90,-170,2855,2786,5641,12676
-100,-90,90,2855,2786,5641,12676
-10,-90,180,2855,2786,5641,12676
110,-90,-60,2855,2786,5641,12676
50,-90,-120,2855,2786,5641,12676
160,-70,-40,2808,2834,5642,13221
160,-50,20,2785,2858,5643,12998
10,10,-140,2789,2854,5643,13182
30,60,150,2804,2840,5644,12821
180,60,10,2839,2807,5646,13422
-170,0,-30,2850,2796,5646,13062
-20,-60,-150,2826,2820,5646,12980
-60,-80,120,2856,2790,5646,12843
-180,60,10,2839,2807,5646,13422
10,-20,-150,2826,2821,5647,13048
-170,-50,-10,2860,2787,5647,12989
-180,-70,20,2798,2850,5648,12962
180,-70,20,2798,2850,5648,12962
-30,50,-170,2812,2836,5648,13129
-70,-70,150,2823,2825,5648,13021
150,-80,-30,2871,2778,5649,12856
-40,-20,170,2830,2819,5649,13197
-40,-40,-170,2820,2829,5649,13120
-170,-30,-10,2863,2787,5650,12880
30,40,160,2857,2793,5650,12997
-90,-70,90,2843,2807,5650,13135
-160,-30,-20,2847,2803,5650,13002
-30,0,160,2832,2818,5650,12956
30,60,160,2823,2827,5650,13275
160,-70,-20,2869,2782,5651,12797
170,-70,0,2875,2776,5651,12787
-160,-40,-20,2834,2817,5651,12979
180,-50,20,2839,2813,5652,12988
40,-40,-130,2837,2815,5652,12968
-180,-50,20,2839,2813,5652,12988
-20,-20,160,2853,2799,5652,12994
0,-70,-140,2814,2839,5653,13426
-30,50,-150,2852,2801,5653,13130
50,-30,-140,2870,2783,5653,13442
40,-50,-120,2853,2800,5653,13190
-30,60,-160,2803,2850,5653,12993
140,-50,-20,2858,2796,5654,13230
130,-60,-20,2853,2803,5656,13105
-110,-80,80,2859,2798,5657,12856
0,50,-150,2827,2830,5657,13284
20,0,-140,2834,2824,5658,13242
10,-70,-130,2846,2812,5658,13286
80,-50,-90,2843,2816,5659,13030
-60,-70,160,2815,2844,5659,13172
-10,-30,160,2870,2790,5660,12867
-170,-40,-30,2858,2802,5660,12975
90,-70,-60,2840,2820,5660,13257
20,-50,-130,2886,2775,5661,13240
0,-80,180,2875,2786,5661,12833
0,-80,-180,2875,2786,5661,12833
30,-20,-140,2871,2791,5662,13208
40,-70,-100,2847,2815,5662,13173
170,-50,30,2813,2849,5662,13091
10,-40,-150,2866,2797,5663,12953
170,-80,0,2883,2780,5663,13039
-50,-60,130,2860,2803,5663,13076
0,40,150,2873,2791,5664,13083
180,60,0,2851,2813,5664,13187
-180,60,0,2851,2813,5664,13187
-40,0,180,2869,2796,5665,13411
-40,0,-180,2869,2796,5665,13411
20,10,160,2833,2832,5665,12951
-40,-20,-170,2878,2787,5665,13411
-10,60,160,2854,2811,5665,13264
180,30,-10,2836,2830,5666,13048
-180,30,-10,2836,2830,5666,13048
0,50,150,2875,2792,5667,13092
50,-60,-140,2913,2754,5667,13102
-40,-50,-180,2854,2814,5668,12978
70,-50,-100,2841,2827,5668,13186
-40,-50,180,2854,2814,5668,12978
-90,-70,110,2855,2813,5668,13214
-40,-60,180,2833,2835,5668,12926
-40,-60,-180,2833,2835,5668,12926
-160,-70,50,2854,2815,5669,13139
170,-60,-40,2864,2807,5671,12901
150,10,20,2806,2865,5671,13292
90,-70,-100,2877,2794,5671,13203
-170,-40,-20,2904,2768,5672,12880
10,-80,-170,2861,2811,5672,12848
10,20,-150,2814,2858,5672,13193
160,0,-30,2822,2850,5672,13203
-50,-80,130,2863,2810,5673,12935
150,60,30,2879,2794,5673,13163
70,-60,-120,2886,2787,5673,13188
30,-20,-160,2810,2864,5674,13182
150,-70,-50,2846,2828,5674,13325
170,20,-20,2860,2815,5675,13187
150,-50,10,2832,2843,5675,13197
-20,-60,150,2887,2788,5675,13132
160,-80,-10,2891,2784,5675,12937
30,-80,-150,2884,2791,5675,13034
20,-60,-130,2883,2793,5676,13234
160,-60,20,2834,2842,5676,13088
-30,-80,-180,2873,2803,5676,13141
-30,-80,180,2873,2803,5676,13141
0,-40,-150,2858,2818,5676,13164
120,-70,-20,2811,2865,5676,13336
30,10,-160,2827,2849,5676,13236
-170,-30,-30,2843,2834,5677,13418
10,70,-170,2838,2839,5677,13256
30,70,170,2833,2844,5677,13545
140,-80,-40,2881,2796,5677,13115
-50,-50,150,2853,2825,5678,13212
180,-50,30,2836,2842,5678,12979
10,-10,-150,2826,2852,5678,13140
-180,-50,30,2836,2842,5678,12979
-80,-70,100,2871,2808,5679,13050
30,-10,-140,2853,2826,5679,13090
130,-70,-70,2891,2789,5680,13207
180,-20,-40,2877,2804,5681,13444
20,-30,-140,2830,2851,5681,13320
-180,-20,-40,2877,2804,5681,13444
10,-50,-140,2886,2796,5682,12936
120,-40,-70,2834,2849,5683,13497
60,-50,-110,2864,2820,5684,13455
10,50,-160,2830,2854,5684,13433
160,0,20,2897,2787,5684,13124
-30,-20,-160,2866,2819,5685,13157
110,-50,-60,2850,2836,5686,12997
-20,-70,-160,2851,2836,5687,13267
20,-20,-140,2818,2870,5688,13260
-150,-80,60,2858,2830,5688,13090
100,-60,-70,2912,2777,5689,13163
170,60,20,2863,2826,5689,13738
30,0,-150,2856,2833,5689,13331
-20,-80,-170,2870,2820,5690,13039
-20,10,160,2865,2825,5690,12871
30,50,160,2822,2868,5690,13193
150,30,0,2857,2834,5691,13096
0,70,-170,2839,2852,5691,13380
180,50,0,2884,2807,5691,13206
150,60,40,2864,2827,5691,13535
-180,50,0,2884,2807,5691,13206
-50,-70,170,2855,2836,5691,13130
20,-80,-160,2892,2799,5691,12903
80,-70,-110,2875,2817,5692,13238
-20,60,-170,2849,2844,5693,12899
20,-50,-140,2873,2820,5693,13056
30,-50,-130,2853,2840,5693,12812
-40,-80,170,2881,2813,5694,13178
150,-80,-20,2890,2804,5694,13088
150,-70,-30,2889,2805,5694,13102
20,60,150,2810,2884,5694,13021
-170,0,20,2862,2833,5695,13400
-40,30,-160,2857,2839,5696,13134
70,-70,-120,2904,2792,5696,13074
-10,60,-150,2830,2866,5696,13226
30,-30,-140,2843,2854,5697,13540
30,-10,-160,2840,2858,5698,13224
20,-80,-140,2880,2818,5698,13341
-170,0,10,2849,2849,5698,13195
150,-40,0,2856,2842,5698,13220
-20,30,-150,2893,2806,5699,12949
-60,-60,130,2900,2799,5699,13343
-10,50,-150,2843,2856,5699,13341
-30,-10,-160,2892,2807,5699,13227
100,-70,-50,2862,2837,5699,13288
-10,-80,-160,2866,2834,5700,13039
170,-60,10,2862,2838,5700,13081
60,-60,-130,2903,2797,5700,13321
0,0,160,2874,2826,5700,13105
140,-40,-20,2887,2814,5701,13179
40,-20,-150,2892,2809,5701,13512
-40,40,-160,2861,2842,5703,13420
20,70,-180,2839,2864,5703,13594
20,70,180,2839,2864,5703,13594
-10,-80,170,2916,2787,5703,13069
-170,-20,-10,2878,2825,5703,13301
140,-30,-20,2898,2806,5704,13135
20,60,-180,2853,2851,5704,13568
130,-60,-30,2864,2840,5704,13264
120,-60,-80,2853,2851,5704,13008
10,-30,-150,2875,2829,5704,13197
30,-80,-130,2871,2833,5704,13219
20,60,180,2853,2851,5704,13568
-180,50,10,2855,2850,5705,13467
180,50,10,2855,2850,5705,13467
-100,-80,90,2886,2819,5705,12985
160,10,20,2879,2826,5705,13238
150,-20,10,2857,2849,5706,13447
-170,-10,-10,2884,2822,5706,13073
-30,50,-160,2860,2847,5707,13201
-30,-10,160,2847,2860,5707,13203
-20,-80,160,2898,2810,5708,13111
170,60,10,2860,2848,5708,13199
170,-10,-40,2833,2875,5708,13665
40,-80,-130,2880,2829,5709,13102
-140,-80,70,2873,2836,5709,12960
180,-60,30,2864,2845,5709,13152
60,-60,-100,2891,2818,5709,13356
-180,-60,30,2864,2845,5709,13152
-180,20,20,2842,2868,5710,13203
90,-80,-90,2913,2797,5710,13307
180,20,20,2842,2868,5710,13203
0,40,-150,2862,2848,5710,13330
-40,-80,140,2880,2830,5710,13057
-160,-80,50,2866,2844,5710,13223
90,-70,-90,2887,2824,5711,13180
170,40,-10,2856,2855,5711,13458
170,-70,10,2863,2848,5711,13155
100,-70,-90,2915,2797,5712,13109
-130,-90,80,2875,2837,5712,13291
180,40,0,2890,2822,5712,13430
-60,-90,150,2875,2837,5712,13291
0,-90,-150,2875,2837,5712,13291
50,-90,-100,2875,2837,5712,13291
-40,-90,170,2875,2837,5712,13291
-100,-90,110,2875,2837,5712,13291
-180,40,0,2890,2822,5712,13430
-120,-90,90,2875,2837,5712,13291
10,-90,-140,2875,2837,5712,13291
-80,-90,130,2875,2837,5712,13291
-160,-90,50,2875,2837,5712,13291
-70,-90,140,2875,2837,5712,13291
150,-90,0,2875,2837,5712,13291
20,-90,-130,2875,2837,5712,13291
-110,-90,100,2875,2837,5712,13291
-150,-90,60,2875,2837,5712,13291
140,-90,-10,2875,2837,5712,13291
-20,-90,-170,2875,2837,5712,13291
-30,-90,-180,2875,2837,5712,13291
90,-90,-60,2875,2837,5712,13291
-30,-90,180,2875,2837,5712,13291
-170,-90,40,2875,2837,5712,13291
170,-90,20,2875,2837,5712,13291
130,-90,-20,2875,2837,5712,13291
70,-90,-80,2875,2837,5712,13291
30,-90,-120,2875,2837,5712,13291
-90,-90,120,2875,2837,5712,13291
60,-90,-90,2875,2837,5712,13291
-140,-90,70,2875,2837,5712,13291
160,-90,10,2875,2837,5712,13291
40,-90,-110,2875,2837,5712,13291
70,-80,-110,2914,2798,5712,13152
110,-90,-40,2875,2837,5712,13291
-50,-90,160,2875,2837,5712,13291
60,-80,-120,2904,2808,5712,13121
180,-90,30,2875,2837,5712,13291
80,-90,-70,2875,2837,5712,13291
100,-90,-50,2875,2837,5712,13291
120,-90,-30,2875,2837,5712,13291
-180,-90,30,2875,2837,5712,13291
-10,-90,-160,2875,2837,5712,13291
10,-80,-150,2876,2837,5713,13399
-170,-80,40,2859,2854,5713,13383
150,30,30,2837,2876,5713,13392
160,50,10,2838,2876,5714,13370
-30,-70,-170,2848,2866,5714,13436
-130,-80,80,2884,2831,5715,13109
0,-60,-140,2874,2842,5716,13279
100,-80,-80,2924,2792,5716,13376
-40,-30,160,2909,2808,5717,13331
-180,10,-10,2891,2827,5718,13310
180,10,-10,2891,2827,5718,13310
180,-40,10,2880,2838,5718,13196
100,-50,-90,2846,2872,5718,13525
-180,-40,10,2880,2838,5718,13196
10,-60,-130,2897,2823,5720,13275
60,-40,-120,2876,2844,5720,13440
90,-60,-100,2883,2837,5720,13234
-30,-80,150,2901,2819,5720,13053
0,-80,-150,2884,2837,5721,13184
-40,-30,180,2875,2847,5722,13096
80,-80,-100,2919,2803,5722,13300
-170,-20,-30,2874,2848,5722,13392
-40,-30,-180,2875,2847,5722,13096
-10,60,-160,2863,2859,5722,13285
110,-60,-60,2887,2836,5723,13215
-10,60,170,2849,2874,5723,13101
30,-80,-140,2894,2830,5724,13169
-40,-70,-180,2853,2871,5724,13338
-160,-80,40,2875,2849,5724,13057
180,-40,20,2890,2834,5724,13358
-40,-70,180,2853,2871,5724,13338
-180,-40,20,2890,2834,5724,13358
-40,-10,-170,2916,2809,5725,13638
30,-40,-150,2909,2816,5725,13588
10,30,150,2885,2841,5726,13221
-180,-70,-10,2847,2879,5726,13280
180,-70,-10,2847,2879,5726,13280
-70,-70,110,2894,2832,5726,13196
-30,10,170,2885,2841,5726,13224
-170,-70,40,2884,2842,5726,13395
110,-80,-70,2910,2816,5726,13259
80,-70,-70,2883,2844,5727,13332
0,60,-160,2866,2861,5727,13297
-170,-80,30,2867,2860,5727,13067
130,-80,-50,2897,2830,5727,13182
170,-50,20,2868,2859,5727,13228
-60,-60,140,2914,2814,5728,13363
180,-80,20,2866,2862,5728,13246
180,-60,-20,2870,2858,5728,13378
-180,-80,20,2866,2862,5728,13246
-180,-60,-20,2870,2858,5728,13378
-90,-70,100,2879,2850,5729,13517
170,-80,10,2867,2862,5729,13219
-20,60,-160,2868,2862,5730,13098
170,-50,-40,2875,2855,5730,13206
-150,-80,50,2883,2847,5730,13026
90,-60,-80,2925,2805,5730,13389
30,0,-160,2872,2858,5730,13198
0,30,-150,2844,2886,5730,13495
-10,60,-170,2866,2864,5730,13195
170,50,0,2848,2883,5731,13247
-20,-40,-150,2891,2840,5731,13258
-20,40,170,2858,2873,5731,13435
-70,-70,140,2900,2831,5731,13128
40,-80,-140,2912,2819,5731,13268
160,40,0,2861,2871,5732,13207
20,50,150,2814,2918,5732,13095
50,-80,-130,2925,2808,5733,13254
-10,-40,160,2910,2823,5733,13041
20,10,-150,2871,2863,5734,13338
-170,-10,-20,2902,2832,5734,13185
-170,-30,-20,2918,2817,5735,13114
130,-60,-70,2890,2845,5735,13289
170,-70,20,2873,2862,5735,13339
-40,-10,180,2899,2837,5736,13365
-40,-10,-180,2899,2837,5736,13365
-40,0,-170,2910,2826,5736,13565
40,-80,-120,2892,2844,5736,13230
0,20,-150,2842,2895,5737,13292
70,-40,-110,2902,2835,5737,13521
-180,-50,-30,2866,2871,5737,13139
180,-50,-30,2866,2871,5737,13139
-90,-80,100,2909,2829,5738,13032
50,-30,-130,2848,2891,5739,13697
-170,-50,-20,2878,2861,5739,13089
10,-80,-140,2907,2832,5739,13193
140,-70,0,2870,2869,5739,13848
150,30,10,2849,2890,5739,13448
-20,-10,160,2862,2878,5740,13086
-180,-10,-40,2887,2854,5741,13638
180,-10,-40,2887,2854,5741,13638
130,-40,-40,2885,2857,5742,13157
0,-60,-150,2871,2871,5742,13187
-30,40,180,2860,2882,5742,13325
-30,40,-180,2860,2882,5742,13325
160,60,30,2879,2864,5743,13677
10,-70,-170,2921,2822,5743,13250
-10,30,-150,2884,2859,5743,13199
40,-20,-140,2905,2839,5744,13584
160,40,30,2872,2872,5744,13552
0,-70,-150,2896,2848,5744,13004
180,20,-10,2885,2861,5746,13366
170,-30,20,2912,2834,5746,13401
-180,20,-10,2885,2861,5746,13366
10,-60,-140,2902,2844,5746,13195
20,-10,170,2867,2880,5747,13406
10,-50,-180,2941,2806,5747,13228
-80,-80,110,2921,2826,5747,13027
10,-50,180,2941,2806,5747,13228
100,-70,-80,2940,2808,5748,13124
160,-70,-10,2897,2851,5748,13143
-30,30,-150,2899,2849,5748,13425
160,-70,20,2889,2860,5749,13405
10,60,150,2877,2872,5749,13213
10,60,-170,2884,2866,5750,13552
-80,-70,110,2906,2844,5750,13519
170,-40,20,2886,2864,5750,13040
110,-70,-70,2932,2820,5752,13205
-50,-80,160,2903,2849,5752,13305
-70,-80,120,2929,2823,5752,12908
20,-80,-150,2911,2842,5753,13173
-20,50,170,2896,2858,5754,13457
100,-60,-90,2883,2871,5754,13322
170,-50,10,2909,2845,5754,13392
150,20,-10,2855,2900,5755,13596
120,-80,-60,2925,2830,5755,13205
-30,-20,160,2884,2871,5755,13309
170,-80,20,2877,2879,5756,13439
140,-80,-20,2886,2870,5756,13248
20,40,-170,2887,2869,5756,13332
150,-80,0,2884,2872,5756,13156
0,-80,-160,2891,2866,5757,13282
-10,50,160,2908,2850,5758,13221
-10,60,-180,2881,2878,5759,13051
180,-70,30,2877,2882,5759,13531
-140,-80,60,2882,2877,5759,13235
160,-60,0,2890,2869,5759,13317
-10,60,180,2881,2878,5759,13051
-10,-60,160,2924,2835,5759,13541
-180,-70,30,2877,2882,5759,13531
150,-70,10,2894,2865,5759,13534
10,-70,-140,2912,2848,5760,13220
160,-50,10,2894,2866,5760,13468
-40,40,-150,2894,2866,5760,13626
180,-60,-10,2884,2877,5761,13064
-180,-60,-10,2884,2877,5761,13064
140,-80,-10,2901,2860,5761,13233
20,-70,-130,2919,2843,5762,13364
30,-10,-150,2880,2882,5762,13574
20,-40,-170,2931,2831,5762,13435
10,-80,-160,2935,2828,5763,13157
140,-80,-30,2919,2845,5764,13177
150,-60,10,2863,2901,5764,13458
-30,-50,150,2943,2821,5764,13374
0,-50,-150,2910,2855,5765,13196
110,-70,-60,2900,2865,5765,13352
110,-70,-80,2952,2813,5765,13270
170,10,-30,2872,2894,5766,13635
-40,-40,180,2890,2877,5767,13160
-40,-40,-180,2890,2877,5767,13160
160,-80,0,2886,2881,5767,13247
30,-90,-130,2894,2874,5768,13359
-100,-90,100,2894,2874,5768,13359
130,-90,-30,2894,2874,5768,13359
70,-90,-90,2894,2874,5768,13359
-120,-90,80,2894,2874,5768,13359
-170,-90,30,2894,2874,5768,13359
0,-90,-160,2894,2874,5768,13359
-40,-90,160,2894,2874,5768,13359
180,-50,-10,2927,2841,5768,13167
30,-70,-120,2917,2851,5768,13511
-160,-90,40,2894,2874,5768,13359
60,-90,-100,2894,2874,5768,13359
110,-90,-50,2894,2874,5768,13359
-140,-90,60,2894,2874,5768,13359
-180,40,10,2896,2872,5768,13668
160,-90,0,2894,2874,5768,13359
150,-90,-10,2894,2874,5768,13359
-90,-90,110,2894,2874,5768,13359
10,-90,-150,2894,2874,5768,13359
-80,-90,120,2894,2874,5768,13359
10,-30,170,2899,2869,5768,13269
120,-90,-40,2894,2874,5768,13359
-130,-90,70,2894,2874,5768,13359
20,-90,-140,2894,2874,5768,13359
80,-90,-80,2894,2874,5768,13359
-70,-90,130,2894,2874,5768,13359
-180,-50,-10,2927,2841,5768,13167
180,-90,20,2894,2874,5768,13359
-60,-90,140,2894,2874,5768,13359
100,-90,-60,2894,2874,5768,13359
-50,-90,150,2894,2874,5768,13359
90,-90,-70,2894,2874,5768,13359
-10,-90,-170,2894,2874,5768,13359
40,-90,-120,2894,2874,5768,13359
180,40,10,2896,2872,5768,13668
50,-90,-110,2894,2874,5768,13359
-110,-90,90,2894,2874,5768,13359
-150,-90,50,2894,2874,5768,13359
-30,-90,170,2894,2874,5768,13359
140,-90,-20,2894,2874,5768,13359
-20,-90,180,2894,2874,5768,13359
170,-90,10,2894,2874,5768,13359
-20,-90,-180,2894,2874,5768,13359
-180,-90,20,2894,2874,5768,13359
80,-60,-90,2950,2819,5769,13390
140,-60,0,2854,2915,5769,13601
80,-70,-100,2913,2856,5769,13382
-40,30,-170,2915,2854,5769,13708
170,-60,20,2859,2910,5769,13366
-180,-30,20,2910,2860,5770,13417
110,-80,-60,2905,2865,5770,13300
180,-30,20,2910,2860,5770,13417
160,-80,10,2880,2890,5770,13289
-40,-50,170,2915,2855,5770,13138
110,-70,-40,2892,2879,5771,13497
130,-80,-40,2930,2841,5771,13168
160,50,30,2898,2873,5771,13672
170,-20,20,2901,2870,5771,13406
-30,-50,-160,2877,2894,5771,13633
-10,-70,-160,2893,2879,5772,13116
-20,-50,-150,2862,2910,5772,13371
160,-40,10,2905,2867,5772,13586
120,-70,-70,2961,2812,5773,13380
150,-80,-10,2883,2890,5773,13252
0,-80,-170,2943,2830,5773,13133
170,-20,-40,2907,2866,5773,13551
50,-80,-120,2914,2859,5773,13268
-50,-60,160,2902,2872,5774,13394
10,0,-150,2860,2914,5774,13456
180,-80,30,2892,2883,5775,13507
-180,-80,30,2892,2883,5775,13507
150,-20,0,2904,2872,5776,13580
20,50,180,2899,2877,5776,13448
20,50,-180,2899,2877,5776,13448
160,-60,10,2884,2892,5776,13443
120,-80,-50,2925,2852,5777,13260
130,-70,-10,2875,2903,5778,13739
60,-80,-110,2906,2873,5779,13488
-170,-20,-20,2927,2852,5779,13139
20,-80,-130,2916,2863,5779,13353
0,-50,-140,2909,2871,5780,13396
-20,0,160,2893,2887,5780,13217
50,-80,-110,2917,2863,5780,13262
-60,-80,150,2901,2879,5780,13357
10,60,160,2874,2906,5780,13155
0,-60,170,2948,2833,5781,13204
0,60,160,2888,2893,5781,13525
60,-80,-100,2905,2877,5782,13231
20,-70,-150,2892,2891,5783,13293
140,-60,-20,2943,2841,5784,13665
-10,40,160,2914,2870,5784,13403
0,-70,180,2941,2845,5786,13433
-60,-80,130,2937,2849,5786,13035
0,-70,-180,2941,2845,5786,13433
130,-80,-30,2889,2898,5787,13293
-40,-80,150,2920,2867,5787,13102
-120,-80,90,2907,2880,5787,13302
70,-70,-80,2920,2868,5788,13434
150,50,30,2927,2861,5788,13629
170,50,20,2898,2890,5788,13842
120,-60,-50,2931,2858,5789,13282
70,-60,-110,2936,2854,5790,13503
70,-80,-90,2894,2896,5790,13271
130,-30,-50,2862,2929,5791,13705
160,50,20,2930,2861,5791,13693
-30,-30,-160,2932,2860,5792,13557
70,-80,-100,2913,2879,5792,13558
160,-70,-30,2928,2864,5792,13330
160,-70,0,2890,2902,5792,13260
30,-20,-150,2901,2892,5793,13614
120,-70,-50,2921,2872,5793,13223
90,-70,-70,2918,2876,5794,13418
150,-70,-20,2930,2865,5795,13277
170,-70,-20,2905,2890,5795,13477
20,-60,-160,2964,2831,5795,13543
-30,0,-160,2924,2872,5796,13605
20,-70,-160,2933,2864,5797,13180
-40,-40,170,2929,2868,5797,13568
-50,-80,140,2927,2871,5798,13049
-180,10,-20,2908,2890,5798,13292
100,-70,-70,2914,2884,5798,13511
180,10,-20,2908,2890,5798,13292
-30,-80,160,2939,2860,5799,13176
20,20,-160,2895,2904,5799,13358
160,-70,10,2911,2889,5800,13302
-180,-40,0,2940,2860,5800,13565
180,-40,0,2940,2860,5800,13565
150,-30,0,2918,2883,5801,13516
-180,-40,-10,2918,2883,5801,13296
140,-70,-40,2926,2875,5801,13205
30,-40,-140,2925,2876,5801,13702
-70,-80,140,2910,2891,5801,13502
180,-40,-10,2918,2883,5801,13296
140,-30,-30,2940,2861,5801,13240
10,40,-160,2908,2893,5801,13464
-20,-80,170,2952,2849,5801,13120
-10,-80,-170,2918,2884,5802,13257
150,-50,0,2934,2868,5802,13555
70,-80,-80,2922,2880,5802,13486
50,-70,-100,2928,2874,5802,13539
-60,-70,150,2927,2876,5803,13480
70,-70,-110,2955,2848,5803,13399
20,-40,-160,2910,2893,5803,13606
130,-80,-20,2919,2885,5804,13278
70,-60,-100,2962,2843,5805,13251
-20,-70,-170,2936,2869,5805,13307
70,-50,-110,2929,2877,5806,13652
140,-60,-10,2937,2870,5807,13692
-60,-70,120,2925,2882,5807,13470
80,-80,-90,2908,2900,5808,13491
50,-80,-100,2928,2880,5808,13337
-130,-80,70,2878,2930,5808,13472
-10,-50,160,2918,2891,5809,13743
130,-70,-40,2923,2886,5809,13126
-30,-40,-160,2920,2890,5810,13744
40,-70,-110,2933,2877,5810,13584
-110,-80,100,2918,2893,5811,13415
-70,-70,120,2944,2867,5811,13606
30,-70,-130,2947,2865,5812,13257
60,-70,-90,2913,2899,5812,13491
-10,0,160,2915,2897,5812,13113
-180,0,-10,2931,2882,5813,13293
180,0,-10,2931,2882,5813,13293
-110,-80,90,2898,2915,5813,13559
-80,-80,130,2933,2881,5814,13480
-20,50,180,2903,2911,5814,13436
-20,50,-180,2903,2911,5814,13436
-10,-80,180,2963,2852,5815,13101
-40,10,-170,2911,2904,5815,13727
100,-80,-60,2907,2908,5815,13276
80,-80,-80,2918,2897,5815,13324
180,30,0,2927,2888,5815,13660
-180,30,0,2927,2888,5815,13660
170,-60,-10,2942,2873,5815,13305
-10,-80,-180,2963,2852,5815,13101
-80,-70,120,2938,2878,5816,13425
0,60,170,2916,2900,5816,13088
20,-30,-150,2948,2869,5817,13694
-20,50,-170,2920,2898,5818,13413
-180,-30,10,2921,2897,5818,13494
180,-30,10,2921,2897,5818,13494
-30,40,-150,2935,2884,5819,13432
30,-80,-120,2942,2878,5820,13383
110,-60,-80,2907,2914,5821,13360
-180,10,-30,2919,2902,5821,13662
180,10,-30,2919,2902,5821,13662
-120,-80,80,2897,2925,5822,13559
150,-70,-40,2978,2844,5822,13483
120,-70,-60,2956,2866,5822,13214
60,-60,-110,2962,2860,5822,13373
50,-50,-120,2914,2909,5823,13708
120,-40,-60,2861,2962,5823,13584
-10,-40,-150,2922,2901,5823,13320
10,-70,-160,2931,2892,5823,13233
140,-70,-30,2943,2880,5823,13266
0,50,-160,2882,2941,5823,13660
60,-70,-120,2950,2873,5823,13507
150,0,10,2947,2877,5824,13877
150,40,20,2901,2923,5824,13685
80,-70,-80,2938,2886,5824,13476
150,-70,-10,2913,2911,5824,13371
60,-50,-120,2958,2866,5824,13672
120,-80,-40,2896,2929,5825,13296
90,-80,-80,2928,2897,5825,13465
70,-70,-90,2943,2883,5826,13418
60,-60,-120,2939,2887,5826,13586
20,-70,-140,2959,2868,5827,13315
180,10,20,2905,2922,5827,13912
20,40,150,2926,2901,5827,13575
-180,10,20,2905,2922,5827,13912
160,10,-20,2894,2933,5827,13560
100,-80,-70,2935,2893,5828,13429
-10,-60,-150,2955,2874,5829,13737
10,10,-150,2914,2915,5829,13790
40,-80,-110,2939,2890,5829,13435
130,-70,-50,2951,2879,5830,13178
-40,20,-170,2930,2900,5830,13754
60,-80,-90,2938,2892,5830,13385
120,-80,-30,2932,2899,5831,13359
160,-20,-40,2964,2867,5831,13749
40,-70,-120,2927,2905,5832,13377
-180,20,0,2928,2904,5832,13649
-90,-80,120,2946,2886,5832,13592
110,-70,-50,2925,2907,5832,13493
180,20,0,2928,2904,5832,13649
140,-70,-50,2979,2854,5833,13474
120,-50,-50,2978,2855,5833,13241
170,10,-20,2908,2925,5833,13485
180,30,10,2924,2909,5833,13814
-180,30,10,2924,2909,5833,13814
80,-80,-70,2937,2896,5833,13475
50,-60,-110,2950,2883,5833,13622
-20,-80,180,2934,2900,5834,13280
-20,-80,-180,2934,2900,5834,13280
140,-70,-20,2935,2899,5834,13746
40,-70,-140,2966,2868,5834,13780
50,-40,-130,2930,2904,5834,13672
170,-30,-40,2953,2882,5835,13594
-20,-30,160,2960,2875,5835,13610
150,-10,0,2941,2894,5835,13644
100,-70,-60,2943,2892,5835,13388
80,-70,-90,2995,2841,5836,13739
80,-50,-100,2895,2941,5836,13826
30,-30,-150,2931,2905,5836,13848
-180,10,0,2959,2878,5837,13733
20,-50,-160,2947,2890,5837,13625
90,-70,-80,2972,2865,5837,13576
180,10,0,2959,2878,5837,13733
20,60,170,2920,2917,5837,13847
170,30,-10,2911,2926,5837,13495
140,-70,-10,2914,2923,5837,13582
170,50,10,2925,2913,5838,13638
120,-70,-30,2923,2915,5838,13619
30,-60,-130,2955,2884,5839,13422
-40,-30,170,2974,2865,5839,13488
150,-60,-10,2958,2881,5839,13669
-10,40,-150,2936,2903,5839,13680
150,20,0,2908,2931,5839,13521
-100,-80,110,2947,2893,5840,13568
40,-60,-120,2956,2884,5840,13556
-180,-30,0,2949,2891,5840,13698
-20,50,-160,2940,2900,5840,13601
-30,40,-170,2916,2924,5840,13723
180,-30,0,2949,2891,5840,13698
40,-30,-140,2939,2902,5841,13782
160,-60,-10,2982,2859,5841,13370
30,-70,-140,2925,2916,5841,13501
160,30,-10,2915,2926,5841,13265
-100,-80,100,2926,2916,5842,13665
150,-10,10,2942,2900,5842,13718
170,-50,0,2967,2875,5842,13539
120,-70,-40,2935,2907,5842,13800
20,-40,-150,2934,2908,5842,13674
20,20,160,2923,2919,5842,13427
170,20,20,2934,2908,5842,13891
70,-70,-100,2972,2871,5843,13630
40,-70,-130,2922,2921,5843,13460
130,-70,-60,2994,2849,5843,13482
180,-10,20,2946,2898,5844,13785
-180,-10,20,2946,2898,5844,13785
90,-80,-70,2928,2916,5844,13351
-10,-70,170,2962,2882,5844,13541
180,0,-20,2936,2910,5846,13180
170,-10,20,2956,2890,5846,13461
110,-80,-50,2916,2930,5846,13295
-180,0,-20,2936,2910,5846,13180
50,-70,-120,2946,2901,5847,13755
90,-80,-60,2953,2894,5847,13504
-10,-70,-170,2978,2869,5847,13539
-10,50,-160,2939,2909,5848,13321
30,-60,-150,2984,2865,5849,14013
180,0,-30,2919,2930,5849,13829
20,-20,-150,2951,2898,5849,13775
-180,0,-30,2919,2930,5849,13829
20,0,-150,2925,2925,5850,13642
-180,20,10,2949,2901,5850,13657
-30,-30,160,2972,2878,5850,13550
180,20,10,2949,2901,5850,13657
-40,-40,160,2935,2917,5852,13663
170,10,20,2933,2919,5852,13834
0,-70,-170,2953,2899,5852,13363
20,-60,-140,2943,2909,5852,13539
180,-20,20,2948,2905,5853,13532
-180,-20,20,2948,2905,5853,13532
-30,-70,-180,2958,2895,5853,13533
-30,-70,180,2958,2895,5853,13533
110,-80,-40,2960,2895,5855,13419
170,0,20,2958,2897,5855,13760
20,60,160,2911,2945,5856,13455
150,20,10,2901,2955,5856,13593
140,-60,-60,2948,2909,5857,13650
160,40,10,2913,2944,5857,13633
100,-80,-50,2962,2896,5858,13536
150,-60,-20,2980,2878,5858,13639
-30,-50,-170,2952,2909,5861,13672
10,-50,-150,2921,2940,5861,13583
-40,-50,150,2958,2904,5862,13750
20,-20,180,2951,2911,5862,13622
150,-10,-20,2936,2926,5862,13373
20,-20,-180,2951,2911,5862,13622
-20,30,170,2948,2914,5862,13591
0,-70,-160,2972,2891,5863,13647
-10,10,160,2947,2916,5863,13424
-30,-40,-170,2958,2905,5863,13673
-50,-70,160,2984,2880,5864,13587
-90,-80,110,2950,2914,5864,13733
40,-40,-140,2966,2899,5865,13704
150,-60,0,2963,2902,5865,13775
150,-40,-10,2978,2887,5865,13389
20,-30,-160,2976,2889,5865,13861
-170,-10,-30,2943,2922,5865,13716
10,60,170,2913,2953,5866,13402
180,-50,-20,2947,2919,5866,13616
150,-40,-50,2916,2950,5866,13509
30,-70,-150,2980,2886,5866,13646
-180,-50,-20,2947,2919,5866,13616
170,0,-30,2928,2939,5867,13373
20,-10,-150,2935,2933,5868,13935
-10,30,160,2956,2913,5869,13539
170,-60,-30,2914,2955,5869,13606
150,-60,-50,2945,2924,5869,13806
150,10,-10,2948,2922,5870,13557
30,-50,-150,2992,2878,5870,14115
-30,-60,-170,2950,2920,5870,13567
130,-60,-40,2947,2923,5870,13448
-20,-20,-160,2973,2898,5871,13739
-10,20,160,2968,2904,5872,13467
160,-50,0,2941,2932,5873,13623
-80,-80,120,2960,2914,5874,13795
160,-30,10,2943,2931,5874,13830
50,-70,-130,2965,2910,5875,13755
10,-20,170,2966,2909,5875,13630
-20,-60,-160,2948,2927,5875,13934
150,-70,0,2925,2952,5877,13490
170,10,-10,2936,2943,5879,13576
-30,10,-160,2954,2928,5882,13784
-30,40,-160,2923,2959,5882,13706
160,-10,-30,2894,2988,5882,13478
-30,30,180,2954,2929,5883,13680
-30,30,-180,2954,2929,5883,13680
80,-60,-100,2983,2900,5883,13674
-30,-80,170,2956,2927,5883,13337
130,-70,-30,2941,2943,5884,13899
-20,0,-160,2975,2909,5884,13711
-50,-70,130,2982,2904,5886,13611
170,-40,-40,2967,2920,5887,13874
150,20,20,2944,2944,5888,13872
130,-50,-40,2988,2900,5888,13407
10,-60,-170,3008,2881,5889,13613
150,-20,-10,2972,2917,5889,13701
170,40,0,2963,2928,5891,13804
-50,-60,150,3010,2881,5891,13846
130,-70,-20,2956,2936,5892,13750
160,20,20,2937,2955,5892,13851
170,40,20,2957,2935,5892,14001
10,-70,-150,2991,2902,5893,13486
60,-70,-100,2960,2934,5894,13529
-30,0,170,2969,2927,5896,13832
140,-50,-60,2965,2931,5896,13937
150,-50,-10,2984,2913,5897,13859
-10,-60,-160,2976,2922,5898,13418
170,-40,10,2948,2950,5898,13670
10,-30,-160,2979,2920,5899,13803
140,-30,-50,2910,2989,5899,13855
100,-60,-80,2968,2932,5900,13975
180,0,0,2970,2931,5901,13871
-180,0,0,2970,2931,5901,13871
160,30,10,2974,2928,5902,13652
150,0,-10,2954,2949,5903,13805
110,-50,-80,2947,2956,5903,14366
90,-60,-90,2955,2948,5903,14046
-10,-50,-150,2974,2930,5904,13729
160,30,0,2946,2958,5904,13707
10,10,160,2944,2960,5904,13582
-40,-70,170,3006,2899,5905,13728
60,-70,-110,2988,2918,5906,13688
0,60,180,2942,2965,5907,13453
-40,-60,140,2976,2931,5907,13737
-20,-10,-160,3003,2904,5907,13864
0,60,-180,2942,2965,5907,13453
50,-60,-130,3003,2905,5908,13728
10,60,-180,2961,2948,5909,13748
10,60,180,2961,2948,5909,13748
150,30,20,2948,2962,5910,14058
170,20,-10,2965,2946,5911,13640
160,0,-20,2954,2958,5912,13678
130,-40,-60,2898,3015,5913,13789
160,-60,-40,2965,2948,5913,13747
10,50,150,2980,2935,5915,13556
50,-70,-110,2955,2962,5917,13610
50,-50,-130,3017,2901,5918,13844
40,-50,-140,3030,2889,5919,13973
-180,-40,-30,2989,2931,5920,13728
160,30,20,2995,2925,5920,14042
180,-40,-30,2989,2931,5920,13728
180,-30,-30,2999,2922,5921,13689
150,-20,-40,2922,2999,5921,13753
-20,-70,160,2994,2927,5921,13845
-180,-30,-30,2999,2922,5921,13689
150,40,30,2954,2968,5922,14025
-70,-70,130,2969,2953,5922,13527
160,40,20,2994,2928,5922,14233
140,-60,-30,2997,2926,5923,13558
0,-20,-160,2962,2963,5925,13549
-40,-60,170,2994,2931,5925,13596
-10,-10,-160,2984,2942,5926,13759
-40,-70,140,2992,2934,5926,13765
-70,-80,130,2986,2940,5926,13781
0,60,-170,2973,2954,5927,13689
-10,-50,-160,2965,2962,5927,13818
50,-60,-120,2994,2934,5928,13775
-40,-50,160,2995,2935,5930,13879
150,0,0,2977,2953,5930,13922
170,30,20,2976,2954,5930,14151
-10,40,-160,2964,2967,5931,13415
90,-50,-90,2942,2989,5931,13886
0,-40,-160,2999,2935,5934,13557
20,40,180,2935,2999,5934,13630
20,40,-180,2935,2999,5934,13630
0,-50,170,3024,2910,5934,13484
40,-60,-140,3040,2895,5935,14220
150,10,10,2971,2967,5938,14284
0,10,160,2998,2942,5940,13748
-60,-80,140,2993,2948,5941,13722
-180,0,20,2993,2954,5947,14129
180,0,20,2993,2954,5947,14129
10,-20,-160,2991,2957,5948,13945
20,-20,-160,2995,2953,5948,14073
160,-20,10,3016,2932,5948,13944
-20,10,-160,2992,2956,5948,13829
-20,40,180,3014,2936,5950,13745
-20,40,-180,3014,2936,5950,13745
170,40,10,2981,2970,5951,13984
0,-60,-180,3054,2898,5952,14057
10,50,-170,2962,2990,5952,13819
0,-60,180,3054,2898,5952,14057
-180,-10,0,3004,2949,5953,13834
180,-10,0,3004,2949,5953,13834
0,40,-160,2973,2980,5953,14052
-50,-80,150,2994,2959,5953,13713
100,-50,-80,2925,3030,5955,13858
20,-10,180,3006,2950,5956,13892
-40,-80,160,3015,2941,5956,13632
20,-10,-180,3006,2950,5956,13892
180,-30,-10,2998,2959,5957,13773
-50,-60,140,3036,2921,5957,14139
-20,-30,-160,2991,2966,5957,13854
-180,-30,-10,2998,2959,5957,13773
-20,-60,-170,3026,2932,5958,13765
-180,-20,0,3007,2951,5958,13907
180,-20,0,3007,2951,5958,13907
140,-40,-30,3019,2940,5959,13920
10,-40,-180,3039,2921,5960,13770
10,-40,180,3039,2921,5960,13770
-180,-10,-30,3015,2946,5961,14026
180,-10,-30,3015,2946,5961,14026
-30,-30,-170,3010,2952,5962,13742
-60,-70,130,3027,2936,5963,13813
10,-60,-150,3009,2954,5963,13864
20,-30,-170,3030,2934,5964,13818
20,-60,-150,2996,2969,5965,13527
-30,-70,150,3016,2950,5966,13880
0,-30,-160,3020,2946,5966,13807
-10,-20,-160,2999,2968,5967,13806
30,-60,-140,3002,2965,5967,14030
-20,-50,-160,2986,2981,5967,14193
20,30,-170,3002,2965,5967,13967
150,-60,-30,3022,2946,5968,13816
-30,-50,-180,3013,2955,5968,13682
-30,-50,180,3013,2955,5968,13682
140,-50,-30,3000,2969,5969,13900
20,-50,-150,3002,2967,5969,13774
10,40,150,2979,2991,5970,13846
0,-60,-160,3010,2961,5971,13758
150,-10,-10,2992,2980,5972,13928
110,-50,-70,2957,3017,5974,13672
160,20,10,3024,2951,5975,14060
110,-60,-70,3011,2967,5978,13840
30,-50,-140,3025,2955,5980,14193
120,-50,-60,2955,3025,5980,13644
160,-60,-20,3044,2939,5983,13746
150,-30,-10,3044,2941,5985,13893
150,-20,-20,3026,2960,5986,13975
-10,10,-160,3001,2987,5988,14018
150,10,0,2984,3005,5989,14015
-180,10,10,3029,2962,5991,13954
180,10,10,3029,2962,5991,13954
160,10,10,3033,2958,5991,14028
-10,50,170,3003,2988,5991,13773
-10,0,-160,3032,2960,5992,14009
-20,-70,-180,3016,2976,5992,13686
-20,-70,180,3016,2976,5992,13686
0,20,160,3044,2949,5993,13922
20,50,160,2947,3048,5995,13657
170,30,0,3020,2976,5996,13979
170,-30,10,3007,2989,5996,13951
170,10,10,3041,2956,5997,14120
170,10,0,3012,2985,5997,14132
20,10,-160,3020,2978,5998,13944
-30,-40,-180,3025,2975,6000,13629
-30,-40,180,3025,2975,6000,13629
-20,40,-160,3015,2985,6000,13818
-30,-60,180,3026,2976,6002,13804
-30,-60,-180,3026,2976,6002,13804
-30,20,-160,3025,2978,6003,14080
-20,30,-160,3048,2955,6003,14014
180,-20,10,2988,3016,6004,14304
-180,-20,10,2988,3016,6004,14304
20,-20,-170,3062,2942,6004,14001
-10,-70,180,3028,2977,6005,13678
-10,-70,-180,3028,2977,6005,13678
10,-40,-160,3007,2998,6005,13795
120,-60,-60,3024,2982,6006,13701
-30,-60,150,3048,2959,6007,14173
180,-10,-10,3027,2980,6007,13933
-180,-10,-10,3027,2980,6007,13933
40,-60,-130,3037,2970,6007,14075
-30,-40,160,3055,2953,6008,14281
170,-60,-20,3006,3002,6008,13755
-10,30,-160,3007,3001,6008,13733
10,-60,-160,3022,2988,6010,13863
10,30,-160,2975,3037,6012,13750
20,30,160,3041,2972,6013,13757
170,-10,-30,2999,3014,6013,13929
160,20,0,2996,3017,6013,13918
-10,20,-160,3033,2981,6014,13686
170,20,0,3060,2956,6016,14211
-20,20,-160,3023,2995,6018,13985
40,-50,-130,3022,2996,6018,14215
-10,-40,-160,3037,2983,6020,14064
170,20,10,3042,2978,6020,14420
170,30,10,3043,2979,6022,14353
160,-40,0,3038,2984,6022,14305
10,20,160,3006,3021,6027,13968
160,-10,10,3083,2944,6027,14430
-10,-30,-160,3051,2976,6027,14148
0,-50,-160,3072,2957,6029,13813
160,-50,-10,3051,2978,6029,13907
180,-10,-20,3028,3003,6031,14020
-180,-10,-20,3028,3003,6031,14020
180,0,10,3032,3000,6032,14331
-20,40,-170,3016,3016,6032,14003
-180,0,10,3032,3000,6032,14331
-60,-70,140,3028,3006,6034,13885
-30,-70,170,3045,2989,6034,14064
160,0,10,3058,2976,6034,14185
20,-10,-170,3078,2957,6035,14361
170,0,0,3051,2984,6035,14255
170,0,-20,3010,3026,6036,14007
160,10,-10,3010,3027,6037,14186
160,20,-10,3020,3017,6037,14198
20,0,170,3052,2990,6042,14219
20,-10,-160,3023,3019,6042,14356
160,-30,0,3065,2977,6042,14312
10,-50,-170,3071,2972,6043,14206
-10,-60,-170,3062,2982,6044,13981
0,10,-160,3027,3017,6044,13846
-20,-40,160,3071,2974,6045,14364
-30,30,-170,3054,2992,6046,14213
160,0,0,3034,3013,6047,14190
170,-50,-10,3060,2987,6047,14004
170,-40,0,3039,3009,6048,14085
120,-60,-70,3060,2993,6053,13938
-30,30,-160,3025,3033,6058,14380
160,0,-10,3039,3020,6059,14069
-10,50,180,3028,3032,6060,13973
-10,50,-180,3028,3032,6060,13973
20,50,170,3007,3055,6062,14434
-20,-40,-160,3048,3016,6064,14054
20,40,160,3026,3039,6065,13808
0,50,160,3027,3039,6066,13829
120,-50,-70,3068,2998,6066,14609
-30,-20,-170,3084,2982,6066,14192
150,-50,-20,3059,3008,6067,14316
-40,-70,160,3053,3014,6067,14318
10,20,-160,3006,3062,6068,13965
-30,-10,170,3016,3052,6068,14207
0,-40,170,3086,2982,6068,14208
20,20,170,3032,3037,6069,13974
-10,50,-170,3026,3044,6070,14017
-20,-70,170,3047,3023,6070,14236
-50,-70,150,3054,3017,6071,14122
10,-40,-170,3063,3008,6071,14469
0,50,-170,3063,3010,6073,14027
170,-50,-20,3052,3022,6074,14316
0,0,-160,3046,3030,6076,14017
-10,40,170,3054,3023,6077,14029
-50,-70,140,3089,2989,6078,14146
10,-10,-160,3056,3024,6080,14116
0,-10,-160,3044,3037,6081,13839
150,-20,-30,3027,3055,6082,13942
10,-50,-160,3064,3020,6084,14140
0,-60,-170,3055,3029,6084,14136
150,-50,-50,3046,3039,6085,14244
160,-30,-40,3041,3044,6085,14132
-40,-60,160,3075,3010,6085,14138
140,-60,-40,3068,3018,6086,13968
-180,-10,10,3054,3032,6086,14645
160,-20,0,3113,2973,6086,14304
180,-10,10,3054,3032,6086,14645
-180,-20,-30,3064,3023,6087,14138
180,-20,-30,3064,3023,6087,14138
160,10,0,3051,3037,6088,14458
-30,-10,-170,3093,2996,6089,14408
170,-20,10,3068,3022,6090,14342
10,50,160,3008,3082,6090,13973
-20,-60,160,3078,3013,6091,14211
-180,-40,-20,3077,3014,6091,14087
180,-40,-20,3077,3014,6091,14087
170,0,-10,3059,3035,6094,14083
0,20,-160,3000,3097,6097,14069
0,30,-160,3055,3043,6098,14365
180,-20,-10,3056,3045,6101,14333
-180,-20,-10,3056,3045,6101,14333
150,-30,-20,3082,3020,6102,13974
160,-60,-30,3044,3059,6103,14074
10,-30,180,3114,2990,6104,14296
10,-30,-180,3114,2990,6104,14296
-20,-50,-170,3085,3022,6107,14128
-180,-20,-20,3068,3040,6108,14037
180,-20,-20,3068,3040,6108,14037
130,-40,-50,2978,3132,6110,14091
20,0,-170,3103,3009,6112,14440
170,-10,0,3093,3021,6114,14524
-20,20,170,3072,3043,6115,14163
20,0,-160,3075,3045,6120,14353
160,-10,0,3086,3034,6120,14303
20,0,-180,3085,3037,6122,14303
20,0,180,3085,3037,6122,14303
130,-60,-50,3071,3052,6123,13985
180,-30,-20,3068,3057,6125,14324
-180,-30,-20,3068,3057,6125,14324
0,30,160,3099,3034,6133,14314
20,20,-170,3048,3085,6133,14262
-10,-60,170,3124,3009,6133,14326
-30,-30,-180,3076,3060,6136,14539
-30,-30,180,3076,3060,6136,14539
-20,-60,-180,3100,3037,6137,14414
-20,-60,180,3100,3037,6137,14414
10,-10,170,3102,3038,6140,14383
20,10,170,3071,3070,6141,14294
0,40,160,3110,3032,6142,14456
0,-30,170,3147,2996,6143,14452
-40,-70,150,3110,3041,6151,14689
-30,-20,170,3063,3089,6152,14317
170,-40,-10,3140,3012,6152,14363
20,30,-180,3085,3068,6153,14293
20,30,180,3085,3068,6153,14293
20,40,170,3066,3089,6155,14410
-30,20,-180,3085,3071,6156,14468
-30,20,180,3085,3071,6156,14468
150,-40,-20,3127,3030,6157,14365
20,10,-170,3087,3073,6160,14561
130,-60,-60,3124,3040,6164,14158
0,50,-180,3087,3077,6164,14237
0,50,180,3087,3077,6164,14237
170,-10,-20,3083,3083,6166,14156
-40,-60,150,3145,3024,6169,14447
150,-60,-40,3073,3097,6170,14060
-10,-60,180,3108,3063,6171,14264
-10,-60,-180,3108,3063,6171,14264
140,-60,-50,3098,3074,6172,14114
140,-30,-40,3059,3114,6173,14491
170,-50,-30,3089,3086,6175,14306
10,30,160,3108,3069,6177,14267
10,50,170,3107,3071,6178,14249
170,-20,-30,3104,3075,6179,14402
-30,-70,160,3118,3063,6181,14661
0,50,170,3082,3101,6183,14244
20,30,170,3108,3079,6187,14389
10,0,-160,3085,3104,6189,14656
-30,-50,170,3152,3040,6192,14373
-20,-20,-170,3128,3065,6193,14522
160,-10,-10,3098,3096,6194,14174
160,-10,-20,3100,3094,6194,14488
170,0,10,3108,3086,6194,14591
-30,-60,170,3119,3076,6195,14285
-30,-10,180,3129,3067,6196,14437
-30,-10,-180,3129,3067,6196,14437
170,-10,-10,3124,3073,6197,14401
10,10,-160,3064,3135,6199,14419
160,-50,-40,3117,3087,6204,14474
0,-50,180,3155,3051,6206,14474
0,-50,-180,3155,3051,6206,14474
-20,-50,160,3172,3038,6210,14699
10,-30,-170,3133,3081,6214,14622
-30,0,-180,3119,3103,6222,14769
-30,0,180,3119,3103,6222,14769
170,-30,0,3125,3099,6224,14635
170,-20,0,3146,3079,6225,14650
-30,10,180,3135,3094,6229,14770
-30,10,-180,3135,3094,6229,14770
10,50,-180,3115,3117,6232,14782
10,50,180,3115,3117,6232,14782
-10,40,-170,3105,3127,6232,14358
130,-50,-50,3093,3139,6232,14267
10,40,-170,3079,3155,6234,14731
160,-40,-40,3118,3120,6238,14628
0,-50,-170,3138,3102,6240,14680
140,-40,-50,3060,3180,6240,14425
170,-40,-20,3119,3123,6242,14330
-30,-20,-180,3127,3117,6244,14699
-30,-20,180,3127,3117,6244,14699
-20,10,170,3133,3112,6245,14359
-30,-30,170,3154,3091,6245,14632
130,-50,-60,3111,3135,6246,14613
170,-10,10,3134,3112,6246,14791
-20,-40,-170,3125,3123,6248,14580
160,-40,-10,3143,3105,6248,14764
-30,20,-170,3175,3080,6255,14880
-30,0,-170,3148,3108,6256,14875
160,-50,-20,3169,3095,6264,14545
-10,-50,-170,3174,3091,6265,14661
0,40,-170,3096,3173,6269,14527
170,-20,-10,3150,3122,6272,14719
-20,-30,-170,3146,3136,6282,14533
0,-20,170,3177,3106,6283,14578
-30,-50,160,3185,3102,6287,15031
20,10,-180,3185,3102,6287,14916
20,10,180,3185,3102,6287,14916
-10,40,-180,3139,3150,6289,14378
-10,40,180,3139,3150,6289,14378
-20,-10,-170,3174,3116,6290,14889
170,-20,-20,3156,3135,6291,14904
20,20,180,3173,3118,6291,14925
20,20,-180,3173,3118,6291,14925
10,40,160,3134,3163,6297,14583
160,-30,-10,3205,3094,6299,14899
10,-20,-170,3179,3122,6301,14861
-20,-60,170,3214,3090,6304,14731
160,-20,-10,3154,3151,6305,14715
10,40,170,3183,3128,6311,14911
-30,-40,170,3176,3136,6312,14786
0,-40,-170,3168,3144,6312,14807
-30,10,-170,3203,3110,6313,15048
150,-30,-40,3106,3209,6315,14779
170,-30,-10,3194,3122,6316,14881
-10,30,170,3188,3139,6327,14937
-20,30,-170,3166,3161,6327,14844
0,40,170,3151,3179,6330,14668
140,-50,-50,3115,3215,6330,14982
160,-50,-30,3184,3152,6336,14881
160,-20,-30,3169,3175,6344,14651
0,-10,170,3213,3133,6346,14896
-10,-50,170,3226,3124,6350,15086
-20,30,-180,3222,3129,6351,15061
-20,30,180,3222,3129,6351,15061
0,-40,180,3268,3083,6351,14851
0,-40,-180,3268,3083,6351,14851
-10,30,-170,3193,3164,6357,14843
10,0,170,3232,3130,6362,14948
-10,-30,-170,3212,3151,6363,14928
0,40,-180,3161,3202,6363,14983
0,40,180,3161,3202,6363,14983
-20,-20,170,3170,3193,6363,15013
0,0,170,3187,3177,6364,14766
-10,-20,170,3214,3152,6366,14969
170,-40,-30,3198,3168,6366,15153
-10,-40,-170,3221,3149,6370,14852
140,-40,-40,3179,3197,6376,14798
-30,-60,160,3220,3157,6377,14894
0,20,-170,3185,3193,6378,14779
10,-20,180,3223,3157,6380,15027
10,-20,-180,3223,3157,6380,15027
10,-10,-170,3231,3150,6381,15123
10,0,-170,3229,3153,6382,15182
160,-40,-20,3232,3160,6392,14964
0,-30,-170,3222,3170,6392,14960
140,-50,-40,3177,3217,6394,14768
150,-50,-30,3212,3183,6395,14939
-10,0,170,3230,3168,6398,14693
0,30,-170,3184,3218,6402,15033
-20,20,-170,3216,3188,6404,15152
-20,-50,180,3214,3190,6404,14752
-20,-50,-180,3214,3190,6404,14752
10,40,-180,3171,3235,6406,15086
10,40,180,3171,3235,6406,15086
-10,10,170,3233,3175,6408,14826
-10,20,170,3223,3186,6409,15377
170,-30,-30,3236,3183,6419,14985
10,30,170,3186,3234,6420,14962
-10,-40,170,3241,3181,6422,15280
150,-50,-40,3192,3231,6423,14992
-20,10,-170,3248,3178,6426,15110
160,-30,-20,3246,3186,6432,15078
-20,-10,170,3222,3218,6440,14971
-10,10,-170,3217,3225,6442,15090
-10,-20,-170,3239,3207,6446,15149
-20,-30,170,3258,3188,6446,15515
-10,-30,170,3277,3172,6449,15019
160,-20,-20,3206,3249,6455,14888
10,10,-170,3245,3212,6457,15199
10,30,-170,3147,3312,6459,15356
-10,20,-170,3260,3208,6468,15236
150,-30,-30,3210,3265,6475,15240
170,-30,-20,3266,3212,6478,14996
-20,0,-170,3284,3195,6479,15401
-20,0,170,3282,3208,6490,15239
-20,-40,180,3262,3229,6491,15235
-20,-40,-180,3262,3229,6491,15235
-10,30,-180,3230,3265,6495,15203
-10,30,180,3230,3265,6495,15203
0,-30,-180,3274,3224,6498,15018
0,-30,180,3274,3224,6498,15018
10,30,180,3240,3259,6499,15356
10,30,-180,3240,3259,6499,15356
10,20,-170,3232,3270,6502,15203
0,30,170,3242,3263,6505,15025
0,10,170,3260,3248,6508,15278
-20,-50,170,3288,3222,6510,15421
-10,-50,180,3287,3230,6517,15154
-10,-50,-180,3287,3230,6517,15154
-20,-10,180,3274,3249,6523,15367
-20,-10,-180,3274,3249,6523,15367
10,10,170,3291,3233,6524,15561
0,-20,-170,3271,3255,6526,15478
0,20,170,3275,3255,6530,15340
-10,0,-170,3290,3241,6531,15519
-20,-20,180,3307,3224,6531,15462
-20,-20,-180,3307,3224,6531,15462
-20,-30,180,3289,3248,6537,15473
-20,-30,-180,3289,3248,6537,15473
-20,-40,170,3308,3254,6562,15565
0,0,-170,3284,3281,6565,15306
-20,20,-180,3322,3245,6567,15658
-20,20,180,3322,3245,6567,15658
150,-40,-30,3305,3263,6568,15511
10,20,170,3304,3267,6571,15206
10,-10,180,3333,3243,6576,15293
10,-10,-180,3333,3243,6576,15293
0,10,-170,3289,3297,6586,15180
150,-40,-40,3253,3334,6587,15373
160,-40,-30,3300,3289,6589,15108
-10,-10,170,3280,3311,6591,15255
-10,-10,-170,3301,3302,6603,15674
-20,10,180,3337,3281,6618,15629
-20,10,-180,3337,3281,6618,15629
0,30,180,3291,3334,6625,15447
0,30,-180,3291,3334,6625,15447
0,-10,-170,3326,3301,6627,15638
-20,0,-180,3319,3311,6630,15628
-20,0,180,3319,3311,6630,15628
0,-20,-180,3343,3289,6632,15855
0,-20,180,3343,3289,6632,15855
-10,-30,-180,3336,3321,6657,15672
-10,-30,180,3336,3321,6657,15672
10,0,-180,3368,3300,6668,15835
10,0,180,3368,3300,6668,15835
160,-30,-30,3328,3362,6690,15709
-10,-40,180,3403,3327,6730,15968
-10,-40,-180,3403,3327,6730,15968
10,20,180,3372,3368,6740,16040
10,20,-180,3372,3368,6740,16040
0,-10,-180,3401,3341,6742,15723
0,-10,180,3401,3341,6742,15723
-10,-20,-180,3398,3351,6749,15986
-10,-20,180,3398,3351,6749,15986
-10,20,180,3403,3355,6758,15949
-10,20,-180,3403,3355,6758,15949
-10,0,-180,3395,3369,6764,16030
-10,0,180,3395,3369,6764,16030
10,10,180,3440,3358,6798,16097
10,10,-180,3440,3358,6798,16097
0,10,-180,3435,3380,6815,16134
0,10,180,3435,3380,6815,16134
-10,10,180,3428,3411,6839,16132
-10,10,-180,3428,3411,6839,16132
0,20,180,3423,3422,6845,16076
0,20,-180,3423,3422,6845,16076
-10,-10,-180,3462,3386,6848,16142
-10,-10,180,3462,3386,6848,16142
0,0,-180,3448,3409,6857,16007
0,0,180,3448,3409,6857,16007
