alpha,beta,gamma,ENZ_CA,SUB_CA,TOT_CA,clashes
-10,-40,-40,116,95,211,325
0,-40,-30,117,101,218,335
0,-50,-30,121,99,220,313
-10,-50,-40,123,97,220,340
-20,-50,-50,120,109,229,424
-10,-30,-30,121,111,232,394
-20,-30,-40,119,117,236,377
-20,-40,-50,119,118,237,365
-10,-60,-50,129,113,242,389
-20,-60,-50,126,116,242,419
10,-50,-20,128,116,244,364
-10,-60,-40,131,117,248,396
40,-60,10,125,124,249,395
-10,-40,-30,137,114,251,428
0,-50,-40,125,126,251,446
-20,-60,-60,123,128,251,411
-20,-40,-40,132,120,252,416
10,-60,-20,131,121,252,434
0,-60,-30,134,120,254,434
40,-60,0,129,125,254,393
-30,-60,-70,129,126,255,443
-10,-30,-40,131,124,255,389
30,-60,0,133,123,256,408
-30,-30,-50,125,131,256,438
-30,-50,-60,135,122,257,483
30,-70,-10,129,128,257,379
-30,-40,-50,132,128,260,456
-20,-70,-60,128,133,261,475
50,-60,20,138,123,261,437
0,-30,-30,130,131,261,438
40,-70,0,129,133,262,394
50,-50,20,137,125,262,483
0,-60,-40,139,123,262,408
60,-60,30,135,129,264,474
10,-50,-30,136,129,265,469
-10,-50,-50,134,131,265,479
40,-70,10,129,136,265,486
30,-60,-10,133,133,266,406
40,-50,10,133,133,266,442
10,-70,-30,138,130,268,413
-10,-70,-50,139,129,268,472
50,-60,10,135,133,268,409
10,-40,-20,144,125,269,411
20,-60,-10,141,129,270,431
60,-50,30,140,130,270,506
10,-60,-30,141,130,271,436
0,-70,-40,136,135,271,446
-20,-20,-40,139,133,272,475
30,-70,0,141,132,273,490
10,-70,-20,138,135,273,531
0,-70,-30,145,128,273,549
-20,-50,-60,133,140,273,494
-160,50,90,132,142,274,492
-10,-70,-40,143,131,274,569
20,-60,-20,139,136,275,436
-170,40,90,134,141,275,432
20,-70,-10,141,134,275,508
20,-70,-20,145,130,275,408
50,-70,10,138,137,275,428
-150,60,80,136,140,276,472
30,-50,0,142,136,278,448
0,-40,-20,152,128,280,488
20,-50,-10,143,137,280,451
-170,20,100,136,147,283,440
-130,50,60,131,152,283,464
-20,-50,-40,150,133,283,517
-30,-60,-60,145,140,285,484
-140,50,70,142,143,285,449
-150,50,80,141,148,289,472
-30,-70,-70,147,143,290,511
-20,-70,-50,147,143,290,596
0,-40,-40,148,142,290,543
10,-40,-30,147,144,291,554
60,-40,30,153,139,292,533
0,-30,-20,153,139,292,538
20,-50,-20,147,145,292,523
-170,50,100,150,143,293,539
-10,-20,-30,146,147,293,550
-40,-60,-80,148,146,294,517
60,-70,20,149,146,295,479
-120,50,50,141,154,295,511
60,-60,20,150,145,295,482
-140,60,70,144,152,296,501
-30,-40,-60,152,144,296,521
50,-70,20,145,151,296,497
-130,40,60,154,143,297,478
-150,40,80,148,149,297,495
10,-30,-20,148,149,297,519
-160,40,90,149,148,297,511
-160,40,80,150,148,298,463
70,-60,40,155,143,298,543
-160,60,90,143,155,298,507
-130,60,60,141,159,300,492
-180,40,100,158,144,302,539
50,-40,20,158,144,302,528
-10,-50,-30,163,139,302,525
20,-80,-20,154,148,302,555
180,40,100,158,144,302,539
-150,30,80,161,142,303,501
-40,-40,-60,155,149,304,559
-140,40,70,151,153,304,480
60,-70,30,147,158,305,537
30,-50,-10,158,147,305,559
20,-40,-10,160,146,306,511
-30,-70,-60,148,158,306,631
-150,50,70,152,154,306,515
30,-40,0,159,150,309,524
40,-50,0,161,148,309,554
10,-80,-30,153,156,309,569
-30,-50,-70,155,155,310,531
70,-50,40,164,146,310,578
-30,-50,-50,167,144,311,562
-20,-30,-50,150,161,311,488
30,-80,-10,156,155,311,562
-30,-20,-40,158,154,312,541
-130,40,50,155,157,312,473
-40,-70,-80,156,156,312,556
-170,30,100,156,157,313,589
-180,50,110,164,150,314,609
-150,40,70,155,159,314,486
180,50,110,164,150,314,609
170,40,110,163,152,315,623
-40,-50,-70,162,153,315,602
50,-50,10,152,163,315,527
-10,-40,-50,161,154,315,576
-120,60,50,150,166,316,511
40,-40,10,162,154,316,554
-170,50,90,154,163,317,562
40,-40,20,164,155,319,556
0,-80,-40,155,165,320,569
-160,30,90,158,162,320,572
-40,-30,-50,164,158,322,620
-170,40,100,166,156,322,627
-40,-60,-70,165,157,322,563
40,-80,0,162,160,322,558
50,-40,30,170,153,323,636
70,-70,30,163,160,323,545
-30,-30,-40,158,165,323,539
-30,-20,-50,163,161,324,550
20,-40,-20,165,159,324,640
-140,40,60,165,159,324,523
-40,-70,-70,159,166,325,645
40,-50,20,164,161,325,567
-120,40,50,163,162,325,574
180,50,100,156,170,326,551
-180,50,100,156,170,326,551
-140,30,70,168,158,326,539
-140,50,60,158,169,327,570
20,-30,-10,166,161,327,612
70,-70,40,156,172,328,591
-40,-30,-60,162,168,330,596
-170,60,100,161,170,331,573
30,-30,0,164,168,332,571
0,-50,-20,174,160,334,576
-10,-80,-50,168,166,334,592
-40,-20,-50,165,170,335,617
60,-50,20,168,167,335,534
50,-80,10,166,171,337,574
40,-30,20,174,163,337,597
50,-50,30,177,162,339,606
-10,-20,-40,168,171,339,602
-40,-40,-70,171,168,339,624
0,-20,-30,173,167,340,617
-180,40,110,175,165,340,717
-50,-70,-90,164,176,340,629
60,-50,40,176,164,340,668
180,40,110,175,165,340,717
30,-60,10,172,168,340,663
30,-40,10,175,165,340,574
40,-60,20,168,173,341,635
-40,-50,-60,174,167,341,630
70,-60,30,176,165,341,546
0,-60,-20,179,162,341,691
20,-30,-20,171,171,342,623
60,-80,20,169,173,342,597
-20,-80,-60,173,170,343,631
-180,10,110,174,170,344,708
180,10,110,174,170,344,708
50,-30,20,170,176,346,616
-20,-30,-30,180,166,346,632
40,-80,10,175,172,347,665
0,-20,-20,177,170,347,655
-10,-60,-30,182,165,347,663
-50,-60,-90,171,176,347,575
-20,-10,-40,177,171,348,682
50,-30,30,181,167,348,669
-50,-40,-70,172,177,349,715
-30,-80,-70,172,177,349,651
20,-60,0,182,167,349,739
30,-80,0,175,175,350,648
10,-80,-20,175,175,350,680
180,60,110,173,177,350,623
70,-40,40,178,172,350,632
180,20,110,175,175,350,644
50,-60,30,176,174,350,650
-180,20,110,175,175,350,644
-180,60,110,173,177,350,623
-20,-40,-60,174,177,351,654
30,-40,-10,176,175,351,689
10,-60,-10,182,169,351,730
-110,50,40,179,172,351,614
60,-40,40,190,161,351,717
60,-30,30,178,173,351,659
-20,-60,-40,184,167,351,690
10,-40,-10,180,172,352,642
80,-70,50,166,186,352,610
-180,30,110,173,180,353,658
60,-60,40,178,175,353,646
-160,20,100,184,169,353,595
80,-70,40,180,173,353,627
-40,-80,-80,175,178,353,669
180,30,110,173,180,353,658
50,-80,20,172,181,353,667
20,-80,-10,175,178,353,661
10,-30,-10,181,173,354,658
-170,10,100,176,178,354,588
-160,50,80,177,178,355,619
30,-30,-10,175,180,355,678
20,-50,0,185,171,356,683
70,-80,30,175,181,356,611
40,-30,10,177,179,356,600
80,-80,40,174,183,357,640
30,-50,10,186,171,357,628
-150,20,90,182,175,357,601
-30,-10,-40,186,171,357,704
60,-30,40,187,170,357,705
170,50,120,176,181,357,694
-50,-50,-80,187,171,358,698
10,-50,-10,182,177,359,665
170,20,110,177,183,360,619
60,-80,30,175,185,360,687
-50,-70,-80,175,185,360,703
-160,70,90,179,181,360,600
-120,40,40,180,181,361,592
-30,-60,-50,184,178,362,719
0,-80,-30,186,176,362,727
-20,-20,-30,186,176,362,663
10,-20,-20,186,178,364,669
30,-30,10,189,175,364,592
50,-70,30,180,184,364,736
-120,50,40,175,190,365,597
160,50,120,181,184,365,670
30,-70,10,183,182,365,754
-130,50,50,172,193,365,593
70,-80,40,178,187,365,712
-50,-60,-80,191,174,365,685
-110,60,40,178,187,365,602
20,-40,0,184,181,365,664
-10,-80,-40,190,175,365,753
-10,-10,-30,182,183,365,739
20,-20,-20,181,185,366,683
-180,30,100,191,175,366,642
40,-20,10,183,183,366,625
180,30,100,191,175,366,642
-40,-40,-50,189,178,367,707
-20,-40,-30,193,174,367,699
40,-70,20,185,182,367,734
10,-30,-30,176,191,367,644
-20,-80,-50,189,179,368,780
90,-70,50,192,176,368,717
160,40,120,189,179,368,721
-50,-80,-90,183,186,369,724
30,-20,0,190,179,369,642
80,-60,50,189,181,370,678
-160,10,100,188,182,370,652
-60,-70,-100,179,191,370,720
-130,30,60,187,183,370,666
-50,-30,-60,186,184,370,729
170,50,110,192,179,371,663
-170,70,100,182,189,371,621
20,-70,0,194,178,372,800
-150,70,80,185,187,372,631
70,-50,30,190,183,373,569
-30,-40,-40,191,182,373,705
-160,20,90,184,189,373,582
90,-80,50,185,189,374,685
40,-40,0,188,186,374,747
10,-70,-10,196,179,375,804
70,-50,50,200,176,376,724
-180,20,100,186,190,376,603
-20,-10,-30,196,180,376,790
180,20,100,186,190,376,603
-150,30,90,192,184,376,714
-40,-50,-80,191,186,377,657
-180,0,110,186,191,377,692
170,30,110,188,189,377,701
180,0,110,186,191,377,692
-30,-80,-60,192,185,377,804
30,-20,-10,184,194,378,696
30,-20,10,192,186,378,657
-160,30,100,196,183,379,734
-150,50,90,187,192,379,670
-50,-50,-70,189,190,379,744
-160,30,80,190,189,379,641
90,-70,60,187,193,380,706
-60,-80,-100,188,192,380,750
0,-70,-20,192,188,380,837
-50,-40,-80,184,196,380,742
170,60,120,189,191,380,709
-10,-70,-30,199,181,380,847
100,-80,60,192,188,380,719
-60,-70,-90,185,195,380,755
20,-20,-10,191,190,381,713
-10,-30,-20,196,186,382,729
-160,50,100,182,201,383,728
170,40,120,197,186,383,825
-110,40,40,192,191,383,717
110,-80,70,197,186,383,729
-20,-20,-50,192,192,384,688
80,-80,50,188,196,384,728
-170,0,110,186,199,385,715
-140,30,80,185,200,385,671
0,-60,-50,198,188,386,738
70,-60,50,194,192,386,703
-40,-20,-40,200,186,386,700
60,-70,40,189,198,387,767
-20,-90,-60,194,194,388,727
70,-90,30,194,194,388,727
-150,-90,170,194,194,388,727
140,-90,100,194,194,388,727
-10,-90,-50,194,194,388,727
-130,40,70,187,201,388,696
-40,-90,-80,194,194,388,727
50,-90,10,194,194,388,727
-80,-90,-120,194,194,388,727
40,-90,0,194,194,388,727
20,-90,-20,194,194,388,727
160,-90,120,194,194,388,727
-130,-90,-170,194,194,388,727
150,-90,110,194,194,388,727
180,-10,110,197,191,388,733
-170,-90,150,194,194,388,727
-140,-90,180,194,194,388,727
120,-90,80,194,194,388,727
-60,-90,-100,194,194,388,727
0,-90,-40,194,194,388,727
-70,-90,-110,194,194,388,727
-90,-90,-130,194,194,388,727
80,-90,40,194,194,388,727
180,-90,140,194,194,388,727
10,-90,-30,194,194,388,727
-160,-90,160,194,194,388,727
-180,-90,140,194,194,388,727
-50,-90,-90,194,194,388,727
-170,50,110,193,195,388,785
-100,-90,-140,194,194,388,727
100,-90,60,194,194,388,727
110,-90,70,194,194,388,727
-120,-90,-160,194,194,388,727
-140,-90,-180,194,194,388,727
90,-90,50,194,194,388,727
130,-90,90,194,194,388,727
170,-90,130,194,194,388,727
-180,-10,110,197,191,388,733
-30,-90,-70,194,194,388,727
30,-90,-10,194,194,388,727
-110,-90,-150,194,194,388,727
60,-90,20,194,194,388,727
-140,60,80,196,193,389,667
-10,-20,-20,201,188,389,753
-40,-60,-60,193,196,389,820
-150,60,90,191,198,389,688
-70,-80,-110,193,197,390,782
10,-70,-40,186,204,390,649
-140,50,80,197,194,391,673
0,-70,-50,196,195,391,630
20,-30,0,193,199,392,729
-30,-30,-60,189,203,392,693
-10,-70,-60,201,191,392,679
-140,20,80,193,199,392,652
-130,60,70,192,201,393,642
90,-80,60,195,198,393,751
160,50,130,198,196,394,757
80,-60,40,215,180,395,640
120,-80,80,198,197,395,741
-70,-70,-110,199,196,395,787
-40,-80,-70,205,190,395,847
-30,-40,-70,192,204,396,755
-130,50,70,193,203,396,696
-10,-80,-60,195,201,396,686
70,-40,50,210,187,397,808
-160,60,100,193,204,397,729
-80,-80,-120,192,205,397,815
-140,40,80,207,191,398,709
-20,-70,-70,196,202,398,702
70,-30,40,206,192,398,697
-20,-70,-40,205,193,398,833
-150,40,90,206,192,398,797
-50,-80,-80,205,193,398,873
30,-70,-20,188,210,398,615
-170,30,90,205,193,398,665
0,-80,-50,195,204,399,668
-140,70,70,198,201,399,696
0,-10,-20,207,192,399,771
-130,30,50,199,200,399,662
-180,70,110,204,196,400,684
-10,-40,-20,206,194,400,759
180,70,110,204,196,400,684
40,-30,0,205,195,400,773
40,-20,0,205,195,400,678
50,-20,20,203,197,400,675
150,50,130,206,195,401,749
10,-60,-40,200,201,401,759
40,-70,-10,193,208,401,628
10,-20,-30,202,199,401,756
-10,-10,-40,206,195,401,785
-30,-70,-80,200,201,401,705
140,-80,100,208,193,401,802
100,-80,70,199,203,402,793
-90,-80,-130,197,205,402,818
-130,70,60,204,199,403,727
0,-30,-40,195,209,404,750
-50,-40,-60,207,197,404,827
160,60,130,207,197,404,772
150,50,140,210,194,404,859
-40,-70,-90,199,205,404,702
-10,-60,-60,205,199,404,746
-140,70,80,203,201,404,707
10,-80,-40,191,213,404,669
-130,70,70,199,205,404,707
80,-50,50,216,189,405,727
20,-70,-30,196,210,406,645
100,-70,70,207,199,406,757
-150,20,80,202,204,406,673
20,-80,-30,191,215,406,660
-20,-80,-70,198,209,407,718
100,-70,60,209,198,407,773
-160,70,100,207,200,407,705
130,-80,90,204,204,408,781
-20,-60,-70,210,198,408,757
-120,60,60,193,215,408,691
50,-40,10,210,198,408,795
-170,-10,110,207,201,408,830
-30,-10,-30,216,192,408,809
-150,70,90,208,201,409,694
40,-20,20,213,196,409,766
-170,60,110,204,206,410,798
70,-70,50,200,210,410,814
70,-30,50,218,193,411,818
-170,10,110,201,210,411,819
-120,50,60,205,206,411,754
10,-20,-10,213,199,412,734
150,-80,110,213,199,412,815
-60,-80,-90,209,204,413,894
-120,70,60,205,208,413,741
0,-10,-30,203,210,413,814
-40,-80,-90,201,214,415,727
-60,-60,-100,208,207,415,727
30,-80,-20,200,215,415,670
-60,-50,-90,209,206,415,785
-30,-60,-80,211,204,415,808
-50,-30,-70,218,198,416,766
160,40,130,209,207,416,906
-100,-80,-140,204,212,416,869
60,-40,20,201,215,416,748
110,-70,70,212,205,417,791
-80,-70,-120,213,204,417,863
110,-80,80,214,203,417,816
150,60,140,207,210,417,831
90,-60,60,215,203,418,805
10,-10,-20,220,198,418,832
-30,-70,-50,213,205,418,856
50,-70,0,204,214,418,646
170,0,110,216,202,418,804
60,-20,30,213,205,418,756
150,40,130,213,206,419,849
180,60,100,194,225,419,762
-180,60,100,194,225,419,762
-50,-30,-50,203,216,419,812
-170,20,110,216,203,419,790
-60,-40,-80,210,209,419,842
-50,-50,-90,219,201,420,804
-30,-80,-80,202,218,420,738
50,-20,30,211,209,420,780
-110,-80,-150,205,215,420,888
-40,-60,-90,211,210,421,798
-70,-70,-100,206,215,421,831
-50,-70,-100,209,212,421,733
-160,40,100,210,211,421,847
40,-80,20,212,210,422,917
-100,50,30,215,207,422,759
20,-20,0,212,210,422,783
-50,-80,-100,207,216,423,741
-50,-20,-50,203,220,423,780
-170,30,110,210,213,423,829
-60,-60,-90,214,210,424,841
140,50,150,215,209,424,875
160,-80,120,227,197,424,831
-40,-10,-40,217,207,424,801
-50,-60,-70,213,211,424,895
-30,-20,-30,215,210,425,858
-20,-50,-30,216,209,425,846
30,-10,0,216,209,425,814
-30,-50,-40,216,209,425,832
30,-40,20,219,207,426,828
-110,60,50,210,216,426,724
20,-60,-30,212,214,426,803
-120,30,50,217,209,426,731
120,-80,90,219,208,427,829
50,-40,40,215,212,427,824
-40,-30,-40,215,212,427,855
170,30,120,207,221,428,864
-170,40,110,212,216,428,898
-90,50,20,218,210,428,811
-170,70,110,219,209,428,733
30,-80,10,215,213,428,909
-110,-80,-160,210,218,428,806
30,-60,-20,214,214,428,811
-120,70,50,214,214,428,764
-100,60,30,213,216,429,773
130,-70,90,214,215,429,842
-60,-80,-110,207,222,429,762
-70,-80,-100,218,211,429,945
40,-80,-10,209,220,429,689
-120,-80,-160,209,220,429,910
120,-70,80,216,213,429,820
50,-30,10,216,214,430,828
60,-20,40,221,209,430,841
60,-40,50,230,200,430,914
50,-20,10,215,216,431,816
20,-10,-10,219,212,431,778
-40,-50,-50,222,209,431,869
-10,-10,-20,224,208,432,847
-20,0,-30,219,213,432,903
170,-80,130,231,201,432,856
-150,60,70,212,220,432,803
40,-10,10,214,219,433,741
40,-40,30,228,205,433,821
-80,-80,-130,217,216,433,782
-180,60,120,222,212,434,877
170,70,120,211,223,434,771
180,60,120,222,212,434,877
-60,-50,-80,217,217,434,874
-100,-80,-150,214,220,434,783
50,-80,30,218,217,435,916
-130,30,70,206,229,435,824
-90,-80,-140,216,220,436,783
180,70,120,220,216,436,787
170,10,110,224,212,436,810
-120,-80,-170,213,223,436,806
-180,70,120,220,216,436,787
-130,-80,-170,215,222,437,918
20,-80,0,220,217,437,924
-50,-90,-80,216,222,438,904
150,-90,120,216,222,438,904
-130,-90,-160,216,222,438,904
-10,-90,-40,216,222,438,904
90,-90,60,216,222,438,904
0,-90,-30,216,222,438,904
-100,-90,-130,216,222,438,904
-70,-90,-100,216,222,438,904
60,-90,30,216,222,438,904
-30,-90,-60,216,222,438,904
80,-90,50,216,222,438,904
10,-90,-20,216,222,438,904
-160,-90,170,216,222,438,904
30,-90,0,216,222,438,904
40,-60,-10,224,214,438,837
110,-90,80,216,222,438,904
180,-90,150,216,222,438,904
40,-90,10,216,222,438,904
-110,-90,-140,216,222,438,904
120,-90,90,216,222,438,904
-60,-90,-90,216,222,438,904
-80,-90,-110,216,222,438,904
140,-90,110,216,222,438,904
50,-90,20,216,222,438,904
70,-90,40,216,222,438,904
20,-90,-10,216,222,438,904
-150,-90,180,216,222,438,904
-150,-90,-180,216,222,438,904
170,-90,140,216,222,438,904
-180,-90,150,216,222,438,904
-20,-90,-50,216,222,438,904
-40,-90,-70,216,222,438,904
-120,-90,-150,216,222,438,904
-110,70,50,211,227,438,807
160,-90,130,216,222,438,904
100,-90,70,216,222,438,904
-90,-90,-120,216,222,438,904
50,-80,0,221,217,438,722
-170,-90,160,216,222,438,904
130,-90,100,216,222,438,904
-140,-90,-170,216,222,438,904
-10,-30,-50,212,227,439,880
-180,-80,140,228,211,439,869
-70,-60,-110,219,220,439,844
40,-50,30,225,214,439,849
180,-80,140,228,211,439,869
170,-10,110,218,222,440,797
130,-80,100,224,216,440,872
110,-70,80,222,218,440,817
-40,-70,-60,225,215,440,868
50,-50,40,224,216,440,843
-140,-80,-180,215,226,441,933
-80,-80,-110,221,220,441,964
-170,-80,150,222,219,441,884
-60,-40,-90,224,217,441,847
-140,-80,180,215,226,441,933
-90,70,30,216,226,442,894
-90,-70,-130,223,219,442,950
60,-80,40,224,218,442,914
-60,-70,-110,215,227,442,813
0,-20,-40,219,223,442,862
0,-50,-50,228,215,443,845
-40,-30,-70,218,225,443,817
30,-10,-10,222,221,443,883
-40,-40,-80,215,228,443,899
-130,-80,180,216,227,443,824
-130,-80,-180,216,227,443,824
-110,50,50,222,221,443,864
-10,-50,-60,221,223,444,841
-160,-80,150,225,219,444,854
80,-60,60,218,226,444,837
0,-80,-20,221,224,445,954
-70,-80,-120,221,224,445,790
50,-10,20,222,223,445,778
-100,70,40,214,231,445,859
-170,60,90,214,231,445,870
30,-30,20,230,216,446,840
170,0,120,227,219,446,853
10,-80,-10,224,222,446,925
-100,40,30,218,228,446,925
40,-30,30,234,212,446,877
140,40,150,220,226,446,1012
130,50,160,224,222,446,872
0,-30,-10,229,217,446,869
-60,-90,-110,220,227,447,845
20,-90,-30,220,227,447,845
-20,-90,-70,220,227,447,845
-150,-90,160,220,227,447,845
-130,-90,-180,220,227,447,845
60,-90,10,220,227,447,845
40,-90,-10,220,227,447,845
160,-90,110,220,227,447,845
90,-90,40,220,227,447,845
-170,-90,140,220,227,447,845
50,-90,0,220,227,447,845
0,-90,-50,220,227,447,845
70,-90,20,220,227,447,845
-10,-90,-60,220,227,447,845
170,60,110,218,229,447,814
150,-90,100,220,227,447,845
30,-90,-20,220,227,447,845
110,-90,60,220,227,447,845
170,-90,120,220,227,447,845
-160,-90,150,220,227,447,845
180,-90,130,220,227,447,845
10,-90,-40,220,227,447,845
-120,-90,-170,220,227,447,845
140,40,140,233,214,447,949
100,-90,50,220,227,447,845
130,-90,80,220,227,447,845
-30,-90,-80,220,227,447,845
-80,-90,-130,220,227,447,845
-100,-90,-150,220,227,447,845
-10,-80,-30,219,228,447,961
-180,-90,130,220,227,447,845
-30,-10,-50,227,220,447,884
140,-90,90,220,227,447,845
120,-90,70,220,227,447,845
-40,-90,-90,220,227,447,845
-140,-90,170,220,227,447,845
-50,-90,-100,220,227,447,845
-130,-90,180,220,227,447,845
-90,-90,-140,220,227,447,845
-70,-90,-120,220,227,447,845
-110,-90,-160,220,227,447,845
80,-90,30,220,227,447,845
-150,-80,170,221,227,448,906
150,40,140,224,224,448,984
170,10,120,227,221,448,968
60,-70,10,226,223,449,679
-30,0,-30,237,212,449,889
-140,-80,170,219,231,450,858
130,40,160,227,223,450,877
-160,-80,160,229,221,450,892
-170,-80,140,231,220,451,836
-140,60,60,230,221,451,886
-110,70,40,218,233,451,827
140,50,140,234,218,452,869
180,-80,130,229,223,452,866
160,20,120,231,221,452,833
50,-10,10,229,223,452,819
60,-30,20,236,216,452,930
-180,-80,130,229,223,452,866
40,-10,0,227,226,453,812
-120,40,60,230,223,453,793
170,60,130,230,223,453,931
140,-80,110,227,226,453,908
70,-40,30,216,238,454,785
160,30,120,231,223,454,903
-150,80,90,227,227,454,861
10,-50,-40,226,228,454,881
170,-80,120,232,222,454,893
-100,60,40,224,231,455,800
-60,-50,-100,224,231,455,916
-10,0,-30,232,223,455,908
180,50,120,229,226,455,901
-110,40,30,220,235,455,866
-180,50,120,229,226,455,901
-160,60,80,225,230,455,871
50,-60,0,226,230,456,821
-150,-80,160,227,229,456,865
-50,-70,-70,234,222,456,908
70,-80,50,232,225,457,936
20,-10,0,238,219,457,892
20,-30,10,234,223,457,924
-170,0,100,226,231,457,794
-20,-80,-40,226,231,457,990
-140,80,80,228,230,458,878
140,-70,100,231,227,458,895
170,20,120,223,235,458,922
60,-80,10,232,226,458,752
20,-50,-30,238,220,458,941
-120,30,40,240,218,458,749
-80,50,10,232,227,459,844
-90,60,30,221,239,460,888
-10,-50,-20,238,222,460,898
60,-30,50,238,222,460,986
-60,40,-10,229,232,461,857
-50,50,-10,220,241,461,863
140,60,150,228,233,461,886
-30,0,-40,227,234,461,851
-50,-60,-100,227,234,461,821
100,-60,70,237,224,461,884
-70,40,0,230,231,461,845
160,-80,110,238,223,461,925
80,-70,60,225,236,461,911
50,-30,40,241,220,461,912
-160,0,110,229,233,462,983
-80,-70,-110,230,232,462,944
0,-40,-10,237,225,462,886
60,-20,50,244,218,462,1023
-20,0,-40,233,230,463,908
180,10,100,229,234,463,713
-180,10,100,229,234,463,713
-90,-80,-120,230,233,463,997
-130,20,70,229,234,463,836
0,-20,-10,236,228,464,896
160,70,140,233,231,464,826
-140,30,60,230,235,465,858
-40,-20,-60,234,231,465,900
30,-50,20,242,223,465,908
70,-80,20,238,228,466,821
90,-60,50,239,227,466,835
-60,-40,-70,245,221,466,983
-180,40,120,227,239,466,955
180,40,120,227,239,466,955
-30,-80,-50,232,234,466,1023
-120,80,60,227,240,467,892
20,-10,-20,230,237,467,907
170,70,130,234,233,467,839
-70,-70,-120,233,235,468,867
160,10,120,237,231,468,978
140,-80,90,243,225,468,949
30,-10,10,241,227,468,887
-160,80,100,233,236,469,861
-150,30,70,245,224,469,784
150,70,150,235,235,470,841
-170,80,110,239,231,470,842
-40,-10,-50,238,232,470,915
-130,80,70,232,238,470,881
150,-80,100,246,224,470,945
-40,-10,-30,245,225,470,991
150,-80,120,232,238,470,947
-50,30,-20,235,235,470,923
-90,-70,-140,235,235,470,895
-100,-70,-150,228,243,471,940
140,70,160,243,228,471,831
-70,-60,-100,240,231,471,961
20,-20,10,238,233,471,911
-80,70,20,233,238,471,966
-50,-20,-40,242,230,472,931
120,-70,90,232,240,472,882
30,-50,-20,237,235,472,1018
180,-20,110,240,232,472,961
-180,-20,110,240,232,472,961
10,-10,-10,241,231,472,899
-60,-30,-70,247,226,473,899
170,-10,120,242,231,473,945
-20,-10,-20,245,228,473,973
-50,-50,-60,236,237,473,957
80,-80,60,247,227,474,951
120,40,170,227,247,474,931
-60,50,0,229,245,474,890
-90,60,20,225,249,474,946
-80,-70,-130,231,243,474,905
-160,-10,110,237,237,474,925
-130,60,50,239,235,474,906
40,-20,30,245,229,474,972
-140,20,70,245,230,475,804
160,60,140,240,235,475,962
80,-50,60,251,224,475,894
150,60,150,238,238,476,988
-30,-30,-30,240,236,476,948
-100,-70,-140,239,237,476,1044
50,-10,30,236,240,476,889
30,-40,-20,232,244,476,985
40,-10,20,248,228,476,886
-20,-50,-70,230,247,477,957
160,70,130,240,238,478,855
60,-50,50,243,235,478,953
-180,80,120,242,236,478,844
130,40,150,253,225,478,987
180,80,120,242,236,478,844
20,-50,10,245,234,479,1034
120,40,160,247,232,479,930
150,-70,110,242,237,479,940
50,-60,40,238,241,479,979
80,-80,30,247,233,480,876
140,60,160,240,240,480,984
20,-40,10,250,230,480,981
-40,0,-30,249,231,480,935
160,30,130,240,240,480,1045
-90,40,20,240,240,480,936
170,80,130,246,234,480,835
-150,20,100,247,234,481,933
90,-80,70,248,233,481,976
-60,-70,-80,248,233,481,957
-110,50,30,234,247,481,857
10,-40,0,245,236,481,1013
-20,-20,-20,241,240,481,981
130,-80,80,249,233,482,940
160,80,140,248,234,482,866
130,40,170,244,238,482,958
-80,40,10,242,240,482,925
160,0,120,240,243,483,957
60,-10,30,246,237,483,880
10,0,-20,238,245,483,963
-60,-60,-80,240,243,483,1029
-110,30,30,253,231,484,854
50,-20,40,257,227,484,1002
-80,60,10,231,253,484,950
-40,-80,-60,238,246,484,1053
-60,30,-10,237,247,484,929
-20,-10,-50,238,246,484,949
80,-50,40,247,237,484,792
-50,40,-10,244,241,485,943
-100,80,40,231,254,485,949
150,80,150,248,237,485,880
-70,60,10,234,251,485,919
60,-20,20,246,239,485,1045
-110,80,50,229,257,486,946
60,-10,40,240,246,486,917
30,-20,20,253,233,486,949
160,-80,130,243,243,486,974
120,40,180,249,237,486,971
120,40,-180,249,237,486,971
70,-70,20,244,242,486,781
-90,80,30,240,246,486,944
-100,50,40,243,243,486,965
80,-40,50,249,237,486,853
10,-10,-30,244,243,487,1001
40,-60,30,246,241,487,985
-40,50,-20,237,250,487,885
-100,-80,-130,239,248,487,1040
160,-70,120,246,241,487,951
40,-50,-10,247,240,487,1065
130,50,150,243,244,487,996
-80,60,20,236,252,488,956
-10,0,-20,252,236,488,974
110,40,-170,251,237,488,946
80,-40,60,266,222,488,982
-110,30,40,252,236,488,879
-50,-20,-60,247,242,489,927
-70,-50,-100,245,244,489,960
10,-30,0,250,239,489,999
-180,0,120,249,240,489,924
180,0,120,249,240,489,924
30,-60,20,250,240,490,1023
-40,40,-20,238,252,490,981
140,50,160,249,241,490,1040
-50,0,-30,257,233,490,967
40,-20,-10,251,240,491,968
-150,10,100,252,240,492,935
-30,-60,-40,249,243,492,1044
110,60,-160,255,237,492,898
110,50,-160,255,237,492,879
130,50,170,252,240,492,1051
130,60,170,250,242,492,949
-60,60,0,237,256,493,931
50,0,10,242,251,493,925
-80,-60,-120,248,245,493,939
180,-10,120,245,248,493,1027
60,-60,10,244,249,493,847
0,0,-30,253,240,493,1031
150,50,150,248,245,493,1093
170,50,130,251,242,493,1068
-110,40,50,247,246,493,985
-180,-10,120,245,248,493,1027
-50,-80,-70,242,252,494,1052
130,70,170,259,235,494,861
20,-40,-30,240,254,494,1008
-140,20,90,250,245,495,955
-110,-70,-160,241,254,495,972
-40,0,-40,249,247,496,903
-70,70,10,249,247,496,986
10,-40,-40,237,259,496,1065
-60,-60,-110,242,254,496,842
10,-50,0,255,241,496,1093
30,-30,-20,242,254,496,1051
-100,70,30,235,262,497,939
0,0,-20,254,243,497,973
160,50,140,251,246,497,1102
150,30,130,254,243,497,1081
-80,80,20,252,246,498,939
100,-80,80,259,239,498,1013
-60,40,0,246,252,498,957
70,-20,40,256,242,498,896
-70,-40,-90,257,241,498,986
0,-50,-10,259,240,499,1040
140,80,160,253,246,499,910
70,-40,60,258,241,499,1073
-30,10,-30,257,242,499,986
-40,60,-20,246,253,499,959
-120,-70,-170,251,248,499,1004
40,0,10,250,249,499,982
-170,-20,120,247,252,499,1082
60,-60,50,246,253,499,1020
90,-70,70,248,251,499,976
-60,-30,-80,253,247,500,984
-60,-50,-70,255,245,500,1045
160,60,120,246,254,500,945
50,-20,0,253,247,500,1030
110,30,-170,262,238,500,956
-50,-10,-40,258,242,500,912
-20,-30,-60,244,256,500,990
20,-60,10,249,251,500,1071
-110,-80,-140,250,250,500,1040
-20,-60,-30,260,241,501,1066
170,-80,140,255,247,502,1021
120,30,170,250,252,502,947
-20,10,-30,262,240,502,1036
-60,-30,-60,270,232,502,1006
120,70,-170,255,248,503,922
180,10,120,255,248,503,1050
-180,10,120,255,248,503,1050
0,-10,-10,253,250,503,974
50,0,20,257,246,503,916
10,-20,0,253,250,503,984
110,-60,80,255,249,504,971
120,60,180,259,245,504,919
-110,-70,-150,248,256,504,1090
70,-20,50,267,237,504,944
30,-20,-20,247,257,504,972
-70,50,0,254,250,504,897
120,60,-180,259,245,504,919
-30,70,-20,255,249,504,993
-20,-30,-20,263,242,505,1048
120,-80,70,257,248,505,978
-20,0,-20,267,238,505,1063
120,50,-180,262,243,505,1027
-180,-80,150,259,246,505,1065
-40,-20,-30,254,251,505,1067
170,-20,110,258,247,505,991
180,-80,150,259,246,505,1065
110,40,180,248,257,505,979
120,50,180,262,243,505,1027
110,40,-180,248,257,505,979
-50,40,-20,247,259,506,962
-40,10,-30,260,246,506,966
90,-50,60,265,241,506,913
-140,30,90,257,249,506,1002
-40,30,-20,254,252,506,1054
-30,-50,-80,255,251,506,1016
-130,-70,-180,252,254,506,1005
-130,-70,180,252,254,506,1005
110,30,-180,261,246,507,938
-50,60,-10,244,263,507,947
-100,40,20,252,255,507,952
110,30,180,261,246,507,938
-120,60,40,252,255,507,917
-70,-50,-90,257,251,508,1036
120,50,170,255,253,508,983
-50,-40,-90,255,253,508,1053
-30,-20,-60,254,254,508,1071
130,60,160,243,266,509,954
-120,30,60,249,260,509,1024
-160,-70,150,267,243,510,1036
-40,80,-10,255,255,510,1001
0,80,-50,265,245,510,977
-90,50,30,253,257,510,1004
-40,-60,-50,253,257,510,1079
-70,50,10,254,256,510,931
50,-10,40,260,250,510,1079
40,-30,-10,248,262,510,1036
20,-30,-30,251,260,511,1089
-160,10,110,253,258,511,1091
130,-70,100,252,259,511,960
0,-10,-40,258,254,512,1053
130,80,170,258,254,512,924
120,70,180,261,251,512,904
-70,80,10,254,258,512,959
50,-10,0,256,256,512,988
-150,30,100,264,248,512,980
-100,30,30,254,258,512,1121
120,70,-180,261,251,512,904
180,-20,120,259,254,513,1146
40,-40,-10,257,256,513,1039
-180,-20,120,259,254,513,1146
-40,-50,-90,265,248,513,1039
90,-80,40,262,251,513,935
60,-10,20,259,254,513,1029
90,-60,70,251,262,513,963
170,-70,130,261,252,513,1000
-180,-70,130,267,247,514,1064
-30,60,-20,258,256,514,976
150,70,140,261,253,514,942
180,-70,130,267,247,514,1064
-170,20,90,256,258,514,860
-50,80,0,261,254,515,999
-20,70,-30,257,258,515,1004
0,-60,-10,268,247,515,1130
170,-70,120,267,249,516,1078
70,-30,30,260,256,516,1023
-50,-40,-50,261,255,516,1071
40,0,0,258,258,516,996
-180,30,120,259,258,517,1068
60,-10,50,270,247,517,1084
-70,-60,-120,263,254,517,934
-10,-60,-20,271,246,517,1102
-40,70,-10,261,256,517,1030
40,-10,-10,257,260,517,998
-120,-80,-150,261,256,517,1056
180,30,120,259,258,517,1068
-130,-80,-160,262,255,517,1061
110,70,-160,269,249,518,928
-100,70,50,256,262,518,1052
60,0,30,268,250,518,946
-60,-80,-80,254,264,518,1092
-170,-20,110,262,256,518,953
-120,-70,-160,255,263,518,1129
-60,70,0,259,259,518,1004
-60,50,-10,261,257,518,933
-40,-40,-40,276,243,519,1050
160,-10,120,257,262,519,997
70,-30,60,274,245,519,1092
-150,-70,160,271,248,519,1059
-80,50,20,259,260,519,1013
100,-80,50,268,251,519,978
70,-50,60,276,243,519,1065
-50,10,-30,274,246,520,946
140,90,160,263,258,521,990
-160,90,100,263,258,521,990
80,90,-140,263,258,521,990
-140,90,80,263,258,521,990
-110,90,50,263,258,521,990
-150,90,90,263,258,521,990
120,50,-170,262,259,521,1085
-90,90,30,263,258,521,990
10,80,-60,268,253,521,984
30,90,-90,263,258,521,990
180,90,120,263,258,521,990
-50,90,-10,263,258,521,990
-170,-80,160,263,258,521,1083
0,90,-60,263,258,521,990
120,90,-180,263,258,521,990
-120,90,60,263,258,521,990
120,90,180,263,258,521,990
110,90,-170,263,258,521,990
-170,90,110,263,258,521,990
-70,90,10,263,258,521,990
-20,80,-30,267,254,521,965
10,90,-70,263,258,521,990
170,90,130,263,258,521,990
60,90,-120,263,258,521,990
50,90,-110,263,258,521,990
160,90,140,263,258,521,990
-10,90,-50,263,258,521,990
150,90,150,263,258,521,990
-60,90,0,263,258,521,990
-100,90,40,263,258,521,990
130,90,170,263,258,521,990
90,90,-150,263,258,521,990
20,90,-80,263,258,521,990
-20,90,-40,263,258,521,990
-30,90,-30,263,258,521,990
70,90,-130,263,258,521,990
40,90,-100,263,258,521,990
10,-60,0,268,253,521,1130
-40,90,-20,263,258,521,990
-160,10,90,263,258,521,918
-180,90,120,263,258,521,990
-80,90,20,263,258,521,990
100,90,-160,263,258,521,990
-130,90,70,263,258,521,990
-160,0,100,252,270,522,983
-180,-70,140,263,259,522,1021
180,20,120,255,267,522,1091
-80,-60,-110,262,260,522,1077
100,50,-140,266,256,522,987
40,-70,30,260,262,522,1108
180,-70,140,263,259,522,1021
-180,20,120,255,267,522,1091
-50,70,-10,259,263,522,995
-170,0,120,253,269,522,1094
120,30,-180,267,256,523,955
-130,-70,-170,263,260,523,1132
160,-70,110,271,252,523,1032
30,0,0,269,254,523,1033
-20,60,-30,270,253,523,991
-40,70,-20,257,266,523,948
120,30,180,267,256,523,955
-10,80,-40,272,251,523,949
-170,-70,140,267,256,523,1062
-30,80,-20,265,258,523,986
-70,60,0,254,270,524,948
-30,40,-30,264,260,524,998
-150,-80,180,267,257,524,1074
100,40,-150,262,262,524,923
-150,-80,-180,267,257,524,1074
-50,30,-10,264,260,524,1042
100,-70,80,265,259,524,1065
20,0,-10,272,253,525,1059
-90,80,40,262,263,525,1066
-110,80,60,262,263,525,1070
-140,-70,170,267,258,525,1060
-70,30,0,253,272,525,1026
50,-50,0,265,260,525,1099
-30,-40,-30,274,251,525,1076
-70,-40,-100,269,257,526,1037
30,-10,20,266,260,526,1064
-140,-80,-170,265,261,526,1079
-70,-70,-90,270,256,526,1108
-60,80,0,262,264,526,986
-130,80,80,263,263,526,1069
40,0,20,269,257,526,1055
-80,-90,-100,268,259,527,1084
20,-90,0,268,259,527,1084
150,-90,130,268,259,527,1084
140,-90,120,268,259,527,1084
-60,-90,-80,268,259,527,1084
140,-60,100,271,256,527,1051
90,-90,70,268,259,527,1084
50,-90,30,268,259,527,1084
-50,-90,-70,268,259,527,1084
-160,-90,-180,268,259,527,1084
-170,-90,170,268,259,527,1084
-180,-90,160,268,259,527,1084
30,-90,10,268,259,527,1084
-10,-90,-30,268,259,527,1084
-90,-90,-110,268,259,527,1084
80,-90,60,268,259,527,1084
10,-90,-10,268,259,527,1084
-40,-90,-60,268,259,527,1084
-50,20,-20,265,262,527,1030
-160,-90,180,268,259,527,1084
70,-90,50,268,259,527,1084
-140,-90,-160,268,259,527,1084
-100,-90,-120,268,259,527,1084
-30,-90,-50,268,259,527,1084
130,-90,110,268,259,527,1084
-120,-90,-140,268,259,527,1084
-120,80,70,263,264,527,1094
0,-90,-20,268,259,527,1084
120,-90,100,268,259,527,1084
40,-90,20,268,259,527,1084
110,-90,90,268,259,527,1084
-150,-90,-170,268,259,527,1084
100,-90,80,268,259,527,1084
-20,-90,-40,268,259,527,1084
-110,-90,-130,268,259,527,1084
60,-90,40,268,259,527,1084
-70,-90,-90,268,259,527,1084
180,-90,160,268,259,527,1084
160,-90,140,268,259,527,1084
-130,-90,-150,268,259,527,1084
100,60,-150,282,245,527,966
170,-90,150,268,259,527,1084
-10,-20,-50,263,265,528,1087
110,50,-170,269,259,528,957
0,70,-50,271,257,528,1015
-10,70,-40,269,259,528,1014
-60,80,10,271,257,528,1028
-100,80,50,262,266,528,1066
30,0,10,265,263,528,1103
-150,40,100,264,265,529,1095
-70,70,20,262,267,529,1108
-70,80,20,270,259,529,1036
140,-70,110,265,264,529,1027
150,-60,110,267,262,529,1055
-50,-10,-30,275,254,529,1083
-160,-80,170,271,258,529,1077
20,0,-20,272,258,530,1048
110,-80,60,269,261,530,1001
110,-80,90,272,258,530,1053
-90,70,40,255,275,530,1084
100,70,-150,281,249,530,961
-10,60,-40,264,266,530,1021
10,-70,0,265,265,530,1118
-90,-70,-120,264,267,531,1093
50,-70,40,268,263,531,1098
40,-10,30,269,262,531,1122
160,-10,110,269,262,531,975
-100,30,20,264,267,531,1049
120,80,-180,272,260,532,948
-140,40,90,276,256,532,1050
120,80,180,272,260,532,948
-130,20,60,265,267,532,968
0,-40,-50,258,274,532,1099
-170,-10,120,259,273,532,1169
-40,20,-30,272,260,532,1058
150,20,130,273,259,532,1110
110,30,170,275,257,532,1002
140,80,170,270,262,532,978
-50,70,0,269,264,533,1042
-60,70,10,273,260,533,1047
-10,0,-40,259,274,533,1030
-80,70,30,265,268,533,1097
-30,70,-30,256,278,534,1003
10,0,-10,280,254,534,1101
-30,0,-20,274,260,534,1094
-50,-50,-100,268,266,534,1054
30,0,-10,270,264,534,1045
-170,-70,150,272,262,534,1049
30,-70,20,272,263,535,1141
-140,-70,-180,268,267,535,1111
-150,10,90,272,263,535,964
20,-70,10,273,262,535,1153
-70,-50,-110,272,263,535,1076
-90,30,20,261,274,535,1174
-140,-70,180,268,267,535,1111
110,40,-160,274,261,535,1031
-110,70,60,269,266,535,1020
-130,40,80,266,270,536,1017
-120,70,70,270,266,536,1014
-50,-20,-70,271,265,536,1019
-150,80,100,265,271,536,1071
0,-70,-10,274,262,536,1142
150,80,160,267,269,536,988
-160,80,90,262,274,536,1054
-140,80,90,267,269,536,1081
100,-60,60,276,260,536,1027
50,-20,50,279,258,537,1202
150,30,140,269,268,537,1178
-70,30,-10,266,271,537,1035
110,50,-150,275,262,537,990
-70,-60,-90,264,274,538,1182
160,-20,110,275,263,538,1040
130,80,180,275,263,538,972
130,80,-180,275,263,538,972
-40,20,-20,274,264,538,1109
20,80,-70,276,263,539,1011
-60,-20,-50,268,271,539,1037
110,40,170,281,258,539,971
-160,40,110,269,270,539,1060
-160,50,110,267,272,539,1074
-80,80,30,274,265,539,1069
-30,60,-30,268,272,540,1021
50,-40,0,279,261,540,1168
60,0,20,268,272,540,1020
130,-60,90,282,258,540,1072
-90,70,20,267,274,541,1035
-70,-80,-90,268,273,541,1138
-60,60,10,267,274,541,1113
170,-20,120,277,264,541,1179
70,-60,60,274,268,542,1101
-160,80,110,264,278,542,1075
120,60,-170,271,271,542,990
-150,70,100,272,271,543,1044
-40,50,-10,273,270,543,1084
-20,40,-30,274,269,543,1093
160,80,150,268,275,543,1020
100,30,-170,266,277,543,1013
120,40,-170,280,263,543,1129
130,70,-180,265,278,543,987
20,-20,-30,270,273,543,1062
-60,-40,-100,274,269,543,1133
130,70,180,265,278,543,987
60,0,40,276,267,543,1054
-140,50,90,271,273,544,1020
140,40,160,269,275,544,1143
-20,50,-30,268,276,544,1082
-40,60,-10,273,271,544,1026
-50,-60,-60,269,275,544,1156
-130,80,60,271,273,544,1104
50,-30,50,286,258,544,1200
120,30,160,271,273,544,1081
70,80,-120,277,267,544,995
70,90,-120,272,273,545,1024
-60,90,10,272,273,545,1024
20,-10,10,286,259,545,1052
180,90,130,272,273,545,1024
-170,90,120,272,273,545,1024
-100,90,50,272,273,545,1024
-20,90,-30,272,273,545,1024
-10,90,-40,272,273,545,1024
100,90,-150,272,273,545,1024
0,90,-50,272,273,545,1024
130,90,-180,272,273,545,1024
50,-40,50,277,268,545,1167
-150,50,100,268,277,545,1046
100,80,-150,284,261,545,951
-40,90,-10,272,273,545,1024
-80,90,30,272,273,545,1024
130,90,180,272,273,545,1024
-70,90,20,272,273,545,1024
80,90,-130,272,273,545,1024
30,90,-80,272,273,545,1024
-160,90,110,272,273,545,1024
-50,90,0,272,273,545,1024
-130,90,80,272,273,545,1024
110,90,-160,272,273,545,1024
120,90,-170,272,273,545,1024
170,90,140,272,273,545,1024
-180,90,130,272,273,545,1024
40,90,-90,272,273,545,1024
-120,90,70,272,273,545,1024
-30,90,-20,272,273,545,1024
-110,90,60,272,273,545,1024
60,90,-110,272,273,545,1024
-140,90,90,272,273,545,1024
-160,20,110,269,276,545,1113
50,90,-100,272,273,545,1024
-90,90,40,272,273,545,1024
-150,-70,170,277,268,545,1110
10,90,-60,272,273,545,1024
150,60,130,268,277,545,1104
-150,90,100,272,273,545,1024
160,90,150,272,273,545,1024
140,90,170,272,273,545,1024
90,90,-140,272,273,545,1024
-30,20,-30,280,265,545,1105
20,90,-70,272,273,545,1024
110,80,-160,283,262,545,954
150,90,160,272,273,545,1024
170,40,130,262,284,546,1134
120,-60,90,280,266,546,1012
110,60,-150,276,270,546,1031
60,80,-110,273,274,547,1018
-160,-70,160,277,270,547,1097
100,60,-140,286,261,547,1043
-90,-60,-130,272,275,547,1117
-170,80,100,272,275,547,1039
-60,20,-10,272,276,548,1128
-40,0,-20,279,269,548,1152
170,80,140,272,276,548,1038
10,70,-60,274,274,548,1048
50,-30,0,271,278,549,1131
130,40,-180,279,270,549,1086
130,40,180,279,270,549,1086
80,80,-130,281,268,549,978
-30,40,-20,274,275,549,1089
-90,-60,-140,278,271,549,1108
120,80,-170,284,266,550,963
-80,-60,-130,282,268,550,1043
90,-50,70,279,271,550,1059
50,0,0,270,280,550,1058
-30,50,-20,279,271,550,1095
130,50,180,280,270,550,1165
80,-70,30,275,275,550,908
130,50,-180,280,270,550,1165
-140,60,90,268,282,550,1040
-150,60,100,263,287,550,1064
180,80,130,268,282,550,1067
-50,-10,-50,279,271,550,1049
-180,80,130,268,282,550,1067
-20,-70,-30,277,273,550,1149
-50,10,-20,276,275,551,1062
140,40,130,289,262,551,1149
-170,80,120,263,288,551,1080
-50,-30,-80,270,281,551,1075
160,40,140,265,286,551,1182
100,40,-140,286,265,551,950
-70,40,10,276,276,552,1048
-50,60,0,270,282,552,1092
110,-70,90,280,272,552,1162
160,-60,110,273,279,552,1073
30,-10,-20,266,286,552,1090
-40,10,-20,278,275,553,1127
-110,60,60,281,272,553,1025
-10,-70,-20,285,268,553,1167
-130,30,80,274,279,553,1101
-30,-30,-70,272,281,553,1146
-120,60,70,277,276,553,1008
-80,30,10,275,278,553,1176
160,20,130,279,274,553,1213
-50,0,-40,281,272,553,996
160,-60,120,278,276,554,1087
-50,80,-10,281,273,554,1014
40,10,10,281,273,554,1083
120,-80,100,278,276,554,1082
-60,10,-20,277,277,554,1045
50,0,30,290,264,554,1031
-60,20,-20,280,274,554,1067
-180,-30,120,272,283,555,1062
60,-70,50,281,274,555,1128
60,-10,60,280,275,555,1267
-130,50,80,270,285,555,1008
180,-30,120,272,283,555,1062
-60,0,-30,272,283,555,1067
-10,10,-30,284,271,555,1152
180,80,110,277,279,556,1029
50,80,-100,275,281,556,1038
10,-10,0,291,265,556,1156
70,-60,20,266,290,556,931
-120,20,50,286,270,556,1067
-30,50,-30,274,282,556,1008
-180,80,110,277,279,556,1029
30,80,-80,283,273,556,1036
-30,10,-20,282,274,556,1232
40,10,0,280,276,556,1148
110,80,-170,284,273,557,1006
140,30,140,289,268,557,1130
-170,50,120,281,276,557,1156
140,70,150,283,275,558,1032
-160,30,110,270,288,558,1107
100,50,-150,293,265,558,1008
40,80,-90,278,280,558,1053
-50,50,0,283,275,558,1118
-140,70,90,276,282,558,1012
-150,80,80,273,286,559,1096
-80,-80,-100,277,282,559,1177
-40,40,-10,284,275,559,1115
-30,-10,-20,281,278,559,1142
-130,70,80,275,284,559,1026
-10,10,-20,292,267,559,1172
-140,10,90,279,280,559,1052
130,30,160,284,275,559,1186
120,-60,80,286,274,560,1092
-30,20,-20,288,272,560,1146
140,70,170,277,283,560,1048
-170,60,120,278,282,560,1114
-130,60,80,267,293,560,1012
130,30,150,287,273,560,1191
-60,-40,-60,282,278,560,1193
90,80,-140,287,273,560,966
130,-60,100,284,277,561,1098
60,-50,10,282,279,561,1083
-100,-70,-130,275,286,561,1190
150,-50,110,281,280,561,1204
-50,20,-10,282,279,561,1197
50,10,10,284,277,561,1099
-160,60,110,265,296,561,1111
-170,-30,120,274,287,561,1100
130,60,-180,278,284,562,1101
130,60,180,278,284,562,1101
-150,0,100,278,284,562,1147
100,80,-160,284,278,562,1076
-70,-40,-80,297,265,562,1187
100,30,-180,287,276,563,1032
150,40,150,283,280,563,1250
100,30,180,287,276,563,1032
-120,50,70,272,291,563,1083
-10,-40,-60,271,292,563,1139
-20,70,-40,274,289,563,1103
40,-40,40,287,277,564,1203
170,-60,120,289,275,564,1078
-160,-20,120,271,293,564,1137
-10,-20,-10,286,278,564,1088
-100,60,50,279,285,564,1096
10,-30,-40,266,299,565,1187
80,70,-120,287,278,565,1040
-140,80,70,277,288,565,1123
140,30,150,292,273,565,1244
120,50,-160,290,275,565,1121
150,10,130,283,282,565,1228
-20,10,-20,295,270,565,1191
60,-20,60,289,277,566,1314
10,70,-50,290,276,566,1114
-30,10,-40,290,276,566,1105
-70,-50,-80,285,281,566,1223
150,-70,100,296,270,566,1106
110,-60,70,297,269,566,1114
180,-60,130,290,277,567,1097
-180,-60,130,290,277,567,1097
10,0,-30,284,283,567,1195
70,-20,60,304,263,567,1152
-50,-30,-40,289,278,567,1159
150,30,120,289,278,567,1094
110,70,-170,283,285,568,1032
140,-70,90,294,274,568,1117
-160,-10,120,274,294,568,1297
170,-30,120,289,279,568,1187
-100,-60,-140,280,288,568,1203
-100,40,40,285,284,569,1206
150,-70,120,284,285,569,1119
110,60,-170,287,282,569,1069
-80,40,20,283,286,569,1199
-130,20,80,287,282,569,1090
-60,-30,-50,290,279,569,1171
-180,60,130,287,283,570,1182
60,-10,10,276,294,570,1152
150,-10,120,287,283,570,1171
100,30,-150,282,288,570,1080
180,60,130,287,283,570,1182
-70,60,20,285,285,570,1166
160,30,110,293,277,570,1012
-160,70,110,285,286,571,1065
100,-60,80,286,285,571,1085
40,-30,40,296,275,571,1212
-10,-30,-10,287,284,571,1162
-120,20,60,288,284,572,1156
-70,-30,-80,294,278,572,1172
-170,-60,140,280,292,572,1156
20,-10,-30,274,298,572,1212
70,-70,60,290,282,572,1200
-60,30,0,293,279,572,1194
90,70,-130,291,282,573,1063
120,50,160,275,298,573,1131
-80,-70,-100,288,285,573,1235
-40,30,-30,286,287,573,1143
70,70,-110,287,286,573,1070
-170,70,120,285,288,573,1112
-40,-20,-70,278,296,574,1168
160,70,150,284,290,574,1138
110,40,-150,285,289,574,1099
-90,30,10,279,295,574,1168
-20,-40,-20,288,286,574,1228
0,0,-10,286,288,574,1180
60,-20,10,283,291,574,1214
-80,60,30,289,285,574,1226
0,60,-40,289,286,575,1203
-110,30,50,293,282,575,1150
100,30,-160,289,286,575,1063
-90,40,30,282,293,575,1268
-90,-80,-110,287,288,575,1209
50,-50,50,293,283,576,1255
130,40,140,315,261,576,1191
170,30,130,287,289,576,1264
-30,-70,-40,292,284,576,1181
120,30,-170,297,280,577,1144
10,-20,-40,287,290,577,1227
90,70,-140,308,269,577,1052
50,-10,50,289,288,577,1271
110,30,-160,292,285,577,1130
150,70,160,285,292,577,1127
50,80,-90,288,289,577,1139
-30,30,-20,291,286,577,1191
-60,-20,-70,293,284,577,1068
20,70,-60,298,280,578,1134
-90,-60,-120,288,291,579,1198
-10,-10,-10,293,286,579,1172
-80,70,10,295,284,579,1148
100,70,-140,299,280,579,1073
20,80,-60,303,276,579,1137
160,-20,120,294,285,579,1213
-120,80,50,298,282,580,1150
30,0,20,290,290,580,1187
130,30,170,282,298,580,1154
60,0,50,292,288,580,1193
50,-80,40,286,294,580,1207
130,-80,110,291,289,580,1132
150,-60,100,292,288,580,1129
140,60,170,290,290,580,1212
-60,-20,-60,284,297,581,1153
180,70,130,295,286,581,1146
-170,10,120,288,293,581,1229
-180,70,130,295,286,581,1146
170,-40,120,287,294,581,1219
160,10,130,298,283,581,1232
140,-60,110,292,289,581,1184
180,50,130,290,291,581,1276
-180,50,130,290,291,581,1276
30,-80,20,298,283,581,1227
140,50,170,300,282,582,1255
120,60,170,288,294,582,1046
-70,-30,-90,290,292,582,1153
-40,10,-40,291,291,582,1109
-80,30,0,288,294,582,1161
30,-40,30,304,279,583,1163
100,40,-160,283,300,583,1046
-90,40,10,281,302,583,1129
-40,-70,-50,300,283,583,1215
10,60,-50,279,304,583,1168
0,10,-20,290,293,583,1220
0,60,-50,295,288,583,1133
-90,60,40,288,295,583,1173
100,70,-160,300,283,583,1136
120,60,-160,299,284,583,1096
-60,-60,-70,299,285,584,1300
-20,10,-40,297,287,584,1236
-20,-40,-70,276,308,584,1204
50,10,20,300,284,584,1101
20,0,0,299,285,584,1187
-170,-40,130,289,295,584,1194
0,70,-40,302,282,584,1136
160,-70,130,294,290,584,1178
110,50,-140,291,293,584,1150
150,40,120,313,271,584,1126
-110,50,60,284,300,584,1199
40,-80,30,292,292,584,1227
80,-40,70,302,283,585,1258
60,-40,60,311,274,585,1273
-110,-70,-140,293,292,585,1230
-40,30,-10,297,288,585,1221
-80,-50,-110,289,296,585,1231
40,0,-10,285,301,586,1228
170,-60,130,290,296,586,1123
-50,50,-20,289,297,586,1046
-40,80,-20,299,287,586,1068
60,80,-100,297,289,586,1135
60,10,10,295,291,586,1079
-10,60,-30,299,287,586,1184
40,80,-80,299,287,586,1149
40,10,20,304,282,586,1217
60,0,10,285,302,587,1132
80,-60,70,298,289,587,1280
110,70,-150,303,284,587,1081
30,80,-70,299,288,587,1163
-20,30,-30,296,291,587,1223
160,20,110,295,292,587,1022
140,-80,120,295,293,588,1173
-40,-50,-40,303,285,588,1266
-50,0,-20,301,287,588,1161
40,0,30,303,285,588,1294
50,10,0,289,299,588,1221
-30,-20,-20,295,293,588,1199
160,-30,110,286,302,588,1186
60,-80,50,296,292,588,1218
170,70,140,291,297,588,1172
-70,-40,-110,289,299,588,1203
60,-30,60,305,284,589,1301
80,-50,70,300,289,589,1247
100,50,-130,301,288,589,1177
120,-70,100,295,294,589,1274
160,0,110,294,295,589,1128
170,80,120,294,295,589,1072
170,60,140,297,292,589,1209
80,-40,40,297,292,589,1098
170,-30,110,288,301,589,1123
150,60,160,300,289,589,1247
150,0,120,299,291,590,1170
-100,-80,-120,297,293,590,1224
-20,20,-20,301,289,590,1269
-10,-10,-50,291,299,590,1230
30,-30,30,310,280,590,1193
100,50,-160,287,304,591,1070
-20,20,-30,304,287,591,1247
170,50,140,297,294,591,1317
-20,30,-20,299,292,591,1172
-20,70,-20,307,285,592,1113
50,0,40,301,291,592,1197
10,80,-50,312,280,592,1158
20,-80,10,300,292,592,1238
90,80,-150,299,293,592,1173
80,80,-120,298,294,592,1119
-10,70,-30,305,287,592,1156
120,-50,90,310,282,592,1180
-30,70,-10,308,285,593,1131
140,60,140,288,305,593,1237
-20,60,-20,311,282,593,1186
-170,40,120,291,302,593,1231
-80,-50,-120,297,297,594,1230
100,40,-170,295,299,594,1109
100,-50,80,310,284,594,1193
-180,-40,120,283,311,594,1240
0,10,-30,307,287,594,1271
-20,60,-40,297,297,594,1148
-60,-10,-40,303,291,594,1148
-20,40,-20,304,290,594,1217
30,-20,30,309,285,594,1261
-50,20,-30,303,291,594,1216
110,80,-150,307,287,594,1146
180,-40,120,283,311,594,1240
120,70,-160,303,292,595,1141
-80,40,0,291,304,595,1133
140,30,130,303,292,595,1194
-60,-10,-30,305,291,596,1206
60,10,20,290,306,596,1093
170,-70,140,299,297,596,1231
-110,60,30,290,306,596,1129
-60,-20,-40,311,285,596,1211
-10,50,-40,286,311,597,1158
100,-50,70,303,294,597,1125
90,80,-130,308,289,597,1120
-60,60,-10,300,298,598,1100
90,-40,70,310,288,598,1181
180,-60,140,302,296,598,1199
-50,40,0,301,297,598,1220
160,-40,110,300,298,598,1193
-10,80,-30,308,290,598,1143
-180,-60,140,302,296,598,1199
-150,-10,110,303,296,599,1149
70,-80,60,301,298,599,1237
20,60,-60,303,296,599,1208
150,50,160,300,299,599,1309
10,-80,0,297,303,600,1236
170,30,100,322,278,600,1018
20,-30,20,312,288,600,1258
150,-30,110,303,297,600,1263
-150,0,110,304,296,600,1232
-30,30,-30,304,296,600,1114
90,60,-130,311,289,600,1098
140,20,140,304,297,601,1307
-100,50,20,300,301,601,1072
30,70,-70,304,297,601,1186
70,80,-110,302,299,601,1136
-30,-50,-30,304,297,601,1310
80,-30,60,314,287,601,1160
-100,-60,-150,298,303,601,1270
40,-20,40,309,292,601,1302
-30,0,-50,297,304,601,1291
-20,80,-20,307,294,601,1138
-40,20,-10,300,301,601,1236
30,-10,30,296,306,602,1311
90,-70,40,313,289,602,1080
100,80,-140,313,289,602,1133
150,-40,110,305,297,602,1221
160,-50,120,302,300,602,1262
130,-70,80,311,291,602,1185
100,60,-130,300,302,602,1185
110,-60,90,305,297,602,1235
0,-20,0,301,301,602,1282
-70,-30,-70,312,290,602,1239
-180,-30,110,300,303,603,1123
90,60,-140,312,291,603,1087
60,-40,10,298,305,603,1253
0,80,-40,313,290,603,1163
160,-80,140,309,294,603,1246
180,-30,110,300,303,603,1123
-50,-70,-60,309,294,603,1284
-160,-60,150,315,288,603,1226
160,60,150,309,295,604,1294
20,-40,20,317,287,604,1325
-50,-50,-50,310,294,604,1262
150,-20,110,308,296,604,1173
-80,-50,-100,309,295,604,1288
-30,80,-10,308,297,605,1136
160,80,130,300,305,605,1101
-80,-40,-100,301,304,605,1259
-60,-50,-110,301,304,605,1172
40,-50,40,309,296,605,1270
-80,-60,-100,306,299,605,1330
-120,40,70,300,306,606,1093
140,40,170,296,310,606,1205
90,50,-130,304,302,606,1121
130,-50,100,311,296,607,1204
10,10,-20,308,299,607,1217
180,0,100,307,301,608,1066
-30,80,-30,312,296,608,1115
-120,-70,-150,310,298,608,1273
-160,-20,110,300,308,608,1101
-180,0,100,307,301,608,1066
-10,-40,-10,305,303,608,1247
180,40,90,307,302,609,1117
80,-30,50,315,294,609,1152
120,80,-160,312,297,609,1175
60,-30,10,305,304,609,1319
-110,80,40,302,307,609,1184
60,0,60,310,299,609,1267
-160,-30,130,291,318,609,1357
-110,-80,-130,309,300,609,1293
10,-30,10,310,299,609,1263
0,-30,0,305,304,609,1232
170,-50,120,311,298,609,1267
-180,40,90,307,302,609,1117
-120,20,40,318,291,609,1110
130,30,140,313,296,609,1205
-120,30,70,300,309,609,1250
-50,-20,-30,326,284,610,1296
150,-80,130,306,304,610,1212
150,-60,120,304,306,610,1258
140,20,130,313,297,610,1198
40,10,-10,307,303,610,1243
30,10,10,307,303,610,1266
30,0,-20,294,316,610,1296
20,70,-70,307,304,611,1199
0,-80,-10,302,309,611,1270
-180,-80,160,317,294,611,1319
40,-10,40,316,295,611,1345
60,70,-100,304,307,611,1155
180,-80,160,317,294,611,1319
170,-80,150,317,295,612,1296
30,10,0,317,295,612,1266
140,-50,100,306,306,612,1244
160,50,150,309,303,612,1367
100,40,-130,315,297,612,1180
-160,-70,170,315,297,612,1310
-140,10,80,299,313,612,1092
-70,20,0,304,308,612,1320
-110,-60,-160,305,307,612,1312
-110,-60,-150,312,300,612,1302
-40,80,0,318,295,613,1175
-10,40,-30,310,303,613,1236
-40,40,-30,305,308,613,1089
60,-50,60,321,292,613,1358
-10,-80,-20,299,314,613,1302
100,30,-140,310,304,614,1115
80,70,-130,315,299,614,1173
50,70,-90,308,306,614,1158
150,20,120,319,295,614,1096
-10,50,-30,313,301,614,1282
-50,30,0,313,302,615,1314
-70,70,0,305,310,615,1226
-140,10,100,308,307,615,1272
-130,-70,-160,314,301,615,1333
-60,0,-20,305,310,615,1272
20,-20,20,314,301,615,1252
-120,-60,-170,307,309,616,1323
-180,-70,150,306,310,616,1287
90,60,-120,312,304,616,1242
-110,20,40,313,303,616,1237
160,40,110,321,295,616,1098
180,-70,150,306,310,616,1287
-60,50,10,306,310,616,1205
80,-80,70,312,305,617,1277
110,20,170,291,326,617,1168
10,-20,10,314,303,617,1283
-20,50,-20,320,297,617,1231
110,-50,80,325,292,617,1188
130,70,-170,315,302,617,1234
170,10,130,301,316,617,1306
-40,-30,-30,307,310,617,1292
-40,90,0,318,300,618,1241
10,90,-50,318,300,618,1241
70,90,-110,318,300,618,1241
-70,90,30,318,300,618,1241
150,90,170,318,300,618,1241
20,90,-60,318,300,618,1241
50,90,-90,318,300,618,1241
90,90,-130,318,300,618,1241
110,90,-150,318,300,618,1241
-10,20,-20,316,302,618,1256
-160,90,120,318,300,618,1241
30,90,-70,318,300,618,1241
-30,90,-10,318,300,618,1241
-120,90,80,318,300,618,1241
-80,90,40,318,300,618,1241
-140,90,100,318,300,618,1241
100,90,-140,318,300,618,1241
170,90,150,318,300,618,1241
-150,90,110,318,300,618,1241
-90,90,50,318,300,618,1241
-50,90,10,318,300,618,1241
120,90,-160,318,300,618,1241
-100,90,60,318,300,618,1241
-60,90,20,318,300,618,1241
130,90,-170,318,300,618,1241
140,-50,110,322,296,618,1256
-10,90,-30,318,300,618,1241
-170,90,130,318,300,618,1241
0,90,-40,318,300,618,1241
130,20,150,317,301,618,1403
-20,90,-20,318,300,618,1241
180,90,140,318,300,618,1241
140,90,-180,318,300,618,1241
60,90,-100,318,300,618,1241
140,90,180,318,300,618,1241
40,90,-80,318,300,618,1241
-110,90,70,318,300,618,1241
-180,90,140,318,300,618,1241
-50,80,10,317,301,618,1190
80,90,-120,318,300,618,1241
-130,90,90,318,300,618,1241
160,90,160,318,300,618,1241
50,0,-10,308,311,619,1259
130,70,160,314,305,619,1210
-70,-30,-60,318,301,619,1301
-70,20,-10,312,307,619,1188
-60,-30,-90,315,304,619,1237
30,10,-10,315,304,619,1285
20,0,-30,312,307,619,1382
-30,30,-10,315,305,620,1248
0,0,-40,295,325,620,1277
-130,20,50,321,299,620,1137
180,-50,130,314,306,620,1224
100,20,-170,318,302,620,1271
-180,-50,130,314,306,620,1224
-170,-30,130,303,318,621,1372
120,-60,100,318,303,621,1290
170,40,100,321,300,621,1170
-60,10,-30,309,312,621,1218
70,-10,50,318,304,622,1210
160,-50,110,305,317,622,1294
-170,-80,170,323,299,622,1323
-180,-40,130,309,313,622,1327
-10,30,-30,304,318,622,1260
40,70,-80,316,306,622,1194
180,-40,130,309,313,622,1327
-120,-80,-140,317,306,623,1315
80,-70,70,317,306,623,1318
-140,-70,-170,322,301,623,1323
50,-10,-10,301,322,623,1344
-20,-80,-30,308,315,623,1330
-120,-70,-180,306,317,623,1285
-120,-70,180,306,317,623,1285
150,20,140,302,321,623,1420
60,-10,70,318,305,623,1348
-160,-80,180,322,301,623,1336
-160,-80,-180,322,301,623,1336
-110,-70,-170,310,313,623,1252
-70,-60,-80,324,299,623,1398
130,50,-170,321,303,624,1279
130,60,-170,310,314,624,1303
140,-40,110,314,310,624,1310
70,-50,20,303,321,624,1192
-130,-80,-150,314,310,624,1328
110,-50,90,326,299,625,1266
110,20,-180,316,309,625,1145
-20,-50,-20,315,310,625,1372
110,20,180,316,309,625,1145
-170,30,120,313,312,625,1306
160,0,130,310,316,626,1316
110,60,-140,311,315,626,1199
120,20,160,320,306,626,1347
-150,10,110,309,317,626,1314
120,40,-160,326,300,626,1284
10,10,-30,315,311,626,1420
-170,-70,160,317,309,626,1323
110,50,170,309,317,626,1190
130,-50,90,319,308,627,1294
170,20,130,310,317,627,1400
-180,40,130,302,325,627,1354
150,80,140,313,314,627,1149
180,40,130,302,325,627,1354
150,0,130,317,311,628,1349
-40,70,0,326,302,628,1181
-150,-80,-170,323,305,628,1333
110,50,-180,302,326,628,1200
130,-70,110,308,320,628,1370
-60,80,20,318,310,628,1238
110,50,180,302,326,628,1200
130,30,-180,312,317,629,1212
-160,0,120,310,319,629,1334
120,40,150,335,294,629,1268
-90,-50,-130,319,310,629,1319
-70,40,-10,304,325,629,1194
70,-10,40,324,305,629,1182
170,-50,130,313,316,629,1287
-100,30,40,318,311,629,1326
120,30,150,331,298,629,1225
130,30,180,312,317,629,1212
160,-40,120,317,312,629,1300
140,-60,90,324,306,630,1283
160,50,110,301,329,630,1246
-170,20,120,315,315,630,1312
70,-20,30,316,314,630,1232
0,-40,0,317,314,631,1348
80,80,-140,317,314,631,1230
-150,-60,160,329,302,631,1329
-50,70,10,322,309,631,1209
-60,30,-20,317,314,631,1249
30,-50,30,324,307,631,1310
10,0,0,319,312,631,1342
-70,30,10,313,318,631,1326
-60,-50,-60,322,310,632,1338
-100,20,20,312,320,632,1277
140,10,140,319,313,632,1504
-100,50,50,311,321,632,1325
160,10,110,331,301,632,1214
100,40,180,325,307,632,1123
-170,-50,140,314,318,632,1243
100,40,-180,325,307,632,1123
-40,0,-50,307,325,632,1362
170,40,140,306,327,633,1424
20,0,10,321,312,633,1299
150,10,120,319,314,633,1290
140,-20,110,325,308,633,1283
20,10,-20,324,309,633,1344
100,70,-130,327,306,633,1256
-90,-70,-110,323,310,633,1332
90,50,-120,316,318,634,1269
-20,-20,-60,321,313,634,1375
-30,-80,-40,315,319,634,1357
-60,-70,-70,319,315,634,1365
-30,60,-10,333,301,634,1226
130,80,-170,320,314,634,1231
90,-70,80,323,312,635,1431
-130,-60,-180,323,312,635,1344
-130,-60,180,323,312,635,1344
160,-30,120,329,306,635,1400
90,70,-120,326,309,635,1251
-10,20,-30,324,311,635,1344
-150,-70,180,326,310,636,1338
80,-30,70,334,302,636,1321
100,-70,50,323,313,636,1250
10,-10,-40,315,321,636,1364
-40,-10,-20,321,315,636,1295
10,-40,10,322,314,636,1401
-160,70,80,310,326,636,1333
-150,-70,-180,326,310,636,1338
120,-70,70,327,309,636,1265
-30,20,-40,327,310,637,1251
120,20,170,310,327,637,1293
-20,80,-40,324,313,637,1174
170,0,130,322,315,637,1277
0,-10,0,324,313,637,1372
0,50,-40,326,311,637,1351
-120,20,70,325,312,637,1264
10,60,-60,320,317,637,1249
90,-80,80,321,316,637,1335
-150,70,70,315,323,638,1299
-10,40,-20,330,308,638,1363
30,0,30,320,318,638,1398
140,50,-180,328,311,639,1376
140,30,160,314,325,639,1427
0,-50,0,323,316,639,1450
-140,-80,-160,325,314,639,1339
140,50,180,328,311,639,1376
-30,40,-10,324,315,639,1320
-130,-70,170,317,322,639,1322
80,70,-110,330,310,640,1268
-70,80,30,321,319,640,1254
-180,-50,140,326,314,640,1348
160,30,140,316,324,640,1435
90,-60,80,329,311,640,1393
30,60,-70,324,316,640,1251
180,-50,140,326,314,640,1348
-10,30,-20,323,317,640,1294
140,-10,120,320,321,641,1372
180,-30,130,319,322,641,1397
180,70,100,317,324,641,1294
50,-10,60,327,314,641,1500
-180,-30,130,319,322,641,1397
170,-40,110,313,328,641,1264
-180,70,100,317,324,641,1294
-150,10,80,321,320,641,1146
80,60,-120,332,309,641,1160
-20,40,-40,313,328,641,1221
70,-30,70,332,309,641,1333
10,-50,10,326,316,642,1430
-70,50,20,329,313,642,1308
-10,0,-10,324,318,642,1328
140,80,-180,325,317,642,1277
40,20,0,322,320,642,1312
0,-30,-50,312,330,642,1346
140,80,180,325,317,642,1277
20,-10,20,329,314,643,1356
-140,-60,170,331,313,644,1369
150,-20,120,338,306,644,1409
-100,20,30,326,318,644,1334
-80,50,30,323,321,644,1349
160,-60,130,320,325,645,1348
-60,70,20,319,326,645,1303
-30,20,-10,330,315,645,1286
-60,70,-10,321,324,645,1302
-170,-50,130,309,336,645,1265
-110,40,60,325,320,645,1310
-170,-20,130,317,328,645,1419
-10,40,-40,322,324,646,1287
-80,80,40,325,321,646,1299
110,70,-140,332,314,646,1302
-170,70,90,317,329,646,1369
20,-50,20,336,311,647,1411
0,30,-30,337,310,647,1321
-110,20,30,336,311,647,1211
-170,-60,150,340,307,647,1323
-140,0,100,330,317,647,1373
0,20,-30,326,321,647,1355
110,-70,60,333,314,647,1272
150,-50,120,334,314,648,1381
110,30,-150,328,320,648,1303
-120,-60,-160,331,317,648,1393
70,70,-100,319,329,648,1313
150,50,120,322,326,648,1324
-70,70,30,326,322,648,1320
-20,0,-50,318,330,648,1401
-40,-80,-50,327,321,648,1362
-80,20,0,322,326,648,1286
60,0,0,317,332,649,1307
-20,20,-40,328,321,649,1331
20,10,-10,331,318,649,1272
-150,-70,150,326,323,649,1269
10,10,-10,328,321,649,1383
-60,10,-10,314,335,649,1376
140,-40,100,336,313,649,1278
-70,-50,-120,330,319,649,1331
-30,50,-10,330,319,649,1302
80,60,-110,326,325,651,1299
-100,80,60,327,324,651,1343
-50,-40,-100,327,324,651,1400
-90,50,40,322,329,651,1373
70,70,-120,324,327,651,1204
0,20,-20,326,326,652,1311
-60,-10,-50,331,321,652,1240
-180,-50,120,329,323,652,1328
150,80,170,326,326,652,1311
-160,20,80,328,324,652,1158
150,40,160,317,335,652,1394
130,-40,100,331,321,652,1311
110,20,-170,333,319,652,1292
40,-10,-20,315,337,652,1392
-80,70,40,326,326,652,1388
-10,80,-50,331,321,652,1214
180,-50,120,329,323,652,1328
160,40,150,320,333,653,1463
-40,60,0,337,316,653,1337
50,0,50,337,316,653,1432
70,-10,60,341,312,653,1319
130,40,-170,339,314,653,1318
70,-40,70,332,321,653,1425
0,40,-30,336,318,654,1354
-50,-80,-60,330,324,654,1375
130,20,160,331,323,654,1409
-70,-40,-70,336,318,654,1388
-10,70,-50,312,342,654,1254
30,70,-80,330,324,654,1313
-140,-70,160,331,323,654,1295
-90,80,50,328,326,654,1315
-100,80,30,321,333,654,1285
100,20,-180,326,328,654,1228
150,30,150,326,328,654,1449
100,20,180,326,328,654,1228
-160,-50,140,328,327,655,1268
-10,-50,-10,332,323,655,1473
50,10,30,340,315,655,1318
110,10,170,333,322,655,1351
70,80,-130,334,321,655,1266
-50,10,-10,326,329,655,1355
-140,20,100,313,342,655,1275
30,10,-20,334,321,655,1444
-150,-20,120,319,336,655,1390
-100,-70,-160,327,328,655,1227
-20,50,-40,319,337,656,1215
70,-20,70,337,319,656,1446
170,50,100,316,340,656,1232
110,40,-140,333,323,656,1318
-90,50,10,316,340,656,1255
60,-20,70,340,316,656,1468
-170,-60,130,337,320,657,1261
90,-50,80,331,326,657,1351
-160,-70,140,331,326,657,1252
100,-80,90,329,328,657,1407
-180,0,130,326,331,657,1351
130,-60,110,328,329,657,1402
180,0,130,326,331,657,1351
40,60,-70,339,318,657,1377
90,-50,50,319,338,657,1236
-70,-70,-80,327,331,658,1398
150,-40,100,333,325,658,1300
120,-50,100,336,322,658,1368
10,-10,10,336,323,659,1377
140,10,130,332,327,659,1449
60,10,30,335,324,659,1227
140,60,180,332,328,660,1423
-30,-40,-80,315,345,660,1362
140,60,-180,332,328,660,1423
-100,-60,-130,334,326,660,1424
130,20,140,335,325,660,1336
20,60,-50,335,325,660,1431
-40,-30,-80,327,333,660,1349
140,20,150,339,322,661,1516
140,70,-180,328,333,661,1362
140,70,180,328,333,661,1362
-90,20,10,330,331,661,1325
160,-10,130,336,326,662,1406
-10,60,-50,324,338,662,1243
-140,-60,-180,341,321,662,1476
-80,30,20,331,331,662,1456
120,70,170,330,332,662,1340
-140,-60,180,341,321,662,1476
-60,0,-40,317,346,663,1263
-20,-10,-10,336,327,663,1360
170,70,110,327,336,663,1290
-140,70,60,316,347,663,1376
50,-60,50,341,322,663,1447
40,-60,40,332,331,663,1414
-40,10,-10,339,324,663,1299
-160,-20,130,319,344,663,1488
-80,-50,-90,340,323,663,1433
-60,-80,-70,331,332,663,1374
-180,-90,170,336,328,664,1389
-90,-90,-100,336,328,664,1389
10,-90,0,336,328,664,1389
-170,-90,180,336,328,664,1389
160,-90,150,336,328,664,1389
-110,-90,-120,336,328,664,1389
140,50,130,333,331,664,1343
130,-90,120,336,328,664,1389
140,-90,130,336,328,664,1389
170,-90,160,336,328,664,1389
150,-90,140,336,328,664,1389
-100,-90,-110,336,328,664,1389
180,-90,170,336,328,664,1389
-10,-90,-20,336,328,664,1389
-130,-90,-140,336,328,664,1389
0,40,-40,326,338,664,1343
-80,-90,-90,336,328,664,1389
20,-90,10,336,328,664,1389
0,-90,-10,336,328,664,1389
-120,-90,-130,336,328,664,1389
0,10,-10,338,326,664,1396
120,50,-150,330,334,664,1309
-170,-90,-180,336,328,664,1389
120,-90,110,336,328,664,1389
-150,-90,-160,336,328,664,1389
80,-90,70,336,328,664,1389
-160,-60,140,328,336,664,1298
-140,-90,-150,336,328,664,1389
-20,-90,-30,336,328,664,1389
-40,-90,-50,336,328,664,1389
-30,-90,-40,336,328,664,1389
-50,-90,-60,336,328,664,1389
50,-90,40,336,328,664,1389
90,-90,80,336,328,664,1389
-170,-10,130,326,338,664,1519
60,-90,50,336,328,664,1389
-160,-40,140,326,338,664,1374
-160,-90,-170,336,328,664,1389
110,-90,100,336,328,664,1389
30,60,-60,336,328,664,1389
70,-90,60,336,328,664,1389
-70,-90,-80,336,328,664,1389
100,-90,90,336,328,664,1389
-60,-90,-70,336,328,664,1389
40,-90,30,336,328,664,1389
30,-90,20,336,328,664,1389
140,0,130,330,335,665,1469
0,-20,-50,336,329,665,1494
120,20,150,325,340,665,1448
0,30,-20,336,329,665,1381
90,-40,80,332,333,665,1388
140,-70,120,333,332,665,1426
140,80,150,342,323,665,1234
40,0,-20,324,341,665,1496
60,70,-110,323,343,666,1249
50,20,0,339,327,666,1398
60,10,0,336,331,667,1328
-80,-40,-110,333,334,667,1306
150,-50,100,339,328,667,1385
-130,10,80,334,333,667,1209
-60,-20,-80,331,336,667,1309
150,-10,110,326,341,667,1234
50,-20,60,342,325,667,1491
140,-30,110,328,340,668,1370
-60,20,0,342,326,668,1375
100,20,-150,340,328,668,1350
-40,-60,-40,337,331,668,1494
-90,-70,-150,328,340,668,1317
-170,80,130,324,344,668,1436
130,60,150,327,342,669,1379
-180,-10,130,329,340,669,1467
-80,-40,-90,341,328,669,1420
-60,40,10,330,339,669,1374
-50,60,-20,331,338,669,1264
180,-10,130,329,340,669,1467
-90,70,50,342,328,670,1377
10,20,-20,343,327,670,1399
-30,-60,-30,335,335,670,1526
170,-10,130,331,339,670,1439
110,30,160,355,315,670,1269
-30,-30,-20,343,327,670,1383
-40,-40,-90,345,325,670,1442
-160,-30,120,330,341,671,1334
100,-70,90,341,330,671,1510
170,80,150,330,341,671,1414
180,50,90,331,340,671,1282
-110,80,70,336,335,671,1375
-180,50,90,331,340,671,1282
180,80,140,324,348,672,1436
-180,80,140,324,348,672,1436
20,10,-30,342,330,672,1534
-160,-40,130,329,343,672,1305
160,70,160,334,339,673,1453
-30,10,-10,342,331,673,1309
-80,-30,-90,343,330,673,1398
150,-40,120,331,342,673,1467
130,10,150,332,341,673,1520
110,60,-180,320,353,673,1338
110,60,180,320,353,673,1338
180,10,130,335,339,674,1441
0,-60,0,343,331,674,1495
-180,10,130,335,339,674,1441
0,80,-60,340,334,674,1296
-20,0,-10,341,333,674,1419
-170,40,80,352,322,674,1160
70,60,-110,334,340,674,1263
-130,10,70,341,333,674,1246
60,-10,80,350,324,674,1467
-100,70,60,338,337,675,1356
-10,10,-40,341,334,675,1483
20,10,0,348,327,675,1425
10,-60,10,336,339,675,1490
110,20,160,333,342,675,1295
150,10,140,330,345,675,1563
150,70,170,330,345,675,1436
180,-20,130,338,337,675,1545
-50,60,10,346,329,675,1371
20,-60,20,342,333,675,1479
100,60,-160,347,328,675,1406
50,10,-10,330,345,675,1446
-180,-20,130,338,337,675,1545
0,60,-30,345,331,676,1426
-130,-60,-170,351,325,676,1495
30,-60,30,349,327,676,1462
90,-40,60,344,332,676,1340
40,-20,50,353,323,676,1460
40,20,-10,341,335,676,1350
-150,-60,150,338,338,676,1330
-10,10,-10,339,337,676,1473
-150,20,110,327,349,676,1412
100,-60,90,341,335,676,1481
-160,10,120,337,339,676,1415
-70,-80,-80,339,337,676,1411
170,-40,130,338,338,676,1500
-120,80,80,339,338,677,1404
30,10,20,347,330,677,1437
180,-60,120,345,332,677,1271
-180,-60,120,345,332,677,1271
50,70,-100,326,351,677,1305
10,60,-40,351,326,677,1453
-20,30,-40,330,347,677,1358
50,20,10,336,341,677,1409
-70,-20,-50,344,334,678,1390
110,80,-140,343,335,678,1408
-90,30,30,330,348,678,1466
170,70,150,339,339,678,1475
-150,-60,170,349,330,679,1457
-90,80,20,334,345,679,1338
110,-80,100,345,334,679,1465
-160,-50,150,341,338,679,1422
70,-50,70,359,320,679,1509
160,80,160,334,345,679,1382
150,60,170,351,328,679,1519
60,-10,0,334,346,680,1472
40,60,-80,329,351,680,1287
-160,80,120,330,350,680,1441
-120,-80,-180,342,339,681,1270
30,-50,-30,341,340,681,1471
100,80,-130,344,337,681,1393
40,-20,-20,331,350,681,1446
-90,-50,-120,340,341,681,1457
-120,-80,180,342,339,681,1270
-150,30,110,349,333,682,1478
30,0,-30,333,349,682,1541
90,70,-150,347,335,682,1347
130,-50,110,344,338,682,1478
-40,30,0,349,334,683,1447
10,30,-30,342,341,683,1329
-170,-70,130,340,343,683,1261
30,70,-60,343,340,683,1440
-110,-80,-170,344,339,683,1307
160,-70,140,346,337,683,1504
120,20,-180,342,342,684,1310
120,20,180,342,342,684,1310
50,60,-80,354,330,684,1351
-20,-60,-20,339,345,684,1589
70,0,20,346,338,684,1415
100,50,-120,338,346,684,1480
-160,-60,160,353,331,684,1446
10,50,-50,349,335,684,1352
-110,70,70,340,345,685,1410
-100,-50,-140,341,344,685,1501
100,-40,80,341,344,685,1412
-10,-30,-60,342,343,685,1469
120,60,-150,338,347,685,1309
40,-30,-20,334,352,686,1465
70,-10,30,345,341,686,1386
70,80,-100,345,341,686,1377
0,50,-30,349,337,686,1478
120,10,160,342,344,686,1433
-10,30,-40,332,354,686,1419
80,-60,30,332,354,686,1213
30,-30,-30,326,360,686,1500
10,80,-70,338,349,687,1337
60,-60,60,350,337,687,1515
-60,60,20,347,340,687,1438
-40,50,0,355,332,687,1447
-130,80,90,343,345,688,1436
40,10,-20,346,342,688,1471
140,40,180,342,346,688,1413
-20,10,-10,351,337,688,1474
110,40,160,369,319,688,1435
90,80,-120,352,336,688,1403
60,80,-90,347,341,688,1384
140,40,-180,342,346,688,1413
40,70,-90,338,350,688,1337
-150,80,110,336,352,688,1417
170,-60,140,350,338,688,1458
120,-40,100,354,335,689,1480
-50,-30,-90,349,340,689,1523
160,70,120,340,349,689,1301
-180,30,130,345,344,689,1576
180,30,130,345,344,689,1576
150,-70,130,348,341,689,1457
30,-10,-30,343,346,689,1554
-170,-40,140,350,339,689,1483
60,80,-120,344,345,689,1334
-130,-80,170,346,344,690,1296
-50,-10,-20,352,338,690,1423
-10,60,-20,366,324,690,1433
70,60,-100,341,349,690,1340
40,70,-70,337,353,690,1428
-70,-20,-70,355,335,690,1403
-20,20,-10,359,331,690,1454
-120,10,60,347,343,690,1352
50,70,-80,337,353,690,1420
80,80,-110,353,337,690,1402
20,0,20,351,339,690,1465
-20,-20,-10,354,336,690,1445
-180,30,90,366,325,691,1300
100,-50,90,350,341,691,1490
10,50,-40,353,338,691,1460
70,-10,70,357,334,691,1508
-160,-10,100,343,348,691,1310
-140,-60,160,352,339,691,1385
-100,-70,-120,359,332,691,1427
180,30,90,366,325,691,1300
30,20,-10,352,340,692,1475
-110,20,50,350,342,692,1451
170,-50,110,346,346,692,1433
50,-20,-10,340,352,692,1462
30,20,0,365,327,692,1427
-140,80,100,338,354,692,1441
-170,-50,150,339,353,692,1542
10,20,-30,357,335,692,1448
-170,-10,100,344,348,692,1291
-80,-50,-130,346,346,692,1414
-80,-70,-140,333,359,692,1349
-80,20,10,350,342,692,1439
100,20,-160,344,349,693,1436
-90,-80,-150,347,346,693,1326
60,0,70,352,341,693,1375
40,0,40,355,338,693,1542
20,80,-80,345,348,693,1389
10,40,-30,349,345,694,1421
30,-20,-30,346,348,694,1431
170,-30,130,355,339,694,1512
-140,-80,160,352,342,694,1313
-70,10,-10,347,348,695,1435
0,40,-20,362,333,695,1526
90,50,-140,339,356,695,1332
-90,20,20,350,346,696,1503
-140,30,100,353,343,696,1351
-100,-80,-160,349,347,696,1316
-20,30,-10,352,344,696,1413
-180,-10,100,344,352,696,1250
130,10,140,341,355,696,1555
180,-10,100,344,352,696,1250
-50,30,-30,351,345,696,1430
-80,-60,-90,363,333,696,1587
60,70,-90,344,352,696,1385
80,-30,40,342,355,697,1380
-130,70,50,339,358,697,1468
-140,70,100,355,342,697,1499
-180,60,140,358,339,697,1587
180,-70,120,347,350,697,1321
-180,-70,120,347,350,697,1321
180,60,140,358,339,697,1587
-50,-60,-50,358,339,697,1516
120,-80,110,352,345,697,1526
40,-30,50,360,338,698,1502
-70,0,-20,353,345,698,1426
-50,-20,-80,351,347,698,1508
40,20,10,358,340,698,1434
-30,-20,-70,342,357,699,1454
-180,70,140,353,346,699,1482
120,30,-160,358,341,699,1509
50,-10,70,363,336,699,1539
180,70,140,353,346,699,1482
-40,-10,-60,346,353,699,1519
-90,-60,-110,355,344,699,1581
50,80,-110,352,348,700,1360
-70,0,-30,342,358,700,1398
-70,60,30,351,349,700,1518
160,-50,130,358,342,700,1548
-60,-30,-40,355,345,700,1461
50,20,-10,368,332,700,1450
-50,-40,-40,351,349,700,1466
-130,70,90,357,343,700,1460
-50,20,0,357,343,700,1469
-130,10,90,346,354,700,1401
70,0,30,351,349,700,1365
40,10,30,358,342,700,1506
-10,-60,-10,359,341,700,1606
100,10,170,354,347,701,1327
120,70,-150,356,345,701,1363
-60,-40,-50,352,349,701,1442
50,80,-80,353,348,701,1414
160,60,160,367,334,701,1571
-30,30,-40,343,359,702,1348
120,-40,90,370,332,702,1425
140,-20,120,366,336,702,1542
100,30,-130,355,347,702,1357
120,80,-150,358,344,702,1450
130,50,140,351,351,702,1356
60,-30,70,360,342,702,1556
-40,-20,-20,361,342,703,1464
-150,70,110,351,352,703,1501
-140,40,100,359,344,703,1463
-80,60,40,343,360,703,1519
140,-60,120,346,357,703,1525
-40,-40,-30,364,339,703,1494
-40,40,0,351,353,704,1505
50,-30,60,364,340,704,1553
-10,20,-40,354,350,704,1533
-70,40,20,358,346,704,1508
150,50,170,349,355,704,1521
20,-50,-40,350,354,704,1485
80,-30,80,364,341,705,1530
20,20,-20,357,348,705,1523
170,60,150,372,333,705,1580
-120,70,80,354,351,705,1431
40,-50,-20,355,350,705,1495
-150,-50,150,367,338,705,1450
-10,50,-20,364,341,705,1523
-130,20,90,352,354,706,1449
-80,-80,-90,351,355,706,1465
120,40,-150,355,351,706,1452
-50,0,-50,342,364,706,1491
10,0,-40,336,370,706,1539
0,50,-50,351,355,706,1361
0,-10,-50,349,357,706,1572
-170,70,130,354,352,706,1493
150,-10,130,356,350,706,1512
110,-40,90,365,342,707,1462
-150,-20,130,338,369,707,1547
10,20,-10,361,346,707,1526
-70,-10,-40,360,347,707,1389
20,70,-50,360,347,707,1476
40,20,-20,358,349,707,1551
-50,70,-20,343,365,708,1395
20,50,-50,351,357,708,1486
130,-80,120,363,345,708,1563
50,60,-90,359,349,708,1396
-100,40,50,351,357,708,1559
-30,0,-10,367,341,708,1475
-50,10,-40,354,354,708,1400
-110,-70,-130,361,347,708,1497
20,10,10,362,347,709,1526
70,-20,80,379,330,709,1565
-70,-20,-40,359,350,709,1460
-170,0,130,351,358,709,1534
100,20,170,342,367,709,1278
10,70,-40,366,343,709,1467
110,-70,100,360,349,709,1561
-80,40,30,351,359,710,1577
-80,80,10,349,361,710,1433
180,20,130,351,359,710,1526
0,70,-30,368,342,710,1406
70,-60,70,368,342,710,1619
-180,20,130,351,359,710,1526
20,60,-70,345,365,710,1353
-170,10,90,363,347,710,1334
10,30,-20,363,347,710,1493
60,-20,0,350,361,711,1554
40,-10,50,367,344,711,1577
-160,50,120,354,357,711,1500
130,80,160,361,350,711,1362
160,20,140,353,358,711,1647
170,-70,150,360,351,711,1531
-70,10,-20,354,357,711,1344
-70,-20,-80,361,351,712,1459
110,10,160,344,368,712,1486
20,20,-30,363,349,712,1513
30,80,-90,355,357,712,1417
130,20,170,350,362,712,1493
40,80,-70,357,355,712,1409
-150,-30,130,345,367,712,1444
30,-10,40,365,348,713,1572
10,40,-40,365,348,713,1475
10,-50,-50,353,360,713,1498
0,20,-10,359,354,713,1543
130,10,160,365,348,713,1566
-150,-80,150,357,356,713,1337
-80,-80,-140,354,359,713,1394
-20,40,-10,367,347,714,1483
30,80,-60,360,354,714,1427
-130,-60,170,355,359,714,1463
-160,60,120,362,352,714,1517
-70,-70,-130,346,369,715,1393
60,60,-100,366,349,715,1362
70,-40,20,354,361,715,1516
-120,-60,180,363,352,715,1448
-160,70,120,353,362,715,1501
-110,30,60,351,364,715,1423
40,80,-100,364,351,715,1399
-110,-60,-170,360,355,715,1523
-90,-50,-110,357,358,715,1580
-120,-60,-180,363,352,715,1448
130,-40,110,365,350,715,1534
-10,-60,-70,351,364,715,1418
100,50,-170,355,360,715,1450
-40,50,-30,344,372,716,1364
-70,-10,-30,363,353,716,1413
0,0,0,357,359,716,1603
-150,-10,120,336,380,716,1553
-10,20,-10,367,349,716,1529
80,60,-100,368,348,716,1535
90,50,-110,365,351,716,1517
130,-20,110,370,346,716,1538
130,50,-160,362,355,717,1503
170,10,100,362,355,717,1258
70,-10,20,360,357,717,1515
180,-40,140,369,348,717,1587
-180,-40,140,369,348,717,1587
10,80,-40,365,353,718,1430
-50,-10,-60,365,353,718,1537
-10,30,-10,364,354,718,1543
140,10,150,352,366,718,1663
130,0,130,364,355,719,1602
-80,-40,-120,371,348,719,1397
-100,60,20,351,368,719,1479
80,50,-110,353,366,719,1452
100,40,-120,357,362,719,1412
0,-60,-60,363,357,720,1424
-70,-20,-60,361,359,720,1426
0,30,-40,368,352,720,1480
30,-30,40,368,352,720,1555
10,40,-20,369,351,720,1590
140,30,170,351,369,720,1492
-40,0,-10,364,356,720,1437
150,-30,120,358,362,720,1578
-60,-20,-30,371,349,720,1580
30,10,-30,362,359,721,1600
-170,60,130,363,358,721,1564
90,60,-110,362,359,721,1559
130,-30,110,367,354,721,1547
-60,-60,-60,376,345,721,1541
-150,-30,140,359,362,721,1478
70,0,50,369,352,721,1490
60,-20,80,368,353,721,1645
80,-50,80,372,350,722,1615
40,-70,40,365,357,722,1586
130,80,-160,365,357,722,1505
-170,-40,120,369,353,722,1418
-80,-70,-90,364,358,722,1506
20,80,-50,361,361,722,1438
-20,-60,-80,355,367,722,1399
20,20,-10,370,352,722,1540
-120,10,70,354,368,722,1378
-120,10,50,365,358,723,1426
30,-20,40,368,355,723,1583
-90,-80,-100,359,364,723,1515
0,70,-60,356,367,723,1424
20,-70,20,372,351,723,1604
-20,-30,-10,361,362,723,1542
-160,20,120,351,372,723,1547
-10,-70,-10,368,356,724,1603
10,10,0,360,364,724,1586
170,-20,130,375,349,724,1626
50,-70,50,375,349,724,1591
130,30,-170,368,356,724,1412
30,-70,30,363,361,724,1608
60,60,-90,367,357,724,1387
140,-80,130,369,355,724,1614
-130,60,90,366,358,724,1466
140,0,120,362,362,724,1457
-10,80,-20,369,355,724,1376
20,-20,30,375,350,725,1597
50,-30,-10,365,360,725,1581
0,-70,0,363,362,725,1631
-80,50,0,352,373,725,1430
-70,-30,-100,368,357,725,1482
140,20,160,368,357,725,1594
-70,-80,-130,357,368,725,1418
-60,-70,-120,368,358,726,1389
10,0,10,373,353,726,1540
50,-40,60,378,348,726,1621
170,20,100,366,360,726,1329
-150,40,110,359,367,726,1498
-150,20,70,367,359,726,1383
130,0,140,365,362,727,1604
30,20,-20,374,353,727,1553
-150,60,110,371,357,728,1527
-150,50,110,369,359,728,1443
110,30,-140,367,361,728,1499
150,70,130,350,378,728,1404
140,-50,120,367,362,729,1626
10,50,-30,376,353,729,1609
-20,60,-10,386,343,729,1466
50,0,60,368,361,729,1559
-110,-60,-140,367,362,729,1540
-160,-30,140,367,362,729,1581
110,-30,100,383,346,729,1638
50,10,-20,355,374,729,1694
-70,20,10,370,359,729,1612
-10,70,-20,379,350,729,1400
180,-70,160,367,363,730,1576
40,-40,50,373,357,730,1563
70,60,-90,376,354,730,1561
60,0,-10,355,375,730,1508
60,20,10,367,363,730,1469
120,10,170,367,363,730,1526
-180,-70,160,367,363,730,1576
20,40,-40,376,355,731,1568
-140,60,100,363,368,731,1507
120,50,150,375,356,731,1419
80,50,-100,370,361,731,1596
0,80,-30,370,361,731,1404
-60,30,10,365,366,731,1547
-150,-40,140,368,364,732,1461
50,0,-20,369,363,732,1574
-90,-50,-140,366,366,732,1508
110,50,-130,361,371,732,1534
140,-10,130,362,370,732,1682
60,-10,90,379,354,733,1521
-50,-30,-30,373,360,733,1511
-160,-80,140,377,356,733,1415
10,-70,10,372,361,733,1604
130,-10,120,361,372,733,1579
80,-40,80,367,366,733,1543
30,30,-20,378,356,734,1551
20,-70,-40,361,373,734,1480
100,60,-120,372,362,734,1518
70,-30,80,381,353,734,1594
100,-40,90,383,351,734,1535
20,-20,-40,369,365,734,1609
-30,-40,-20,369,365,734,1605
110,-50,100,367,367,734,1595
60,10,40,372,362,734,1432
-70,-50,-70,376,358,734,1555
-90,60,50,365,369,734,1514
-140,50,100,365,369,734,1512
-30,-10,-60,360,374,734,1627
-130,40,90,358,377,735,1538
80,-60,80,383,352,735,1716
0,20,-40,372,363,735,1618
90,-20,100,373,362,735,1535
-80,-30,-80,373,363,736,1522
0,10,-40,362,374,736,1666
170,30,140,364,372,736,1756
150,-60,130,367,370,737,1655
90,40,-120,370,367,737,1416
110,-60,100,367,370,737,1646
-50,0,-10,373,364,737,1539
160,10,140,363,374,737,1614
-70,80,0,357,381,738,1499
20,40,-20,366,372,738,1657
-10,0,-50,354,384,738,1593
100,30,170,387,352,739,1413
10,-70,-50,370,369,739,1460
-120,60,80,364,375,739,1498
180,-60,150,377,362,739,1618
-160,30,120,377,362,739,1629
-180,-60,150,377,362,739,1618
90,40,-140,365,374,739,1453
-170,50,130,363,377,740,1593
-150,-50,160,389,351,740,1592
130,-60,80,389,351,740,1544
120,-50,80,385,355,740,1547
-80,-30,-70,362,378,740,1580
160,50,160,359,381,740,1633
-60,-40,-110,372,368,740,1523
-40,20,-40,370,370,740,1413
-100,60,60,367,374,741,1519
-140,0,110,384,357,741,1510
130,-20,120,390,351,741,1645
170,-50,140,382,359,741,1627
20,30,-20,377,364,741,1534
150,20,150,370,371,741,1672
120,10,150,359,382,741,1582
120,-30,100,387,355,742,1574
-100,-60,-160,368,374,742,1584
-80,-30,-100,375,367,742,1467
130,60,-160,378,364,742,1458
140,0,140,370,372,742,1709
50,-40,-10,358,384,742,1618
80,-20,90,389,353,742,1570
-70,-30,-50,381,361,742,1510
-60,-80,-120,368,374,742,1441
20,20,0,379,364,743,1548
-160,-10,130,362,381,743,1612
-60,0,-10,379,364,743,1629
-20,80,-10,375,368,743,1404
120,80,170,377,366,743,1454
-60,40,-20,372,372,744,1392
-170,-60,160,378,366,744,1647
170,50,150,372,372,744,1644
-60,-60,-120,375,369,744,1528
170,-60,110,377,367,744,1417
150,-80,140,377,367,744,1642
20,-40,-40,367,377,744,1643
-170,-80,130,378,367,745,1427
-30,-10,-10,381,364,745,1517
80,60,-130,372,373,745,1504
70,0,10,373,372,745,1582
90,30,-160,365,380,745,1366
-170,10,130,369,376,745,1570
-170,-70,170,380,365,745,1597
130,70,-160,372,373,745,1499
60,60,-80,376,369,745,1635
30,-60,-30,380,365,745,1512
10,30,-10,376,370,746,1636
-40,60,-30,361,385,746,1393
-60,-30,-100,376,370,746,1583
0,30,-10,371,375,746,1639
-50,50,10,376,370,746,1561
40,-40,-20,359,387,746,1640
-80,-40,-80,384,362,746,1602
130,-40,90,383,363,746,1497
20,-30,-40,358,388,746,1655
-20,70,-10,386,361,747,1459
80,70,-100,375,372,747,1598
120,-70,110,380,367,747,1672
110,40,-130,371,377,748,1554
160,-20,130,378,370,748,1705
-20,-70,-20,381,367,748,1663
130,-30,100,374,374,748,1476
90,-30,80,375,373,748,1597
-40,20,0,383,365,748,1570
-30,-50,-90,379,369,748,1518
80,-20,50,394,354,748,1452
30,-40,-30,360,389,749,1655
30,40,-20,389,360,749,1669
-20,50,-10,390,360,750,1575
-30,80,0,377,373,750,1432
110,70,180,372,378,750,1499
-120,70,40,367,383,750,1511
20,40,-30,382,368,750,1542
70,-30,20,379,371,750,1617
110,70,-180,372,378,750,1499
-120,-70,-140,377,373,750,1538
30,50,-60,381,370,751,1605
150,30,160,373,378,751,1736
-70,-10,-50,369,382,751,1440
-140,10,70,378,373,751,1358
20,-60,-40,375,376,751,1543
30,20,10,392,359,751,1516
20,50,-40,392,360,752,1648
-110,60,70,374,378,752,1482
30,50,-50,384,368,752,1699
-30,70,0,394,358,752,1474
-30,-60,-90,371,381,752,1478
140,80,-170,379,374,753,1597
70,0,40,375,378,753,1454
-160,40,120,373,380,753,1582
50,60,-70,381,372,753,1668
150,40,170,361,392,753,1617
90,-50,90,383,370,753,1635
10,-60,-50,377,376,753,1485
-50,-70,-110,380,373,753,1445
-90,90,60,379,375,754,1526
30,90,-60,379,375,754,1526
180,90,150,379,375,754,1526
90,90,-120,379,375,754,1526
-110,90,80,379,375,754,1526
70,90,-100,379,375,754,1526
-10,90,-20,379,375,754,1526
0,90,-30,379,375,754,1526
50,90,-80,379,375,754,1526
-60,90,30,379,375,754,1526
-170,90,140,379,375,754,1526
140,90,-170,379,375,754,1526
110,90,-140,379,375,754,1526
-40,70,-30,371,383,754,1539
-30,90,0,379,375,754,1526
-90,-70,-100,379,375,754,1602
-70,90,40,379,375,754,1526
40,90,-70,379,375,754,1526
80,90,-110,379,375,754,1526
170,90,160,379,375,754,1526
-180,90,150,379,375,754,1526
-120,90,90,379,375,754,1526
120,90,-150,379,375,754,1526
20,-30,30,393,361,754,1679
-100,90,70,379,375,754,1526
140,-30,100,371,383,754,1510
130,90,-160,379,375,754,1526
100,90,-130,379,375,754,1526
-130,30,90,372,382,754,1541
10,90,-40,379,375,754,1526
60,90,-90,379,375,754,1526
-50,90,20,379,375,754,1526
-130,90,100,379,375,754,1526
-160,90,130,379,375,754,1526
-80,90,50,379,375,754,1526
150,90,180,379,375,754,1526
20,90,-50,379,375,754,1526
50,0,70,387,367,754,1524
-40,90,10,379,375,754,1526
-20,90,-10,379,375,754,1526
-110,-50,-150,371,383,754,1619
150,90,-180,379,375,754,1526
-150,90,120,379,375,754,1526
160,90,170,379,375,754,1526
-150,-40,150,381,373,754,1651
-140,90,110,379,375,754,1526
-40,70,10,399,356,755,1564
110,20,-160,382,373,755,1673
100,-30,100,388,367,755,1642
60,-70,60,389,366,755,1628
30,-40,40,381,374,755,1667
-100,-50,-150,379,376,755,1583
-140,-50,160,401,355,756,1617
90,-20,110,392,364,756,1621
40,-60,-20,375,381,756,1582
20,-10,30,395,361,756,1635
-30,-70,-30,384,372,756,1686
-40,80,10,377,379,756,1495
160,-40,130,385,371,756,1675
100,-20,110,392,364,756,1615
10,30,-40,377,380,757,1645
-50,-80,-110,380,377,757,1433
60,-40,70,397,360,757,1717
0,-70,-60,372,385,757,1503
90,40,-130,380,377,757,1385
-10,40,-10,389,368,757,1640
-70,-40,-60,385,372,757,1598
70,-20,90,395,362,757,1613
70,70,-90,386,371,757,1644
50,20,-20,380,377,757,1610
20,50,-60,382,375,757,1518
110,90,180,377,381,758,1612
110,90,-180,377,381,758,1612
-100,90,30,377,381,758,1612
180,90,110,377,381,758,1612
-40,90,-30,377,381,758,1612
-10,90,-60,377,381,758,1612
40,90,-110,377,381,758,1612
130,90,160,377,381,758,1612
-60,90,-10,377,381,758,1612
70,90,-140,377,381,758,1612
-100,-60,-120,384,374,758,1727
-170,90,100,377,381,758,1612
-140,90,70,377,381,758,1612
-20,90,-50,377,381,758,1612
-160,90,90,377,381,758,1612
150,90,140,377,381,758,1612
-150,90,80,377,381,758,1612
20,90,-90,377,381,758,1612
160,-80,150,386,372,758,1686
-30,90,-40,377,381,758,1612
-130,90,60,377,381,758,1612
-180,90,110,377,381,758,1612
80,90,-150,377,381,758,1612
120,90,170,377,381,758,1612
-50,90,-20,377,381,758,1612
170,90,120,377,381,758,1612
-120,90,50,377,381,758,1612
-20,-30,-70,384,374,758,1638
10,90,-80,377,381,758,1612
-70,90,0,377,381,758,1612
100,90,-170,377,381,758,1612
60,90,-130,377,381,758,1612
-80,90,10,377,381,758,1612
-90,90,20,377,381,758,1612
160,90,130,377,381,758,1612
50,90,-120,377,381,758,1612
-110,90,40,377,381,758,1612
90,90,-160,377,381,758,1612
140,90,150,377,381,758,1612
30,90,-100,377,381,758,1612
0,90,-70,377,381,758,1612
-50,80,20,385,374,759,1565
70,-10,90,405,354,759,1562
30,-70,-30,378,381,759,1507
170,-80,160,385,374,759,1686
-100,-80,-110,374,385,759,1561
-20,-40,-10,387,372,759,1708
50,20,20,389,370,759,1520
90,70,-110,385,374,759,1583
20,-10,-40,368,392,760,1725
40,0,-30,369,391,760,1679
-70,50,-10,375,385,760,1434
40,10,-30,375,385,760,1673
-150,-70,-170,394,366,760,1653
-160,-40,150,377,384,761,1720
60,50,-80,373,388,761,1621
110,-40,100,399,362,761,1630
-10,-20,0,393,368,761,1665
90,-30,90,390,371,761,1652
120,60,160,374,387,761,1570
-90,40,40,382,379,761,1627
-170,50,80,386,376,762,1441
-70,-60,-130,382,380,762,1529
160,30,150,377,385,762,1808
-50,-70,-50,396,366,762,1683
-60,80,-10,373,389,762,1568
0,50,-20,381,381,762,1655
120,-20,110,389,373,762,1634
-10,-10,0,384,378,762,1719
-150,-10,100,373,389,762,1520
20,-40,30,392,371,763,1668
-130,50,90,375,388,763,1588
20,30,-30,387,376,763,1528
-80,-60,-140,385,379,764,1567
-60,-10,-20,397,367,764,1659
30,60,-80,379,385,764,1480
-100,-50,-130,381,384,765,1697
-40,-70,-40,395,370,765,1677
-50,40,10,387,378,765,1647
30,20,-30,381,384,765,1651
30,40,-30,390,375,765,1686
40,30,-20,391,375,766,1546
50,-20,70,394,372,766,1726
-40,-50,-30,392,374,766,1666
110,-20,110,393,373,766,1652
90,-40,90,387,379,766,1625
70,-70,70,390,376,766,1722
80,-10,110,390,376,766,1606
-30,10,-50,387,379,766,1669
100,20,-140,384,383,767,1434
170,-70,110,392,375,767,1463
-60,50,20,383,384,767,1648
180,50,140,381,386,767,1669
-180,50,140,381,386,767,1669
-40,-80,-100,385,382,767,1471
-180,-80,170,385,382,767,1687
180,-80,170,385,382,767,1687
110,10,-180,365,402,767,1637
110,10,180,365,402,767,1637
-170,-80,180,388,379,767,1682
-170,-80,-180,388,379,767,1682
130,-70,120,395,373,768,1727
-160,-50,130,386,382,768,1483
120,-30,110,394,374,768,1670
-50,80,-20,386,382,768,1599
-160,-70,180,387,381,768,1627
-160,-70,-180,387,381,768,1627
80,-20,100,398,370,768,1658
-120,-60,-150,396,372,768,1601
80,-20,60,408,361,769,1533
-140,20,60,395,374,769,1399
10,-40,-50,379,390,769,1651
60,20,0,388,381,769,1658
120,0,140,380,389,769,1730
-10,-30,0,393,376,769,1725
180,-80,120,394,376,770,1469
70,10,10,379,391,770,1515
-180,-80,120,394,376,770,1469
60,10,-10,386,384,770,1615
20,30,-10,397,373,770,1613
-170,-30,140,392,378,770,1735
140,-30,120,389,381,770,1712
0,-50,-60,383,388,771,1586
70,-20,20,390,381,771,1624
-140,-70,-160,394,377,771,1662
100,70,-120,394,377,771,1609
140,-40,120,388,383,771,1633
-70,20,-20,389,382,771,1506
-10,-70,-70,381,390,771,1569
160,-30,130,395,377,772,1722
150,0,140,393,379,772,1762
-130,-70,-150,400,372,772,1614
20,0,-40,375,397,772,1710
140,-50,90,396,376,772,1492
50,-50,-10,374,398,772,1597
-60,80,30,387,385,772,1618
-150,0,90,386,387,773,1539
-30,30,0,390,383,773,1638
120,20,-170,381,392,773,1480
150,80,180,381,393,774,1640
150,80,-180,381,393,774,1640
-110,-80,-120,387,387,774,1603
40,60,-60,390,384,774,1722
140,30,180,367,407,774,1691
-110,-50,-160,391,383,774,1639
-170,40,130,384,390,774,1731
80,-30,90,401,373,774,1723
30,60,-50,390,384,774,1718
140,30,-180,367,407,774,1691
70,-10,10,387,387,774,1705
140,-10,110,383,392,775,1489
70,-10,80,407,368,775,1580
-50,-50,-40,395,380,775,1653
90,60,-150,384,391,775,1550
100,10,180,366,409,775,1527
60,10,50,390,385,775,1590
120,10,140,392,383,775,1640
-80,50,40,388,387,775,1663
100,10,-180,366,409,775,1527
110,60,-130,383,392,775,1594
30,40,-40,394,382,776,1701
10,40,-50,395,382,777,1586
-20,10,-50,391,386,777,1742
130,10,130,382,395,777,1557
0,-10,10,395,382,777,1749
-70,50,30,390,387,777,1668
-10,-50,-70,391,387,778,1631
60,70,-80,392,386,778,1677
120,-60,110,390,388,778,1755
-30,60,0,410,368,778,1622
80,-20,80,411,367,778,1642
-140,-50,170,392,386,778,1719
160,-40,100,398,381,779,1473
-160,-50,160,399,380,779,1718
10,20,-40,391,388,779,1724
80,-10,100,406,373,779,1634
-30,40,0,389,390,779,1647
170,-80,110,400,379,779,1548
100,50,180,374,406,780,1457
100,50,-180,374,406,780,1457
-70,-60,-70,403,377,780,1681
-90,-60,-150,387,393,780,1552
-50,-60,-110,390,390,780,1583
110,10,150,375,405,780,1699
-70,30,20,392,388,780,1724
80,-50,30,373,407,780,1494
-150,0,120,389,391,780,1669
70,10,30,388,393,781,1538
-70,10,0,391,390,781,1665
-20,-70,-80,379,402,781,1586
140,50,-170,402,379,781,1664
110,-30,110,404,377,781,1660
130,-10,130,392,389,781,1789
20,10,20,397,384,781,1699
10,70,-70,384,398,782,1646
60,0,80,412,370,782,1653
20,40,-50,390,392,782,1659
130,20,180,390,392,782,1617
40,50,-60,395,387,782,1729
0,-20,10,394,388,782,1754
130,20,-180,390,392,782,1617
70,-40,80,404,379,783,1672
40,-50,50,401,382,783,1695
60,-20,90,403,380,783,1731
-130,10,60,385,398,783,1432
10,10,-40,390,393,783,1786
70,50,-90,385,398,783,1663
100,-30,90,402,381,783,1649
-90,-40,-110,412,372,784,1614
-140,10,110,385,399,784,1709
-30,-80,-90,399,385,784,1530
0,-80,0,399,385,784,1711
-150,-80,-160,399,385,784,1694
160,80,170,382,402,784,1680
-70,80,40,391,393,784,1651
10,-80,10,397,387,784,1729
-160,-80,-170,404,380,784,1677
-50,-20,-20,398,387,785,1695
-50,-10,-70,390,395,785,1694
100,-40,70,408,377,785,1731
120,0,150,395,390,785,1761
30,50,-40,409,376,785,1743
120,50,-140,401,384,785,1701
140,70,140,376,409,785,1591
10,-20,20,399,386,785,1696
-10,0,0,392,394,786,1732
150,-30,100,380,406,786,1473
40,20,20,402,384,786,1575
-170,-30,110,392,394,786,1452
10,-30,20,412,374,786,1756
-130,-60,-160,405,381,786,1682
20,40,-10,406,380,786,1736
30,30,-10,400,386,786,1625
-120,-80,-130,394,392,786,1613
-110,20,60,388,398,786,1611
130,40,-160,402,385,787,1645
110,-40,80,409,379,788,1710
-20,-50,-80,398,390,788,1663
150,70,180,393,395,788,1751
-30,50,0,409,379,788,1670
50,10,40,404,384,788,1613
-150,-50,140,404,384,788,1500
150,70,-180,393,395,788,1751
-100,20,40,396,392,788,1627
10,-40,20,398,390,788,1760
90,30,-170,393,395,788,1398
-120,50,80,402,386,788,1663
-50,70,20,408,380,788,1682
50,50,-70,391,398,789,1700
160,0,140,394,395,789,1792
50,30,-20,402,387,789,1656
20,-80,20,405,384,789,1714
10,60,-30,403,386,789,1761
140,70,-170,391,398,789,1643
170,10,140,381,408,789,1757
20,60,-40,399,390,789,1701
90,-60,40,375,415,790,1601
-30,-20,-10,401,389,790,1631
70,0,60,409,381,790,1653
-40,-30,-20,401,389,790,1696
-140,-80,-150,404,386,790,1664
40,40,-40,399,392,791,1756
-60,20,-30,401,390,791,1649
-80,-50,-80,405,386,791,1725
30,-80,30,406,385,791,1729
20,50,-30,396,395,791,1774
90,-60,90,405,386,791,1825
-160,-60,170,403,388,791,1662
170,0,100,390,401,791,1483
60,20,20,389,402,791,1551
-120,30,80,392,399,791,1731
150,-20,130,401,391,792,1763
40,50,-70,394,398,792,1627
10,-10,20,412,380,792,1666
40,30,-30,399,393,792,1672
-10,-80,-10,402,390,792,1706
40,20,-30,393,399,792,1707
120,0,130,399,393,792,1656
140,60,-170,398,394,792,1694
-60,-70,-60,406,386,792,1707
0,-30,10,404,388,792,1834
170,80,160,391,401,792,1733
-100,30,50,401,391,792,1665
170,20,140,395,397,792,1809
-130,-80,-140,399,393,792,1611
160,40,160,392,401,793,1728
-130,-50,170,396,397,793,1729
30,30,-30,394,399,793,1679
-90,-60,-100,399,394,793,1833
-80,80,50,397,397,794,1678
-40,-60,-100,393,401,794,1605
10,40,-10,403,391,794,1793
120,-40,110,406,388,794,1698
90,-30,70,414,380,794,1688
0,40,-50,393,401,794,1604
-170,-50,120,407,387,794,1629
70,-10,100,416,378,794,1570
-90,-40,-100,404,390,794,1738
-170,20,130,402,392,794,1677
-20,-80,-20,402,393,795,1760
50,-60,-10,407,388,795,1690
-30,-50,-20,407,388,795,1745
110,-50,70,404,391,795,1691
50,-50,60,417,378,795,1721
50,-80,50,403,392,795,1737
110,0,150,393,402,795,1710
-120,40,80,389,406,795,1670
90,20,-170,404,391,795,1563
90,20,-160,393,402,795,1557
-140,0,90,399,396,795,1638
40,-80,40,402,393,795,1722
160,70,170,398,398,796,1810
-180,40,140,389,407,796,1757
140,-70,130,412,384,796,1784
150,60,180,408,388,796,1766
180,40,140,389,407,796,1757
-20,-80,-80,402,394,796,1557
150,60,-180,408,388,796,1766
0,40,-10,407,389,796,1745
40,40,-30,395,401,796,1742
-80,-30,-110,394,403,797,1668
160,-60,140,395,402,797,1783
40,30,-10,405,392,797,1623
90,-20,120,415,382,797,1668
-120,-50,-170,403,394,797,1745
120,0,160,401,396,797,1699
-150,-20,110,388,409,797,1468
110,-30,90,397,401,798,1673
170,40,150,396,402,798,1764
30,10,30,408,390,798,1718
-170,30,130,396,402,798,1795
-150,10,120,402,396,798,1749
30,-50,40,410,388,798,1776
110,20,-150,414,384,798,1743
-80,30,30,405,393,798,1763
-70,70,40,398,400,798,1790
110,80,-180,401,398,799,1613
110,80,180,401,398,799,1613
120,-10,130,412,387,799,1814
60,-30,0,391,408,799,1739
-60,10,0,402,398,800,1676
-10,-80,-70,399,401,800,1566
100,10,160,390,410,800,1658
50,50,-80,400,400,800,1586
110,-20,100,406,394,800,1707
0,-40,-60,392,408,800,1670
-40,-70,-100,403,397,800,1535
70,10,0,397,404,801,1614
-90,80,60,393,408,801,1712
110,70,-130,410,391,801,1671
0,-80,-60,399,402,801,1601
20,0,30,412,389,801,1738
80,80,-100,411,391,802,1674
-150,-60,-180,407,395,802,1703
-150,-60,180,407,395,802,1703
20,70,-40,410,392,802,1794
-100,-70,-110,406,396,802,1708
150,0,110,399,403,802,1609
50,-10,80,417,385,802,1683
-70,0,-10,402,400,802,1696
110,-20,120,403,399,802,1772
100,-20,100,404,398,802,1711
10,20,0,415,387,802,1699
80,-20,110,404,398,802,1682
-130,-90,170,404,399,803,1568
70,10,20,397,406,803,1619
110,-90,50,404,399,803,1568
20,-50,30,407,396,803,1809
10,-90,-50,404,399,803,1568
-30,-90,-90,404,399,803,1568
-50,-90,-110,404,399,803,1568
-80,-90,-140,404,399,803,1568
140,-90,80,404,399,803,1568
120,-10,120,402,401,803,1707
70,-90,10,404,399,803,1568
-170,-90,130,404,399,803,1568
-40,-90,-100,404,399,803,1568
170,-90,110,404,399,803,1568
180,-90,120,404,399,803,1568
90,40,-160,406,397,803,1527
50,-90,-10,404,399,803,1568
130,-90,70,404,399,803,1568
20,-90,-40,404,399,803,1568
90,-30,100,418,385,803,1700
-160,-90,140,404,399,803,1568
-150,-90,150,404,399,803,1568
50,30,-30,409,394,803,1662
-140,-90,160,404,399,803,1568
-120,-90,-180,404,399,803,1568
120,-90,60,404,399,803,1568
-100,-90,-160,404,399,803,1568
40,-90,-20,404,399,803,1568
150,-90,90,404,399,803,1568
-90,-90,-150,404,399,803,1568
-30,20,0,400,403,803,1697
50,70,-70,410,393,803,1727
30,-90,-30,404,399,803,1568
160,-90,100,404,399,803,1568
-60,-10,-60,399,404,803,1702
0,-90,-60,404,399,803,1568
-20,-90,-80,404,399,803,1568
-70,-90,-130,404,399,803,1568
-120,-90,180,404,399,803,1568
-110,-90,-170,404,399,803,1568
-180,-90,120,404,399,803,1568
90,-90,30,404,399,803,1568
-10,-90,-70,404,399,803,1568
-60,-90,-120,404,399,803,1568
100,-90,40,404,399,803,1568
-160,40,70,414,389,803,1485
40,-10,-30,396,407,803,1865
80,-90,20,404,399,803,1568
60,-90,0,404,399,803,1568
120,-50,110,400,404,804,1729
130,-60,120,407,397,804,1835
80,-70,80,412,392,804,1827
-90,-40,-120,414,390,804,1640
20,10,-40,395,409,804,1799
120,-20,120,410,395,805,1784
-80,20,-10,396,409,805,1672
-140,-60,-170,418,387,805,1707
-20,20,0,406,400,806,1833
20,30,-40,400,406,806,1706
60,-50,70,422,384,806,1857
-20,-50,-10,412,394,806,1798
50,20,-30,403,403,806,1774
0,10,0,407,399,806,1790
140,10,120,405,401,806,1532
-90,-50,-100,407,399,806,1712
180,-40,110,400,407,807,1606
-60,-10,-70,403,404,807,1738
-180,-40,110,400,407,807,1606
140,40,-170,409,398,807,1669
-40,-20,-80,398,409,807,1801
130,0,150,406,401,807,1852
70,50,-100,395,412,807,1638
-30,70,-40,397,410,807,1723
-40,-50,-100,397,410,807,1660
20,20,10,417,390,807,1716
-20,10,0,412,395,807,1780
40,50,-50,411,396,807,1812
-110,10,40,414,394,808,1697
0,60,-60,407,401,808,1506
100,-40,100,415,393,808,1780
40,-70,-20,400,408,808,1600
180,-50,150,412,396,808,1781
-180,-50,150,412,396,808,1781
160,-60,100,415,393,808,1566
60,-80,60,409,400,809,1767
-10,-40,0,408,401,809,1824
40,70,-60,412,397,809,1785
40,40,-20,423,386,809,1791
-30,-70,-90,397,412,809,1589
-60,70,30,410,399,809,1747
-30,40,-40,411,398,809,1559
60,50,-90,397,412,809,1655
-100,80,70,398,412,810,1769
-180,80,150,393,417,810,1758
80,70,-140,402,408,810,1646
-50,30,10,414,396,810,1758
180,80,150,393,417,810,1758
0,-40,10,410,400,810,1906
140,10,160,413,398,811,1752
-100,10,20,408,403,811,1661
150,50,-180,417,394,811,1708
150,50,180,417,394,811,1708
100,60,-170,384,427,811,1654
30,40,-50,411,400,811,1738
80,-40,90,417,394,811,1834
50,40,-40,406,405,811,1723
70,80,-90,415,396,811,1669
10,-80,-50,406,405,811,1586
-80,20,20,414,398,812,1691
90,80,-110,415,397,812,1719
-120,20,80,396,416,812,1661
60,-30,80,416,396,812,1878
-80,-20,-70,410,402,812,1651
-170,-40,150,410,402,812,1796
110,-10,130,407,405,812,1842
100,40,170,433,380,813,1567
-160,-20,140,399,414,813,1799
-80,10,0,401,412,813,1615
100,-20,120,413,400,813,1799
0,0,-50,388,425,813,1885
-10,50,-10,424,389,813,1734
0,60,-20,412,402,814,1783
120,-60,70,416,398,814,1702
-30,-30,-80,403,411,814,1800
-160,0,90,408,406,814,1586
10,50,-20,421,393,814,1779
50,-10,-20,402,412,814,1795
-90,60,10,389,425,814,1663
160,-70,100,420,394,814,1605
-60,-50,-50,419,395,814,1791
100,-50,60,412,402,814,1602
180,-30,140,409,406,815,1840
-90,50,50,404,411,815,1745
30,30,-40,411,404,815,1864
-40,60,10,424,391,815,1801
110,0,160,422,393,815,1702
-90,-40,-130,414,401,815,1721
-180,-30,140,409,406,815,1840
160,-80,100,422,394,816,1632
10,70,-30,417,399,816,1820
30,70,-50,416,400,816,1805
130,0,120,403,413,816,1624
70,-80,70,414,402,816,1816
-10,10,0,415,401,816,1802
140,-20,130,420,396,816,1844
-100,50,60,391,425,816,1719
-160,0,130,406,410,816,1863
-110,10,50,411,406,817,1738
-60,-50,-120,407,410,817,1758
40,40,-50,419,398,817,1785
-80,-20,-80,403,414,817,1706
170,-40,140,422,395,817,1903
150,-70,140,421,396,817,1833
170,70,160,404,413,817,1826
-70,-30,-110,407,411,818,1674
-30,-80,-30,416,402,818,1771
-150,40,60,412,406,818,1518
40,50,-40,413,405,818,1811
-110,70,30,407,411,818,1717
80,-20,70,427,391,818,1638
-170,80,140,401,418,819,1786
-130,40,40,398,421,819,1510
60,40,-50,415,404,819,1787
-70,-10,-20,415,404,819,1722
-70,-20,-90,406,413,819,1644
100,-30,110,417,402,819,1701
-10,30,0,413,406,819,1834
10,10,10,417,402,819,1764
70,20,10,408,411,819,1681
50,40,-50,411,408,819,1762
130,10,170,413,407,820,1725
60,80,-80,418,402,820,1717
-40,10,0,409,411,820,1730
-130,10,100,410,411,821,1670
70,-20,110,420,401,821,1778
-50,10,0,418,403,821,1699
140,20,170,416,405,821,1763
160,60,170,422,399,821,1820
-110,-60,-130,419,402,821,1836
120,60,-140,417,404,821,1700
-20,30,0,413,409,822,1781
-70,-50,-130,413,409,822,1750
-60,40,20,416,406,822,1809
-40,80,-30,411,411,822,1713
-40,-10,-10,422,400,822,1728
70,-20,100,418,404,822,1789
110,30,-130,404,419,823,1738
130,-30,120,421,402,823,1828
-10,10,-50,410,413,823,1884
90,50,-150,403,420,823,1612
90,40,-110,404,419,823,1642
50,30,-10,432,392,824,1763
-140,-20,130,405,419,824,1775
-110,50,70,414,410,824,1702
70,-10,110,418,406,824,1660
-110,80,80,406,418,824,1782
140,-60,130,419,405,824,1912
30,0,40,416,409,825,1803
-30,10,0,420,405,825,1826
90,40,-150,397,428,825,1707
70,50,-80,422,403,825,1784
-80,-30,-60,412,413,825,1722
60,-40,0,414,411,825,1768
-130,-50,-180,413,412,825,1782
90,-20,90,427,398,825,1730
100,-60,100,419,406,825,1956
0,30,-50,401,424,825,1798
0,0,10,419,406,825,1814
50,50,-60,419,406,825,1767
-130,-50,180,413,412,825,1782
60,10,60,413,413,826,1574
90,30,-140,420,406,826,1578
20,20,-40,418,408,826,1905
-80,30,-10,416,410,826,1699
100,10,-170,416,411,827,1754
-170,-20,140,412,415,827,1856
50,-30,70,429,398,827,1910
-70,-70,-70,431,396,827,1789
-150,20,120,407,420,827,1802
20,-80,-40,407,420,827,1588
100,-10,120,415,412,827,1859
-30,60,-40,400,427,827,1620
160,20,150,412,415,827,1993
-70,-40,-120,416,411,827,1773
-140,-10,110,405,423,828,1715
150,10,150,408,420,828,1853
30,30,0,422,406,828,1759
50,80,-70,424,404,828,1723
80,-80,80,428,400,828,1881
50,40,-30,427,401,828,1750
10,-30,-50,412,417,829,1809
30,40,-10,432,397,829,1844
-160,50,70,416,413,829,1674
100,10,-150,417,412,829,1748
120,30,-150,424,405,829,1790
100,80,-120,420,409,829,1754
90,-10,120,429,401,830,1769
160,-50,100,415,415,830,1737
-20,0,0,420,410,830,1859
90,20,-150,417,413,830,1586
-140,-20,120,396,434,830,1711
110,0,170,418,413,831,1718
-110,-70,-120,421,410,831,1760
-90,10,10,417,414,831,1793
-20,-10,-60,407,424,831,1873
100,-50,100,422,410,832,1784
30,50,-30,412,420,832,1870
-90,30,40,420,412,832,1763
-60,0,-50,394,438,832,1784
150,20,160,419,414,833,1856
-80,70,50,409,424,833,1825
110,0,140,404,429,833,1818
-150,-50,170,424,409,833,1764
-60,20,10,417,416,833,1761
40,0,50,423,411,834,1851
50,50,-50,415,419,834,1873
60,40,-60,422,412,834,1792
100,10,-160,420,414,834,1894
-160,80,130,406,428,834,1794
150,-40,130,425,409,834,1919
10,-20,-50,421,413,834,1954
30,-80,-30,410,424,834,1611
-40,30,-40,412,423,835,1591
150,-50,130,426,409,835,1830
-110,-50,-140,420,415,835,1816
80,50,-120,430,405,835,1658
50,60,-60,424,411,835,1863
-10,-20,-60,426,409,835,1876
-10,20,0,416,419,835,1794
-40,10,-50,417,418,835,1893
-180,70,150,417,419,836,1786
150,-80,90,434,402,836,1711
40,80,-60,424,412,836,1739
40,-20,60,424,412,836,1781
0,20,0,415,421,836,1815
10,30,-50,417,419,836,1898
10,0,20,436,400,836,1801
130,-10,110,405,431,836,1686
30,0,-40,405,431,836,1806
40,60,-90,410,426,836,1767
180,70,150,417,419,836,1786
60,0,90,432,405,837,1694
90,-70,90,433,404,837,1897
-40,-10,-70,422,415,837,1872
-140,-40,150,431,406,837,1809
70,-50,80,441,396,837,1845
150,-10,140,424,413,837,1897
130,-40,120,427,410,837,1801
70,-30,90,424,413,837,1876
10,50,-60,415,423,838,1644
30,50,-70,408,430,838,1710
-10,50,-50,410,428,838,1619
-130,0,100,423,415,838,1740
50,10,-30,407,432,839,1853
10,-50,20,428,411,839,1791
170,-10,100,412,427,839,1576
50,0,80,427,412,839,1718
110,-40,110,425,414,839,1831
-100,10,30,416,423,839,1776
-110,10,30,431,408,839,1710
60,50,-70,430,409,839,1748
-130,80,100,413,426,839,1824
40,-80,-20,407,433,840,1605
-140,80,110,414,426,840,1823
90,-80,90,435,405,840,1920
-150,80,120,413,427,840,1826
-50,60,20,425,415,840,1881
60,0,-20,405,435,840,1832
50,50,-40,421,419,840,1868
80,50,-90,424,416,840,1845
-120,80,90,412,428,840,1819
-120,-50,-160,428,413,841,1769
-140,40,50,431,410,841,1525
-150,-20,140,402,439,841,1819
160,-10,140,432,409,841,1895
100,70,-170,421,420,841,1762
40,-10,60,429,412,841,1820
-90,20,30,421,421,842,1740
30,80,-50,426,416,842,1739
-60,-20,-90,420,422,842,1809
160,60,110,415,427,842,1740
-120,10,80,416,426,842,1728
-80,-40,-70,428,414,842,1835
120,-10,140,422,420,842,1959
-10,-50,0,420,423,843,1955
170,0,140,426,417,843,1844
120,10,-180,407,436,843,1832
-40,-80,-40,430,413,843,1806
120,10,180,407,436,843,1832
120,0,170,413,431,844,1800
50,-80,-10,412,432,844,1648
60,20,-30,421,424,845,1801
110,60,170,409,436,845,1821
-30,80,-40,423,422,845,1804
-70,0,-40,414,431,845,1670
100,-60,50,412,433,845,1805
-70,-20,-30,427,418,845,1810
-80,-60,-80,433,413,846,1860
50,-70,-10,417,429,846,1746
90,-40,50,424,422,846,1697
40,30,0,433,413,846,1797
130,70,150,409,437,846,1770
150,-30,130,430,416,846,1890
140,-10,140,420,426,846,1978
-90,-30,-100,426,421,847,1874
10,-10,-50,419,428,847,1904
30,-20,50,437,411,848,1841
60,-10,100,436,412,848,1673
20,50,-20,430,418,848,1913
50,-20,80,436,412,848,1911
110,80,-130,431,417,848,1851
80,-30,100,428,420,848,1887
-10,30,-50,417,432,849,1766
10,30,0,440,409,849,1846
-60,-40,-40,432,417,849,1878
160,-70,150,444,406,850,1879
-140,20,110,405,445,850,1738
100,-80,100,441,409,850,1964
60,30,-30,432,418,850,1807
20,70,-80,424,426,850,1819
20,30,0,434,417,851,1807
-110,40,70,422,429,851,1785
120,40,-140,425,426,851,1843
60,-80,0,418,433,851,1681
170,60,160,430,421,851,1873
100,-10,130,413,438,851,1935
-20,-10,0,439,412,851,1943
-120,-50,180,430,422,852,1821
-120,-50,-180,430,422,852,1821
40,-60,50,426,426,852,1895
60,20,-20,442,410,852,1883
120,70,-140,437,415,852,1740
-60,60,30,423,429,852,1846
-20,40,0,436,417,853,1841
150,30,170,426,427,853,1900
0,70,-20,435,418,853,1814
40,30,-40,427,426,853,1876
-10,-40,-70,425,428,853,1821
-140,50,50,439,414,853,1666
130,-10,140,423,430,853,1972
110,-10,120,436,417,853,1850
80,-40,30,417,436,853,1714
-50,-80,-50,429,424,853,1849
-50,-50,-110,429,424,853,1847
60,40,-40,443,410,853,1727
130,-50,120,429,424,853,1893
50,10,50,433,420,853,1816
-100,-40,-140,431,423,854,1847
-80,10,-10,428,426,854,1692
-110,10,60,423,431,854,1796
80,-50,90,443,411,854,1915
80,-20,120,429,425,854,1777
160,50,170,424,431,855,1828
-100,-50,-120,446,409,855,1919
-130,30,40,445,410,855,1468
0,-50,10,427,428,855,1897
-30,-60,-20,438,417,855,1877
110,10,-170,415,440,855,1830
-20,-60,-10,436,419,855,1950
-100,70,70,424,431,855,1881
110,50,160,438,417,855,1626
90,40,-170,437,419,856,1608
40,50,-30,430,426,856,1919
140,0,150,429,427,856,1971
110,-60,60,420,436,856,1808
20,80,-40,439,417,856,1783
100,10,-140,422,434,856,1776
150,60,120,421,435,856,1752
130,70,-150,432,424,856,1865
90,60,-100,438,418,856,1847
170,-60,150,432,425,857,1902
10,80,-30,440,417,857,1768
-40,-30,-90,444,413,857,1939
-90,70,60,421,437,858,1885
40,60,-50,435,423,858,1897
170,-10,140,428,430,858,1977
10,-60,20,431,427,858,1904
-140,-40,160,435,423,858,1937
-180,-20,140,425,433,858,1983
-70,60,40,420,438,858,1846
90,-10,110,429,429,858,1828
-140,-30,140,428,430,858,1721
100,0,150,424,434,858,1814
180,-20,140,425,433,858,1983
80,-20,40,428,430,858,1654
50,30,-40,440,419,859,1880
-80,-70,-80,442,417,859,1841
90,30,-150,422,437,859,1637
90,-30,110,435,424,859,1864
80,-10,90,445,415,860,1759
-160,10,130,422,438,860,1866
-160,70,130,432,428,860,1859
-90,-40,-90,432,428,860,1948
-70,10,-30,420,440,860,1732
170,-70,160,445,416,861,1906
30,20,20,442,419,861,1879
50,40,-60,442,419,861,1892
50,30,0,433,428,861,1910
0,50,-10,448,413,861,1910
-150,-40,130,432,429,861,1753
-10,60,-10,450,411,861,1848
110,20,-140,437,424,861,1841
30,20,-40,434,428,862,1983
-50,-10,-10,439,423,862,1828
120,-30,120,431,431,862,1848
20,-60,30,434,428,862,1953
20,30,-50,428,434,862,1953
30,-60,40,436,426,862,1918
30,40,-60,440,422,862,1917
100,0,160,431,431,862,1762
100,-30,80,440,422,862,1890
-70,40,30,424,438,862,1798
60,30,-20,445,417,862,1831
50,-60,60,440,423,863,1944
90,20,-180,439,424,863,1656
-40,50,10,437,426,863,1907
120,-20,100,429,434,863,1765
90,20,180,439,424,863,1656
-80,-20,-50,437,426,863,1797
50,10,70,444,420,864,1761
100,80,-170,425,439,864,1764
-170,70,140,437,427,864,1846
100,10,150,423,441,864,1826
-40,-60,-30,443,422,865,1823
180,60,150,426,439,865,1914
-130,0,90,424,441,865,1775
90,10,-170,431,434,865,1809
-70,-10,-70,425,440,865,1841
-180,60,150,426,439,865,1914
90,-40,100,442,423,865,1948
110,-80,110,453,413,866,1988
180,-60,160,435,431,866,1909
20,40,-60,438,428,866,1917
-40,40,10,449,417,866,1891
-180,-60,160,435,431,866,1909
90,10,-150,434,432,866,1812
40,40,-10,452,414,866,1902
-170,-50,160,434,432,866,1955
-110,30,70,430,437,867,1841
0,30,0,428,439,867,1865
60,60,-70,443,424,867,1897
50,0,-30,424,443,867,1915
90,50,-100,438,429,867,1924
60,-60,0,445,422,867,1805
90,10,-160,438,429,867,1847
100,-70,100,447,421,868,1936
-140,-50,150,449,419,868,1697
60,40,-30,450,418,868,1813
120,80,-140,439,429,868,1909
-60,-80,-60,434,434,868,1883
50,40,-20,464,405,869,1828
-70,-30,-40,437,432,869,1857
90,-80,30,431,438,869,1814
-120,-60,-140,445,424,869,1914
180,30,140,428,441,869,2062
-40,-40,-20,451,418,869,1923
-90,-30,-90,437,432,869,1871
-180,30,140,428,441,869,2062
60,10,-20,428,441,869,2008
40,50,-80,429,440,869,1734
60,20,-10,442,428,870,1892
130,60,-150,434,436,870,1853
180,20,140,433,437,870,1899
-180,20,140,433,437,870,1899
40,30,-50,438,432,870,1983
150,10,110,446,425,871,1703
-50,40,-30,436,435,871,1769
70,0,0,438,433,871,2040
30,-10,-40,421,450,871,2020
60,-10,-10,429,442,871,1999
0,80,-20,442,429,871,1808
-150,70,120,437,434,871,1916
30,60,-40,451,420,871,1936
160,-30,100,432,439,871,1644
-100,-60,-110,445,426,871,1933
80,-10,120,441,431,872,1772
-60,10,-40,430,442,872,1865
-20,-20,0,448,424,872,2016
110,-10,140,427,445,872,1960
-180,0,140,443,429,872,1982
70,60,-120,434,438,872,1803
70,60,-80,442,430,872,1859
180,0,140,443,429,872,1982
-50,-40,-30,443,429,872,1896
130,50,-150,440,433,873,1838
-70,-10,-60,433,440,873,1829
30,-30,50,441,432,873,1941
30,50,-20,438,435,873,1938
-10,40,-50,423,450,873,1772
150,40,180,422,451,873,1869
150,40,-180,422,451,873,1869
-20,-40,-80,438,436,874,1950
-170,-10,140,438,436,874,2072
60,-50,0,422,452,874,1877
110,-70,110,452,422,874,1973
-120,40,30,445,429,874,1701
30,30,-50,435,439,874,1962
-140,70,110,430,445,875,1910
-10,-60,0,440,435,875,1989
140,60,130,427,448,875,1810
-100,-50,-160,442,433,875,1865
120,-80,120,452,423,875,1996
-30,50,-40,416,459,875,1764
120,-30,90,437,439,876,1791
-140,-10,120,418,458,876,1920
110,-20,130,447,429,876,1997
40,40,-60,440,436,876,1923
-80,-50,-140,443,433,876,1841
80,60,-90,446,430,876,1838
90,-10,100,432,444,876,1825
30,10,-40,428,449,877,1947
140,-80,80,454,423,877,1772
50,30,-50,444,433,877,1967
-180,-70,170,450,427,877,1968
-150,50,60,442,435,877,1830
180,-70,170,450,427,877,1968
-100,70,20,427,450,877,1914
-40,30,10,450,428,878,1891
-120,70,90,434,444,878,1884
70,70,-80,459,419,878,1970
170,50,160,432,446,878,1916
-120,-70,-130,449,429,878,1881
120,20,140,442,436,878,1794
-90,20,0,435,443,878,1717
130,20,130,447,431,878,1737
-80,-20,-90,436,443,879,1720
-10,20,-50,441,438,879,1906
100,30,-120,434,445,879,1813
-110,70,80,426,453,879,1907
110,-30,120,443,436,879,1828
-70,30,-20,448,431,879,1785
70,0,70,459,420,879,1716
-120,10,40,452,427,879,1708
-150,-10,130,424,455,879,1928
-170,30,80,465,414,879,1638
-60,-20,-20,453,426,879,1999
-10,80,-10,446,433,879,1849
-150,-30,120,439,440,879,1745
10,0,-50,425,455,880,1968
80,70,-90,461,419,880,1955
-20,80,-50,441,439,880,1942
70,-80,10,423,457,880,1733
0,10,-50,440,440,880,1966
130,80,-150,442,438,880,1897
70,70,-130,434,446,880,1864
0,-60,10,447,433,880,1884
-140,-10,100,428,453,881,1729
170,-30,140,439,442,881,1954
-30,-30,-10,459,422,881,1915
60,-60,70,455,426,881,2039
110,-60,110,451,430,881,2099
-20,-20,-70,430,451,881,1940
100,0,140,428,453,881,1812
60,40,-70,448,433,881,1926
100,20,-130,429,453,882,1738
100,50,-110,449,433,882,1904
-30,0,0,444,438,882,1984
130,-20,130,451,431,882,1932
50,-20,-20,435,447,882,1952
-50,20,-40,437,445,882,1856
180,-50,110,454,428,882,1795
60,-40,80,453,429,882,1961
-180,-50,110,454,428,882,1795
100,60,-110,455,427,882,1911
60,30,-10,454,429,883,1887
-80,-20,-60,449,434,883,1810
120,-20,130,439,444,883,2023
40,-30,60,452,431,883,1942
-60,-30,-30,455,428,883,1904
70,-20,10,439,444,883,1946
170,60,100,438,445,883,1784
60,30,-40,441,443,884,1815
-70,-80,-70,442,442,884,1890
-80,10,10,438,447,885,1902
-30,0,-60,434,451,885,2036
-130,-50,-170,449,436,885,2034
-40,0,-60,437,448,885,2144
110,10,140,438,447,885,1904
90,-30,60,456,429,885,1820
-110,20,70,436,449,885,1876
70,-60,80,458,427,885,2017
70,10,40,449,436,885,1747
160,30,160,450,436,886,2026
-80,40,40,440,446,886,1939
170,30,150,446,440,886,2129
130,0,160,444,442,886,1977
-20,50,0,456,430,886,1861
-70,-50,-60,455,431,886,1947
-130,70,100,436,450,886,1910
0,10,10,450,436,886,1890
100,40,-110,447,440,887,1959
-160,10,80,446,441,887,1725
40,20,-40,449,439,888,2096
130,-80,130,459,429,888,2026
-80,60,0,444,444,888,1804
-130,20,100,432,456,888,1739
60,20,-40,438,450,888,1971
-80,-40,-130,437,452,889,1878
40,-20,-30,434,455,889,1928
170,-20,100,435,454,889,1636
-180,-10,140,443,446,889,2019
80,-80,20,429,460,889,1772
-20,70,-50,442,447,889,1882
180,-10,140,443,446,889,2019
-80,60,50,432,457,889,1869
-110,30,20,448,441,889,1697
-60,-10,-80,436,453,889,1916
60,50,-60,446,443,889,1886
-50,-30,-100,447,442,889,1890
-150,-30,150,450,439,889,1997
20,-90,20,459,431,890,1939
150,-90,150,459,431,890,1939
-20,-90,-20,459,431,890,1939
-100,-90,-100,459,431,890,1939
-90,-90,-90,459,431,890,1939
60,-90,60,459,431,890,1939
-50,-90,-50,459,431,890,1939
40,-90,40,459,431,890,1939
100,-90,100,459,431,890,1939
-110,-90,-110,459,431,890,1939
30,-90,30,459,431,890,1939
160,-90,160,459,431,890,1939
10,-90,10,459,431,890,1939
-40,-90,-40,459,431,890,1939
-80,-90,-80,459,431,890,1939
50,-90,50,459,431,890,1939
-120,-90,-120,459,431,890,1939
-10,-90,-10,459,431,890,1939
-30,-90,-30,459,431,890,1939
-60,-90,-60,459,431,890,1939
-50,-60,-40,454,436,890,1883
180,-90,-180,459,431,890,1939
-70,-90,-70,459,431,890,1939
80,-90,80,459,431,890,1939
110,-90,110,459,431,890,1939
70,-90,70,459,431,890,1939
130,-90,130,459,431,890,1939
120,-90,120,459,431,890,1939
140,-90,140,459,431,890,1939
110,-50,110,452,438,890,2000
90,-90,90,459,431,890,1939
0,-90,0,459,431,890,1939
180,-90,180,459,431,890,1939
170,-90,170,459,431,890,1939
-180,-90,-180,459,431,890,1939
-170,-90,-170,459,431,890,1939
-160,-90,-160,459,431,890,1939
-180,-90,180,459,431,890,1939
-130,-90,-130,459,431,890,1939
-140,-90,-140,459,431,890,1939
-150,-90,-150,459,431,890,1939
-150,-40,160,445,446,891,1940
-10,70,-10,460,431,891,1864
-100,20,50,449,442,891,1861
100,-10,140,437,455,892,1958
140,20,-180,439,453,892,2029
-60,50,-20,432,460,892,1726
160,10,150,430,462,892,2014
60,70,-70,459,433,892,2010
140,20,180,439,453,892,2029
80,40,-100,435,457,892,1819
-20,80,0,452,440,892,1890
0,20,-50,443,450,893,1950
-110,-50,-170,454,439,893,1878
-50,-10,-80,440,453,893,2008
40,10,40,454,439,893,1922
-90,10,20,452,441,893,1949
100,-20,130,453,440,893,1927
-160,-40,120,460,433,893,1902
120,-70,120,462,432,894,2011
-50,50,20,447,447,894,1982
160,-50,140,461,433,894,1943
-10,40,0,460,434,894,1970
20,60,-30,454,440,894,1984
0,-30,-60,441,454,895,2034
30,70,-90,452,444,896,1956
50,20,-40,443,453,896,2004
-140,-20,140,430,466,896,2022
-140,60,110,444,452,896,1976
60,10,70,448,448,896,1816
150,-60,140,455,441,896,2028
-90,-50,-90,461,436,897,1975
10,20,10,454,443,897,1929
-90,-50,-150,442,455,897,1856
20,-20,40,455,442,897,1978
60,20,30,450,447,897,1753
180,10,140,447,450,897,1941
-180,10,140,447,450,897,1941
-120,30,30,462,436,898,1739
150,-70,90,461,437,898,1826
170,-20,140,449,449,898,2106
-120,-50,-150,448,451,899,1929
90,70,-100,471,428,899,2000
100,-20,90,455,444,899,1960
100,-10,110,443,456,899,1933
-80,-20,-40,463,436,899,1851
100,20,160,425,474,899,1807
-60,30,20,457,443,900,1922
50,-10,90,469,431,900,1875
-20,70,0,459,441,900,1924
-150,-60,140,449,452,901,1875
60,50,-50,460,441,901,2022
-90,-70,-90,465,436,901,1965
-140,30,50,468,434,902,1612
-140,-50,180,460,442,902,1916
90,-10,130,456,446,902,1884
-150,60,120,450,452,902,1970
-70,-40,-50,449,453,902,1996
-140,-50,-180,460,442,902,1916
-50,-20,-90,462,440,902,2033
-100,-40,-130,462,441,903,1928
160,-20,100,454,449,903,1711
-80,-80,-80,453,450,903,1905
-30,80,10,452,451,903,1941
140,70,-160,455,449,904,1933
50,-40,70,472,432,904,2021
-50,20,10,453,451,904,1944
110,20,150,436,469,905,1873
-170,-70,180,458,447,905,2062
50,20,30,455,450,905,1866
60,70,-120,455,450,905,1972
120,10,130,448,457,905,1887
-90,-40,-140,459,446,905,1934
-130,50,40,435,470,905,1788
-170,-70,-180,458,447,905,2062
180,20,90,474,431,905,1745
-180,20,90,474,431,905,1745
-10,-20,10,462,444,906,2185
130,-20,100,448,458,906,1854
60,-20,100,462,444,906,2056
160,-40,140,467,439,906,2089
140,80,-160,452,455,907,1917
110,0,130,454,453,907,1896
150,70,-170,467,440,907,2008
130,30,-160,454,453,907,2013
50,70,-60,462,445,907,2026
50,30,10,448,459,907,1982
-30,-40,-90,457,450,907,1902
-90,40,50,440,468,908,1989
130,-80,70,457,451,908,1842
-90,-30,-110,446,462,908,1932
100,-30,120,465,443,908,1920
-180,60,90,448,461,909,1812
20,-30,40,453,456,909,2139
180,60,90,448,461,909,1812
140,10,170,460,449,909,1925
140,-30,130,461,448,909,2049
-20,20,-50,457,452,909,1878
50,60,-100,463,447,910,1877
100,0,170,442,468,910,1918
10,50,-10,462,448,910,2037
20,-70,30,462,448,910,2019
-160,20,130,454,456,910,1994
-40,-20,-10,463,447,910,1967
-40,0,0,457,453,910,1978
70,20,0,453,457,910,1889
140,20,120,462,449,911,1806
-30,-40,-10,457,454,911,2045
-130,-60,-150,466,445,911,2011
-80,-10,-30,459,452,911,1913
-160,-30,150,470,441,911,2020
150,-20,100,451,460,911,1680
70,40,-80,461,450,911,1870
70,10,50,465,446,911,1874
10,-30,30,465,447,912,2100
-130,-70,-140,464,448,912,1988
100,-80,40,453,459,912,1875
-30,40,10,460,452,912,2085
60,0,100,477,436,913,1823
-20,-30,0,456,457,913,2137
-180,-40,150,462,451,913,2016
160,40,170,457,456,913,2040
180,-40,150,462,451,913,2016
30,-10,50,470,443,913,1931
40,-70,50,458,455,913,2080
-90,-30,-80,448,465,913,1964
-140,-30,150,450,464,914,2116
-120,60,90,450,464,914,2097
-170,60,140,445,469,914,2021
-80,-10,-40,453,461,914,1912
20,-10,40,469,445,914,1961
-10,-30,10,457,457,914,2159
-140,30,110,449,465,914,1925
-40,80,20,455,459,914,2023
-10,-10,10,464,451,915,2094
-180,50,150,460,455,915,1980
160,-20,140,461,454,915,2139
-170,-60,170,467,448,915,2001
10,10,-50,451,464,915,2065
90,-50,100,473,442,915,2013
180,50,150,460,455,915,1980
-70,-10,-80,459,457,916,1966
40,70,-50,469,447,916,2051
90,40,-100,468,448,916,2019
-130,60,100,451,465,916,2047
70,40,-50,462,454,916,1943
-120,10,90,440,476,916,1878
50,40,-70,462,454,916,1967
-10,80,-60,463,453,916,2031
-170,50,140,454,462,916,2064
140,-80,140,473,444,917,2069
110,-80,50,458,459,917,1906
40,10,-40,449,468,917,2093
10,40,0,479,439,918,2008
140,60,-160,464,454,918,1996
140,-20,100,449,469,918,1850
70,30,-30,473,445,918,1893
-160,-60,130,455,463,918,1837
-160,-10,140,443,476,919,2052
70,50,-70,462,457,919,1913
80,-30,30,455,464,919,2040
10,-70,20,469,450,919,2057
90,80,-160,450,469,919,1943
140,-40,90,457,462,919,1886
-20,60,0,478,441,919,1985
110,60,-120,473,447,920,1985
-160,60,130,455,465,920,2028
30,-70,40,469,451,920,2043
130,30,130,474,446,920,1746
70,10,60,469,451,920,1898
100,70,-110,476,444,920,2004
-90,-60,-90,464,456,920,2017
-110,90,90,456,465,921,1965
180,90,160,456,465,921,1965
-60,90,40,456,465,921,1965
140,90,-160,456,465,921,1965
-40,90,20,456,465,921,1965
-180,90,160,456,465,921,1965
100,90,-120,456,465,921,1965
-80,90,60,456,465,921,1965
70,-40,90,477,444,921,2052
50,90,-70,456,465,921,1965
40,90,-60,456,465,921,1965
130,90,-150,456,465,921,1965
90,90,-110,456,465,921,1965
-150,30,120,457,464,921,1951
20,90,-40,456,465,921,1965
-140,90,120,456,465,921,1965
-140,50,110,456,465,921,2006
90,-20,80,469,452,921,2021
-130,90,110,456,465,921,1965
60,90,-80,456,465,921,1965
150,90,-170,456,465,921,1965
-120,90,100,456,465,921,1965
-10,90,-10,456,465,921,1965
-60,-60,-50,473,448,921,2015
0,90,-20,456,465,921,1965
-90,90,70,456,465,921,1965
80,90,-100,456,465,921,1965
-70,90,50,456,465,921,1965
10,90,-30,456,465,921,1965
160,90,-180,456,465,921,1965
-170,90,150,456,465,921,1965
160,90,180,456,465,921,1965
-100,90,80,456,465,921,1965
170,90,170,456,465,921,1965
-50,90,30,456,465,921,1965
-20,90,0,456,465,921,1965
120,90,-140,456,465,921,1965
-150,90,130,456,465,921,1965
60,30,-50,465,456,921,2035
110,90,-130,456,465,921,1965
-30,90,10,456,465,921,1965
30,90,-50,456,465,921,1965
50,50,-90,460,461,921,1820
70,90,-90,456,465,921,1965
-160,90,140,456,465,921,1965
-160,-60,180,465,457,922,2108
-10,-70,0,468,454,922,2003
-90,60,60,452,470,922,1971
-50,0,-60,453,469,922,2154
-160,-60,-180,465,457,922,2108
60,60,-110,465,457,922,1914
-160,-70,-170,468,454,922,2102
150,10,160,458,465,923,2094
0,-70,10,470,453,923,2022
-20,-70,-10,475,448,923,2039
10,-20,30,464,459,923,2154
-90,10,0,450,473,923,1800
60,30,0,477,446,923,1942
-160,50,130,462,461,923,2009
150,80,-170,459,464,923,1950
-10,0,10,465,459,924,2062
120,-80,60,467,457,924,1909
-60,50,30,468,456,924,1980
60,40,-80,454,470,924,1939
50,60,-50,472,452,924,2014
70,50,-110,463,461,924,1858
10,20,-50,469,455,924,1991
-100,40,60,462,463,925,1918
70,0,80,480,445,925,1867
-130,50,100,459,466,925,2022
130,60,140,464,462,926,1874
170,20,150,461,465,926,2116
-30,-70,-20,477,449,926,2064
150,-60,90,473,453,926,1868
-110,40,20,443,483,926,1849
-100,-50,-110,456,470,926,2045
120,-60,120,473,453,926,2125
140,-50,130,468,459,927,2123
60,10,-30,453,474,927,2071
70,40,-70,475,452,927,1990
-10,-10,-60,458,469,927,2056
120,20,-160,458,469,927,2052
-80,-10,-50,454,473,927,1845
120,70,160,446,481,927,1958
-60,0,0,471,456,927,1992
-50,-30,-20,481,446,927,2025
-60,-10,-10,482,446,928,2109
40,50,-20,478,450,928,2004
-110,60,80,459,469,928,2114
10,60,-20,477,451,928,2024
60,-30,90,477,451,928,2116
-170,0,90,479,449,928,1882
20,20,-50,468,460,928,2051
140,-40,130,462,466,928,2053
140,50,-160,465,464,929,2012
60,60,-60,479,450,929,2017
170,-50,150,475,454,929,2064
80,-60,90,476,453,929,2076
30,-20,-40,463,467,930,2116
-170,60,80,459,471,930,1869
130,-30,130,469,461,930,2048
-30,60,10,474,457,931,2125
120,-10,110,453,478,931,1950
80,-40,100,470,461,931,2073
80,-10,80,488,443,931,1976
70,30,-40,467,464,931,1912
-80,-30,-50,465,466,931,2011
120,-40,120,470,462,932,1996
-40,-40,-100,470,462,932,1885
-130,-40,160,456,476,932,2060
0,-10,20,481,451,932,2087
130,-70,130,485,447,932,2076
110,70,-120,480,452,932,2036
50,70,-110,481,451,932,2082
-150,50,120,455,478,933,2012
-130,0,110,464,469,933,2016
80,40,-110,473,460,933,1904
110,50,-120,462,471,933,1953
30,70,-40,474,460,934,2141
40,70,-100,470,464,934,2065
-110,10,70,460,474,934,1948
40,20,-50,476,459,935,2112
70,-30,100,476,459,935,2131
-120,20,90,451,484,935,1918
10,10,20,481,454,935,2090
-90,-80,-90,472,463,935,1985
90,30,-130,461,474,935,1889
-90,30,0,459,476,935,1884
-30,70,10,472,463,935,2010
90,-20,130,464,471,935,1971
20,50,-10,474,461,935,2094
150,-20,140,472,464,936,2137
40,60,-40,480,456,936,2072
20,0,-50,450,486,936,2003
170,40,160,465,471,936,2071
10,40,-60,462,474,936,2063
70,-10,0,470,466,936,2086
130,20,-170,455,481,936,1888
-50,80,30,461,475,936,2052
150,20,170,475,462,937,2071
60,30,10,470,467,937,1935
90,30,180,482,455,937,1861
20,50,-70,471,466,937,1910
10,-10,30,487,450,937,2136
90,30,-180,482,455,937,1861
80,-10,50,482,455,937,1818
80,-30,110,472,465,937,2035
-40,20,10,470,467,937,2046
-110,-50,-130,479,459,938,2113
-100,60,70,456,482,938,2069
150,0,150,461,477,938,2201
30,20,-50,481,457,938,2089
-10,-30,-70,470,468,938,2095
40,0,-40,462,477,939,2054
50,50,-30,477,462,939,2022
90,10,180,440,499,939,1926
90,10,-180,440,499,939,1926
-70,10,10,455,485,940,2055
70,0,100,479,461,940,1948
0,20,10,480,460,940,1993
0,-20,20,490,450,940,2094
130,40,-150,469,471,940,2031
120,0,120,470,470,940,1926
-160,-40,160,471,469,940,2124
160,-30,140,471,469,940,2136
-140,-30,130,467,474,941,1908
-70,20,20,466,475,941,1977
-140,-60,-160,473,468,941,2158
80,40,-90,480,462,942,1941
160,70,180,478,464,942,2057
-50,10,-50,450,492,942,2156
-70,0,-50,460,482,942,2050
100,-40,110,477,465,942,2047
160,70,-180,478,464,942,2057
-130,0,80,459,483,942,1836
50,0,90,477,466,943,1915
120,-10,150,473,470,943,2108
50,-30,80,479,464,943,2182
70,-30,10,474,469,943,2121
-80,0,-20,478,465,943,1939
0,40,0,470,474,944,2016
10,-40,30,483,461,944,2142
70,20,-30,469,475,944,2056
40,30,-60,473,471,944,2046
140,30,-170,478,466,944,2032
180,80,100,473,472,945,1990
-160,-50,170,474,471,945,2072
70,40,-60,485,460,945,2028
-100,20,10,473,472,945,1853
-70,60,-10,467,478,945,1921
30,-40,50,479,466,945,2131
-180,80,100,473,472,945,1990
-160,30,130,477,468,945,2069
80,50,-80,476,469,945,2050
-150,-60,-170,474,472,946,2079
70,10,-10,461,485,946,1923
-20,20,10,476,470,946,2168
70,0,90,498,448,946,2015
-170,0,140,468,478,946,2232
160,80,-180,474,472,946,2016
-50,0,0,477,469,946,1936
160,80,180,474,472,946,2016
-80,-40,-60,470,476,946,2089
150,20,110,459,488,947,1868
140,-20,140,476,471,947,2116
-140,0,120,473,474,947,2096
-30,30,10,476,471,947,2139
50,10,60,475,472,947,2009
-40,-70,-30,492,455,947,2099
150,-80,150,491,456,947,2116
20,10,30,489,459,948,2087
110,-20,140,464,484,948,2085
60,-20,-10,463,485,948,2053
-170,80,90,473,475,948,2011
80,-10,70,501,448,949,1976
40,-40,60,481,468,949,2110
-30,-10,0,486,463,949,2145
40,80,-50,488,462,950,2112
-10,10,10,475,475,950,2103
-130,80,50,465,485,950,2177
110,-10,150,469,481,950,2075
-100,-40,-150,482,468,950,2009
-130,-50,160,488,462,950,1988
-160,80,80,476,474,950,2038
70,20,20,460,490,950,1855
-130,-40,170,462,488,950,2144
70,-50,10,477,474,951,2030
170,80,110,474,477,951,2019
-170,-30,150,482,470,952,2153
150,60,-170,480,472,952,2104
60,-70,0,459,493,952,1956
60,80,-70,494,458,952,2057
140,30,120,496,457,953,1772
90,30,-120,474,479,953,1881
-20,0,-60,473,480,953,2113
70,80,-80,497,456,953,2058
50,30,-60,481,472,953,2034
120,-30,130,475,478,953,2028
-20,30,-50,463,490,953,1985
130,-30,90,464,489,953,1876
-140,-70,-150,483,470,953,2079
-50,40,20,481,472,953,2109
-60,80,40,469,484,953,2094
20,70,-30,481,473,954,2157
90,50,-90,476,478,954,2141
0,-30,20,483,471,954,2206
50,-70,60,483,471,954,2142
-80,-50,-70,483,471,954,2162
50,80,-60,495,460,955,2077
40,40,-70,486,469,955,2119
30,40,0,498,457,955,2172
20,-40,40,488,467,955,2218
-120,80,40,470,485,955,2115
-110,-40,-150,474,481,955,2065
-150,80,70,469,487,956,2077
-10,50,0,489,467,956,2054
-170,-60,120,476,480,956,1974
-100,-80,-100,483,473,956,2036
110,40,-120,473,484,957,2059
-140,-40,140,490,467,957,1965
-90,-40,-80,484,473,957,2132
110,10,-160,480,478,958,2119
80,-10,60,501,457,958,1957
20,-10,-50,472,486,958,2244
20,40,0,499,459,958,1998
-130,30,100,465,493,958,1981
60,50,-40,494,465,959,2052
-140,80,60,469,490,959,2173
0,-20,-60,482,477,959,2321
-90,70,10,472,487,959,2047
-70,50,40,473,486,959,1969
20,10,-50,481,478,959,2111
-60,0,-60,482,477,959,2182
120,-50,120,494,465,959,2219
-30,20,10,486,474,960,2198
-130,10,50,493,467,960,1824
-140,-40,170,476,484,960,2195
-20,-40,0,479,481,960,2234
130,-20,140,467,493,960,2137
30,60,-30,494,466,960,2163
-70,-60,-60,495,465,960,2147
90,80,-100,494,467,961,2054
-100,-70,-100,493,468,961,2041
-80,0,-10,484,477,961,2027
40,30,10,486,475,961,2159
-140,-60,150,496,465,961,2014
-110,-60,-120,498,463,961,2102
-90,-30,-70,475,487,962,2012
-100,-40,-120,487,475,962,2077
70,60,-70,497,465,962,2022
70,40,-40,501,461,962,1941
90,-50,40,470,492,962,1965
40,-10,70,495,467,962,2080
30,30,-60,485,477,962,2166
120,-20,140,483,479,962,2157
-10,20,10,490,472,962,2139
-30,50,10,488,474,962,2191
0,80,-70,493,470,963,2144
130,-10,150,479,484,963,2201
-40,70,20,485,478,963,2125
120,50,-130,493,470,963,2010
-180,-20,100,479,484,963,1829
-100,30,60,476,487,963,2038
40,20,30,492,471,963,2095
180,-20,100,479,484,963,1829
110,-30,130,489,475,964,2060
110,-10,110,485,479,964,2057
120,60,-130,498,466,964,2046
140,-70,140,506,458,964,2146
-140,40,110,484,480,964,2113
40,-30,-30,477,487,964,2143
140,0,160,491,474,965,2234
-170,10,140,493,472,965,2088
-150,-70,-160,486,479,965,2138
80,50,-130,481,484,965,1979
-70,80,50,480,486,966,2142
-70,30,30,483,483,966,2090
80,80,-90,503,463,966,2066
0,30,10,496,470,966,2229
90,-60,100,492,474,966,2230
150,30,-180,479,488,967,2191
50,40,-10,515,452,967,2025
10,60,-70,486,481,967,1983
-130,-20,130,465,502,967,2061
70,40,-90,477,490,967,1987
60,30,-60,480,487,967,2045
170,80,170,487,480,967,2062
150,30,180,479,488,967,2191
-150,0,130,483,484,967,2255
10,0,30,499,469,968,2222
-150,40,120,471,497,968,2149
90,0,-160,486,482,968,2041
-30,-10,-70,475,494,969,2147
20,30,10,498,471,969,2081
40,-20,70,491,478,969,2213
70,-40,10,491,478,969,2056
90,-30,120,488,482,970,2013
160,-60,150,496,474,970,2159
-100,10,40,484,486,970,2086
170,10,150,490,480,970,2178
90,-40,110,490,480,970,2174
150,50,-170,480,490,970,2156
-40,-50,-20,514,457,971,2101
-90,20,40,496,475,971,2068
-70,-10,-10,487,484,971,2176
-10,-40,10,489,482,971,2267
90,-10,140,474,497,971,1997
90,0,160,476,495,971,1931
120,-40,80,489,482,971,2116
30,80,-40,502,469,971,2123
130,0,170,484,488,972,2022
60,20,-50,497,475,972,2180
70,20,-40,483,489,972,2060
0,-40,20,489,483,972,2197
-110,-80,-110,495,477,972,2113
-100,-40,-110,486,486,972,2089
-110,0,50,487,485,972,2014
80,80,-150,476,497,973,2038
20,60,-20,502,471,973,2227
10,70,-20,496,477,973,2197
70,80,-140,482,491,973,2117
130,10,180,490,483,973,2141
130,10,-180,490,483,973,2141
50,-20,90,491,483,974,2184
-120,50,90,489,485,974,2097
0,0,20,502,472,974,2159
0,60,-10,504,471,975,2100
20,80,-30,501,474,975,2137
-50,70,30,482,493,975,2174
50,20,-50,488,487,975,2190
-80,-30,-120,485,491,976,2061
-30,-20,-80,494,482,976,2195
160,20,160,486,490,976,2240
30,-30,-40,483,493,976,2213
110,-40,120,491,485,976,2148
-10,30,10,490,486,976,2256
130,-60,130,497,479,976,2321
20,-80,30,498,478,976,2166
120,60,150,479,497,976,1933
20,30,-60,493,483,976,2179
-170,20,140,483,493,976,2149
-160,40,130,481,495,976,2156
60,80,-130,481,496,977,2173
-20,60,-50,494,483,977,1990
80,-70,90,515,462,977,2255
-60,-30,-110,487,490,977,2148
120,70,-130,507,470,977,2069
120,30,-140,490,487,977,2121
120,30,140,493,484,977,1861
10,30,10,491,487,978,2139
60,-70,70,489,489,978,2233
170,70,170,482,496,978,2163
-180,80,160,493,485,978,2112
-170,80,150,489,489,978,2149
80,40,-80,508,470,978,2091
100,-30,130,493,485,978,2166
-110,-40,-160,487,491,978,2113
-50,-40,-110,502,476,978,2154
180,80,160,493,485,978,2112
-170,40,140,484,494,978,2241
160,-80,160,504,474,978,2142
170,-80,170,493,485,978,2204
50,-10,-30,480,499,979,2209
10,-80,20,500,479,979,2158
90,50,-160,475,504,979,2042
30,30,10,505,474,979,2199
0,50,-60,479,501,980,2071
50,10,-40,478,502,980,2258
30,40,-70,498,482,980,2213
-80,-10,-20,490,490,980,2092
160,-10,100,464,516,980,1989
-110,80,30,477,503,980,2131
180,40,150,493,488,981,2245
-60,30,-30,501,480,981,2107
30,-80,40,501,480,981,2152
-80,20,30,493,488,981,2048
70,30,-50,496,485,981,2008
-180,40,150,493,488,981,2245
160,60,180,485,496,981,2173
160,60,-180,485,496,981,2173
90,70,-160,483,499,982,2142
-70,0,0,503,479,982,2083
60,-50,80,509,473,982,2178
-130,40,100,492,490,982,2111
100,80,-110,498,485,983,2070
-140,-10,130,469,515,984,2266
80,60,-140,482,502,984,2059
60,50,-100,493,491,984,2029
-110,20,20,504,480,984,1982
-20,30,10,491,494,985,2270
-120,-40,-180,486,499,985,2169
-140,0,80,488,497,985,1822
40,-80,50,505,480,985,2215
80,60,-80,507,478,985,2145
-120,-40,180,486,499,985,2169
60,20,40,504,481,985,2031
-120,-80,-120,502,483,985,2154
70,30,-20,503,484,987,2052
90,50,-170,474,513,987,1974
70,-70,80,509,478,987,2273
150,-50,140,505,482,987,2278
-150,80,130,488,499,987,2198
-30,-50,-10,514,473,987,2215
-10,70,-60,506,481,987,2127
-80,0,0,482,506,988,2164
160,30,170,504,484,988,2325
70,-50,90,505,483,988,2215
-80,-10,-80,496,492,988,2114
10,80,-20,510,479,989,2193
100,0,-150,483,506,989,2236
-50,0,-70,499,490,989,2335
90,20,170,484,505,989,2014
100,30,160,489,500,989,2070
-160,80,140,492,497,989,2169
-80,70,0,487,502,989,2058
-170,30,140,489,500,989,2247
80,10,10,497,492,989,2065
90,10,170,481,509,990,1830
-100,30,10,489,501,990,2075
-120,-40,-170,497,493,990,2216
-150,30,60,508,483,991,1865
-50,-70,-40,513,478,991,2174
-80,-20,-30,505,486,991,2150
160,0,150,488,503,991,2328
10,80,-80,507,485,992,2195
0,80,-10,513,479,992,2238
80,-50,100,506,486,992,2268
-30,10,10,504,488,992,2287
-10,0,-60,497,495,992,2333
-140,-20,110,477,516,993,2025
60,10,80,512,481,993,1956
90,-70,100,517,476,993,2284
-80,10,20,487,506,993,2259
-80,80,60,500,493,993,2169
-130,80,110,491,502,993,2216
-30,20,-50,493,501,994,2133
140,-70,80,503,491,994,2070
110,10,-150,511,483,994,2237
-40,10,10,511,483,994,2168
-110,0,40,503,491,994,2145
100,-10,150,481,514,995,2156
160,80,120,490,505,995,2130
-170,-20,100,496,499,995,1883
60,60,-50,525,470,995,2162
0,70,-10,521,474,995,2236
40,0,60,510,486,996,2269
120,10,-170,487,509,996,2144
-60,70,40,509,487,996,2175
130,-50,80,501,495,996,2020
50,60,-40,520,476,996,2213
-140,80,120,489,507,996,2233
-50,-50,-30,523,473,996,2144
60,40,-20,521,475,996,2080
-70,-20,-100,503,493,996,2177
100,-50,110,504,493,997,2183
-110,0,60,502,495,997,2104
30,50,-10,522,475,997,2151
-40,60,20,508,490,998,2246
-20,10,10,512,486,998,2209
70,0,-10,490,508,998,2243
100,0,180,488,510,998,2089
-80,0,-30,479,519,998,2058
-120,80,100,497,501,998,2239
-70,70,50,511,487,998,2189
90,-10,90,496,502,998,2230
-80,-10,-70,500,498,998,2045
100,0,-180,488,510,998,2089
20,80,-90,504,495,999,2288
-100,-40,-100,502,497,999,2191
-90,-30,-120,504,495,999,2101
50,-50,70,520,479,999,2286
-60,10,10,501,498,999,2202
-120,0,70,512,487,999,1982
150,-30,140,510,489,999,2301
-70,-20,-20,499,500,999,2187
0,-80,10,512,487,999,2181
-180,-80,-180,504,496,1000,2255
-130,-10,110,484,516,1000,2188
180,-80,-180,504,496,1000,2255
50,80,-120,505,495,1000,2235
70,50,-60,513,487,1000,2163
-180,-80,180,504,496,1000,2255
180,-80,180,504,496,1000,2255
-50,-20,-10,511,490,1001,2254
-120,-60,-130,512,489,1001,2231
-70,-40,-130,508,493,1001,2177
90,10,160,492,509,1001,1980
-160,-30,110,501,500,1001,1871
-150,10,130,490,511,1001,2347
130,-40,130,499,502,1001,2217
110,80,-120,509,492,1001,2131
10,-50,30,507,494,1001,2294
-60,40,30,508,494,1002,2153
40,-40,-30,498,504,1002,2240
50,-80,60,516,486,1002,2263
170,-40,150,500,502,1002,2298
-90,80,70,502,500,1002,2200
-140,-80,-140,505,497,1002,2243
100,-20,140,484,518,1002,2134
-130,10,110,488,514,1002,2167
-30,-20,0,501,501,1002,2290
-100,80,80,492,510,1002,2227
-100,80,20,493,510,1003,2199
20,20,20,512,491,1003,2207
-180,70,160,499,504,1003,2235
-80,50,50,495,508,1003,2102
-130,-50,-160,504,499,1003,2235
180,70,160,499,504,1003,2235
150,-40,140,506,497,1003,2277
-110,80,90,495,509,1004,2233
0,50,0,510,494,1004,2331
90,40,-90,507,497,1004,2204
-20,-30,-80,508,496,1004,2373
-160,30,70,509,495,1004,1990
110,20,-130,487,517,1004,2223
50,10,80,514,491,1005,2008
30,10,-50,514,491,1005,2228
-10,-80,0,515,490,1005,2176
40,60,-30,514,491,1005,2286
80,-20,30,501,505,1006,2108
50,-30,-20,488,518,1006,2272
-50,60,30,508,498,1006,2257
140,-10,150,491,515,1006,2343
140,40,-160,505,501,1006,2210
110,30,150,502,505,1007,2060
70,-60,10,501,506,1007,2077
40,80,-110,506,501,1007,2258
70,20,-20,505,502,1007,2324
-110,-40,-140,509,498,1007,2179
90,0,150,494,514,1008,1966
-80,30,40,511,497,1008,2210
60,70,-60,526,483,1009,2278
100,60,180,489,520,1009,2177
-120,0,80,506,503,1009,2111
150,-70,150,526,483,1009,2210
-90,-20,-80,490,519,1009,2197
-130,-80,-130,518,491,1009,2208
70,-30,110,506,503,1009,2230
100,60,-180,489,520,1009,2177
130,60,-140,506,503,1009,2174
-40,-30,-10,515,495,1010,2219
160,50,180,503,507,1010,2229
90,0,-150,512,498,1010,2129
160,50,-180,503,507,1010,2229
-110,50,80,503,508,1011,2272
90,20,-140,495,516,1011,2138
100,-60,110,514,497,1011,2354
110,0,-180,491,520,1011,2155
130,40,130,535,476,1011,2065
-60,-40,-120,532,479,1011,2166
110,0,180,491,520,1011,2155
-50,10,10,507,504,1011,2167
-120,-50,-140,515,497,1012,2289
10,30,-60,502,510,1012,2193
-100,-50,-100,516,496,1012,2210
140,0,110,500,512,1012,2050
70,70,-70,526,486,1012,2269
-40,-10,0,506,507,1013,2358
-170,-80,-170,515,498,1013,2313
100,30,-110,499,514,1013,2175
90,60,-90,525,488,1013,2281
-120,-50,170,497,517,1014,2143
-130,-40,180,505,509,1014,2279
30,-40,-40,495,519,1014,2307
-50,30,20,511,503,1014,2155
-130,-40,-180,505,509,1014,2279
-20,-50,0,515,499,1014,2299
-150,-50,180,515,500,1015,2202
-150,-50,-180,515,500,1015,2202
50,40,-80,511,504,1015,2226
-40,50,20,515,500,1015,2379
30,0,-50,497,518,1015,2204
-120,40,90,506,510,1016,2207
170,60,170,504,513,1017,2243
-140,10,120,506,511,1017,2306
60,30,-70,514,503,1017,2207
-150,-40,170,509,508,1017,2341
-130,-60,160,521,497,1018,2113
170,-60,160,517,501,1018,2222
70,-70,10,501,517,1018,2114
-60,-50,-40,527,491,1018,2270
-10,-50,10,517,501,1018,2335
-60,0,-70,515,503,1018,2342
-150,-80,-150,515,503,1018,2270
-170,-20,150,501,518,1019,2381
-60,60,-20,505,514,1019,2164
80,-10,40,509,510,1019,2019
60,-80,70,522,497,1019,2325
-20,-10,10,520,500,1020,2381
130,70,-140,515,505,1020,2136
-120,50,30,505,515,1020,2085
-100,20,60,502,518,1020,2217
-80,-20,-100,506,515,1021,2092
100,0,-160,516,505,1021,2234
30,80,-100,517,504,1021,2302
-20,-80,-10,525,496,1021,2203
100,50,170,509,512,1021,1943
-60,-70,-50,521,500,1021,2222
40,70,-40,533,488,1021,2303
-140,-30,160,513,508,1021,2367
60,0,-30,500,522,1022,2195
-90,10,30,511,511,1022,2258
50,70,-50,530,492,1022,2269
130,10,120,508,514,1022,1987
-160,60,70,504,518,1022,2212
-170,70,150,510,512,1022,2281
20,-50,-50,506,516,1022,2316
-100,-60,-100,515,508,1023,2177
20,-50,40,520,503,1023,2360
110,30,-120,501,522,1023,2225
-160,-80,-160,520,503,1023,2316
100,-10,100,502,521,1023,2095
-10,80,0,523,500,1023,2326
150,80,130,501,522,1023,2196
0,-50,20,526,498,1024,2316
70,0,110,518,506,1024,2218
-160,-20,150,508,516,1024,2431
-80,-10,-60,507,517,1024,2178
-180,-50,160,512,513,1025,2249
180,-50,160,512,513,1025,2249
70,20,-10,500,525,1025,2338
-20,0,10,521,504,1025,2327
90,-30,50,512,513,1025,2055
-10,60,0,530,495,1025,2257
110,-10,160,510,516,1026,2240
110,-20,90,512,515,1027,2196
100,-40,120,510,517,1027,2320
70,30,-80,511,516,1027,2124
-150,-10,140,502,525,1027,2219
70,-80,80,525,502,1027,2363
-120,30,90,507,520,1027,2206
-160,70,140,511,516,1027,2305
120,-30,140,514,514,1028,2296
180,-30,150,516,512,1028,2331
-20,40,10,521,507,1028,2325
-180,-30,150,516,512,1028,2331
90,60,-160,496,532,1028,2208
-10,70,0,535,493,1028,2348
0,10,20,522,507,1029,2277
170,0,150,517,512,1029,2398
-40,0,-70,514,515,1029,2392
10,-60,30,528,501,1029,2401
-90,50,60,516,513,1029,2243
120,-10,160,505,524,1029,2369
40,-30,70,523,506,1029,2338
110,10,-140,518,512,1030,2316
-90,-20,-70,520,510,1030,2178
40,0,70,534,496,1030,2301
170,-30,100,520,511,1031,2014
160,10,160,513,518,1031,2357
130,-50,130,517,514,1031,2410
-140,-50,-170,517,515,1032,2320
160,0,100,513,520,1033,2059
-60,20,20,516,517,1033,2281
10,20,20,534,499,1033,2349
30,10,40,528,505,1033,2261
30,70,-30,531,502,1033,2341
20,0,40,522,511,1033,2184
100,-70,110,535,499,1034,2313
60,40,-90,518,516,1034,2237
60,10,-40,503,531,1034,2361
-20,40,-50,506,528,1034,2181
120,-40,130,516,518,1034,2319
-110,-70,-110,532,502,1034,2159
80,70,-80,535,500,1035,2297
160,-10,150,515,520,1035,2379
120,80,-130,529,506,1035,2223
-100,50,70,513,522,1035,2334
40,-50,60,527,508,1035,2345
160,-50,150,524,511,1035,2335
-20,10,-60,520,516,1036,2377
-120,0,90,504,532,1036,2191
110,-30,80,515,521,1036,2257
80,0,20,523,513,1036,2288
130,50,-140,506,530,1036,2247
-80,10,-20,512,525,1037,2202
-20,-20,10,518,519,1037,2477
-40,-10,-80,513,524,1037,2311
-30,-80,-20,537,500,1037,2262
-80,70,60,531,506,1037,2262
-130,-20,120,510,527,1037,2188
30,-50,50,532,505,1037,2385
-90,30,50,513,524,1037,2251
70,10,-20,513,525,1038,2216
90,40,-180,526,512,1038,1910
90,40,180,526,512,1038,1910
80,-10,30,529,509,1038,2183
-150,-20,150,528,510,1038,2378
-70,10,-40,514,524,1038,2394
-100,10,50,513,526,1039,2273
10,60,-10,532,508,1040,2338
70,30,-60,505,535,1040,2139
140,-30,140,516,524,1040,2321
0,40,10,535,505,1040,2387
30,20,30,524,516,1040,2279
120,40,-130,512,528,1040,2219
120,40,140,529,511,1040,2123
80,-30,120,523,517,1040,2192
20,-20,-50,522,519,1041,2417
70,-10,120,517,524,1041,2115
10,50,0,541,500,1041,2308
100,-40,60,519,522,1041,2199
150,-10,150,521,520,1041,2390
-150,-30,160,519,522,1041,2413
90,10,-140,495,547,1042,2131
-90,0,10,526,516,1042,2431
40,40,0,541,501,1042,2302
-70,40,40,515,528,1043,2261
-80,-60,-70,527,516,1043,2351
-90,-50,-80,528,515,1043,2393
70,20,-50,530,513,1043,2247
170,30,160,534,509,1043,2398
-110,-50,-120,533,510,1043,2351
180,60,160,509,535,1044,2417
-120,-60,170,519,525,1044,2236
80,10,20,526,518,1044,2124
140,-60,140,534,510,1044,2437
-180,60,160,509,535,1044,2417
-30,-30,0,530,515,1045,2443
70,30,-70,530,515,1045,2136
-50,50,-30,501,544,1045,2195
130,-30,140,519,526,1045,2267
-20,80,10,535,510,1045,2362
-130,20,40,544,502,1046,1920
-140,70,120,519,527,1046,2326
-60,-20,-100,528,518,1046,2216
-90,-20,-90,521,525,1046,2209
170,-10,150,523,523,1046,2441
80,-50,20,515,531,1046,2222
30,60,-20,530,516,1046,2396
-100,10,10,515,532,1047,2127
-100,0,30,523,524,1047,2348
120,0,180,515,532,1047,2257
80,0,10,522,525,1047,2266
120,0,-180,515,532,1047,2257
-120,-40,170,502,545,1047,2297
-40,-80,-30,547,500,1047,2313
0,-60,20,532,515,1047,2386
110,70,170,512,535,1047,2287
-90,-30,-60,541,507,1048,2251
-70,-30,-30,535,513,1048,2293
130,80,-140,536,512,1048,2239
30,-20,60,525,523,1048,2275
0,0,-60,528,520,1048,2451
-90,70,70,529,519,1048,2354
-130,0,70,533,515,1048,1915
110,20,140,533,516,1049,2219
150,20,180,520,529,1049,2396
-180,30,150,527,522,1049,2412
-60,60,40,534,515,1049,2237
160,-70,160,532,517,1049,2325
150,20,-180,520,529,1049,2396
180,30,150,527,522,1049,2412
-110,-60,-180,524,526,1050,2252
-150,70,130,521,529,1050,2339
-100,70,80,523,527,1050,2378
-120,0,60,520,530,1050,1986
-110,-40,-170,522,528,1050,2264
40,-10,-40,510,540,1050,2326
150,40,-170,518,532,1050,2334
60,-10,110,535,515,1050,2121
50,-40,-20,513,537,1050,2365
80,40,-120,528,522,1050,2189
-110,-60,180,524,526,1050,2252
-130,60,40,522,529,1051,2261
110,-60,120,539,512,1051,2505
-20,50,10,546,505,1051,2343
-130,-10,120,509,542,1051,2363
-110,40,80,525,527,1052,2332
60,-40,90,537,515,1052,2318
140,-40,140,526,526,1052,2457
70,-40,100,535,517,1052,2410
120,20,-150,530,522,1052,2311
20,60,-80,532,520,1052,2233
-80,-30,-40,541,511,1052,2314
-60,-30,-20,533,520,1053,2405
-10,90,0,539,514,1053,2347
180,-60,170,537,516,1053,2401
-180,-60,170,537,516,1053,2401
-160,90,150,539,514,1053,2347
-70,90,60,539,514,1053,2347
100,90,-110,539,514,1053,2347
-60,90,50,539,514,1053,2347
-80,90,70,539,514,1053,2347
90,90,-100,539,514,1053,2347
50,90,-60,539,514,1053,2347
40,90,-50,539,514,1053,2347
-20,90,10,539,514,1053,2347
130,90,-140,539,514,1053,2347
160,90,-170,539,514,1053,2347
180,90,170,539,514,1053,2347
110,90,-120,539,514,1053,2347
-50,90,40,539,514,1053,2347
140,90,-150,539,514,1053,2347
-170,90,160,539,514,1053,2347
80,0,30,537,516,1053,2246
-150,90,140,539,514,1053,2347
-180,90,170,539,514,1053,2347
-90,90,80,539,514,1053,2347
70,30,-10,535,518,1053,2252
10,90,-20,539,514,1053,2347
150,90,-160,539,514,1053,2347
-40,90,30,539,514,1053,2347
0,90,-10,539,514,1053,2347
120,90,-130,539,514,1053,2347
70,90,-80,539,514,1053,2347
30,90,-40,539,514,1053,2347
-130,90,120,539,514,1053,2347
-70,-40,-40,542,511,1053,2355
60,90,-70,539,514,1053,2347
170,90,-180,539,514,1053,2347
80,-80,90,533,520,1053,2413
-120,90,110,539,514,1053,2347
20,90,-30,539,514,1053,2347
-70,0,-60,532,521,1053,2308
80,90,-90,539,514,1053,2347
-110,90,100,539,514,1053,2347
-140,90,130,539,514,1053,2347
-30,90,20,539,514,1053,2347
170,90,180,539,514,1053,2347
-100,90,90,539,514,1053,2347
80,-10,130,517,537,1054,2189
-120,70,100,532,522,1054,2328
-180,-20,150,516,538,1054,2442
180,-20,150,516,538,1054,2442
70,60,-60,550,504,1054,2251
60,-30,100,542,512,1054,2397
30,-50,-40,522,532,1054,2370
-130,-30,160,529,525,1054,2397
150,30,110,529,526,1055,2043
30,50,-80,526,529,1055,2196
100,10,140,527,528,1055,2256
-110,20,80,524,531,1055,2211
-70,-70,-60,535,520,1055,2332
50,30,20,524,532,1056,2172
-110,10,80,516,540,1056,2232
-90,-40,-70,532,524,1056,2291
20,-40,-50,521,535,1056,2337
70,50,-50,539,517,1056,2327
110,-20,150,524,533,1057,2345
140,60,-150,532,525,1057,2313
40,10,-50,535,522,1057,2340
-80,40,-10,521,536,1057,2193
-30,80,20,547,510,1057,2419
-100,0,20,534,523,1057,2277
70,-20,0,517,540,1057,2324
110,60,160,524,534,1058,2111
10,20,-60,538,520,1058,2356
-140,60,50,537,521,1058,2087
-40,40,-40,537,521,1058,2189
-130,-30,150,525,533,1058,2399
20,-60,40,532,526,1058,2434
-160,0,140,529,530,1059,2488
170,50,170,531,528,1059,2293
110,-50,120,537,522,1059,2342
-70,-30,-120,542,517,1059,2386
-60,-10,-90,528,531,1059,2300
-180,20,150,532,527,1059,2355
70,20,30,503,556,1059,2188
50,50,-20,548,511,1059,2274
180,20,150,532,527,1059,2355
-140,-20,150,526,533,1059,2459
100,50,-100,530,529,1059,2366
140,-50,140,531,528,1059,2567
-160,-30,160,538,521,1059,2350
-90,80,10,527,532,1059,2364
-120,20,30,551,509,1060,2121
30,20,-60,529,531,1060,2282
-170,-40,160,530,530,1060,2265
90,-50,110,551,509,1060,2419
-150,60,130,528,532,1060,2407
-130,70,110,531,529,1060,2344
-10,40,10,531,529,1060,2435
-40,40,20,535,526,1061,2398
20,70,-20,546,515,1061,2413
-130,-20,140,506,555,1061,2334
-140,20,120,528,533,1061,2408
0,-10,-60,533,528,1061,2395
-20,60,10,543,519,1062,2411
0,40,-60,516,546,1062,2293
-50,-40,-20,547,515,1062,2404
90,0,-170,522,541,1063,2277
100,-30,70,552,511,1063,2264
-70,-10,-90,531,532,1063,2273
90,30,-110,543,520,1063,2186
90,0,170,536,527,1063,2246
140,40,120,536,527,1063,2209
-150,20,130,534,530,1064,2360
-110,0,30,544,520,1064,2269
70,-60,90,548,516,1064,2455
-30,0,10,540,524,1064,2483
-160,10,140,529,535,1064,2540
-110,-40,-130,543,522,1065,2322
-10,-10,20,543,522,1065,2436
-60,-40,-30,537,528,1065,2419
-110,70,90,541,525,1066,2363
-50,50,30,543,523,1066,2360
20,20,-60,542,524,1066,2211
-10,10,-60,533,533,1066,2466
100,60,-100,552,514,1066,2366
170,-20,150,540,526,1066,2491
50,0,-40,530,537,1067,2390
180,10,150,533,534,1067,2454
-170,60,150,522,545,1067,2472
140,80,-150,543,524,1067,2293
150,-50,90,523,544,1067,2136
-180,10,150,533,534,1067,2454
90,-20,70,550,517,1067,2217
10,-50,-60,529,539,1068,2390
-30,10,-60,526,542,1068,2409
60,-60,80,549,519,1068,2473
90,70,-90,550,518,1068,2394
130,-10,160,526,542,1068,2540
120,-20,150,531,537,1068,2395
-120,10,100,525,543,1068,2238
-50,-80,-40,552,517,1069,2397
40,20,-60,545,524,1069,2368
-70,0,-70,538,531,1069,2389
50,-60,70,550,519,1069,2493
20,-30,-50,529,540,1069,2420
20,-20,50,547,522,1069,2383
100,0,130,531,539,1070,2259
90,0,180,535,535,1070,2176
150,10,170,533,537,1070,2391
170,-70,170,551,519,1070,2386
90,0,-180,535,535,1070,2176
160,10,100,532,539,1071,2091
100,0,-170,533,538,1071,2318
160,20,170,544,527,1071,2451
-130,-70,160,540,531,1071,2277
50,20,40,540,531,1071,2327
-160,-20,100,538,534,1072,2123
60,-10,-20,540,532,1072,2451
30,-30,60,536,536,1072,2400
90,-70,30,521,551,1072,2205
-150,60,60,517,555,1072,2311
40,10,50,551,521,1072,2435
150,0,160,542,531,1073,2509
-180,0,150,531,542,1073,2566
-80,-40,-140,535,538,1073,2330
180,0,150,531,542,1073,2566
-70,70,-10,532,541,1073,2262
-60,-20,-10,540,533,1073,2451
-80,0,-40,531,542,1073,2254
-50,-10,0,534,540,1074,2356
-90,40,0,529,545,1074,2269
-130,-60,-140,534,540,1074,2355
160,-40,150,532,542,1074,2496
-110,50,20,533,542,1075,2231
80,-70,20,534,541,1075,2201
-130,-10,130,522,553,1075,2501
-20,70,10,561,514,1075,2428
-40,-20,-90,558,517,1075,2419
90,-80,100,555,521,1076,2454
90,-40,40,526,550,1076,2209
40,-60,60,545,531,1076,2506
130,-20,150,539,538,1077,2540
-100,-40,-160,546,531,1077,2337
100,0,-140,530,547,1077,2287
-180,-10,150,537,540,1077,2503
70,30,0,543,534,1077,2194
180,-10,150,537,540,1077,2503
20,40,-70,541,537,1078,2412
90,20,-130,521,557,1078,2085
-130,20,110,527,551,1078,2322
-120,-40,-160,540,538,1078,2345
70,40,-30,552,526,1078,2269
70,40,-100,545,534,1079,2275
40,-50,-30,525,554,1079,2449
-120,-70,170,534,545,1079,2249
110,-70,120,565,514,1079,2415
110,-30,140,532,547,1079,2415
80,50,-70,550,529,1079,2342
-70,-50,-50,543,536,1079,2416
-120,0,100,531,549,1080,2203
180,10,90,553,527,1080,2180
170,-40,100,545,535,1080,2155
50,-30,90,550,530,1080,2521
50,-40,80,551,529,1080,2411
-180,10,90,553,527,1080,2180
110,-40,70,539,541,1080,2314
-20,50,-50,507,573,1080,2313
-90,-20,-60,547,534,1081,2298
-160,60,140,521,560,1081,2459
-10,-60,10,554,527,1081,2448
-140,60,120,536,545,1081,2426
-110,30,80,534,547,1081,2352
130,30,-150,530,552,1082,2396
140,70,-150,545,537,1082,2282
-170,20,80,537,545,1082,2137
150,-10,100,539,543,1082,2145
-20,-30,10,545,537,1082,2516
-90,-20,-50,552,530,1082,2213
80,40,-70,535,548,1083,2397
30,0,50,554,529,1083,2336
80,0,40,544,539,1083,2266
20,60,-10,561,522,1083,2506
60,-30,-10,531,552,1083,2392
-80,-70,-70,548,535,1083,2361
-130,-40,-170,546,537,1083,2534
-80,-10,-10,548,535,1083,2358
140,80,140,524,559,1083,2338
-130,-50,-150,539,544,1083,2386
160,40,-180,536,548,1084,2395
50,30,-70,560,524,1084,2281
160,40,180,536,548,1084,2395
130,-70,70,536,548,1084,2286
110,10,130,546,538,1084,2289
-70,60,50,547,537,1084,2330
80,-40,20,529,556,1085,2392
-40,0,10,550,535,1085,2480
-110,-60,-110,560,525,1085,2351
80,-40,110,542,544,1086,2532
50,80,-50,556,530,1086,2515
-170,-60,180,548,538,1086,2475
-30,-60,-10,551,535,1086,2387
-170,-60,-180,548,538,1086,2475
120,20,130,548,539,1087,2144
-60,-80,-50,566,521,1087,2441
0,70,-70,551,536,1087,2457
10,-20,40,552,535,1087,2522
0,20,20,547,541,1088,2453
-10,-20,20,553,535,1088,2528
110,-40,130,544,544,1088,2489
40,80,-40,557,531,1088,2510
60,20,-60,546,542,1088,2357
80,40,-60,547,541,1088,2324
100,40,-100,545,544,1089,2409
60,-40,-10,539,550,1089,2492
60,20,50,551,538,1089,2233
100,-80,110,564,526,1090,2469
40,30,20,547,543,1090,2384
80,-10,20,548,542,1090,2457
-100,-30,-100,546,544,1090,2322
100,-70,40,540,551,1091,2290
100,-50,50,544,547,1091,2304
-30,-30,-90,567,524,1091,2422
-90,0,0,541,550,1091,2438
-40,30,20,553,540,1093,2402
180,-60,110,550,543,1093,2239
140,0,170,545,548,1093,2543
-180,-60,110,550,543,1093,2239
-100,-40,-90,552,541,1093,2432
-140,-70,150,554,540,1094,2313
-40,80,30,566,528,1094,2469
-90,-20,-100,534,560,1094,2373
-60,10,-50,535,560,1095,2525
50,20,50,554,541,1095,2303
-20,-60,0,554,541,1095,2425
-50,20,20,552,543,1095,2410
80,0,50,542,553,1095,2298
-100,-60,-170,539,556,1095,2303
170,-30,150,552,543,1095,2443
50,20,-60,552,544,1096,2354
80,30,-50,545,551,1096,2276
60,50,-30,572,525,1097,2359
80,0,110,544,553,1097,2373
-80,20,-20,540,557,1097,2429
150,70,-160,556,541,1097,2350
-10,-20,-70,540,557,1097,2530
10,-70,30,562,536,1098,2564
40,50,-10,556,542,1098,2363
140,50,-150,547,551,1098,2506
60,10,90,551,547,1098,2267
10,-40,-60,537,561,1098,2430
80,10,0,556,543,1099,2376
-80,80,0,556,543,1099,2490
-120,0,50,548,551,1099,2142
-80,-40,-50,557,542,1099,2448
10,40,10,560,539,1099,2414
-100,40,10,540,559,1099,2243
0,10,-60,554,545,1099,2540
90,-30,130,543,557,1100,2405
-80,40,50,554,546,1100,2332
20,-30,50,549,551,1100,2536
-80,0,10,536,564,1100,2547
30,-60,50,551,550,1101,2547
10,50,-70,547,554,1101,2384
-40,-60,-20,565,536,1101,2380
60,80,-60,563,538,1101,2508
-40,20,-50,560,541,1101,2433
50,20,60,553,548,1101,2294
0,30,-60,539,562,1101,2324
70,50,-120,555,546,1101,2389
-110,-70,180,544,558,1102,2265
80,30,-40,538,564,1102,2204
-130,-10,100,533,569,1102,2267
-50,-60,-30,574,528,1102,2454
-130,60,110,548,554,1102,2462
-110,-70,-180,544,558,1102,2265
100,20,150,546,556,1102,2197
-140,-10,140,543,559,1102,2487
-60,20,-40,555,547,1102,2335
-180,-70,180,562,541,1103,2485
180,-70,-180,562,541,1103,2485
90,-40,120,550,553,1103,2506
140,10,180,550,553,1103,2439
180,-70,180,562,541,1103,2485
30,80,-30,564,539,1103,2594
-180,-70,-180,562,541,1103,2485
140,10,-180,550,553,1103,2439
-70,-80,-60,576,527,1103,2488
-40,10,-60,542,561,1103,2576
-170,-10,150,553,551,1104,2532
-90,-40,-150,555,549,1104,2279
-80,-20,-110,556,548,1104,2272
10,10,30,558,546,1104,2598
-130,0,120,539,565,1104,2576
50,10,90,558,546,1104,2258
80,-60,100,560,544,1104,2534
110,-80,120,571,533,1104,2487
-130,-30,140,551,553,1104,2403
150,80,-160,561,544,1105,2421
50,10,-50,553,552,1105,2436
-140,-40,-180,547,558,1105,2462
-140,-40,180,547,558,1105,2462
180,50,160,548,557,1105,2461
-180,50,160,548,557,1105,2461
-80,-80,-70,571,535,1106,2480
60,20,70,550,556,1106,2303
-40,-20,0,555,551,1106,2508
-100,0,40,558,548,1106,2493
120,-70,130,582,524,1106,2510
-120,20,100,538,568,1106,2371
-110,0,70,546,561,1107,2345
-70,20,-30,548,559,1107,2371
70,10,-30,564,543,1107,2399
60,30,20,547,560,1107,2357
-120,-70,-120,572,535,1107,2335
100,-10,160,549,558,1107,2302
150,60,-160,559,548,1107,2460
70,-20,120,546,562,1108,2291
150,-20,150,552,556,1108,2606
120,-50,130,561,548,1109,2552
-170,-40,110,559,550,1109,2264
-40,-40,-10,560,549,1109,2445
-10,60,-60,563,546,1109,2410
-90,-30,-130,545,564,1109,2390
40,-40,70,564,545,1109,2505
160,-20,150,560,549,1109,2603
90,10,150,538,572,1110,2271
90,-20,60,563,547,1110,2353
20,50,0,578,534,1112,2409
-90,0,20,556,556,1112,2615
70,80,-70,564,548,1112,2510
10,-30,40,564,548,1112,2516
-50,30,-40,549,563,1112,2350
80,-90,90,564,549,1113,2454
10,-90,20,564,549,1113,2454
90,-90,100,564,549,1113,2454
180,-90,-170,564,549,1113,2454
40,-90,50,564,549,1113,2454
-150,-90,-140,564,549,1113,2454
-120,-40,-150,548,565,1113,2387
-180,-90,-170,564,549,1113,2454
-100,-90,-90,564,549,1113,2454
-70,-90,-60,564,549,1113,2454
80,10,30,558,555,1113,2305
60,-90,70,564,549,1113,2454
-90,-90,-80,564,549,1113,2454
20,-90,30,564,549,1113,2454
-40,-90,-30,564,549,1113,2454
-140,-90,-130,564,549,1113,2454
-150,-70,140,570,543,1113,2316
-30,70,20,570,543,1113,2482
-170,-90,-160,564,549,1113,2454
130,-90,140,564,549,1113,2454
0,-50,-70,555,558,1113,2430
130,-40,140,554,559,1113,2580
-120,-90,-110,564,549,1113,2454
140,-90,150,564,549,1113,2454
-110,-90,-100,564,549,1113,2454
170,-90,180,564,549,1113,2454
170,-90,-180,564,549,1113,2454
150,-60,150,569,544,1113,2506
0,-90,10,564,549,1113,2454
120,-90,130,564,549,1113,2454
-80,-90,-70,564,549,1113,2454
-160,-90,-150,564,549,1113,2454
-60,-90,-50,564,549,1113,2454
110,-90,120,564,549,1113,2454
30,-90,40,564,549,1113,2454
-10,-90,0,564,549,1113,2454
70,-90,80,564,549,1113,2454
50,-90,60,564,549,1113,2454
160,-90,170,564,549,1113,2454
-130,-90,-120,564,549,1113,2454
100,-90,110,564,549,1113,2454
170,-50,160,557,556,1113,2521
-20,-90,-10,564,549,1113,2454
-50,-90,-40,564,549,1113,2454
170,20,160,560,553,1113,2518
150,-90,160,564,549,1113,2454
-30,-90,-20,564,549,1113,2454
-130,-30,170,544,570,1114,2638
-10,-30,20,565,549,1114,2568
-150,0,80,556,558,1114,2263
-50,0,10,567,547,1114,2434
-170,50,150,553,561,1114,2473
-150,50,130,544,570,1114,2555
-170,-50,170,563,552,1115,2459
50,0,100,578,537,1115,2284
110,40,150,571,545,1116,2271
-160,-60,-170,561,555,1116,2498
-160,50,140,556,560,1116,2572
80,60,-70,576,540,1116,2390
-60,30,30,563,554,1117,2460
-50,80,40,577,540,1117,2492
20,80,-20,571,546,1117,2622
80,80,-80,566,551,1117,2531
-150,30,130,549,569,1118,2483
-10,0,20,571,547,1118,2483
60,20,60,563,555,1118,2167
-130,-40,150,568,550,1118,2393
10,70,-10,569,549,1118,2509
0,-40,-70,555,563,1118,2496
-150,-50,130,567,551,1118,2299
-170,-30,160,575,544,1119,2576
140,-20,150,552,567,1119,2604
90,0,140,553,566,1119,2378
70,10,70,546,573,1119,2302
50,-10,100,555,564,1119,2312
-100,-30,-110,554,565,1119,2360
-30,-10,10,566,554,1120,2603
90,30,170,561,559,1120,2281
-30,0,-70,569,551,1120,2571
-130,-20,150,551,569,1120,2619
-160,-70,130,569,551,1120,2331
50,70,-40,577,543,1120,2532
-100,40,70,553,567,1120,2557
50,20,70,561,559,1120,2246
-90,-20,-40,573,547,1120,2426
40,-20,80,562,558,1120,2501
30,-40,60,564,557,1121,2599
70,60,-130,549,572,1121,2395
-60,70,-20,567,554,1121,2460
80,-60,20,547,574,1121,2365
-50,-30,-10,575,546,1121,2469
-30,60,20,571,550,1121,2598
-140,-60,-150,562,559,1121,2508
-90,-80,-80,578,544,1122,2502
-10,10,20,579,543,1122,2464
50,-50,-20,559,564,1123,2464
0,20,-60,568,555,1123,2488
30,60,-90,567,556,1123,2501
100,70,-100,576,547,1123,2481
160,80,-170,567,556,1123,2503
20,-70,40,572,551,1123,2625
-160,20,140,557,566,1123,2430
0,60,0,582,541,1123,2464
170,40,170,551,573,1124,2465
110,-10,100,557,567,1124,2346
60,70,-50,589,536,1125,2490
-20,-10,-70,565,561,1126,2582
160,70,-170,564,562,1126,2511
-160,-50,-180,572,554,1126,2550
120,-80,130,580,546,1126,2572
-160,-50,180,572,554,1126,2550
0,-60,-70,582,545,1127,2470
-100,-30,-130,564,563,1127,2386
150,-50,150,571,556,1127,2714
20,40,10,579,548,1127,2482
-70,40,-20,579,548,1127,2294
80,30,-80,570,558,1128,2288
80,40,-50,559,569,1128,2331
90,30,-100,573,555,1128,2321
-90,-60,-80,577,551,1128,2504
-140,10,60,584,544,1128,2136
-110,-50,180,555,573,1128,2391
-110,-50,-180,555,573,1128,2391
-20,-40,10,572,556,1128,2588
130,80,150,545,584,1129,2505
140,20,-170,557,572,1129,2377
50,60,-30,583,546,1129,2507
-140,0,130,566,563,1129,2622
-40,70,30,582,547,1129,2489
150,40,110,570,560,1130,2273
-10,-70,10,580,550,1130,2584
-80,-50,-60,571,559,1130,2547
120,30,-130,549,582,1131,2572
100,-50,120,567,564,1131,2609
60,0,110,582,549,1131,2281
-90,-70,-80,574,557,1131,2484
-170,-70,-170,570,562,1132,2549
10,-30,-60,564,568,1132,2525
110,0,120,561,571,1132,2345
110,0,-170,556,576,1132,2408
-100,-70,-170,557,575,1132,2350
10,10,-60,574,558,1132,2552
130,40,-140,560,573,1133,2469
-120,60,100,563,570,1133,2429
40,-10,80,586,547,1133,2459
0,-70,20,577,556,1133,2561
-180,-40,160,571,562,1133,2494
180,-40,160,571,562,1133,2494
90,80,-90,577,556,1133,2533
140,-10,160,563,570,1133,2727
170,80,180,575,559,1134,2551
100,20,-120,550,584,1134,2419
170,80,-180,575,559,1134,2551
120,-70,60,561,573,1134,2438
30,-10,-50,563,571,1134,2593
-100,-30,-120,565,569,1134,2394
100,-20,80,568,566,1134,2490
70,70,-60,582,552,1134,2532
-120,-30,170,551,583,1134,2540
80,30,-60,556,579,1135,2416
-150,-50,-170,569,566,1135,2631
80,70,-150,548,587,1135,2542
120,-50,70,551,584,1135,2449
40,60,-20,586,549,1135,2546
-60,80,50,577,558,1135,2604
-110,60,90,572,564,1136,2417
-50,10,-60,568,568,1136,2671
80,20,-40,566,570,1136,2427
80,20,0,563,573,1136,2282
-150,10,70,560,576,1136,2277
110,-70,50,566,571,1137,2394
140,10,110,578,559,1137,2287
-10,50,10,582,555,1137,2559
-30,30,-50,562,575,1137,2369
80,20,10,574,563,1137,2298
-50,60,-30,564,573,1137,2420
-30,-40,0,580,558,1138,2532
-80,-20,-20,575,563,1138,2436
-130,-70,-130,588,550,1138,2492
70,20,-60,568,570,1138,2394
-80,0,-50,562,576,1138,2383
80,-20,130,560,578,1138,2387
160,-30,150,567,572,1139,2646
50,-70,70,578,561,1139,2633
0,-20,30,570,569,1139,2628
20,-40,50,586,553,1139,2640
150,-40,150,565,574,1139,2758
-60,50,40,572,568,1140,2432
70,10,-40,566,574,1140,2493
120,-60,130,586,554,1140,2672
80,-20,20,565,575,1140,2424
-60,-10,0,571,570,1141,2520
-90,-30,-50,586,555,1141,2469
40,70,-30,596,545,1141,2599
-100,-50,-90,576,565,1141,2595
60,40,-10,598,544,1142,2299
-160,-10,150,569,573,1142,2570
130,0,180,553,589,1142,2388
40,40,-80,576,566,1142,2512
130,0,-180,553,589,1142,2388
10,70,-80,574,568,1142,2655
-180,80,170,575,568,1143,2633
-100,-30,-90,567,576,1143,2465
180,80,170,575,568,1143,2633
-140,-50,-160,567,576,1143,2579
40,30,-70,575,568,1143,2471
120,20,-140,566,578,1144,2507
-60,-50,-130,589,555,1144,2313
-140,30,120,563,581,1144,2453
100,10,-130,578,566,1144,2459
-90,10,-10,563,582,1145,2436
110,50,-110,572,573,1145,2539
-100,-80,-90,589,556,1145,2561
30,-10,60,568,577,1145,2397
90,50,-80,578,567,1145,2527
-20,30,20,590,555,1145,2661
-50,-10,-90,569,576,1145,2538
-100,10,60,568,578,1146,2414
-70,80,-10,569,577,1146,2594
10,-40,40,580,566,1146,2684
120,10,120,565,581,1146,2332
0,-30,30,583,563,1146,2592
30,-70,50,580,568,1148,2657
90,-60,110,586,562,1148,2630
-160,-40,170,556,592,1148,2618
-120,-50,-130,587,561,1148,2533
40,-70,60,575,574,1149,2682
170,10,160,574,575,1149,2662
80,40,-130,569,580,1149,2475
180,40,160,579,570,1149,2614
110,20,-120,560,589,1149,2535
-70,-60,-140,593,556,1149,2480
-180,40,160,579,570,1149,2614
40,50,-90,575,574,1149,2517
-160,40,140,572,577,1149,2655
50,40,0,583,567,1150,2417
130,20,-160,560,590,1150,2567
-160,30,140,573,577,1150,2594
-70,80,60,587,563,1150,2618
-20,20,20,591,559,1150,2682
-120,-30,-180,567,584,1151,2584
-10,20,20,597,554,1151,2579
130,-30,150,559,592,1151,2647
90,-10,150,578,573,1151,2431
-30,50,20,586,565,1151,2654
-120,-30,180,567,584,1151,2584
-70,-20,-110,592,559,1151,2481
-150,-60,-160,574,578,1152,2554
10,60,0,597,555,1152,2687
-80,60,60,572,580,1152,2494
160,70,110,577,576,1153,2458
80,0,0,575,578,1153,2564
-10,-60,-80,584,569,1153,2505
-80,-10,-90,579,574,1153,2434
-100,60,80,580,573,1153,2512
110,-50,60,563,590,1153,2569
80,30,-70,573,580,1153,2434
40,60,-100,579,575,1154,2503
-50,0,-80,573,581,1154,2519
160,60,-170,576,578,1154,2529
70,-50,100,585,569,1154,2596
80,50,-140,555,599,1154,2445
-40,20,20,585,570,1155,2565
-10,-40,20,581,574,1155,2713
-60,0,10,571,584,1155,2553
80,20,-50,580,575,1155,2420
80,20,-30,576,579,1155,2457
-70,10,20,569,586,1155,2472
-100,0,50,575,581,1156,2542
-170,80,160,582,574,1156,2685
-60,-60,-40,591,565,1156,2577
90,0,-140,572,585,1157,2390
-140,20,50,593,564,1157,2135
10,80,-10,595,562,1157,2689
70,30,10,577,580,1157,2453
-140,-50,140,584,573,1157,2414
150,70,120,582,575,1157,2526
-70,0,10,566,591,1157,2487
-20,-70,0,596,561,1157,2621
10,0,-60,583,574,1157,2696
100,-30,140,570,587,1157,2528
30,-60,-40,590,568,1158,2624
0,-10,30,579,579,1158,2654
-150,0,140,591,567,1158,2665
20,10,-60,583,575,1158,2661
140,-30,150,569,590,1159,2687
70,-10,-10,574,585,1159,2625
20,-60,-50,593,566,1159,2585
80,-30,20,575,584,1159,2517
-120,0,110,566,593,1159,2556
-50,40,30,596,563,1159,2541
40,0,-50,588,571,1159,2477
130,-70,140,610,549,1159,2642
50,60,-110,586,574,1160,2549
-70,20,30,580,580,1160,2549
70,50,-40,603,557,1160,2467
30,30,20,590,570,1160,2653
80,0,90,582,579,1161,2478
170,70,180,580,581,1161,2592
10,-60,-60,598,563,1161,2499
-140,50,120,563,598,1161,2596
60,-20,110,594,567,1161,2376
60,10,-50,585,576,1161,2519
-90,-10,-40,559,602,1161,2498
170,70,-180,580,581,1161,2592
-30,-70,-10,597,564,1161,2592
-80,10,30,578,583,1161,2583
-10,30,20,600,561,1161,2696
-100,30,70,584,577,1161,2588
40,-30,80,593,569,1162,2684
-60,0,-80,583,579,1162,2623
30,30,-70,590,572,1162,2502
-90,40,60,572,591,1163,2572
60,-70,80,604,559,1163,2677
150,30,-170,567,596,1163,2559
110,0,-160,582,581,1163,2621
50,50,-100,584,579,1163,2584
160,0,160,578,585,1163,2718
120,-20,90,563,601,1164,2403
90,-10,-160,581,583,1164,2427
100,80,-100,596,568,1164,2604
60,-50,90,582,582,1164,2597
140,50,120,587,577,1164,2344
130,0,110,590,575,1165,2371
130,-80,140,592,573,1165,2637
0,70,0,596,569,1165,2649
-90,60,70,576,590,1166,2506
80,0,60,581,585,1166,2434
0,-40,30,597,569,1166,2679
90,20,160,587,579,1166,2318
60,60,-40,605,561,1166,2579
80,50,-60,592,574,1166,2564
70,0,-20,573,593,1166,2507
-50,-60,-120,596,571,1167,2516
-30,-20,10,581,586,1167,2705
-110,-40,180,579,588,1167,2428
-110,-80,-100,604,563,1167,2619
-110,-40,-180,579,588,1167,2428
20,-50,50,588,579,1167,2789
60,50,-110,601,566,1167,2494
-170,0,150,569,599,1168,2827
-90,-40,-60,593,575,1168,2562
150,50,110,583,585,1168,2325
30,70,-20,610,558,1168,2722
10,30,20,588,580,1168,2638
-140,-30,120,587,581,1168,2297
50,-50,80,584,584,1168,2685
110,60,-110,604,564,1168,2508
80,20,20,571,597,1168,2499
140,-60,80,591,578,1169,2484
140,-30,90,566,603,1169,2351
40,-50,70,588,581,1169,2752
80,30,-30,589,580,1169,2389
-30,40,20,596,573,1169,2695
120,-10,170,558,611,1169,2531
140,30,-160,569,600,1169,2599
-110,-50,-110,589,581,1170,2566
-110,-40,-120,601,569,1170,2519
100,40,160,607,563,1170,2403
80,0,120,587,583,1170,2495
-130,-40,-160,577,593,1170,2736
0,50,10,599,571,1170,2670
-140,-30,170,586,585,1171,2783
-160,-70,-160,583,588,1171,2629
-10,-40,-80,585,587,1172,2577
-80,80,70,599,574,1173,2692
160,-60,160,599,574,1173,2617
-80,10,-30,581,593,1174,2482
80,0,100,586,588,1174,2429
130,20,120,590,584,1174,2335
70,20,40,579,595,1174,2446
90,-20,140,577,597,1174,2428
170,-50,100,580,594,1174,2303
120,80,160,569,605,1174,2651
130,50,130,603,572,1175,2386
-130,-10,140,582,593,1175,2668
150,50,-160,581,594,1175,2643
0,30,20,592,583,1175,2642
10,-10,40,599,577,1176,2598
-150,-70,-150,591,585,1176,2608
-80,-30,-130,588,588,1176,2567
140,-70,150,610,566,1176,2695
-60,-60,-130,607,569,1176,2385
-140,-70,-140,602,574,1176,2600
-50,70,40,614,563,1177,2576
130,-60,140,606,571,1177,2724
120,-40,140,581,596,1177,2704
20,-10,50,584,593,1177,2532
-170,40,150,591,586,1177,2657
-170,10,150,593,584,1177,2764
-70,-60,-50,611,566,1177,2687
150,-30,150,587,591,1178,2735
170,70,100,591,587,1178,2429
-150,-20,100,575,603,1178,2415
90,40,-80,595,583,1178,2593
-40,60,30,610,569,1179,2631
80,30,-160,578,601,1179,2247
170,60,-180,574,605,1179,2668
40,10,60,600,579,1179,2637
170,60,180,574,605,1179,2668
10,-20,-60,592,588,1180,2778
-160,-10,90,596,584,1180,2361
0,80,0,603,577,1180,2755
-110,10,20,588,592,1180,2438
110,40,-110,586,594,1180,2568
-170,-70,120,588,592,1180,2471
-70,-70,-140,592,589,1181,2545
110,70,-110,599,582,1181,2591
-170,20,150,598,583,1181,2660
-40,50,-40,577,604,1181,2547
-140,-40,130,594,588,1182,2413
120,-30,150,584,598,1182,2684
-90,10,40,593,589,1182,2645
-50,70,-30,595,587,1182,2622
130,10,-170,582,600,1182,2585
30,-50,60,598,585,1183,2783
60,60,-120,585,598,1183,2673
-40,-30,0,592,591,1183,2672
10,-50,40,604,579,1183,2767
40,-60,-30,598,585,1183,2718
130,-20,160,582,601,1183,2807
60,30,-80,600,583,1183,2553
160,30,180,588,596,1184,2723
-20,10,20,614,570,1184,2658
-150,40,130,570,614,1184,2665
160,30,-180,588,596,1184,2723
140,-80,150,599,585,1184,2700
-130,50,110,574,610,1184,2576
-170,30,150,602,582,1184,2651
120,-10,100,571,613,1184,2534
-30,30,20,606,579,1185,2680
150,-80,160,597,588,1185,2742
-120,-40,-140,607,578,1185,2582
70,-70,90,604,581,1185,2658
-30,20,20,620,565,1185,2588
110,-10,170,581,604,1185,2532
-60,40,-30,602,583,1185,2458
80,30,-150,566,620,1186,2377
-70,-30,-20,613,574,1187,2676
-70,-10,0,591,596,1187,2592
-90,80,80,603,584,1187,2732
-40,-50,-10,612,575,1187,2580
-100,20,70,586,601,1187,2600
-160,80,150,592,595,1187,2715
80,10,-160,588,600,1188,2402
-90,-70,-160,599,589,1188,2433
90,-60,30,590,598,1188,2504
100,-40,130,584,604,1188,2708
-30,-10,-80,592,597,1189,2773
-40,-70,-20,611,578,1189,2670
90,60,-80,603,586,1189,2634
20,90,-100,589,601,1190,2725
70,90,-150,589,601,1190,2725
-60,90,-20,589,601,1190,2725
-120,0,40,621,569,1190,2320
-40,-10,10,598,592,1190,2729
0,90,-80,589,601,1190,2725
30,90,-110,589,601,1190,2725
100,90,-180,589,601,1190,2725
-50,90,-30,589,601,1190,2725
-90,90,10,589,601,1190,2725
-140,90,60,589,601,1190,2725
-30,90,-50,589,601,1190,2725
100,90,180,589,601,1190,2725
90,90,-170,589,601,1190,2725
120,90,160,589,601,1190,2725
130,90,150,589,601,1190,2725
-150,90,70,589,601,1190,2725
50,90,-130,589,601,1190,2725
150,90,130,589,601,1190,2725
-180,90,100,589,601,1190,2725
80,90,-160,589,601,1190,2725
120,-20,160,588,602,1190,2631
-80,90,0,589,601,1190,2725
180,90,100,589,601,1190,2725
-40,90,-40,589,601,1190,2725
-110,90,30,589,601,1190,2725
-100,-40,-80,587,603,1190,2632
-10,90,-70,589,601,1190,2725
60,90,-140,589,601,1190,2725
-110,20,90,589,601,1190,2598
20,20,30,605,585,1190,2700
-170,90,90,589,601,1190,2725
-100,-30,-80,600,590,1190,2609
160,90,120,589,601,1190,2725
-180,-30,100,588,602,1190,2391
140,90,140,589,601,1190,2725
-70,90,-10,589,601,1190,2725
-160,90,80,589,601,1190,2725
10,90,-90,589,601,1190,2725
-130,90,50,589,601,1190,2725
-20,90,-60,589,601,1190,2725
40,90,-120,589,601,1190,2725
180,-30,100,588,602,1190,2391
80,-50,110,604,586,1190,2689
110,90,170,589,601,1190,2725
80,-40,120,598,592,1190,2691
-100,90,20,589,601,1190,2725
-120,90,40,589,601,1190,2725
170,90,110,589,601,1190,2725
70,-40,0,569,622,1191,2648
-80,-30,-30,613,578,1191,2683
-70,50,50,596,595,1191,2586
90,0,130,598,593,1191,2547
-120,-10,120,586,606,1192,2654
20,70,-90,599,593,1192,2755
120,10,-160,593,599,1192,2621
-50,-20,0,606,586,1192,2721
-120,-80,-110,610,583,1193,2701
-90,-20,-30,604,589,1193,2621
150,-10,160,595,598,1193,2870
-10,80,10,616,577,1193,2795
30,60,-10,628,565,1193,2699
-20,40,20,610,584,1194,2797
-10,-50,-80,606,588,1194,2535
110,80,-110,607,587,1194,2662
-180,70,170,597,597,1194,2675
-70,-50,-140,613,581,1194,2596
90,-30,40,586,608,1194,2465
-150,80,140,599,595,1194,2731
180,70,170,597,597,1194,2675
-60,10,20,594,600,1194,2605
-30,10,20,610,585,1195,2712
70,-40,110,602,593,1195,2770
-40,-30,-100,605,590,1195,2543
90,-10,80,597,598,1195,2733
80,70,-70,608,587,1195,2687
170,0,160,595,600,1195,2790
-90,-60,-160,596,599,1195,2508
40,0,80,599,596,1195,2598
-80,-70,-150,601,594,1195,2501
170,30,170,597,598,1195,2748
80,10,-10,580,616,1196,2565
60,-50,-10,591,605,1196,2660
40,10,70,608,588,1196,2540
70,-30,0,584,612,1196,2683
90,0,120,579,617,1196,2512
-120,50,100,587,609,1196,2627
-100,80,90,605,591,1196,2796
-20,-20,-80,609,588,1197,2681
100,-60,120,618,579,1197,2742
-130,80,120,596,601,1197,2777
-180,70,90,589,608,1197,2495
180,70,90,589,608,1197,2495
-100,50,10,587,610,1197,2553
-130,-30,130,595,602,1197,2390
30,40,10,631,566,1197,2643
-140,-10,90,595,602,1197,2582
-50,-70,-30,617,581,1198,2693
40,20,40,608,590,1198,2622
-60,80,-20,599,599,1198,2720
30,10,-60,592,606,1198,2763
110,10,-130,595,603,1198,2633
160,30,100,604,594,1198,2428
-90,-50,-70,602,596,1198,2712
90,-20,50,595,604,1199,2482
-150,-40,-180,589,610,1199,2721
-150,-40,180,589,610,1199,2721
-90,-20,-110,600,599,1199,2446
-160,-50,120,599,601,1200,2580
80,-70,100,614,586,1200,2673
80,10,-170,611,589,1200,2496
80,40,-160,590,610,1200,2411
-120,60,30,586,614,1200,2655
-100,-70,-90,614,586,1200,2601
70,10,-50,595,605,1200,2628
150,-40,90,595,605,1200,2460
110,0,-150,582,619,1201,2726
-140,10,130,605,596,1201,2868
-10,60,10,616,585,1201,2657
-20,-50,10,615,586,1201,2785
-20,-10,20,600,602,1202,2804
-110,80,100,603,599,1202,2795
140,70,130,604,598,1202,2602
-140,80,130,601,601,1202,2766
-100,-60,-90,614,588,1202,2630
130,70,140,596,606,1202,2624
90,60,-170,597,605,1202,2655
80,0,80,605,598,1203,2566
160,-80,170,605,598,1203,2789
-150,-10,90,610,594,1204,2510
-130,30,110,599,605,1204,2593
100,-20,150,587,617,1204,2540
-50,10,20,622,582,1204,2701
-110,-30,-170,593,611,1204,2632
70,40,-110,623,581,1204,2601
-100,0,10,602,603,1205,2597
80,-10,10,589,617,1206,2734
-80,-60,-150,631,575,1206,2593
-30,-50,0,623,583,1206,2704
-20,0,20,623,584,1207,2740
-20,-60,-90,621,586,1207,2502
80,30,-90,618,589,1207,2459
130,-10,170,596,611,1207,2679
0,0,30,610,598,1208,2758
-140,40,120,590,618,1208,2665
90,40,-70,601,607,1208,2714
-90,20,50,590,618,1208,2651
140,-40,150,607,601,1208,2961
20,30,20,611,597,1208,2756
-10,40,20,619,590,1209,2863
-120,80,110,606,603,1209,2797
160,40,100,613,596,1209,2393
60,0,-40,605,605,1210,2690
160,20,100,600,610,1210,2334
70,30,-90,598,612,1210,2524
120,10,-150,598,612,1210,2834
160,50,-170,593,618,1211,2684
80,0,-160,616,595,1211,2430
50,-40,90,613,598,1211,2835
-10,-50,20,611,600,1211,2805
-120,30,100,599,612,1211,2667
160,10,170,602,610,1212,2771
80,40,-140,589,623,1212,2692
90,0,110,603,609,1212,2599
110,0,-140,591,621,1212,2732
-60,-70,-130,614,598,1212,2567
120,50,140,622,591,1213,2444
130,-50,140,605,608,1213,2835
-140,-40,-170,607,606,1213,2847
-30,-60,-100,634,580,1214,2637
-40,-60,-110,633,581,1214,2669
-110,50,90,608,606,1214,2722
20,70,-10,623,591,1214,2844
160,-50,160,611,603,1214,2808
-80,-10,0,608,606,1214,2789
-120,-30,-170,595,620,1215,2735
100,30,-100,605,610,1215,2705
-70,30,40,602,613,1215,2628
90,-10,-150,609,606,1215,2574
-90,-10,-30,603,612,1215,2642
-110,0,80,588,627,1215,2625
80,10,40,617,599,1216,2451
-90,0,30,610,606,1216,2886
-120,-60,-120,623,593,1216,2582
-100,-30,-140,599,618,1217,2529
-80,20,40,609,608,1217,2686
170,-40,160,611,606,1217,2793
-60,70,50,615,602,1217,2725
-120,-10,130,602,616,1218,2731
70,40,-20,623,595,1218,2495
-120,-30,160,605,614,1219,2721
100,0,120,607,612,1219,2643
80,20,-150,593,626,1219,2510
-50,-30,-110,614,605,1219,2617
-70,-20,-10,614,605,1219,2687
180,-30,160,618,602,1220,2838
-180,-30,160,618,602,1220,2838
160,20,-180,608,613,1221,2844
-10,20,-60,613,608,1221,2700
160,20,180,608,613,1221,2844
80,40,-150,602,619,1221,2542
-60,10,-60,611,610,1221,2709
-170,70,160,613,608,1221,2808
80,20,-10,597,624,1221,2596
-50,-50,-20,622,599,1221,2709
100,60,170,593,629,1222,2533
-60,-50,-30,618,604,1222,2827
-10,30,-60,601,621,1222,2684
70,70,-140,597,625,1222,2745
80,60,-150,594,629,1223,2708
140,-60,150,631,592,1223,2860
120,0,-170,614,609,1223,2727
150,0,170,597,626,1223,2902
-100,-50,-170,613,610,1223,2685
120,60,-120,629,594,1223,2711
110,-40,140,619,604,1223,2820
-110,10,90,599,624,1223,2518
70,60,-50,634,590,1224,2630
80,40,-40,631,593,1224,2499
120,70,-120,618,606,1224,2718
80,20,-20,614,610,1224,2691
-50,-70,-120,616,609,1225,2635
10,-10,-60,602,623,1225,2770
-180,60,170,604,621,1225,2770
180,60,170,604,621,1225,2770
-130,-20,160,616,609,1225,2891
-150,-30,170,598,627,1225,2894
-120,40,100,606,620,1226,2764
-40,50,30,618,608,1226,2804
-150,-40,120,612,614,1226,2577
120,80,-120,620,606,1226,2724
50,-20,100,623,604,1227,2601
-100,10,70,604,623,1227,2628
-10,70,10,632,595,1227,2764
-110,-30,-160,605,622,1227,2679
-50,60,40,624,603,1227,2795
30,50,0,625,602,1227,2672
90,-70,110,622,606,1228,2734
-150,-20,160,614,614,1228,2813
170,20,170,616,612,1228,2778
-110,-40,-110,622,606,1228,2609
170,-80,180,626,603,1229,2832
170,-80,-180,626,603,1229,2832
-60,40,40,616,613,1229,2711
-80,-60,-60,636,593,1229,2799
-160,-20,160,609,620,1229,2855
30,70,-100,628,602,1230,2797
-80,0,20,604,626,1230,2820
170,-60,170,615,615,1230,2832
50,-60,-20,618,613,1231,2752
-70,10,-50,611,620,1231,2819
-130,-30,180,606,626,1232,2850
-130,-30,-180,606,626,1232,2850
0,-50,30,630,602,1232,2824
-130,-50,-140,616,616,1232,2786
10,-80,30,627,605,1232,2834
-60,-40,-20,614,618,1232,2771
-130,10,120,613,620,1233,2931
50,-80,70,638,595,1233,2789
-90,-10,-50,611,622,1233,2579
-20,-50,-90,624,609,1233,2666
110,-50,130,626,608,1234,2921
90,50,-180,606,628,1234,2525
90,50,180,606,628,1234,2525
-180,-50,170,619,615,1234,2780
-180,30,160,625,609,1234,2757
160,-10,160,620,614,1234,2930
180,30,160,625,609,1234,2757
180,-50,170,619,615,1234,2780
-80,0,-60,623,611,1234,2755
100,-10,90,601,634,1235,2741
150,-70,160,641,594,1235,2811
-130,-80,-120,626,609,1235,2788
40,-80,60,634,601,1235,2778
-40,60,-40,609,626,1235,2798
-100,-30,-70,625,611,1236,2673
80,0,70,645,591,1236,2589
0,-80,20,625,611,1236,2830
-160,60,150,611,625,1236,2789
-110,-30,-150,620,616,1236,2701
110,30,-110,607,629,1236,2804
110,80,170,603,634,1237,2802
60,-40,100,631,606,1237,2836
-110,-30,180,609,628,1237,2632
-110,-30,-180,609,628,1237,2632
-60,-70,-40,634,603,1237,2788
140,-20,160,631,606,1237,2856
0,60,-70,635,603,1238,2755
-90,-10,-80,621,617,1238,2679
30,-20,70,622,616,1238,2844
150,0,100,614,624,1238,2527
-100,0,60,621,618,1239,2652
100,70,-180,604,636,1240,2785
-180,20,160,620,620,1240,2900
100,70,180,604,636,1240,2785
180,20,160,620,620,1240,2900
-10,-10,-70,633,607,1240,2951
-30,-30,10,616,624,1240,2816
-10,-80,10,627,613,1240,2808
-130,40,110,609,631,1240,2756
50,30,-80,633,607,1240,2715
-140,20,130,619,622,1241,2847
60,10,100,616,625,1241,2623
70,20,50,614,627,1241,2509
-150,10,140,621,620,1241,2984
-20,-20,20,621,620,1241,2895
-170,-20,160,623,618,1241,2840
30,40,-80,625,617,1242,2701
120,50,-120,629,613,1242,2679
-10,40,-60,613,629,1242,2731
-20,80,20,639,603,1242,2869
180,0,90,629,613,1242,2573
-140,-20,160,617,625,1242,2907
-180,0,90,629,613,1242,2573
-150,-10,150,613,630,1243,2930
-150,-80,-140,622,621,1243,2835
100,-10,170,610,633,1243,2687
-70,-40,-30,622,622,1244,2789
-80,50,60,620,624,1244,2743
100,20,-110,607,637,1244,2672
-180,10,160,623,621,1244,2882
80,50,-50,625,619,1244,2720
-70,-50,-40,618,626,1244,2856
180,10,160,623,621,1244,2882
-40,10,20,629,616,1245,2685
30,-80,50,639,606,1245,2794
-140,-80,-130,629,616,1245,2865
130,-40,80,616,629,1245,2656
70,20,60,625,620,1245,2614
170,-20,160,624,622,1246,2882
-160,70,150,626,620,1246,2840
-170,60,160,616,630,1246,2825
-90,0,-10,617,629,1246,2657
100,50,-90,610,636,1246,2845
80,20,-160,605,641,1246,2395
20,-80,40,632,614,1246,2816
-100,50,80,637,610,1247,2813
0,-30,-70,621,626,1247,2790
-20,-70,-90,627,620,1247,2791
-50,-50,-120,632,615,1247,2655
-60,-30,-10,634,613,1247,2829
-50,-20,-100,652,595,1247,2660
-150,60,140,620,628,1248,2766
-70,0,-80,628,620,1248,2783
-40,-70,-110,623,625,1248,2710
-160,0,150,623,626,1249,2924
50,-10,-40,602,647,1249,2734
-10,50,-60,605,644,1249,2828
170,-10,160,628,622,1250,2977
170,50,180,612,638,1250,2839
170,50,-180,612,638,1250,2839
-160,-80,-150,628,622,1250,2882
-170,70,80,617,633,1250,2779
-110,-30,-130,626,624,1250,2772
-180,-80,-170,634,617,1251,2854
100,40,-90,634,617,1251,2861
60,-80,80,640,611,1251,2847
10,50,10,645,606,1251,2845
180,-80,-170,634,617,1251,2854
-150,70,140,626,625,1251,2840
80,20,-170,633,619,1252,2564
-20,50,20,626,626,1252,2932
100,-60,40,609,643,1252,2595
-130,0,130,622,630,1252,2864
-50,80,-30,632,621,1253,2812
70,10,80,646,607,1253,2571
-20,70,20,647,606,1253,2900
110,-30,150,618,635,1253,2763
110,-60,130,637,616,1253,2837
-170,-40,170,631,622,1253,2873
90,30,-90,631,623,1254,2613
-120,-10,110,616,638,1254,2788
60,-60,90,638,616,1254,2867
100,-70,120,635,619,1254,2825
80,30,-140,624,630,1254,2776
-140,-10,150,623,631,1254,2983
-110,-70,-100,647,608,1255,2707
-170,-80,-160,637,618,1255,2855
120,-30,80,622,633,1255,2730
-20,-80,0,636,619,1255,2861
40,10,-60,617,639,1256,2818
50,20,80,629,627,1256,2588
-110,-30,-140,625,631,1256,2733
-120,-40,160,612,644,1256,2767
-30,-70,-100,639,617,1256,2800
0,40,20,636,620,1256,2867
-50,30,30,638,619,1257,2746
-180,-70,110,621,637,1258,2652
180,-70,110,621,637,1258,2652
-20,0,-70,642,616,1258,2882
-180,-20,160,648,610,1258,2921
180,-20,160,648,610,1258,2921
-120,10,30,647,611,1258,2541
-80,-50,-50,648,611,1259,2900
60,-60,-10,626,633,1259,2863
140,0,180,621,638,1259,2665
140,-10,100,617,642,1259,2652
160,50,100,612,647,1259,2457
140,0,-180,621,638,1259,2665
40,-20,-40,623,636,1259,2867
-110,40,90,626,633,1259,2854
150,10,180,636,624,1260,2766
150,10,-180,636,624,1260,2766
-120,-30,-160,622,638,1260,2836
-90,-50,-160,632,628,1260,2666
-80,0,-70,628,632,1260,2766
180,0,160,637,623,1260,2976
130,-10,100,612,648,1260,2643
100,-10,-160,619,641,1260,2755
40,40,10,657,603,1260,2757
-50,20,-50,623,637,1260,2798
-180,0,160,637,623,1260,2976
0,-70,-70,636,624,1260,2772
-30,-80,-10,641,620,1261,2885
90,70,-80,650,611,1261,2863
20,10,40,641,620,1261,2775
80,30,-110,622,639,1261,2680
90,-50,120,620,641,1261,2878
20,30,-70,631,630,1261,2709
0,10,30,639,623,1262,2989
30,-30,70,639,623,1262,2905
-90,20,-10,612,650,1262,2714
130,80,-130,641,621,1262,2799
-40,-80,-20,645,618,1263,2927
140,20,110,633,630,1263,2608
140,40,-150,631,632,1263,2843
80,30,-20,634,629,1263,2700
-90,-30,-40,641,622,1263,2811
80,30,-170,625,638,1263,2553
60,-20,-20,618,645,1263,2855
70,-80,90,649,615,1264,2877
-90,-30,-140,625,639,1264,2726
-130,-20,110,614,650,1264,2721
-30,40,-50,623,641,1264,2868
-140,0,140,629,636,1265,3016
-40,40,30,653,612,1265,2812
-140,70,130,641,624,1265,2839
110,-70,130,645,620,1265,2924
80,-10,140,626,639,1265,2679
90,30,-80,639,626,1265,2738
120,10,-140,626,640,1266,2966
80,0,160,607,659,1266,2583
-50,-80,-30,646,620,1266,2957
60,40,0,631,636,1267,2667
160,-40,160,634,633,1267,3036
-80,-40,-40,647,620,1267,2836
140,80,-140,642,625,1267,2814
70,-60,100,639,628,1267,2886
-70,-70,-50,654,613,1267,2823
-120,0,120,634,633,1267,2870
-40,70,-40,638,630,1268,2778
80,30,-10,623,645,1268,2699
80,-60,110,637,631,1268,2952
-70,-30,-130,638,631,1269,2736
130,-40,150,633,636,1269,2983
50,-20,-30,628,641,1269,2841
-50,10,-70,625,644,1269,2879
80,10,-150,623,647,1270,2618
130,70,-130,649,622,1271,2760
-70,70,60,639,632,1271,2892
-140,-80,150,629,642,1271,2748
0,60,10,667,604,1271,2950
80,10,50,636,635,1271,2737
170,-30,160,638,633,1271,2992
70,20,-70,642,629,1271,2726
-110,30,90,621,651,1272,2811
-180,-60,180,649,623,1272,2896
-180,-60,-180,649,623,1272,2896
180,-60,-180,649,623,1272,2896
180,-60,180,649,623,1272,2896
50,40,-90,627,645,1272,2786
-90,-80,-160,621,651,1272,2727
-90,30,60,641,632,1273,2803
90,50,-70,642,631,1273,2818
-100,-30,-150,638,635,1273,2725
80,30,-100,642,631,1273,2660
-120,10,110,625,648,1273,2852
-30,-20,-90,636,637,1273,2897
-150,-80,140,635,639,1274,2826
-130,-10,90,618,656,1274,2649
-130,-50,150,641,633,1274,2754
-120,-40,-130,651,623,1274,2755
-180,-10,160,642,633,1275,2922
-150,20,140,626,649,1275,2956
180,-10,160,642,633,1275,2922
20,50,-80,648,627,1275,2776
10,70,0,658,617,1275,3047
80,0,170,625,650,1275,2509
-60,-80,-40,652,623,1275,2958
-10,-70,-80,645,631,1276,2809
20,0,-60,659,617,1276,2918
-80,30,50,640,636,1276,2848
-90,-10,-20,631,645,1276,2704
10,-60,40,651,625,1276,3023
60,20,-70,638,638,1276,2609
-100,-80,-170,624,652,1276,2709
-90,-10,-70,633,644,1277,2670
140,-50,150,638,639,1277,3024
10,0,40,654,624,1278,2805
80,-80,100,666,612,1278,2915
80,20,-60,633,645,1278,2755
50,30,30,649,629,1278,2743
-30,80,30,655,624,1279,2912
50,-60,80,654,625,1279,2969
-150,-30,110,638,641,1279,2533
-130,-80,160,631,648,1279,2757
-130,0,60,659,621,1280,2459
10,40,-70,636,644,1280,2781
10,-70,-60,651,629,1280,2810
30,-60,60,655,626,1281,3036
20,-60,50,653,628,1281,2985
-180,50,170,640,641,1281,2841
140,-10,170,630,651,1281,3010
80,50,-150,637,644,1281,2774
180,50,170,640,641,1281,2841
-80,-50,-150,652,629,1281,2785
-60,10,-70,649,632,1281,2796
-110,-60,-100,649,633,1282,2819
-130,-40,-150,627,655,1282,2787
-130,20,120,635,648,1283,2943
150,40,-160,634,649,1283,2857
130,30,-140,636,647,1283,2824
50,50,-10,676,607,1283,2860
-110,-80,180,630,653,1283,2693
160,-20,160,650,633,1283,3038
-40,10,-70,641,642,1283,3014
-110,-80,-180,630,653,1283,2693
80,0,-170,635,649,1284,2711
-50,-40,-10,634,650,1284,2838
-20,20,-60,643,641,1284,2954
-90,50,70,641,643,1284,2837
-70,10,-60,635,649,1284,2933
110,50,150,650,635,1285,2651
90,30,-70,638,647,1285,2736
-130,70,120,656,629,1285,2879
110,-20,160,647,638,1285,2907
-160,20,70,653,632,1285,2598
30,0,60,652,634,1286,2819
80,60,-60,671,615,1286,2821
-90,50,0,638,648,1286,2873
-170,-60,-170,659,627,1286,2961
-110,0,90,630,656,1286,2751
160,-70,170,655,631,1286,2931
150,-20,160,646,640,1286,3080
100,60,-90,655,632,1287,2925
120,40,-120,631,656,1287,2782
90,-50,30,638,649,1287,2820
60,30,30,640,647,1287,2662
-110,60,20,629,658,1287,2796
100,80,180,620,668,1288,2936
100,80,-180,620,668,1288,2936
40,70,-110,648,640,1288,2869
-80,70,70,646,642,1288,2908
40,-60,70,657,631,1288,3017
90,-10,160,629,659,1288,2814
90,-40,130,654,634,1288,2925
50,10,-60,632,657,1289,2860
80,10,180,633,656,1289,2607
-30,70,30,650,639,1289,3070
90,-60,120,648,641,1289,2992
80,10,-180,633,656,1289,2607
160,90,-160,656,634,1290,2867
-180,90,-180,656,634,1290,2867
-150,90,150,656,634,1290,2867
80,30,-120,634,656,1290,2802
150,90,-150,656,634,1290,2867
-50,90,50,656,634,1290,2867
-170,90,170,656,634,1290,2867
-160,90,160,656,634,1290,2867
-140,90,140,656,634,1290,2867
150,-60,160,654,636,1290,2950
-80,90,80,656,634,1290,2867
0,90,0,656,634,1290,2867
70,30,20,636,654,1290,2626
-10,90,10,656,634,1290,2867
130,90,-130,656,634,1290,2867
180,90,-180,656,634,1290,2867
60,90,-60,656,634,1290,2867
100,90,-100,656,634,1290,2867
50,90,-50,656,634,1290,2867
90,90,-90,656,634,1290,2867
70,90,-70,656,634,1290,2867
30,90,-30,656,634,1290,2867
120,90,-120,656,634,1290,2867
-60,90,60,656,634,1290,2867
-140,-50,-150,629,661,1290,2865
170,90,-170,656,634,1290,2867
10,90,-10,656,634,1290,2867
40,90,-40,656,634,1290,2867
-180,90,180,656,634,1290,2867
140,90,-140,656,634,1290,2867
100,-40,50,636,654,1290,2695
110,90,-110,656,634,1290,2867
100,-30,60,639,651,1290,2806
80,90,-80,656,634,1290,2867
-30,90,30,656,634,1290,2867
-40,90,40,656,634,1290,2867
20,90,-20,656,634,1290,2867
-90,90,90,656,634,1290,2867
-70,90,70,656,634,1290,2867
-20,60,20,647,643,1290,2920
-20,90,20,656,634,1290,2867
180,90,180,656,634,1290,2867
-130,90,130,656,634,1290,2867
-120,90,120,656,634,1290,2867
-110,90,110,656,634,1290,2867
-110,-50,-100,650,640,1290,2800
-100,90,100,656,634,1290,2867
-100,-30,-160,642,649,1291,2817
40,-40,80,649,642,1291,2876
90,-10,70,640,651,1291,2822
-130,-60,-130,652,639,1291,2835
20,60,0,668,623,1291,2963
60,-30,110,658,633,1291,2891
-40,-20,10,650,641,1291,2901
50,80,-40,667,624,1291,2992
160,-30,160,648,643,1291,3060
-120,-20,130,635,657,1292,2668
-120,-80,170,636,656,1292,2737
-170,50,160,645,648,1293,2858
130,60,-130,647,646,1293,2818
40,80,-30,673,620,1293,2961
20,-70,-50,666,627,1293,2852
-140,60,130,640,653,1293,2793
70,0,120,653,640,1293,2697
100,0,110,639,654,1293,2670
60,80,-50,669,625,1294,2987
-120,70,110,658,636,1294,2912
-80,-80,-150,643,651,1294,2792
150,-30,160,645,649,1294,3099
-40,30,-50,623,672,1295,2922
-20,-60,10,661,634,1295,2956
-10,-60,20,649,646,1295,2984
40,10,80,647,649,1296,2717
-150,20,60,664,632,1296,2683
-80,10,-40,658,638,1296,2880
-120,-20,160,648,649,1297,2891
-60,20,30,650,647,1297,2916
-40,0,-80,643,654,1297,2843
-160,-30,170,647,650,1297,3036
-60,60,50,659,639,1298,2931
-50,-10,10,655,643,1298,2965
10,20,30,659,640,1299,3004
90,20,-120,651,648,1299,2760
-40,80,-40,666,634,1300,2958
-160,-80,130,655,645,1300,2859
150,20,-170,645,655,1300,2810
120,70,150,634,666,1300,2785
-130,70,40,645,656,1301,2910
-70,-80,-50,670,632,1302,2973
80,-20,10,637,666,1303,2953
60,20,80,643,660,1303,2654
-100,-40,-70,656,647,1303,2867
-130,-10,150,650,653,1303,3133
-60,-30,-120,659,644,1303,2860
0,-60,30,665,638,1303,2988
-80,-70,-60,668,635,1303,2888
-20,-30,20,663,640,1303,3010
90,40,-60,643,661,1304,2862
70,-30,120,659,645,1304,2767
-140,-30,-180,645,659,1304,3057
-140,-30,180,645,659,1304,3057
-100,70,90,656,648,1304,2945
-30,-50,-100,676,629,1305,2862
-130,-20,170,652,653,1305,3067
-120,-20,140,645,660,1305,2937
50,0,-50,655,650,1305,2914
170,-60,100,651,654,1305,2737
-50,50,40,676,630,1306,2956
-10,-30,30,660,646,1306,3062
-100,-30,-60,671,635,1306,2822
120,-60,140,658,648,1306,2957
130,-60,70,655,651,1306,2868
90,10,140,645,662,1307,2782
120,0,110,638,669,1307,2982
-170,-10,160,656,651,1307,3078
-90,-10,-60,655,652,1307,2805
140,70,-140,659,648,1307,2837
120,20,-130,637,670,1307,2936
90,-10,-170,662,646,1308,2863
-170,-50,180,649,659,1308,2942
70,10,90,651,657,1308,2816
40,30,30,664,644,1308,2962
60,70,-130,646,662,1308,2927
-170,-50,-180,649,659,1308,2942
-70,-10,-100,660,649,1309,2853
-30,-60,0,669,640,1309,2938
-70,-80,-140,669,640,1309,2826
90,-80,110,671,638,1309,2976
40,-10,-50,643,666,1309,2929
60,40,-100,659,651,1310,2898
-50,40,-40,659,651,1310,2865
20,-30,60,657,653,1310,2971
-160,10,150,654,656,1310,3152
-90,70,80,660,651,1311,2928
30,80,-20,679,632,1311,3035
-40,-40,0,667,644,1311,2885
-120,-50,-120,667,644,1311,2943
-40,80,40,662,649,1311,2970
-40,-50,-110,685,626,1311,2884
50,40,10,660,651,1311,2847
80,10,-20,631,680,1311,2833
-150,-50,-160,643,669,1312,2959
-60,-20,0,661,651,1312,2953
70,40,-10,655,657,1312,2780
150,80,-150,665,647,1312,2898
-120,-70,-110,675,637,1312,2851
-40,-60,-10,678,634,1312,2966
80,0,130,643,670,1313,2726
-160,70,70,634,679,1313,2901
30,20,-70,644,669,1313,2806
70,-50,0,643,670,1313,3037
0,-20,-70,649,664,1313,2963
-130,10,40,662,651,1313,2558
-120,-20,170,647,666,1313,2994
-30,20,-60,658,655,1313,2987
-20,-40,-90,646,668,1314,2836
-90,-60,-70,672,642,1314,2974
-130,-30,-170,655,659,1314,3056
-140,70,50,642,673,1315,2957
30,-40,70,665,650,1315,3048
120,-70,140,667,648,1315,2970
120,-50,140,660,656,1316,3239
-110,70,100,667,649,1316,2991
130,-20,90,622,694,1316,2809
130,50,-130,650,666,1316,2865
-100,-20,-90,641,675,1316,2858
100,10,130,663,653,1316,2843
-30,0,20,659,657,1316,2895
90,30,-60,628,689,1317,2727
70,0,-30,648,669,1317,2755
100,-10,-150,643,674,1317,2861
70,20,70,655,662,1317,2747
-10,-20,30,661,656,1317,3113
170,-70,180,662,656,1318,3008
10,40,20,673,645,1318,2936
70,80,-60,685,633,1318,3092
170,-70,-180,662,656,1318,3008
-90,-20,-20,671,648,1319,2979
160,40,-170,651,668,1319,2996
0,-30,40,654,666,1320,3009
-90,0,-20,649,671,1320,2885
20,80,-10,686,634,1320,3069
80,20,30,655,665,1320,2828
-30,-40,10,671,649,1320,3017
140,60,-140,648,672,1320,2867
-90,0,-30,640,680,1320,2826
60,30,-90,657,663,1320,2916
-90,-10,-90,650,670,1320,2868
-100,-50,-80,667,653,1320,2931
-100,-20,-80,658,663,1321,2839
-120,-10,140,664,657,1321,3034
80,20,180,675,646,1321,2801
80,20,-180,675,646,1321,2801
-140,0,70,657,665,1322,2522
60,50,-20,680,642,1322,2859
-110,-40,-100,669,653,1322,2867
100,-10,-180,651,672,1323,2841
100,-10,180,651,672,1323,2841
-90,-40,-50,672,651,1323,2941
-90,10,50,658,666,1324,3051
20,50,10,680,644,1324,2963
100,70,-90,677,647,1324,3023
160,0,170,649,676,1325,3223
130,-30,160,655,670,1325,3114
-130,60,120,661,664,1325,2945
-170,-80,120,667,658,1325,2916
-170,-10,90,653,673,1326,2778
-100,40,80,674,652,1326,3076
50,-30,100,679,647,1326,2948
80,-10,0,655,671,1326,2976
-160,-50,-170,655,672,1327,3078
80,10,60,670,657,1327,2886
-10,50,20,676,651,1327,3148
-60,-40,-130,675,652,1327,2809
10,-30,50,666,661,1327,3029
-160,50,150,658,669,1327,2813
140,-30,160,654,674,1328,3115
-100,60,10,673,655,1328,2819
-150,-40,-170,659,669,1328,3094
-30,80,-50,687,642,1329,3029
30,-70,-40,684,645,1329,2951
-80,-80,-60,691,638,1329,2985
-30,-10,20,663,666,1329,3045
130,20,-150,653,676,1329,2969
150,60,-150,649,680,1329,2951
-90,20,60,655,674,1329,3041
40,-10,90,674,656,1330,2840
80,10,170,635,695,1330,2702
170,10,170,656,674,1330,3136
50,70,-120,665,665,1330,2959
150,70,-150,670,660,1330,2943
90,-40,30,660,670,1330,2906
-120,-20,150,657,674,1331,3035
70,-20,-10,660,671,1331,2993
50,10,100,683,648,1331,2720
80,-30,10,650,681,1331,2914
-50,-60,-20,683,649,1332,3073
40,0,90,674,658,1332,2713
0,70,10,689,643,1332,3180
150,-50,160,674,658,1332,3104
-120,70,30,648,685,1333,2910
-70,20,-40,660,673,1333,2910
100,-80,120,678,655,1333,2995
10,60,-80,673,660,1333,3083
120,30,-120,645,689,1334,2987
-70,40,50,668,666,1334,2971
140,10,-170,665,669,1334,2918
20,-40,60,671,663,1334,3067
40,30,-80,664,671,1335,2979
80,0,140,657,678,1335,2743
-80,-10,-100,686,649,1335,2935
100,-50,130,657,678,1335,3122
-100,0,70,669,666,1335,2872
-80,-20,-120,689,647,1336,3083
-140,-60,-140,663,673,1336,2907
50,20,-70,673,663,1336,2819
-90,-10,0,663,673,1336,3027
-70,60,60,686,650,1336,2930
-130,-40,140,674,662,1336,2902
100,20,140,673,663,1336,2769
-100,20,80,643,694,1337,2980
170,-50,170,669,668,1337,2985
-40,0,20,676,661,1337,3071
-10,-10,30,678,660,1338,3109
170,40,90,682,656,1338,2683
110,-20,80,642,696,1338,2933
100,40,-80,676,662,1338,3044
10,80,0,698,640,1338,3157
-50,-30,0,673,666,1339,3007
90,10,-130,659,680,1339,2902
-180,-40,170,678,661,1339,3085
180,-40,170,678,661,1339,3085
-70,0,20,662,677,1339,2949
10,-40,50,684,656,1340,3082
130,10,110,672,668,1340,2805
40,-70,-30,673,667,1340,2996
80,10,160,664,676,1340,2821
-100,-20,-100,665,676,1341,2916
-110,0,20,674,667,1341,2739
140,60,120,688,653,1341,2592
-160,-40,-180,671,671,1342,3113
-100,30,80,655,687,1342,3032
-160,-40,180,671,671,1342,3113
180,-80,110,674,669,1343,2984
-70,10,30,672,671,1343,3025
-180,-80,110,674,669,1343,2984
-40,-10,-90,672,672,1344,3061
-80,-20,-10,668,676,1344,3064
-50,80,50,675,669,1344,3025
-100,-40,-170,676,669,1345,2898
80,0,-180,663,682,1345,2759
30,-20,-50,676,669,1345,3156
80,0,180,663,682,1345,2759
-40,70,40,674,672,1346,3139
-160,-60,-160,672,674,1346,3045
60,-50,100,677,669,1346,3122
110,50,-100,667,679,1346,3121
-90,-70,-70,693,653,1346,2983
80,20,-140,656,690,1346,2764
-140,-40,-160,657,690,1347,3061
50,70,-30,691,656,1347,3102
-120,-10,100,669,678,1347,2802
-120,-30,150,679,668,1347,3063
-150,70,60,646,701,1347,2948
40,20,-70,675,673,1348,2831
120,-40,150,668,680,1348,3110
-100,10,80,657,691,1348,2868
-10,-30,-80,668,680,1348,3112
160,80,-160,685,664,1349,3012
-90,-10,10,675,674,1349,3052
-100,-10,30,675,674,1349,3021
-90,-50,-60,684,665,1349,3022
90,-20,40,662,689,1351,2983
-10,0,-70,691,660,1351,3157
-20,-40,20,689,662,1351,3071
-60,-20,-110,698,653,1351,2997
-50,-80,-120,674,677,1351,2962
-150,30,140,673,678,1351,2977
-150,50,140,658,693,1351,2908
-80,50,-10,663,689,1352,2969
-120,-30,-150,688,664,1352,2922
60,10,-60,671,682,1353,2914
170,40,-180,662,691,1353,3108
110,0,110,664,689,1353,2906
80,0,150,653,700,1353,2791
110,-10,180,665,688,1353,2935
170,40,180,662,691,1353,3108
110,-10,-180,665,688,1353,2935
90,80,-170,654,699,1353,3054
-170,-30,170,687,667,1354,3218
90,0,100,658,696,1354,2913
-140,-20,100,659,695,1354,2767
-90,-30,-30,688,666,1354,2991
160,-60,170,675,680,1355,3103
-60,-10,10,675,680,1355,3070
90,40,170,692,663,1355,2717
-40,-80,-110,677,678,1355,2975
80,30,0,661,694,1355,2925
-180,-70,-170,678,678,1356,3116
180,-70,-170,678,678,1356,3116
90,-10,170,660,696,1356,2916
150,-40,160,682,674,1356,3193
-60,-80,-130,683,673,1356,2861
-40,30,30,687,669,1356,3055
-80,0,30,692,665,1357,3062
0,-40,40,688,669,1357,3131
-170,-50,110,692,665,1357,2911
-10,-40,30,686,671,1357,3094
-50,20,30,687,670,1357,3128
70,-60,0,685,672,1357,3016
100,-20,70,691,666,1357,3045
30,10,50,697,661,1358,3048
-30,70,-50,695,663,1358,3032
110,-80,130,690,668,1358,3045
-90,-10,-10,661,697,1358,2959
-140,30,130,673,685,1358,3058
-60,-60,-30,690,668,1358,3102
80,80,-70,709,649,1358,3128
-120,-20,180,682,677,1359,3083
-10,0,30,688,671,1359,3171
-130,0,140,683,676,1359,3189
-100,-20,-70,683,676,1359,2901
-160,40,150,670,689,1359,3030
150,-10,170,677,682,1359,3202
-120,-20,-180,682,677,1359,3083
100,-60,130,677,683,1360,3126
110,20,130,685,675,1360,2846
80,40,-170,662,698,1360,2694
-130,-70,-120,699,661,1360,3064
130,-20,170,681,680,1361,3149
-80,40,60,689,672,1361,3149
10,-70,40,679,682,1361,3146
-160,-10,160,684,677,1361,3173
110,30,140,680,682,1362,2902
-160,20,150,665,697,1362,3170
0,-70,30,687,675,1362,3166
80,30,-130,657,705,1362,2964
130,0,-170,673,690,1363,2990
40,20,50,693,670,1363,3050
-30,50,-50,672,691,1363,3077
30,20,40,699,664,1363,3042
80,-30,130,684,679,1363,3028
-150,40,140,676,687,1363,3046
-120,-50,160,669,694,1363,3055
-150,-60,-150,679,685,1364,2973
90,-10,-180,661,703,1364,2903
150,10,100,676,688,1364,2802
-30,60,30,686,678,1364,3123
-160,30,150,686,678,1364,3076
90,-10,180,661,703,1364,2903
-100,-20,-110,675,690,1365,2828
-170,40,160,691,674,1365,3118
60,-10,-30,670,695,1365,2961
50,-70,-20,689,677,1366,3029
-70,30,-30,692,674,1366,3001
120,-10,-180,667,700,1367,3018
110,-30,70,684,683,1367,3067
0,-20,40,678,689,1367,3096
80,-10,-160,686,681,1367,2753
120,-10,180,667,700,1367,3018
50,-50,90,686,681,1367,3173
-100,-10,40,687,680,1367,2967
-20,80,-60,704,664,1368,3154
40,50,0,701,667,1368,3011
-90,0,40,692,676,1368,3069
-70,10,-70,694,674,1368,2972
-130,-40,-140,690,678,1368,3024
-170,0,160,690,678,1368,3134
-90,-80,-70,703,665,1368,3043
-30,-80,-100,685,684,1369,3078
40,-50,80,692,677,1369,3185
40,-20,90,688,681,1369,3030
80,50,-160,669,700,1369,2954
80,20,-70,691,678,1369,2934
60,30,40,682,687,1369,2920
0,20,30,678,692,1370,3101
170,-70,100,675,695,1370,2984
-150,0,150,690,680,1370,3230
-90,-20,-120,685,685,1370,2948
20,40,20,711,659,1370,3055
20,-70,50,691,680,1371,3242
120,30,130,699,672,1371,2837
-120,60,110,681,690,1371,3039
70,50,-30,698,674,1372,2935
-110,0,100,692,680,1372,2972
-170,10,160,689,683,1372,3257
60,40,10,666,706,1372,2876
160,-10,170,695,677,1372,3359
110,-60,50,669,704,1373,2977
-60,0,20,690,683,1373,3049
70,10,100,686,687,1373,2985
80,-50,120,684,689,1373,3122
-30,-90,-10,701,673,1374,3191
-160,-90,-140,701,673,1374,3191
-50,-90,-30,701,673,1374,3191
-120,-90,-100,701,673,1374,3191
-180,-90,-160,701,673,1374,3191
160,-90,180,701,673,1374,3191
160,-90,-180,701,673,1374,3191
150,-90,170,701,673,1374,3191
60,-90,80,701,673,1374,3191
-20,-90,0,701,673,1374,3191
170,-90,-170,701,673,1374,3191
180,40,170,693,681,1374,3144
110,-90,130,701,673,1374,3191
-60,-90,-40,701,673,1374,3191
-90,-90,-70,701,673,1374,3191
100,30,-90,699,675,1374,3062
50,-90,70,701,673,1374,3191
-80,-90,-60,701,673,1374,3191
100,30,150,689,685,1374,2851
80,-90,100,701,673,1374,3191
-40,-90,-20,701,673,1374,3191
-110,-90,-90,701,673,1374,3191
-140,-90,-120,701,673,1374,3191
-120,20,110,676,698,1374,3041
100,-90,120,701,673,1374,3191
70,-90,90,701,673,1374,3191
180,-90,-160,701,673,1374,3191
30,-90,50,701,673,1374,3191
-150,-90,-130,701,673,1374,3191
130,-90,150,701,673,1374,3191
10,-90,30,701,673,1374,3191
130,60,130,706,668,1374,2693
90,-90,110,701,673,1374,3191
140,-90,160,701,673,1374,3191
-140,50,130,674,700,1374,3005
-70,-90,-50,701,673,1374,3191
120,-90,140,701,673,1374,3191
-100,-90,-80,701,673,1374,3191
-10,-90,10,701,673,1374,3191
20,-90,40,701,673,1374,3191
40,-90,60,701,673,1374,3191
-130,-90,-110,701,673,1374,3191
-180,40,170,693,681,1374,3144
0,-90,20,701,673,1374,3191
-170,-90,-150,701,673,1374,3191
40,70,-20,715,660,1375,3168
130,-50,150,697,679,1376,3313
-90,-30,-150,678,698,1376,2925
50,60,-20,701,675,1376,3057
-80,-30,-20,702,674,1376,3119
-110,-10,40,697,679,1376,2955
150,0,180,692,685,1377,3139
150,0,-180,692,685,1377,3139
-70,-10,10,682,695,1377,3156
130,30,120,693,684,1377,2888
60,70,-40,706,671,1377,3164
-80,60,70,700,677,1377,3052
-100,-20,-60,704,673,1377,2987
-30,10,-70,679,698,1377,3233
-60,80,60,686,692,1378,3090
70,-50,110,693,685,1378,3115
30,-70,60,701,677,1378,3197
90,20,150,698,680,1378,2791
-10,-80,-80,681,697,1378,3206
140,-50,80,674,704,1378,3040
-70,-40,-140,708,671,1379,3023
-80,-30,-140,680,699,1379,3164
10,60,10,712,667,1379,3158
170,30,90,708,671,1379,2790
110,20,-110,691,689,1380,3073
-10,10,30,699,681,1380,3098
100,-40,140,688,692,1380,3177
80,10,-30,710,670,1380,2988
-20,-70,10,696,685,1381,3212
-60,30,40,692,689,1381,3133
-170,-70,-160,702,679,1381,3095
130,-60,150,695,686,1381,3085
0,80,10,713,669,1382,3259
100,50,160,698,684,1382,2875
110,60,-100,710,672,1382,3147
170,80,-170,697,686,1383,3118
160,60,-160,678,705,1383,3126
-90,40,70,693,690,1383,3170
80,10,-50,681,703,1384,2952
120,-80,140,701,683,1384,3106
130,-70,150,714,670,1384,3028
-130,-30,-160,684,700,1384,3129
110,70,-100,713,671,1384,3192
120,0,-160,671,713,1384,3078
-100,-60,-80,705,679,1384,3107
80,80,-160,674,710,1384,3184
70,40,-120,687,698,1385,3128
-30,60,-50,678,707,1385,3080
-100,-10,20,705,680,1385,3038
90,60,-70,706,679,1385,3175
-90,10,-20,678,707,1385,2995
-20,-80,-90,692,693,1385,3188
-170,30,160,704,681,1385,3166
-10,60,20,710,675,1385,3215
50,-70,80,707,679,1386,3229
-10,20,30,707,679,1386,3141
-80,0,-80,701,685,1386,3028
-120,-60,-110,702,684,1386,3077
-140,-20,170,691,696,1387,3323
0,50,20,704,683,1387,3192
150,60,110,702,685,1387,2850
120,-60,60,689,698,1387,3127
40,-70,70,699,689,1388,3234
130,-10,180,683,706,1389,3015
20,-10,-60,694,695,1389,3166
-90,10,60,698,691,1389,3086
130,-10,-180,683,706,1389,3015
-70,-60,-40,712,678,1390,3219
-100,-30,-50,712,679,1391,3045
80,20,170,680,711,1391,2755
0,-80,-70,689,702,1391,3238
-80,-10,10,687,704,1391,3194
140,50,-140,666,725,1391,3104
-30,50,30,700,691,1391,3147
-70,20,40,696,695,1391,3158
80,0,-10,687,705,1392,3079
130,10,-160,673,719,1392,3155
140,0,100,708,684,1392,3046
160,70,-160,695,697,1392,3141
-160,0,80,709,684,1393,2957
140,20,-160,672,721,1393,3107
-130,10,130,689,705,1394,3255
-120,0,130,691,703,1394,3141
10,30,-70,687,707,1394,3084
10,-20,50,702,692,1394,3092
-170,20,160,690,704,1394,3266
-80,10,40,713,681,1394,3207
-70,-30,-10,706,688,1394,3201
90,60,-180,682,712,1394,3082
90,60,180,682,712,1394,3082
-30,30,30,726,669,1395,3165
-40,-30,10,694,701,1395,3080
80,40,-30,706,689,1395,2912
-60,50,50,720,675,1395,3091
180,30,170,703,692,1395,3196
-180,30,170,703,692,1395,3196
60,60,-30,703,692,1395,3028
90,70,-170,686,709,1395,3205
30,30,30,710,686,1396,3113
-80,10,-50,707,689,1396,3098
-70,-20,-120,707,689,1396,3270
20,-20,60,703,693,1396,3125
-20,10,-70,692,704,1396,3323
100,10,-120,668,728,1396,3026
-150,-10,160,701,695,1396,3410
-90,0,-40,693,703,1396,2939
20,-50,60,705,691,1396,3320
-10,-70,20,700,696,1396,3181
-10,80,-70,718,679,1397,3184
-60,-10,-100,716,681,1397,3095
30,-10,70,683,715,1398,3094
-50,0,20,714,684,1398,3112
170,30,-180,704,695,1399,3193
160,10,-180,687,712,1399,3112
170,30,180,704,695,1399,3193
-100,-20,-50,708,691,1399,3042
160,10,180,687,712,1399,3112
40,10,90,714,685,1399,2748
140,-20,170,695,704,1399,3271
-10,80,20,728,672,1400,3327
100,-10,-140,697,703,1400,3012
70,30,30,676,724,1400,2844
-30,40,30,695,705,1400,3076
-90,60,80,708,692,1400,3135
-10,10,-70,699,701,1400,3197
90,80,-80,727,674,1401,3235
100,50,-80,720,681,1401,3188
140,30,-150,687,714,1401,3130
40,20,70,698,703,1401,2958
-50,40,40,712,690,1402,3139
90,-10,50,699,703,1402,2945
-120,-20,120,690,712,1402,2939
-80,-40,-150,705,697,1402,3219
-170,10,80,719,684,1403,3039
-50,70,50,711,692,1403,3225
110,70,160,689,714,1403,3015
170,50,90,682,721,1403,2774
-110,-40,-90,711,693,1404,3024
-50,-20,10,702,702,1404,3218
-10,70,20,722,682,1404,3345
170,-80,100,705,699,1404,3094
-30,-20,20,713,692,1405,3138
100,-10,-170,716,689,1405,3209
60,-70,90,709,696,1405,3287
160,30,-170,692,713,1405,3140
-140,40,130,709,696,1405,3116
110,-50,140,704,701,1405,3322
30,70,-10,726,679,1405,3285
110,40,-100,696,709,1405,3205
0,-50,40,711,694,1405,3200
-90,60,0,697,708,1405,3042
10,-50,50,701,704,1405,3220
80,-10,-170,716,690,1406,2947
130,40,-130,683,723,1406,3167
30,-50,70,705,702,1407,3243
120,-30,160,696,711,1407,3204
90,-30,140,702,706,1408,3043
90,-10,60,700,709,1409,3023
20,20,-70,704,705,1409,2979
100,80,-90,734,676,1410,3251
-180,-30,170,720,690,1410,3466
-70,-40,-20,715,695,1410,3157
180,-30,170,720,690,1410,3466
-140,-70,-130,714,696,1410,3263
-150,-30,180,691,720,1411,3359
-150,-30,-180,691,720,1411,3359
20,0,50,719,692,1411,3000
70,50,-130,698,713,1411,3105
170,20,-180,701,711,1412,3200
170,20,180,701,711,1412,3200
-100,-70,-80,721,692,1413,3107
-130,30,120,684,729,1413,3300
90,30,160,701,712,1413,2831
-80,-40,-30,732,681,1413,3139
-20,30,-60,704,710,1414,3166
-110,60,100,703,711,1414,3158
70,70,-50,722,692,1414,3247
-100,60,90,701,713,1414,3144
-70,80,70,713,701,1414,3206
-80,30,-20,703,712,1415,3062
-140,-30,-170,685,730,1415,3269
30,0,-60,710,705,1415,3169
70,40,0,695,720,1415,2861
100,0,-130,717,698,1415,3005
70,-10,130,702,713,1415,3019
-40,20,30,726,689,1415,3177
-160,-70,-150,713,702,1415,3217
40,-30,-40,690,726,1416,3283
-30,-70,0,717,699,1416,3185
-130,-50,-130,709,707,1416,3151
-100,-80,-80,718,698,1416,3115
90,50,-60,714,702,1416,3109
170,-10,170,725,693,1418,3257
-110,10,100,686,732,1418,3164
180,20,170,696,722,1418,3247
-180,20,170,696,722,1418,3247
170,0,170,721,697,1418,3358
110,10,120,714,704,1418,3032
-20,-30,-90,716,702,1418,3146
-10,-50,30,715,704,1419,3235
-40,-50,0,721,698,1419,3203
80,10,-40,719,700,1419,3074
170,70,-170,713,706,1419,3296
70,10,-60,721,699,1420,3215
150,30,-160,704,716,1420,3175
60,30,50,702,718,1420,2958
140,-70,160,731,689,1420,3126
170,-40,170,724,697,1421,3339
-30,-50,10,713,709,1422,3266
-90,-10,20,718,704,1422,3348
-140,-10,160,714,708,1422,3372
60,-70,-10,722,700,1422,3119
80,-50,10,718,704,1422,3349
50,-30,-30,701,721,1422,3204
40,-30,90,703,719,1422,3151
-130,50,120,707,716,1423,3163
30,50,-90,716,707,1423,3236
130,-80,150,725,698,1423,3221
100,-50,40,702,721,1423,2971
-120,10,120,695,728,1423,3425
120,10,-130,714,709,1423,3360
-60,20,-50,718,705,1423,3269
-140,0,150,712,711,1423,3376
110,0,-130,716,707,1423,3198
-60,-50,-20,721,702,1423,3253
150,-20,170,703,720,1423,3361
-70,0,-90,701,723,1424,3087
-180,80,180,712,712,1424,3199
180,80,-180,712,712,1424,3199
-130,-20,-180,713,711,1424,3282
180,80,180,712,712,1424,3199
-180,80,-180,712,712,1424,3199
-130,-20,180,713,711,1424,3282
-20,30,30,733,691,1424,3217
10,-80,-60,709,716,1425,3243
40,40,-90,707,718,1425,3194
80,0,-150,710,715,1425,2928
-140,10,140,700,725,1425,3386
80,30,-180,717,709,1426,3049
80,30,180,717,709,1426,3049
-110,-20,-180,715,712,1427,3117
-110,-20,180,715,712,1427,3117
-100,-40,-60,727,700,1427,3122
-50,-50,-10,723,705,1428,3208
-120,-20,-170,709,719,1428,3194
-40,60,40,716,712,1428,3233
-110,-40,170,690,738,1428,3175
60,-10,120,711,718,1429,2989
40,20,60,722,707,1429,3066
-160,0,160,716,714,1430,3289
0,-10,40,714,716,1430,3291
-20,20,30,733,698,1431,3243
-70,-50,-30,725,706,1431,3257
150,50,-150,703,729,1432,3174
120,60,140,734,698,1432,2887
80,20,40,726,706,1432,3051
-60,-40,-10,703,729,1432,3207
-110,-10,30,720,712,1432,3056
130,20,-140,705,727,1432,3329
0,50,-70,709,724,1433,3303
20,-80,-50,715,718,1433,3275
-90,-40,-40,725,708,1433,3133
-180,-50,-180,730,704,1434,3321
60,-30,-20,698,736,1434,3344
180,-50,-180,730,704,1434,3321
180,-50,180,730,704,1434,3321
-180,-50,180,730,704,1434,3321
-60,30,-40,725,709,1434,3137
40,60,-10,731,704,1435,3171
-110,-30,170,707,728,1435,3148
-40,20,-60,721,715,1436,3217
30,-80,-40,714,722,1436,3321
170,-60,-180,726,710,1436,3313
10,10,40,735,701,1436,3188
-100,-30,-40,731,705,1436,3132
-130,-10,160,723,713,1436,3435
170,-60,180,726,710,1436,3313
80,-10,150,709,727,1436,3145
-140,-50,-140,720,717,1437,3310
60,30,60,722,716,1438,2911
-20,70,-60,725,713,1438,3291
-20,-10,-80,720,719,1439,3243
-110,-10,50,726,714,1440,2906
-160,70,160,720,720,1440,3329
70,-70,100,728,712,1440,3377
-100,0,80,698,742,1440,3207
70,60,-40,711,729,1440,3111
120,60,-110,728,712,1440,3313
-110,70,20,705,736,1441,3175
120,20,120,728,713,1441,2985
-40,-10,20,726,715,1441,3249
-170,80,170,717,724,1441,3311
80,-10,170,703,738,1441,3097
-70,-20,0,714,727,1441,3380
-70,50,60,741,700,1441,3251
-20,10,30,740,701,1441,3323
-150,-70,-140,723,718,1441,3323
0,80,-80,736,705,1441,3241
-120,50,110,702,739,1441,3261
-50,-40,-120,750,691,1441,3125
-40,-70,-10,731,711,1442,3229
80,50,-170,713,729,1442,3076
-160,-40,110,707,735,1442,3020
-110,-30,-120,731,712,1443,3071
100,30,-80,731,712,1443,3099
170,60,-170,710,733,1443,3327
-120,-30,-140,728,716,1444,3100
120,-40,70,724,720,1444,3282
180,70,-180,718,727,1445,3306
-180,70,-180,718,727,1445,3306
-180,70,180,718,727,1445,3306
90,30,-50,697,748,1445,2955
180,70,180,718,727,1445,3306
110,-10,90,709,736,1445,3104
-80,20,-30,735,711,1446,3214
20,70,0,746,700,1446,3427
110,80,-100,747,699,1446,3307
90,20,-110,740,706,1446,3029
180,60,-180,715,731,1446,3348
80,30,10,718,728,1446,3074
-110,0,110,715,731,1446,3160
-180,60,-180,715,731,1446,3348
0,-80,30,743,703,1446,3417
180,60,180,715,731,1446,3348
-180,60,180,715,731,1446,3348
-170,70,170,720,727,1447,3398
-60,0,-90,716,731,1447,3299
20,30,30,739,708,1447,3401
-120,-10,90,713,735,1448,2999
-90,-40,-160,729,719,1448,3076
-170,-30,100,709,739,1448,2926
-120,-10,150,730,718,1448,3335
80,-10,160,698,750,1448,3189
-170,-40,-180,726,723,1449,3398
-170,-40,180,726,723,1449,3398
-80,80,80,731,718,1449,3292
90,20,-50,718,732,1450,3095
70,30,-100,739,711,1450,3220
70,60,-140,693,758,1451,3183
-20,80,30,745,706,1451,3369
110,-10,-160,713,738,1451,3349
-20,70,30,743,708,1451,3430
-10,30,30,742,709,1451,3264
140,-40,160,726,725,1451,3339
40,20,80,734,717,1451,3007
-110,-80,-90,732,720,1452,3216
160,-50,170,733,719,1452,3343
-140,-60,140,737,716,1453,3188
80,10,-140,696,757,1453,3013
90,-50,130,713,740,1453,3325
-60,70,60,732,721,1453,3313
-130,40,120,722,731,1453,3348
-100,10,0,737,717,1454,3122
40,40,20,731,723,1454,3179
-120,-90,170,729,726,1455,3262
40,-90,-30,729,726,1455,3262
-170,-90,120,729,726,1455,3262
50,-90,-20,729,726,1455,3262
50,-40,100,734,721,1455,3267
-70,-90,-140,729,726,1455,3262
70,-90,0,729,726,1455,3262
-20,-90,-90,729,726,1455,3262
-100,-90,-170,729,726,1455,3262
140,-90,70,729,726,1455,3262
180,-90,110,729,726,1455,3262
-110,-90,180,729,726,1455,3262
-30,-90,-100,729,726,1455,3262
-60,-90,-130,729,726,1455,3262
20,-90,-50,729,726,1455,3262
0,-90,-70,729,726,1455,3262
80,-90,10,729,726,1455,3262
120,-90,50,729,726,1455,3262
-80,-90,-150,729,726,1455,3262
150,-90,80,729,726,1455,3262
100,-90,30,729,726,1455,3262
-10,-90,-80,729,726,1455,3262
30,-90,-40,729,726,1455,3262
90,-90,20,729,726,1455,3262
90,20,-60,713,742,1455,3047
-160,-90,130,729,726,1455,3262
130,-90,60,729,726,1455,3262
-10,-80,20,736,719,1455,3357
10,-90,-60,729,726,1455,3262
-150,-90,140,729,726,1455,3262
170,-90,100,729,726,1455,3262
60,-90,-10,729,726,1455,3262
-140,-90,150,729,726,1455,3262
-40,-90,-110,729,726,1455,3262
160,-90,90,729,726,1455,3262
-180,-90,110,729,726,1455,3262
-130,-90,160,729,726,1455,3262
-90,-90,-160,729,726,1455,3262
110,-90,40,729,726,1455,3262
-110,-90,-180,729,726,1455,3262
-50,-90,-120,729,726,1455,3262
90,-30,30,709,747,1456,3270
-160,80,160,731,725,1456,3341
-60,10,30,736,720,1456,3336
-30,20,30,747,709,1456,3271
-110,-30,-110,712,745,1457,3140
120,0,-140,725,732,1457,3293
-80,-60,-50,748,709,1457,3337
-20,40,30,749,708,1457,3236
-110,-50,170,708,750,1458,3295
80,50,-40,734,724,1458,3109
110,30,-100,720,738,1458,3356
-90,0,50,735,724,1459,3294
-150,-20,170,728,731,1459,3514
160,-80,90,736,723,1459,3215
110,-10,-150,715,744,1459,3473
30,0,70,720,739,1459,3250
-80,20,50,736,723,1459,3326
100,-30,150,725,734,1459,3195
170,-30,170,733,726,1459,3519
140,-10,-180,718,742,1460,3322
-30,-40,-100,738,722,1460,3127
70,80,-150,715,745,1460,3268
140,-10,180,718,742,1460,3322
-130,20,130,717,743,1460,3416
140,-80,160,745,715,1460,3278
-90,0,-50,722,739,1461,3016
80,20,-130,719,742,1461,3155
120,0,-150,714,748,1462,3328
130,30,-130,718,744,1462,3251
120,20,-120,723,739,1462,3270
-20,-80,10,737,725,1462,3336
80,20,-80,724,739,1463,3092
-110,-30,-100,734,729,1463,3210
-20,50,30,744,719,1463,3299
120,70,-110,761,702,1463,3394
90,40,-50,725,739,1464,3051
-80,10,-60,735,729,1464,3203
120,-20,170,721,743,1464,3277
70,-70,0,748,716,1464,3249
-130,0,50,737,728,1465,2875
-90,80,90,731,734,1465,3371
160,60,100,746,720,1466,3109
-120,-30,140,726,740,1466,3219
80,-10,-180,727,739,1466,3112
80,-10,180,727,739,1466,3112
70,-10,-20,718,748,1466,3325
-80,-20,-130,737,729,1466,3261
-80,-50,-40,745,721,1466,3288
110,-40,60,733,733,1466,3275
150,-70,170,747,720,1467,3250
50,20,90,725,742,1467,2956
50,0,110,732,736,1468,3021
30,40,20,753,715,1468,3199
-140,20,140,729,740,1469,3470
50,40,20,728,742,1470,3189
60,0,-50,726,744,1470,3236
40,-80,-30,734,736,1470,3395
-20,-50,20,729,741,1470,3321
-70,50,-20,732,738,1470,3137
-150,-60,130,755,716,1471,3092
-150,10,150,739,732,1471,3483
0,30,30,746,725,1471,3336
60,0,120,726,746,1472,3136
120,80,-110,758,714,1472,3344
80,-70,110,744,728,1472,3426
-160,-20,170,743,729,1472,3506
140,-50,160,735,737,1472,3401
-150,70,150,735,737,1472,3348
-50,-40,0,728,744,1472,3350
-90,-10,-100,754,718,1472,3260
-120,-10,160,750,722,1472,3429
-50,-70,-20,755,717,1472,3291
-100,-10,10,743,730,1473,3288
-90,-20,-130,736,737,1473,3185
50,30,40,756,717,1473,3273
90,10,20,728,745,1473,3210
170,20,90,746,727,1473,3112
-120,0,140,742,732,1474,3484
-30,-30,20,745,729,1474,3333
-110,-10,70,730,744,1474,3199
50,30,-90,747,727,1474,3344
110,10,-120,727,748,1475,3329
-110,50,100,723,752,1475,3355
140,-60,160,732,744,1476,3221
50,30,60,748,728,1476,3174
170,-20,170,743,733,1476,3492
-110,20,100,700,776,1476,3252
80,70,-60,751,725,1476,3477
-110,-10,130,731,745,1476,3274
-60,-30,0,739,738,1477,3378
20,60,-90,751,726,1477,3427
70,0,-40,736,741,1477,3312
90,10,10,743,734,1477,3255
-170,60,170,738,739,1477,3391
10,30,30,747,731,1478,3418
-180,-60,-170,753,726,1479,3409
180,-60,-170,753,726,1479,3409
100,-10,80,735,744,1479,3226
-30,0,-80,724,755,1479,3378
70,20,-80,748,731,1479,3222
-150,80,150,742,738,1480,3366
10,-80,40,755,725,1480,3420
-30,-80,0,750,730,1480,3366
110,-10,-140,720,761,1481,3309
-100,-20,-40,740,741,1481,3227
-40,-40,-110,768,713,1481,3125
140,-20,90,712,769,1481,3182
140,40,-140,718,764,1482,3497
-90,-10,30,747,735,1482,3412
10,80,-90,750,732,1482,3284
40,50,-100,741,741,1482,3384
130,10,-150,719,763,1482,3474
-110,-70,-90,756,727,1483,3316
180,-10,170,758,725,1483,3495
-180,-10,170,758,725,1483,3495
100,40,-70,747,736,1483,3244
-140,-40,-150,738,745,1483,3316
80,20,50,770,714,1484,3083
130,80,-120,761,723,1484,3414
-90,-20,-10,728,756,1484,3345
0,0,-70,741,743,1484,3416
80,-60,10,756,728,1484,3349
100,-30,50,737,747,1484,3278
-150,-50,-150,736,748,1484,3345
0,-10,-70,755,729,1484,3477
-110,-50,-90,743,741,1484,3320
150,-80,170,758,726,1484,3315
-180,10,170,732,753,1485,3494
180,10,170,732,753,1485,3494
120,50,-110,750,735,1485,3378
-130,-60,150,745,740,1485,3398
-110,-10,120,733,753,1486,3228
-80,50,70,772,714,1486,3356
-60,20,40,754,732,1486,3444
60,-40,110,743,743,1486,3360
90,20,-70,731,755,1486,3129
-170,-20,170,746,740,1486,3511
140,0,-170,735,751,1486,3244
-100,-50,-70,758,728,1486,3406
180,-20,170,750,737,1487,3495
-180,-20,170,750,737,1487,3495
-160,60,160,740,747,1487,3355
-30,10,30,756,731,1487,3474
-170,-10,170,767,721,1488,3524
-110,-30,-90,739,749,1488,3221
110,-60,140,733,755,1488,3388
-20,40,-60,752,736,1488,3413
-90,50,80,750,739,1489,3370
-20,60,30,753,736,1489,3431
0,10,-70,732,757,1489,3408
-90,30,70,740,749,1489,3441
60,20,-80,743,746,1489,3254
-50,60,50,763,726,1489,3344
160,-20,170,734,755,1489,3479
100,20,-100,736,753,1489,3253
-20,50,-60,732,758,1490,3504
50,-10,-50,736,754,1490,3333
-130,0,150,752,738,1490,3504
40,-40,90,745,745,1490,3394
-120,-80,-100,749,741,1490,3369
50,-10,110,740,751,1491,3268
150,-30,170,739,752,1491,3518
10,50,20,777,714,1491,3339
0,40,-70,751,740,1491,3401
150,-80,80,741,751,1492,3338
-130,-60,-120,761,731,1492,3324
-170,-50,-170,746,746,1492,3495
-100,50,90,729,763,1492,3402
-100,80,100,741,752,1493,3422
160,-30,170,748,745,1493,3544
160,50,-160,726,767,1493,3376
-120,80,120,737,756,1493,3481
-140,80,140,747,746,1493,3398
30,60,0,762,731,1493,3352
-60,-70,-30,765,729,1494,3369
80,10,150,744,750,1494,3116
90,-70,120,751,743,1494,3458
-100,-20,-120,763,732,1495,3332
-110,-20,-170,744,751,1495,3272
-50,10,30,758,738,1496,3480
50,-80,-20,745,752,1497,3399
-120,-10,80,734,763,1497,3174
-10,-20,-80,762,735,1497,3356
-30,80,40,768,729,1497,3411
-110,80,110,740,757,1497,3440
-80,60,-10,747,750,1497,3330
90,-20,150,740,758,1498,3428
100,-20,160,746,752,1498,3385
-140,-20,180,752,746,1498,3537
-60,40,50,770,728,1498,3428
-140,-20,-180,752,746,1498,3537
-180,0,170,761,738,1499,3418
180,0,170,761,738,1499,3418
-130,-10,80,755,744,1499,3072
-120,40,110,747,752,1499,3510
-20,0,30,753,746,1499,3406
-40,50,40,759,740,1499,3364
50,-40,-30,728,771,1499,3329
-120,-50,-110,759,740,1499,3311
-160,-50,-160,742,758,1500,3496
20,-10,60,754,746,1500,3333
-130,-20,-170,746,754,1500,3430
-110,-60,-90,764,736,1500,3389
180,-40,100,744,757,1501,3267
-90,20,70,736,765,1501,3411
-20,-10,30,767,734,1501,3409
-180,-40,100,744,757,1501,3267
160,-80,180,758,743,1501,3418
-120,-40,-120,759,742,1501,3286
160,-80,-180,758,743,1501,3418
100,60,-80,753,748,1501,3448
30,-30,-50,741,760,1501,3545
90,20,0,735,767,1502,3107
20,-20,-60,756,746,1502,3478
30,-60,70,769,733,1502,3566
-160,-40,-170,733,769,1502,3455
-160,-30,-180,760,743,1503,3604
30,50,10,771,732,1503,3237
-160,-30,180,760,743,1503,3604
-70,30,50,767,736,1503,3418
-130,80,130,753,750,1503,3425
-160,10,160,740,763,1503,3561
30,-80,60,757,746,1503,3453
-40,-80,-10,756,747,1503,3385
80,30,20,749,754,1503,3091
80,10,70,761,743,1504,3218
50,40,-100,756,748,1504,3445
180,-10,90,756,749,1505,3154
-180,-10,90,756,749,1505,3154
80,-40,10,740,765,1505,3445
40,-60,80,763,742,1505,3562
-100,0,0,740,765,1505,3298
-140,-80,-120,759,747,1506,3500
50,50,-110,747,759,1506,3444
-40,10,30,742,764,1506,3544
-80,-10,20,774,732,1506,3395
10,-60,50,768,738,1506,3440
-110,40,100,748,758,1506,3443
150,10,-170,750,756,1506,3368
-50,20,-60,764,743,1507,3528
50,30,50,769,738,1507,3239
50,-60,90,740,767,1507,3572
160,-70,90,756,751,1507,3375
10,70,10,770,738,1508,3568
20,40,-80,748,760,1508,3465
-50,30,40,763,745,1508,3381
100,0,100,745,764,1509,3273
10,20,-70,755,754,1509,3245
-40,-20,-100,748,761,1509,3373
90,50,170,764,745,1509,3225
0,0,40,762,747,1509,3472
90,0,90,736,773,1509,3314
-130,-80,-110,761,748,1509,3436
110,40,-90,760,750,1510,3398
80,40,-20,757,753,1510,3313
110,-10,-170,748,763,1511,3420
60,80,-140,734,777,1511,3404
-160,-80,-140,778,733,1511,3568
-100,-10,50,770,741,1511,3297
80,-70,10,751,761,1512,3284
30,10,60,772,740,1512,3355
-90,0,-60,766,746,1512,3280
-70,-70,-40,776,737,1513,3444
70,30,40,747,766,1513,3198
170,10,90,753,760,1513,3171
-30,70,40,771,742,1513,3494
-110,-20,170,741,772,1513,3201
110,-40,150,752,761,1513,3464
80,70,-160,740,774,1514,3519
160,-40,170,761,753,1514,3533
160,20,-170,756,759,1515,3312
-40,-60,0,772,743,1515,3568
-50,30,-50,747,768,1515,3331
20,-80,50,764,751,1515,3454
80,60,-160,751,765,1516,3461
-100,-20,-130,741,775,1516,3195
-160,-60,-150,765,751,1516,3485
40,-40,-40,733,783,1516,3329
20,-60,60,765,751,1516,3540
0,60,20,778,738,1516,3454
80,-20,140,732,784,1516,3316
-40,-40,10,768,749,1517,3331
-160,-60,120,767,750,1517,3234
-120,30,110,740,777,1517,3463
0,-60,40,761,756,1517,3482
-90,-50,-50,768,749,1517,3422
60,-40,-20,747,770,1517,3447
40,-80,70,768,750,1518,3470
110,0,100,757,761,1518,3280
150,-30,90,747,771,1518,3222
-150,0,160,761,758,1519,3577
0,30,-70,759,760,1519,3347
-120,-60,160,762,757,1519,3415
60,50,-120,771,748,1519,3382
-100,20,0,750,769,1519,3297
-170,-80,-150,783,736,1519,3559
80,20,60,766,754,1520,3373
110,20,-100,762,758,1520,3315
100,-20,60,773,747,1520,3367
-90,-30,-20,775,745,1520,3497
90,-10,-140,747,773,1520,3171
90,-10,40,760,760,1520,3484
-80,-20,0,758,763,1521,3454
-40,40,-50,756,765,1521,3455
20,80,-100,764,757,1521,3438
-150,-80,-130,779,742,1521,3566
130,-40,160,748,773,1521,3569
90,20,-40,763,759,1522,3280
-140,70,140,753,769,1522,3441
130,70,-120,773,749,1522,3485
30,80,-110,760,763,1523,3512
-70,10,40,767,756,1523,3493
-130,-10,170,760,763,1523,3639
-150,60,150,749,774,1523,3327
100,-70,130,767,756,1523,3500
-50,-80,-20,771,753,1524,3453
120,-50,150,757,767,1524,3596
-100,-30,-170,749,775,1524,3305
120,40,-110,761,763,1524,3461
100,30,-70,772,753,1525,3159
80,60,-50,753,772,1525,3336
170,-80,-170,773,752,1525,3505
160,-50,90,762,764,1526,3332
60,10,110,747,779,1526,3261
-80,0,-90,766,760,1526,3275
-90,30,-10,765,761,1526,3393
90,10,0,762,764,1526,3339
90,0,20,759,768,1527,3407
-180,-40,180,782,745,1527,3557
-100,-40,-50,781,746,1527,3364
180,-40,180,782,745,1527,3557
170,50,-170,736,791,1527,3509
-180,-40,-180,782,745,1527,3557
130,60,-120,780,747,1527,3473
-110,0,120,743,784,1527,3404
180,-40,-180,782,745,1527,3557
-80,30,60,765,762,1527,3486
-100,40,90,770,758,1528,3489
60,40,-110,751,777,1528,3375
80,20,160,750,779,1529,3132
-50,-10,20,772,757,1529,3471
80,-20,0,740,789,1529,3458
-120,10,130,758,772,1530,3532
-130,-30,120,750,780,1530,3218
70,-40,120,768,762,1530,3397
-110,-10,60,770,760,1530,3202
-120,-40,150,780,751,1531,3384
60,-80,-10,760,771,1531,3445
70,20,-90,782,749,1531,3288
50,-80,80,773,759,1532,3561
-170,-60,-160,786,746,1532,3459
40,80,-120,757,775,1532,3489
-120,-10,170,787,745,1532,3523
-120,20,120,749,784,1533,3670
160,-60,90,764,769,1533,3285
160,-70,180,784,750,1534,3325
-140,0,160,770,764,1534,3678
60,-10,-40,764,770,1534,3413
160,-70,-180,784,750,1534,3325
70,-30,-10,757,777,1534,3387
-120,0,30,783,751,1534,3110
-150,-40,-160,754,780,1534,3467
90,70,-70,775,759,1534,3685
20,20,40,784,751,1535,3460
-110,-40,-80,764,771,1535,3345
140,-80,70,767,768,1535,3455
140,-30,170,754,781,1535,3583
110,60,150,774,761,1535,3071
70,20,80,782,753,1535,3234
-130,10,140,760,776,1536,3605
90,20,10,779,757,1536,3285
10,10,-70,772,764,1536,3521
40,0,100,772,764,1536,3197
-20,-20,30,774,762,1536,3516
90,-10,30,781,755,1536,3504
180,-80,-160,790,747,1537,3564
70,-60,110,769,768,1537,3505
-150,20,150,765,772,1537,3588
-180,-80,-160,790,747,1537,3564
-120,-20,-160,774,764,1538,3427
150,-10,180,751,787,1538,3624
150,-10,-180,751,787,1538,3624
90,-10,20,754,784,1538,3570
60,-60,100,764,775,1539,3544
140,80,-130,793,747,1540,3448
-140,-60,-130,784,756,1540,3595
90,10,130,775,767,1542,3491
-150,-10,170,790,752,1542,3694
-40,40,40,787,755,1542,3479
-90,10,-30,743,799,1542,3358
-100,10,90,767,775,1542,3458
70,-20,130,756,787,1543,3371
-70,70,70,778,765,1543,3424
-60,50,-30,773,770,1543,3377
80,20,-120,749,794,1543,3233
50,20,-80,752,792,1544,3295
20,10,-70,770,774,1544,3564
-20,60,-60,783,762,1545,3487
150,-60,170,765,780,1545,3438
-140,-10,170,784,761,1545,3753
-120,-70,-100,787,758,1545,3512
-140,-10,80,772,773,1545,3242
-100,-30,-30,780,765,1545,3421
-110,-10,80,765,780,1545,3311
60,-20,120,765,780,1545,3328
50,80,-130,761,785,1546,3504
100,70,170,777,769,1546,3309
-30,-60,10,775,771,1546,3583
-70,0,30,778,768,1546,3526
-80,-10,-110,785,761,1546,3369
-50,-60,-10,777,770,1547,3615
110,50,-90,783,764,1547,3515
90,-20,30,771,777,1548,3431
-110,-30,-80,779,769,1548,3281
170,-50,180,790,758,1548,3538
170,-50,-180,790,758,1548,3538
30,30,-80,761,788,1549,3407
10,-10,50,780,769,1549,3384
160,0,180,764,785,1549,3678
60,50,-10,787,762,1549,3293
160,0,-180,764,785,1549,3678
-120,0,150,774,776,1550,3762
-130,70,130,771,779,1550,3528
130,0,-160,747,803,1550,3526
-100,-20,-30,786,764,1550,3439
-20,-60,20,770,780,1550,3554
-40,-20,20,791,759,1550,3301
90,20,-10,775,776,1551,3307
-160,-10,170,782,769,1551,3693
-90,-60,-60,801,750,1551,3538
-30,30,-60,762,789,1551,3564
-60,-80,-30,785,767,1552,3539
-80,-40,-20,787,765,1552,3643
150,20,100,757,795,1552,3276
130,-30,80,758,795,1553,3472
-110,-10,110,759,794,1553,3457
-80,-30,-10,793,760,1553,3489
70,-10,170,777,776,1553,3227
-70,40,60,809,745,1554,3624
60,-80,90,784,770,1554,3615
0,20,-70,778,776,1554,3524
-140,60,140,764,790,1554,3447
90,0,80,779,776,1555,3412
-100,70,10,771,784,1555,3532
80,-10,-150,776,779,1555,3235
70,10,110,747,809,1556,3411
90,20,-80,792,765,1557,3354
-150,-30,-170,754,803,1557,3648
130,10,-140,780,777,1557,3517
-20,-30,30,781,776,1557,3643
90,30,-40,767,791,1558,3301
90,0,30,781,777,1558,3445
-10,-60,30,785,773,1558,3569
-110,30,100,765,793,1558,3513
-40,80,50,792,766,1558,3500
30,-40,-50,764,795,1559,3299
-30,0,30,798,761,1559,3631
170,-10,90,775,784,1559,3137
-120,70,120,785,775,1560,3563
80,20,-90,788,772,1560,3321
-10,70,-70,777,783,1560,3587
110,-30,160,771,790,1561,3489
90,20,20,802,759,1561,3316
-70,-40,-10,787,774,1561,3628
70,-80,0,781,780,1561,3548
-80,-70,-50,798,764,1562,3521
-140,-30,-160,776,786,1562,3577
-60,60,60,795,767,1562,3489
60,20,90,781,781,1562,3272
130,-50,70,772,790,1562,3493
170,10,-180,780,782,1562,3614
80,-60,120,770,792,1562,3565
170,10,180,780,782,1562,3614
90,0,10,759,804,1563,3522
40,0,-60,775,788,1563,3593
-70,20,-50,793,770,1563,3501
-30,60,40,791,772,1563,3581
-50,-30,10,779,784,1563,3492
90,-20,-160,778,785,1563,3462
140,70,-130,801,762,1563,3522
-130,-30,-150,791,773,1564,3373
120,-10,90,768,797,1565,3442
-100,30,90,760,805,1565,3585
-160,20,160,786,779,1565,3623
130,-80,60,784,781,1565,3559
-60,-20,10,780,785,1565,3681
50,30,70,772,794,1566,3282
-90,0,-70,786,780,1566,3552
-90,0,60,787,779,1566,3433
120,-10,-170,801,765,1566,3572
-60,-60,-20,779,787,1566,3607
-150,-60,-140,783,785,1568,3645
-30,-40,20,783,785,1568,3582
40,-10,100,790,778,1568,3386
-80,70,80,776,792,1568,3517
150,80,-140,809,759,1568,3620
70,-80,100,792,777,1569,3611
20,-40,-60,765,804,1569,3430
90,20,-30,767,802,1569,3375
-90,40,80,770,799,1569,3631
-140,10,150,797,772,1569,3697
30,60,-100,800,769,1569,3548
-110,-20,-160,765,804,1569,3472
-10,40,30,802,767,1569,3511
80,90,-70,805,765,1570,3608
-170,90,180,805,765,1570,3608
-70,-80,-40,793,777,1570,3583
-110,90,120,805,765,1570,3608
-70,90,80,805,765,1570,3608
-30,90,40,805,765,1570,3608
-90,90,100,805,765,1570,3608
50,90,-40,805,765,1570,3608
150,90,-140,805,765,1570,3608
-130,90,140,805,765,1570,3608
-80,90,90,805,765,1570,3608
100,90,-90,805,765,1570,3608
30,90,-20,805,765,1570,3608
-120,-10,70,790,780,1570,3303
-10,90,20,805,765,1570,3608
-180,90,-170,805,765,1570,3608
70,90,-60,805,765,1570,3608
160,90,-150,805,765,1570,3608
110,-70,140,787,783,1570,3553
20,90,-10,805,765,1570,3608
0,90,10,805,765,1570,3608
130,90,-120,805,765,1570,3608
-80,0,40,784,786,1570,3674
120,90,-110,805,765,1570,3608
40,90,-30,805,765,1570,3608
-20,90,30,805,765,1570,3608
-150,90,160,805,765,1570,3608
-170,90,-180,805,765,1570,3608
-120,90,130,805,765,1570,3608
-50,90,60,805,765,1570,3608
-60,90,70,805,765,1570,3608
-140,90,150,805,765,1570,3608
60,90,-50,805,765,1570,3608
140,90,-130,805,765,1570,3608
-100,90,110,805,765,1570,3608
180,90,-170,805,765,1570,3608
90,90,-80,805,765,1570,3608
-160,90,170,805,765,1570,3608
170,90,-160,805,765,1570,3608
10,90,0,805,765,1570,3608
-40,90,50,805,765,1570,3608
110,90,-100,805,765,1570,3608
180,50,80,767,804,1571,3316
120,-60,150,762,809,1571,3607
-180,50,80,767,804,1571,3316
-150,30,150,773,798,1571,3642
100,50,-70,797,774,1571,3489
-80,10,50,793,778,1571,3550
40,-50,-40,771,801,1572,3576
-60,20,-60,808,764,1572,3605
-110,-10,140,795,777,1572,3575
-160,30,160,788,784,1572,3676
150,-40,170,782,791,1573,3598
-120,-30,-130,789,786,1575,3403
-30,-30,-100,794,781,1575,3538
-160,80,70,772,804,1576,3595
-170,0,170,798,778,1576,3656
-60,-10,20,787,789,1576,3560
-20,-40,30,797,780,1577,3674
100,10,120,799,778,1577,3417
150,-50,170,794,783,1577,3585
110,-20,170,768,809,1577,3711
70,30,-110,786,791,1577,3508
-90,70,90,775,803,1578,3592
-110,-10,90,778,800,1578,3327
120,10,110,794,784,1578,3391
60,40,20,787,791,1578,3506
70,50,-140,774,804,1578,3484
110,40,140,790,789,1579,3470
-90,-20,0,799,780,1579,3506
150,40,-150,763,816,1579,3662
-180,30,80,792,789,1581,3225
180,30,80,792,789,1581,3225
-100,-10,-80,800,781,1581,3457
80,-80,10,794,788,1582,3563
-110,70,110,789,793,1582,3558
130,20,-130,774,809,1583,3575
120,30,-110,781,803,1584,3532
-90,0,-80,798,786,1584,3479
90,50,-50,802,783,1585,3452
-50,50,50,805,780,1585,3538
130,50,-120,807,778,1585,3609
90,-20,20,784,801,1585,3635
20,60,10,820,765,1585,3562
90,-60,130,779,806,1585,3602
-60,10,-80,776,809,1585,3448
-160,50,160,788,798,1586,3481
-110,-30,-70,792,794,1586,3396
-100,70,100,785,801,1586,3622
80,-40,130,791,795,1586,3595
40,10,-70,785,801,1586,3392
-90,10,-40,811,775,1586,3469
-140,80,50,777,810,1587,3457
-80,40,70,795,792,1587,3684
-50,10,-80,775,812,1587,3324
80,-80,110,799,789,1588,3653
-130,-70,-110,793,795,1588,3661
110,-50,50,781,807,1588,3529
140,10,100,796,792,1588,3360
110,40,-80,816,773,1589,3433
30,-30,80,811,778,1589,3536
-90,70,0,799,790,1589,3625
0,70,20,811,778,1589,3674
140,30,-140,790,799,1589,3647
70,40,-130,776,813,1589,3543
-70,-10,-110,811,778,1589,3492
90,-70,20,788,801,1589,3529
90,10,30,788,801,1589,3477
-90,-40,-30,805,784,1589,3610
80,40,-10,772,818,1590,3405
70,40,10,779,811,1590,3392
90,0,40,796,795,1591,3649
30,-20,80,801,790,1591,3678
-110,80,20,773,818,1591,3576
-150,80,60,784,807,1591,3529
60,30,-100,804,787,1591,3606
-140,30,140,777,814,1591,3627
-150,-20,180,808,784,1592,3864
-130,-40,-130,800,792,1592,3647
-160,40,160,809,783,1592,3679
90,-80,120,801,791,1592,3666
-150,-20,-180,808,784,1592,3864
100,-40,40,789,803,1592,3577
60,-20,-30,792,801,1593,3733
-170,-30,-180,815,778,1593,3768
-170,80,80,788,805,1593,3732
-170,-30,180,815,778,1593,3768
130,-30,170,782,811,1593,3632
-100,0,90,782,811,1593,3573
60,30,70,795,799,1594,3347
-180,50,180,774,820,1594,3546
-180,50,-180,774,820,1594,3546
180,50,180,774,820,1594,3546
180,50,-180,774,820,1594,3546
50,-50,-30,771,823,1594,3537
70,10,-70,804,790,1594,3401
-90,-10,40,799,795,1594,3578
140,-40,80,776,818,1594,3483
-170,50,170,786,808,1594,3475
-130,30,130,775,820,1595,3591
90,-20,-170,822,773,1595,3604
-120,-60,-100,806,789,1595,3646
-110,0,130,783,812,1595,3823
-100,-10,60,793,802,1595,3512
30,-40,80,810,785,1595,3459
100,-50,140,800,795,1595,3709
-70,-50,-20,804,791,1595,3673
-110,-60,170,796,799,1595,3556
140,30,110,805,790,1595,3463
80,10,110,773,823,1596,3472
180,40,80,780,816,1596,3254
80,-10,-10,809,787,1596,3719
-40,70,50,811,785,1596,3627
80,10,-60,782,814,1596,3456
-180,40,80,780,816,1596,3254
20,-30,-60,801,795,1596,3664
50,-50,100,797,800,1597,3543
-140,10,50,828,769,1597,3234
-10,-40,40,797,801,1598,3675
-50,0,-90,812,786,1598,3714
30,-10,-60,814,784,1598,3479
140,10,-160,769,829,1598,3664
80,0,-20,772,826,1598,3532
-70,-60,-30,801,797,1598,3641
-80,20,60,796,803,1599,3798
90,-60,20,808,791,1599,3598
-110,10,110,781,818,1599,3569
-130,0,160,796,803,1599,3773
-120,80,30,781,818,1599,3521
170,-70,-170,825,774,1599,3458
100,60,160,792,808,1600,3304
150,-70,80,807,793,1600,3638
-80,-80,-50,808,792,1600,3715
120,-80,50,800,800,1600,3652
30,10,-70,796,804,1600,3537
-150,40,150,784,816,1600,3632
80,-20,-180,803,798,1601,3316
80,-20,180,803,798,1601,3316
-90,10,70,793,808,1601,3478
-70,60,-20,807,794,1601,3555
-100,20,90,784,818,1602,3625
-100,-10,0,804,798,1602,3496
-90,-10,-110,798,804,1602,3429
120,40,130,803,800,1603,3509
-10,-30,40,812,791,1603,3689
120,-10,-160,796,808,1604,3736
90,0,60,804,800,1604,3540
130,20,110,804,800,1604,3437
0,40,30,823,781,1604,3543
-170,30,170,816,789,1605,3737
-130,80,40,779,826,1605,3470
-80,-50,-30,802,803,1605,3677
80,10,80,827,779,1606,3562
70,30,-150,799,807,1606,3452
-130,60,130,785,821,1606,3509
80,10,90,807,800,1607,3519
0,10,40,816,791,1607,3585
70,40,-150,805,802,1607,3489
170,0,90,796,812,1608,3483
100,70,-80,811,797,1608,3896
180,80,90,791,817,1608,3722
160,-10,180,815,793,1608,3709
100,-20,-150,790,818,1608,3611
50,50,0,831,777,1608,3509
-180,80,90,791,817,1608,3722
160,-10,-180,815,793,1608,3709
100,-80,30,806,803,1609,3663
-60,0,30,805,804,1609,3706
180,-50,-170,803,806,1609,3704
-50,80,60,816,793,1609,3632
90,20,140,805,804,1609,3467
160,80,-150,823,786,1609,3690
-180,-50,-170,803,806,1609,3704
-170,20,170,810,799,1609,3695
120,-70,150,800,810,1610,3582
-80,20,-40,802,808,1610,3481
110,30,-90,799,811,1610,3642
70,-40,-10,780,830,1610,3643
120,0,100,795,816,1611,3562
90,-80,20,807,804,1611,3649
-110,-20,160,802,809,1611,3537
-150,10,160,811,800,1611,3831
80,40,180,817,794,1611,3334
80,40,-180,817,794,1611,3334
100,-10,70,809,803,1612,3527
-100,-60,-70,836,776,1612,3664
-100,-50,-60,820,792,1612,3625
70,0,130,788,825,1613,3443
110,60,-90,820,793,1613,3790
-110,-10,100,785,828,1613,3391
-100,-10,-70,795,819,1614,3457
110,-80,40,817,798,1615,3678
-70,-20,-130,797,818,1615,3523
150,20,-160,794,821,1615,3709
30,-10,80,812,803,1615,3625
90,20,-20,806,810,1616,3387
120,-20,80,797,819,1616,3586
0,-40,50,820,796,1616,3690
-100,-10,-90,806,811,1617,3533
90,-20,-150,806,812,1618,3407
90,-50,20,815,803,1618,3666
100,-80,130,819,800,1619,3724
-50,-50,0,804,815,1619,3703
-150,50,150,803,817,1620,3511
-110,-50,-80,829,791,1620,3705
-10,50,30,828,792,1620,3652
-100,-10,-40,810,810,1620,3469
-100,30,0,798,822,1620,3533
-90,-70,-60,821,800,1621,3613
10,50,-80,835,786,1621,3706
-70,-10,20,808,814,1622,3665
-40,30,40,826,796,1622,3759
-110,-20,-150,815,807,1622,3641
-90,30,80,799,823,1622,3763
30,-50,-50,803,819,1622,3620
-60,10,40,804,819,1623,3669
10,0,-70,811,812,1623,3904
-100,-40,-180,815,809,1624,3515
90,0,50,808,816,1624,3548
-100,-40,180,815,809,1624,3515
170,80,100,795,829,1624,3694
-10,30,-70,811,813,1624,3717
140,20,-150,794,830,1624,3641
-60,-50,-10,805,820,1625,3669
-100,0,-10,815,810,1625,3467
160,40,-160,799,826,1625,3747
-170,10,170,797,828,1625,3889
0,-70,40,818,807,1625,3721
60,10,-70,816,809,1625,3698
-40,0,30,811,814,1625,3731
-70,-20,10,826,800,1626,3823
-120,-40,-110,805,821,1626,3626
-120,-10,60,830,796,1626,3332
40,-50,90,804,822,1626,3790
-140,-30,110,804,822,1626,3566
90,20,-100,792,835,1627,3478
-150,0,70,807,820,1627,3480
170,60,90,819,808,1627,3332
-120,60,120,801,827,1628,3639
70,50,-20,821,807,1628,3414
90,60,-60,806,822,1628,3660
-10,20,-70,819,810,1629,3760
150,70,-140,838,791,1629,3720
-50,0,30,815,814,1629,3870
120,20,-110,817,812,1629,3560
80,30,30,806,824,1630,3452
160,-60,-180,818,812,1630,3651
-90,20,-20,817,813,1630,3506
160,-60,180,818,812,1630,3651
-110,-30,160,826,804,1630,3640
130,0,-150,808,822,1630,3806
30,10,70,808,822,1630,3577
-80,70,-10,832,799,1631,3662
-130,-20,-160,811,820,1631,3609
100,40,150,829,802,1631,3556
160,80,110,794,837,1631,3775
170,0,180,797,834,1631,3936
20,-70,60,841,790,1631,3739
170,0,-180,797,834,1631,3936
130,0,100,818,813,1631,3548
90,0,-130,807,824,1631,3488
40,20,90,820,811,1631,3263
-70,60,70,823,809,1632,3698
70,0,170,812,821,1633,3437
10,-70,50,831,802,1633,3749
-140,-20,-170,809,824,1633,3782
-10,60,30,835,798,1633,3733
170,-40,-180,818,816,1634,3825
50,-20,110,818,816,1634,3597
170,-40,180,818,816,1634,3825
-50,20,40,820,814,1634,3816
-110,-10,170,830,804,1634,3724
130,40,120,825,810,1635,3534
-10,-70,30,816,819,1635,3774
-60,-40,0,820,815,1635,3745
-170,-40,-170,810,825,1635,3790
90,20,-90,817,818,1635,3618
-70,-30,0,829,807,1636,3797
-50,50,-40,823,813,1636,3651
-30,-10,-90,816,820,1636,3754
-100,-20,-140,805,831,1636,3649
-140,-70,-120,832,805,1637,3712
60,60,-130,805,832,1637,3669
-120,-50,-100,821,816,1637,3733
40,60,-110,805,832,1637,3608
130,-10,90,787,851,1638,3546
90,-20,-180,793,845,1638,3602
-120,-10,-180,818,820,1638,3763
-90,-80,-60,825,813,1638,3801
-110,-20,-140,811,827,1638,3782
-170,40,170,816,822,1638,3686
-120,-10,180,818,820,1638,3763
90,-20,180,793,845,1638,3602
180,-30,-180,833,806,1639,3977
-100,-50,-180,816,823,1639,3601
-160,0,170,821,818,1639,3806
170,40,-170,811,828,1639,3676
-130,-10,-180,822,817,1639,3828
-180,-30,180,833,806,1639,3977
180,-30,180,833,806,1639,3977
-130,-10,180,822,817,1639,3828
-100,-50,180,816,823,1639,3601
30,20,50,820,819,1639,3699
70,30,-120,801,838,1639,3540
-180,-30,-180,833,806,1639,3977
-40,-50,10,823,816,1639,3723
60,20,-90,811,828,1639,3557
40,30,-90,825,815,1640,3574
-80,-60,-40,832,808,1640,3686
-70,20,50,824,816,1640,3792
-140,-50,130,826,814,1640,3652
130,40,-120,828,812,1640,3722
70,80,-50,832,809,1641,3912
100,20,130,811,830,1641,3590
-110,10,10,816,825,1641,3728
50,0,-60,808,834,1642,3683
50,-20,-40,837,805,1642,3769
60,80,-40,835,808,1643,3893
120,0,-130,821,822,1643,3663
-100,-10,-30,794,849,1643,3664
60,-50,110,831,812,1643,3528
160,-40,90,829,814,1643,3540
-60,50,60,847,797,1644,3737
90,10,-10,800,844,1644,3490
-130,10,150,826,819,1645,3842
-140,0,170,837,808,1645,3881
150,-20,90,807,838,1645,3597
70,70,-150,804,841,1645,3714
-100,-10,-50,827,818,1645,3495
20,-30,70,824,822,1646,3665
30,-70,70,844,802,1646,3778
70,30,60,819,828,1647,3422
-60,80,70,838,809,1647,3736
-140,50,140,821,826,1647,3648
-30,50,40,846,801,1647,3622
-180,30,-180,837,811,1648,3820
-180,30,180,837,811,1648,3820
180,30,180,837,811,1648,3820
-140,40,140,807,841,1648,3717
-20,-70,20,825,823,1648,3853
180,30,-180,837,811,1648,3820
40,80,-20,847,801,1648,3867
150,80,120,808,840,1648,3788
-130,-50,-120,834,814,1648,3677
50,10,-70,810,838,1648,3664
-110,-30,-60,832,816,1648,3669
-10,60,-70,836,813,1649,3837
-140,-10,-180,825,824,1649,3934
-140,-10,180,825,824,1649,3934
-50,-10,-100,838,812,1650,3658
-140,10,160,824,826,1650,3845
-30,20,-70,831,819,1650,3859
-70,-30,-140,851,799,1650,3651
-110,20,10,835,815,1650,3657
-80,-30,-150,834,816,1650,3781
80,10,140,828,823,1651,3621
100,-60,140,824,827,1651,3771
-100,-10,-10,824,827,1651,3760
30,80,-10,849,802,1651,3869
-110,-40,-70,833,818,1651,3598
90,40,-40,824,828,1652,3493
-40,60,50,853,799,1652,3813
-110,-10,20,823,829,1652,3626
20,-50,-60,831,821,1652,3629
-120,0,160,831,821,1652,3938
120,-40,160,813,840,1653,3754
80,60,-170,828,825,1653,3693
-20,20,-70,829,824,1653,3739
120,10,-120,822,831,1653,3766
-180,40,180,816,838,1654,3764
180,40,-180,816,838,1654,3764
-80,-10,30,824,830,1654,3742
-10,-20,40,827,827,1654,3864
-180,40,-180,816,838,1654,3764
50,80,-30,853,801,1654,3866
110,-80,140,839,815,1654,3794
-90,0,-90,828,826,1654,3758
180,40,180,816,838,1654,3764
40,30,40,824,831,1655,3749
-100,-80,-70,836,819,1655,3851
-40,-30,20,841,814,1655,3645
170,-10,180,839,816,1655,3857
-180,-70,-160,850,805,1655,3700
20,-40,70,825,830,1655,3665
170,-10,-180,839,816,1655,3857
-80,10,-70,837,818,1655,3626
180,-70,-160,850,805,1655,3700
140,-70,70,821,835,1656,3766
160,0,90,838,819,1657,3445
80,-20,-170,845,812,1657,3714
-130,20,140,817,840,1657,3926
150,0,-170,813,844,1657,3650
80,80,-60,842,815,1657,3909
170,80,-160,840,817,1657,3834
150,-20,180,839,818,1657,3859
100,-20,50,824,833,1657,3742
150,-20,-180,839,818,1657,3859
-180,20,180,841,817,1658,3900
-170,-90,-140,829,829,1658,3840
160,-90,-170,829,829,1658,3840
-100,-90,-70,829,829,1658,3840
60,-90,90,829,829,1658,3840
180,20,-180,841,817,1658,3900
-90,-90,-60,829,829,1658,3840
-160,-90,-130,829,829,1658,3840
150,-90,180,829,829,1658,3840
80,10,120,814,844,1658,3717
-40,-90,-10,829,829,1658,3840
20,-90,50,829,829,1658,3840
-10,-90,20,829,829,1658,3840
110,-90,140,829,829,1658,3840
90,-90,120,829,829,1658,3840
-120,-90,-90,829,829,1658,3840
-130,-90,-100,829,829,1658,3840
80,-90,110,829,829,1658,3840
150,-90,-180,829,829,1658,3840
-150,-90,-120,829,829,1658,3840
40,-90,70,829,829,1658,3840
-180,20,-180,841,817,1658,3900
180,-90,-150,829,829,1658,3840
30,-90,60,829,829,1658,3840
-110,-90,-80,829,829,1658,3840
-50,-90,-20,829,829,1658,3840
140,-90,170,829,829,1658,3840
-70,-90,-40,829,829,1658,3840
-180,-90,-150,829,829,1658,3840
180,20,180,841,817,1658,3900
0,-90,30,829,829,1658,3840
120,-90,150,829,829,1658,3840
170,-90,-160,829,829,1658,3840
70,-90,100,829,829,1658,3840
-140,-90,-110,829,829,1658,3840
-30,-90,0,829,829,1658,3840
-60,-90,-30,829,829,1658,3840
100,-90,130,829,829,1658,3840
-80,-90,-50,829,829,1658,3840
50,-90,80,829,829,1658,3840
130,-90,160,829,829,1658,3840
10,-90,40,829,829,1658,3840
-20,-90,10,829,829,1658,3840
40,-60,-40,826,833,1659,3627
70,40,-140,817,843,1660,3801
70,-10,-30,830,830,1660,3725
80,30,170,832,828,1660,3573
70,0,-50,828,832,1660,3628
30,-60,-50,832,828,1660,3622
70,30,50,822,838,1660,3503
40,10,100,845,816,1661,3440
-120,-20,110,815,846,1661,3616
-30,-70,10,837,825,1662,3891
-110,60,110,819,843,1662,3821
-90,20,80,814,848,1662,3773
80,-30,0,805,857,1662,3848
40,20,-80,827,836,1663,3705
70,30,70,818,845,1663,3454
90,20,30,820,843,1663,3492
-120,10,140,846,817,1663,3926
40,-70,80,850,813,1663,3829
90,10,-120,801,863,1664,3634
100,-20,-160,817,847,1664,3717
40,-20,100,839,826,1665,3591
100,-20,-170,825,840,1665,3712
30,0,80,842,823,1665,3762
-100,-40,-40,851,814,1665,3731
-50,20,-70,836,829,1665,3861
90,70,-180,829,836,1665,3693
90,70,180,829,836,1665,3693
10,-40,60,826,839,1665,3611
90,10,-50,828,837,1665,3616
-60,60,-30,852,814,1666,3765
70,-10,140,799,867,1666,3714
0,-30,50,838,828,1666,3655
130,-50,160,832,834,1666,3869
-50,40,50,847,819,1666,3863
70,10,120,813,853,1666,3456
100,-20,170,801,865,1666,3919
-10,70,30,845,821,1666,3813
120,40,-100,845,822,1667,3820
-100,-60,-180,833,834,1667,3546
-20,-50,30,838,829,1667,3919
40,30,70,846,821,1667,3618
-100,-60,180,833,834,1667,3546
110,-30,60,859,809,1668,3855
130,-70,160,830,838,1668,3789
-60,-20,-120,846,822,1668,3728
-140,-40,-140,832,836,1668,3700
80,-20,-160,847,821,1668,3532
140,60,-130,837,832,1669,3763
-30,-50,20,843,826,1669,3953
10,40,30,844,825,1669,3721
70,-20,-20,851,818,1669,3927
-70,-50,-150,854,815,1669,3728
-40,20,-70,845,825,1670,3895
-130,50,130,818,852,1670,3826
-40,-70,0,842,828,1670,3953
120,-50,60,848,822,1670,3816
-60,30,50,837,833,1670,3872
-100,-20,-150,832,838,1670,3718
-100,-20,-20,816,854,1670,3747
60,-50,-20,813,858,1671,3760
-120,20,130,814,857,1671,3774
30,40,-90,850,821,1671,3716
90,30,-30,833,838,1671,3573
-140,20,150,842,830,1672,3930
-50,-70,-10,846,826,1672,3929
-130,-20,100,815,858,1673,3619
90,-40,140,840,833,1673,3938
90,-10,10,807,866,1673,3838
160,-20,-180,835,839,1674,3879
140,80,130,818,856,1674,3873
-100,80,10,812,862,1674,3785
-160,-30,100,837,837,1674,3366
110,30,-80,832,842,1674,3690
70,40,-160,832,842,1674,3561
-90,-20,-140,824,850,1674,3796
170,-30,-180,851,823,1674,3902
-110,-10,160,830,844,1674,3762
170,-30,180,851,823,1674,3902
160,-20,180,835,839,1674,3879
-150,20,160,839,835,1674,4050
90,-20,160,830,845,1675,3879
80,0,-140,832,843,1675,3542
80,10,-70,846,829,1675,3626
20,80,0,863,812,1675,3878
-120,20,20,859,816,1675,3515
0,70,-80,854,822,1676,3786
-170,-70,-150,863,813,1676,3867
10,20,40,855,821,1676,3810
100,-10,-130,843,834,1677,3637
-180,-10,180,855,822,1677,3821
-110,0,140,833,844,1677,4010
180,-10,180,855,822,1677,3821
-160,-30,-170,831,846,1677,3932
-80,-20,10,850,827,1677,3791
180,-10,-180,855,822,1677,3821
110,70,-90,861,816,1677,4035
-180,-10,-180,855,822,1677,3821
-80,30,70,839,839,1678,3900
-100,-70,-70,848,830,1678,3772
-30,-10,30,848,830,1678,3744
120,30,-100,839,839,1678,3837
-150,-70,-130,854,825,1679,3890
90,0,0,837,842,1679,3786
-10,-50,40,865,814,1679,3955
10,-50,-70,845,835,1680,3621
70,-10,180,828,852,1680,3456
130,0,-140,832,848,1680,3931
70,-10,-180,828,852,1680,3456
-100,10,-10,825,855,1680,3689
110,-20,70,858,822,1680,3862
-110,-80,-80,851,829,1680,3904
-90,-30,-160,835,845,1680,3660
120,-80,150,855,826,1681,3856
-80,60,80,840,841,1681,3889
130,-10,-170,832,849,1681,3842
60,-70,100,850,831,1681,3929
100,40,-60,841,841,1682,3665
-100,-20,-160,837,845,1682,3622
20,0,60,848,835,1683,3727
130,30,-120,829,854,1683,3840
30,-50,80,851,832,1683,3946
-110,10,120,828,856,1684,3870
-150,0,170,853,831,1684,3985
80,10,130,839,846,1685,3808
90,0,70,863,822,1685,3892
50,60,-120,838,847,1685,3801
100,-70,30,839,846,1685,3706
120,-10,-140,824,861,1685,3901
-130,40,130,828,858,1686,3775
80,10,100,825,861,1686,3731
120,50,-100,863,823,1686,3945
-160,-70,-140,870,816,1686,3920
70,-10,160,840,846,1686,3646
-50,70,60,855,832,1687,3826
80,40,0,827,860,1687,3567
-120,-20,-150,849,839,1688,3869
-50,-20,-110,879,809,1688,3776
70,-50,120,839,849,1688,3768
50,-70,90,861,827,1688,3876
-160,-20,-180,855,833,1688,4100
-160,-20,180,855,833,1688,4100
90,30,-20,831,858,1689,3517
130,-60,160,829,860,1689,3780
40,-20,-50,871,818,1689,3892
-90,60,90,852,838,1690,3923
110,10,110,858,832,1690,3899
-110,-70,170,840,850,1690,3679
-70,80,80,863,828,1691,3822
-180,80,-170,857,834,1691,3971
-40,10,-80,845,846,1691,3649
100,20,-90,855,836,1691,3711
-20,-20,-90,837,854,1691,3805
-90,-30,-10,852,839,1691,3753
80,20,-100,847,844,1691,3745
-110,-20,-90,851,840,1691,3645
180,80,-170,857,834,1691,3971
-90,-60,-170,835,857,1692,3590
130,80,140,832,860,1692,3965
-70,70,-20,847,845,1692,3799
-110,-10,150,859,833,1692,3876
-100,-10,-20,834,858,1692,3761
140,20,-140,832,860,1692,3878
90,10,40,852,840,1692,3837
-140,0,60,843,849,1692,3514
-180,-50,100,850,843,1693,3635
-90,-50,-40,853,840,1693,3814
180,-50,100,850,843,1693,3635
-120,50,120,842,851,1693,3910
-120,-30,130,826,867,1693,3621
-120,-40,-100,838,855,1693,3706
130,10,-130,853,841,1694,3869
20,-60,-60,849,845,1694,3797
70,60,-150,836,858,1694,3956
-70,10,-80,820,874,1694,3692
-170,-10,-180,845,850,1695,4054
-100,-10,70,850,845,1695,3729
-170,-10,180,845,850,1695,4054
160,10,-170,849,846,1695,3755
10,80,10,878,818,1696,3871
160,-10,90,846,850,1696,3541
-90,-60,-50,854,843,1697,3880
-150,-10,180,861,836,1697,4130
70,50,-160,874,823,1697,3785
-80,-10,-120,848,849,1697,3832
110,30,130,853,844,1697,3680
-100,60,100,840,857,1697,3924
-150,-10,-180,861,836,1697,4130
90,10,120,845,852,1697,3636
120,-10,-150,852,845,1697,3975
20,10,50,862,836,1698,3744
-80,80,90,867,831,1698,3886
-80,10,60,860,839,1699,3752
70,0,180,832,867,1699,3525
130,-80,160,866,833,1699,3889
70,0,-180,832,867,1699,3525
70,30,-160,837,863,1700,3571
110,-20,-160,843,857,1700,3817
10,-30,-70,837,864,1701,3860
100,30,-60,807,894,1701,3566
-90,-20,10,861,840,1701,3915
140,-20,180,856,845,1701,3960
130,-20,180,852,849,1701,3829
-170,-60,110,854,847,1701,3825
140,-20,-180,856,845,1701,3960
-120,30,120,822,879,1701,3916
130,-20,-180,852,849,1701,3829
-90,0,70,857,845,1702,3752
0,-50,50,861,841,1702,3836
110,50,-80,854,848,1702,3779
90,30,-10,832,870,1702,3677
-50,-40,10,857,845,1702,3805
90,-30,20,830,872,1702,3916
170,30,-170,851,851,1702,3862
-170,-50,-160,847,856,1703,3835
-70,50,70,864,839,1703,3980
50,10,110,858,845,1703,3507
-130,-50,140,876,827,1703,3935
-160,10,70,860,843,1703,3509
-120,-70,160,845,858,1703,3707
50,70,-20,846,858,1704,3847
100,-60,30,838,866,1704,3839
-110,50,110,840,864,1704,3913
20,50,20,876,829,1705,3703
-10,-10,40,869,836,1705,4003
120,30,120,851,854,1705,3670
90,80,-70,867,838,1705,3972
-30,40,-60,870,836,1706,3988
0,-50,-80,836,870,1706,3674
50,-60,-30,852,854,1706,3796
10,-40,-70,839,867,1706,3773
40,70,-10,863,843,1706,3851
-50,60,60,877,829,1706,4011
-110,-20,-100,855,851,1706,3715
80,0,-30,846,860,1706,3788
70,-70,110,858,849,1707,3904
-110,0,150,854,853,1707,3928
170,-60,-170,871,836,1707,3836
100,30,140,848,859,1707,3663
100,-30,40,830,879,1709,3858
-10,0,40,855,854,1709,3935
50,20,-90,864,845,1709,3690
70,0,160,832,877,1709,3583
60,70,-30,845,865,1710,3944
10,-20,-70,874,836,1710,3927
70,30,-140,850,860,1710,3793
100,10,110,840,870,1710,3843
-70,-60,-150,866,845,1711,3858
-110,-20,150,862,849,1711,3924
-80,0,50,861,850,1711,3817
-120,-80,-90,863,848,1711,3961
-130,-40,130,841,870,1711,3557
-130,0,170,881,830,1711,3977
-170,-20,-180,866,845,1711,4133
-170,-20,180,866,845,1711,4133
90,10,-40,848,863,1711,3721
60,0,-60,847,865,1712,3832
-70,30,60,870,842,1712,3954
-60,-30,-130,858,854,1712,3748
170,-20,-180,876,836,1712,4016
170,-20,180,876,836,1712,4016
90,-20,170,828,885,1713,4090
110,20,120,862,851,1713,3717
10,-60,-70,852,861,1713,3939
120,-30,70,856,858,1714,3958
-60,-70,-20,873,841,1714,4043
120,80,150,848,866,1714,4086
140,-40,170,861,853,1714,4162
-140,-40,120,859,855,1714,3630
-110,-60,-80,883,832,1715,3900
-110,-70,-80,864,851,1715,3889
40,50,10,876,839,1715,3791
70,10,170,841,874,1715,3577
-180,-20,180,862,854,1716,4087
-40,50,50,873,843,1716,3941
-180,-20,-180,862,854,1716,4087
-130,10,160,874,842,1716,3993
180,-20,-180,862,854,1716,4087
-100,0,-20,852,864,1716,3740
-30,40,40,882,834,1716,3827
-110,-10,180,862,854,1716,4048
180,-20,180,862,854,1716,4087
-110,-10,-180,862,854,1716,4048
-80,-30,0,875,842,1717,3898
-110,0,10,869,848,1717,3781
-150,-10,80,843,874,1717,3743
-120,30,20,863,854,1717,3758
90,-40,20,855,863,1718,3957
-150,10,60,880,838,1718,3733
80,20,-110,844,874,1718,3809
160,-30,90,857,862,1719,3816
-170,0,80,863,856,1719,3603
-40,30,-60,862,857,1719,3899
-10,50,-70,863,857,1720,3968
100,50,-60,864,856,1720,3739
120,20,-100,867,853,1720,3845
160,70,-150,870,850,1720,3944
20,-50,70,862,858,1720,3938
90,10,110,858,862,1720,3854
-170,80,180,872,849,1721,4002
-170,80,-180,872,849,1721,4002
50,30,80,865,857,1722,3641
-40,20,40,865,857,1722,3845
20,30,-80,846,876,1722,3856
-100,-10,80,865,858,1723,3614
80,20,150,860,863,1723,3574
-90,80,100,872,852,1724,3914
-110,20,110,839,885,1724,4045
80,-20,150,836,888,1724,3962
40,-70,-40,865,859,1724,3966
-110,-20,140,866,858,1724,3891
130,-70,60,846,878,1724,3907
80,10,-130,835,889,1724,3695
-60,-60,-140,872,852,1724,3821
-10,10,40,864,860,1724,3895
140,-10,-170,851,874,1725,4020
-110,-20,130,863,862,1725,3653
100,60,-70,867,858,1725,3972
-140,-70,140,878,847,1725,3820
-160,-40,-160,859,866,1725,3974
160,-20,90,853,872,1725,3688
100,-20,-180,847,879,1726,3896
-110,-20,-130,859,867,1726,3812
100,-20,180,847,879,1726,3896
-80,-60,-160,873,853,1726,3838
-140,-50,-130,874,853,1727,4018
150,-10,90,860,867,1727,3776
140,50,-130,845,882,1727,3971
160,60,-150,852,875,1727,4045
150,30,-150,848,879,1727,3896
100,20,-80,854,873,1727,3735
50,40,30,872,856,1728,3867
-130,-70,150,868,860,1728,3714
100,0,90,822,907,1729,3854
70,10,-180,847,882,1729,3585
80,20,70,883,846,1729,3612
70,10,180,847,882,1729,3585
-90,50,90,864,866,1730,3902
-160,-50,-150,859,871,1730,3929
-30,-20,30,863,867,1730,3903
160,-30,180,877,854,1731,3966
160,-30,-180,877,854,1731,3966
-110,30,10,868,863,1731,3873
20,-20,70,864,867,1731,3927
60,40,-120,858,873,1731,3815
60,60,-20,856,875,1731,3777
70,50,-150,856,875,1731,3892
120,-20,-180,853,879,1732,4002
120,-30,170,868,864,1732,3865
140,-80,170,878,854,1732,3979
120,-20,180,853,879,1732,4002
70,70,-40,860,872,1732,4055
160,-50,180,870,862,1732,3864
160,-50,-180,870,862,1732,3864
30,-70,-50,868,865,1733,3911
-100,80,110,880,853,1733,3979
10,-50,60,870,863,1733,3899
140,0,-160,843,890,1733,3871
80,-70,120,873,860,1733,3977
-120,-10,-170,861,873,1734,3955
110,10,-110,864,870,1734,3794
70,30,-130,855,879,1734,3857
30,30,40,887,847,1734,3977
80,50,-180,870,864,1734,3691
-110,-20,-80,869,865,1734,3717
80,50,180,870,864,1734,3691
10,-30,60,878,857,1735,3882
-100,-70,180,882,853,1735,3775
-150,-20,90,856,879,1735,3731
80,-20,170,861,874,1735,3989
80,50,-30,875,860,1735,3762
-100,-70,-180,882,853,1735,3775
90,60,170,867,868,1735,3695
120,60,-100,878,858,1736,4061
-90,-40,-20,875,861,1736,3953
-80,50,80,868,868,1736,3969
-160,-10,180,870,867,1737,4171
-100,50,100,859,878,1737,3945
-20,0,-80,871,866,1737,3963
-160,-10,-180,870,867,1737,4171
180,0,-180,874,864,1738,4047
-60,-30,10,865,873,1738,4020
-150,-70,130,880,858,1738,3923
-100,-10,-60,864,874,1738,3760
100,80,-80,891,847,1738,4053
-180,0,-180,874,864,1738,4047
-180,0,180,874,864,1738,4047
-70,0,40,856,882,1738,3976
50,60,-10,879,859,1738,3836
110,-50,150,878,860,1738,4062
-130,-60,-110,880,858,1738,3967
180,0,180,874,864,1738,4047
-110,10,130,858,881,1739,4021
-70,-70,-30,877,862,1739,4059
0,50,30,893,847,1740,4013
-110,-20,-70,888,852,1740,3792
20,0,-70,871,869,1740,4055
20,50,-90,879,861,1740,3985
-140,0,180,872,869,1741,4129
10,-10,-70,867,874,1741,4025
-20,60,40,895,846,1741,3886
-140,0,-180,872,869,1741,4129
-130,-80,-100,878,864,1742,3972
-160,10,170,869,873,1742,4145
-80,0,-100,869,873,1742,3987
-120,10,150,885,858,1743,4123
-100,0,-30,862,881,1743,3760
40,30,60,857,886,1743,3894
150,60,-140,871,872,1743,3981
-120,80,130,882,861,1743,4063
-150,-30,-160,854,890,1744,3949
120,70,-100,886,858,1744,4162
-80,-50,-160,881,863,1744,3838
-60,-50,-140,874,870,1744,3713
140,-70,170,870,874,1744,3940
10,60,20,883,861,1744,3938
90,40,160,869,875,1744,3793
-90,80,0,852,892,1744,3993
50,-30,110,873,872,1745,3888
110,-20,-180,847,899,1746,4054
20,-70,-60,887,859,1746,3906
110,-20,180,847,899,1746,4054
-80,-40,-10,868,879,1747,4027
140,40,110,875,872,1747,3786
70,0,150,848,899,1747,3637
-150,-40,-150,860,888,1748,4025
-60,40,60,889,859,1748,4038
100,-10,60,884,864,1748,3952
140,40,-130,865,883,1748,4131
70,20,-150,855,893,1748,3721
-110,80,120,888,861,1749,4046
0,80,20,900,849,1749,3901
-90,-50,-170,869,880,1749,3915
-120,-70,-90,884,865,1749,4052
140,-10,90,857,892,1749,3856
140,10,-150,868,881,1749,4139
-150,-20,-170,875,875,1750,4070
-70,-50,-10,885,865,1750,4005
-110,0,160,884,866,1750,3974
100,10,-110,866,884,1750,3792
-60,70,70,886,864,1750,4049
-120,40,120,868,882,1750,4063
50,-70,-30,871,879,1750,4124
20,40,30,886,865,1751,3950
100,20,-70,860,891,1751,3744
-120,-10,50,896,855,1751,3629
-130,-10,-170,887,864,1751,4006
150,-80,180,895,856,1751,4038
150,-80,-180,895,856,1751,4038
-10,-80,30,885,867,1752,4131
60,-60,-20,879,873,1752,4073
-50,-60,-130,876,876,1752,3892
110,-40,50,878,874,1752,3906
-130,-10,70,879,873,1752,3684
-60,20,50,869,883,1752,4000
60,-10,130,853,899,1752,3859
10,-70,-70,893,860,1753,3922
10,70,-90,887,866,1753,4012
-50,-20,20,887,866,1753,3974
40,40,30,883,870,1753,3887
-70,10,50,876,878,1754,4020
30,70,0,893,861,1754,3909
110,0,-120,871,883,1754,3959
40,30,50,864,891,1755,3908
-130,80,140,887,868,1755,4085
160,-40,180,876,879,1755,4092
-140,-30,-150,881,874,1755,3840
160,-40,-180,876,879,1755,4092
-160,20,170,879,876,1755,4143
-20,-80,20,886,869,1755,4169
-100,-30,-20,876,879,1755,3807
-90,10,-50,874,881,1755,3910
-70,20,-60,886,870,1756,3947
10,0,50,892,864,1756,3876
-100,-20,30,871,885,1756,4028
-90,10,80,861,896,1757,3759
-70,30,-40,889,868,1757,3866
-100,-10,-100,891,866,1757,3814
-140,-80,-110,872,885,1757,3988
-30,-60,20,897,861,1758,4202
-40,50,-50,875,883,1758,4112
-40,0,-90,900,858,1758,4097
-130,-30,-140,865,893,1758,3823
-70,-40,0,881,878,1759,4063
-100,-20,-170,875,884,1759,3991
-140,80,150,891,868,1759,4088
-80,-20,-140,891,868,1759,4073
-10,-70,-90,893,866,1759,3966
160,30,-160,897,863,1760,3989
180,60,80,886,875,1761,3624
-180,60,80,886,875,1761,3624
0,-70,-80,893,868,1761,3921
-160,80,170,888,873,1761,4081
40,-30,100,901,860,1761,3772
-50,10,40,874,888,1762,3981
-150,-50,120,870,892,1762,3950
110,80,160,872,890,1762,4198
-10,-10,-80,867,895,1762,4028
20,-60,70,896,866,1762,4166
90,10,50,881,881,1762,3933
-110,-20,-110,875,887,1762,3862
90,30,150,879,884,1763,3734
-70,0,-100,907,856,1763,4042
-50,60,-40,898,865,1763,3962
130,20,-120,869,895,1764,4104
60,50,0,892,872,1764,3953
110,-20,-170,864,900,1764,4006
-180,-40,-170,897,867,1764,4097
-40,-60,10,891,873,1764,4153
-30,10,-80,860,904,1764,3905
180,-40,-170,897,867,1764,4097
-150,80,160,884,881,1765,4074
-150,-50,-140,887,878,1765,3992
170,70,-160,888,877,1765,4153
-100,-30,-180,871,894,1765,3851
-100,10,100,856,909,1765,4074
-90,-10,50,879,886,1765,3942
-100,-30,180,871,894,1765,3851
0,20,40,886,880,1766,3988
-120,0,170,906,860,1766,4215
180,20,80,896,870,1766,3904
-180,20,80,896,870,1766,3904
0,-80,40,896,871,1767,4142
180,-60,-160,892,875,1767,3973
-180,-60,-160,892,875,1767,3973
90,30,0,874,893,1767,3775
110,-10,-130,880,887,1767,3904
90,10,60,873,895,1768,3875
100,-20,-140,874,895,1769,3821
70,-10,150,860,909,1769,3812
-130,20,150,896,873,1769,4058
-40,-80,0,902,867,1769,4230
20,-80,60,914,856,1770,4056
30,40,30,886,884,1770,3966
-80,-70,-40,888,882,1770,4094
-110,-40,-60,911,859,1770,3968
0,-60,-80,891,879,1770,4129
70,60,-30,874,897,1771,3847
70,20,-160,870,901,1771,3643
-100,0,100,877,894,1771,4094
-80,-10,-130,870,901,1771,3960
10,-80,50,910,861,1771,4163
40,-10,-60,885,886,1771,4052
0,-40,-80,879,892,1771,3838
90,-70,130,878,894,1772,4013
110,-70,40,886,886,1772,3930
90,-20,10,882,890,1772,4055
120,-70,50,869,903,1772,4044
120,40,-90,889,883,1772,3971
60,30,80,875,898,1773,3632
10,-20,60,894,879,1773,3992
140,70,120,883,890,1773,4023
180,10,-180,876,897,1773,4178
180,10,180,876,897,1773,4178
-80,20,70,871,902,1773,4027
-180,10,180,876,897,1773,4178
70,0,-170,878,895,1773,3611
-180,10,-180,876,897,1773,4178
160,-80,-170,903,871,1774,4092
110,20,-90,890,884,1774,4044
-30,30,40,901,873,1774,3992
110,-20,-150,878,896,1774,4011
-110,-30,-50,906,868,1774,3860
30,20,60,900,874,1774,3978
-150,10,170,892,883,1775,4203
-140,30,150,885,890,1775,4173
180,-20,90,885,890,1775,3807
150,50,-140,876,899,1775,4044
-10,40,-70,902,873,1775,4121
-180,-20,90,885,890,1775,3807
70,50,-10,903,872,1775,3941
-60,70,-30,895,881,1776,3907
-100,-20,20,890,886,1776,4049
160,0,-170,885,891,1776,4094
-120,10,160,896,880,1776,4093
-80,-60,-30,901,875,1776,4078
110,80,-90,922,855,1777,4162
80,-30,140,883,894,1777,3975
-30,-80,10,907,870,1777,4203
30,-80,70,913,865,1778,4121
90,10,-60,868,910,1778,3781
-60,30,-50,891,887,1778,3977
0,-20,50,893,886,1779,4024
-60,-50,0,890,889,1779,4104
-20,70,40,905,875,1780,4008
-110,-50,-70,899,881,1780,3976
-90,-10,-120,898,882,1780,3984
-170,50,70,893,888,1781,3598
-110,-10,-170,878,903,1781,4098
-170,-30,-170,879,902,1781,4133
170,60,-160,877,904,1781,4135
-120,10,20,864,918,1782,3895
60,10,-80,899,883,1782,3942
-10,-40,-90,900,882,1782,3872
-100,40,100,882,900,1782,4187
-30,20,40,894,888,1782,4061
60,-70,-20,892,891,1783,4259
80,70,-50,879,904,1783,4163
-70,-70,-150,910,874,1784,3919
-130,30,140,870,914,1784,4137
110,40,-70,886,898,1784,3936
-40,-40,20,903,881,1784,3962
-100,-60,-60,906,879,1785,4082
-50,-60,0,897,888,1785,4134
50,20,100,879,906,1785,3711
-170,-20,90,901,884,1785,3899
-70,70,80,907,878,1785,4206
-110,40,110,894,891,1785,4297
-130,0,-180,914,872,1786,4195
80,30,50,906,880,1786,3829
-130,0,180,914,872,1786,4195
-90,40,90,895,892,1787,4162
150,-60,80,885,902,1787,4161
100,0,-120,848,939,1787,3971
-150,-80,-120,892,895,1787,4074
30,-60,80,900,888,1788,4272
-110,-20,-120,895,893,1788,4039
70,40,20,887,901,1788,3886
90,-30,150,875,913,1788,4025
40,60,0,908,880,1788,3983
-10,-50,-90,883,906,1789,4057
90,10,-30,911,878,1789,4016
-90,-70,-170,903,886,1789,4030
100,-50,30,899,890,1789,4049
140,-60,170,889,900,1789,4064
70,20,-100,892,897,1789,4017
-140,20,160,899,891,1790,4196
-10,-60,-90,916,874,1790,4138
-60,-60,-10,895,896,1791,4171
70,-20,-180,887,904,1791,3734
-140,10,170,911,880,1791,4067
70,-20,180,887,904,1791,3734
170,-80,-160,911,880,1791,4135
-50,-80,-10,905,886,1791,4200
-40,-10,30,912,879,1791,4084
60,-30,120,876,915,1791,4004
-70,-40,-150,923,869,1792,3972
-50,-30,-120,909,883,1792,3858
-120,-50,-90,910,882,1792,4096
170,20,-170,899,893,1792,4010
30,10,80,890,903,1793,3905
180,70,-170,887,906,1793,4223
150,70,110,890,903,1793,3979
-180,70,-170,887,906,1793,4223
-160,-70,120,911,882,1793,3995
-130,40,30,894,899,1793,3877
-70,-60,-20,908,886,1794,4133
150,10,-160,884,910,1794,4096
-80,-50,-20,909,885,1794,4027
-170,70,180,896,900,1796,4309
-110,30,110,872,924,1796,4285
-170,70,-180,896,900,1796,4309
-100,-20,-10,883,913,1796,3972
130,40,-110,916,881,1797,4301
100,-40,150,873,924,1797,4163
-170,-80,-140,904,893,1797,4095
130,50,-110,919,879,1798,4306
180,-80,-150,912,886,1798,4092
90,10,-20,902,896,1798,3882
-180,-80,-150,912,886,1798,4092
-60,40,-40,889,909,1798,4105
-90,-20,-150,885,914,1799,3986
130,10,100,899,900,1799,3966
70,20,90,923,876,1799,3942
70,0,140,884,915,1799,3839
20,-10,70,901,898,1799,4060
90,30,10,886,913,1799,3821
110,50,-70,893,907,1800,4022
70,10,160,892,908,1800,3806
-170,60,180,875,925,1800,4277
-170,60,-180,875,925,1800,4277
-100,0,-40,898,902,1800,3772
-120,-10,40,922,878,1800,3739
-90,-40,-170,898,902,1800,4044
-60,20,-70,900,901,1801,4087
-90,-20,20,898,903,1801,4157
-80,-70,-160,920,882,1802,4064
-130,0,40,926,876,1802,3693
90,20,40,910,892,1802,3960
-10,80,30,927,875,1802,3967
-20,-60,30,916,886,1802,4349
-80,80,-10,886,917,1803,4078
-30,-20,-100,926,877,1803,4018
130,-10,-160,893,910,1803,4125
50,-10,120,905,898,1803,3904
150,-30,180,906,898,1804,4194
-140,-20,-160,893,911,1804,3984
150,-30,-180,906,898,1804,4194
-20,30,-70,903,901,1804,4095
120,80,-100,930,875,1805,4232
110,60,-80,897,908,1805,4231
80,30,40,900,905,1805,3928
-160,-20,90,894,912,1806,3904
-160,-80,-130,904,902,1806,4105
10,40,-80,916,890,1806,4127
70,10,-170,893,913,1806,3862
-100,-50,-50,923,883,1806,4057
130,-40,70,906,901,1807,4207
70,-60,-10,912,895,1807,4111
-70,40,70,899,908,1807,4111
110,-10,80,875,932,1807,4076
-130,-70,-100,916,891,1807,4184
-50,30,50,917,891,1808,4154
-130,30,30,899,909,1808,3859
-60,-80,-20,907,901,1808,4178
130,70,130,903,905,1808,4146
-80,-10,40,904,905,1809,4102
-170,40,70,897,912,1809,3930
100,-10,50,892,917,1809,4028
-50,-70,-130,920,889,1809,4089
-70,40,-30,931,878,1809,3999
70,0,-60,887,923,1810,3989
150,-70,-180,908,902,1810,4095
-130,20,30,908,902,1810,3789
150,-70,180,908,902,1810,4095
-150,30,160,902,908,1810,4365
-160,-10,80,895,915,1810,3944
60,50,-130,889,921,1810,4082
140,10,-140,912,899,1811,4077
70,-20,170,901,910,1811,3959
-80,40,-20,921,890,1811,4062
160,70,100,904,908,1812,3915
-20,30,40,917,895,1812,4171
40,-80,80,926,886,1812,4154
-90,-70,-50,908,904,1812,4147
-120,20,140,905,908,1813,4180
30,20,-80,899,914,1813,4040
30,0,90,899,914,1813,4014
100,-20,40,897,917,1814,4331
-70,-10,-120,913,901,1814,4146
-100,20,100,893,921,1814,4342
60,70,-140,867,947,1814,4097
-180,60,-170,890,924,1814,4246
10,-60,60,919,895,1814,4063
180,60,-170,890,924,1814,4246
-30,-30,30,937,877,1814,4136
130,70,-110,924,891,1815,4318
-120,-60,-90,913,902,1815,4173
70,10,-80,925,891,1816,4028
-160,70,170,910,906,1816,4243
100,-30,160,902,914,1816,4203
-20,-60,-100,917,899,1816,4136
100,80,170,895,921,1816,4349
160,50,-150,899,918,1817,4229
-160,30,170,898,919,1817,4271
-80,40,80,907,911,1818,4130
30,20,70,906,912,1818,4063
70,-30,130,897,921,1818,4145
90,40,-30,904,915,1819,3898
80,0,-40,930,889,1819,4085
90,70,-60,918,901,1819,4374
-80,20,-50,913,906,1819,4034
-150,0,180,917,903,1820,4377
-150,0,-180,917,903,1820,4377
-30,-70,-110,918,902,1820,4196
60,40,30,908,912,1820,3976
-20,10,40,937,883,1820,4043
20,70,-100,913,907,1820,4130
60,30,-110,910,911,1821,4115
-160,60,170,888,933,1821,4197
50,30,-100,909,912,1821,4006
-20,20,40,925,896,1821,4029
-60,-70,-140,920,901,1821,4075
-20,-70,-100,916,905,1821,4136
0,60,-80,920,902,1822,4159
-10,20,40,927,895,1822,4097
-40,-70,-120,912,910,1822,4167
60,-10,-50,904,918,1822,4235
-100,-20,0,906,916,1822,4117
-40,-30,-110,945,877,1822,3945
80,60,-40,912,910,1822,4024
80,70,-170,894,928,1822,4091
-40,-60,-120,915,908,1823,4047
60,20,100,904,919,1823,3832
50,-60,100,904,919,1823,4263
120,70,140,914,909,1823,4197
160,10,90,911,913,1824,4108
70,20,-140,907,917,1824,3978
140,30,-130,902,922,1824,4241
-60,60,70,917,907,1824,4235
0,-30,-80,905,920,1825,4126
-110,20,120,895,930,1825,4256
-110,-20,-60,922,903,1825,3885
170,-20,90,905,921,1826,4029
-50,50,60,928,898,1826,4178
40,-60,90,918,908,1826,4371
-140,40,40,935,892,1827,3836
120,-20,-160,896,931,1827,4222
110,-60,150,910,917,1827,4029
20,30,40,905,922,1827,4215
-120,-30,-100,925,902,1827,4103
-90,-20,30,916,912,1828,4189
-70,-80,-30,913,915,1828,4226
-120,-30,-120,913,915,1828,4117
-120,30,130,896,933,1829,4087
40,40,-100,915,914,1829,4119
-90,0,-100,900,929,1829,4223
-70,-10,30,910,919,1829,4223
70,20,-170,891,938,1829,3978
-160,0,180,917,913,1830,4328
70,-50,-10,905,925,1830,4250
-110,-40,160,921,909,1830,4102
-160,0,-180,917,913,1830,4328
-90,40,-10,912,919,1831,3987
-110,-20,120,910,921,1831,4092
-100,-40,-30,925,906,1831,3997
-100,-20,40,904,927,1831,3964
130,60,-110,921,910,1831,4365
-140,-60,-120,943,889,1832,4277
130,80,-110,937,895,1832,4307
60,-30,-30,897,935,1832,4191
-80,70,90,926,906,1832,4281
-100,0,110,912,921,1833,4081
0,-60,50,917,917,1834,4164
-120,-40,-90,918,916,1834,3926
120,50,130,934,901,1835,3985
-50,-50,10,930,905,1835,4220
-10,30,40,952,883,1835,4062
40,30,80,906,929,1835,3820
120,50,-90,939,896,1835,4208
50,-80,90,930,905,1835,4185
-90,20,-30,932,904,1836,4131
80,-40,0,907,929,1836,4258
-10,-60,40,929,907,1836,4236
80,-50,130,919,917,1836,4071
150,-10,-170,918,918,1836,4260
170,-50,-170,912,925,1837,4153
30,-20,-60,931,906,1837,4384
-20,80,40,932,905,1837,4054
150,40,-140,900,938,1838,4210
50,0,120,915,923,1838,3943
-180,-30,-170,917,921,1838,4273
180,-30,-170,917,921,1838,4273
-130,10,170,932,906,1838,4087
-80,-20,20,931,907,1838,4221
30,0,-70,933,906,1839,4226
-100,-10,90,919,920,1839,3896
-160,-20,-170,915,924,1839,4438
140,-50,170,909,931,1840,4246
-70,80,-20,908,932,1840,4167
-90,30,90,906,934,1840,4224
150,0,90,919,921,1840,3982
70,-10,-170,938,902,1840,3807
180,50,-170,895,946,1841,4276
110,-60,40,923,918,1841,4052
-180,50,-170,895,946,1841,4276
-120,-50,150,921,920,1841,4392
-140,70,150,915,926,1841,4267
-140,40,150,922,919,1841,4339
-90,10,-60,933,909,1842,4063
70,-60,120,924,918,1842,4172
-60,-10,-110,957,885,1842,4193
80,-20,160,909,934,1843,4305
-160,50,60,910,933,1843,3933
80,-10,-20,917,926,1843,4166
-170,-60,-150,934,909,1843,4233
-100,-20,10,930,913,1843,4187
70,-10,-40,919,925,1844,4133
-170,0,-180,919,925,1844,4253
-170,0,180,919,925,1844,4253
-140,-10,-170,927,917,1844,4309
-70,20,60,921,924,1845,4158
-140,-20,90,918,927,1845,4122
-90,0,80,902,944,1846,4119
-50,30,-60,933,914,1847,4270
100,-70,140,912,935,1847,4160
-150,40,50,921,926,1847,4005
130,30,-110,927,920,1847,4209
70,60,-160,918,929,1847,4299
-60,-20,20,936,911,1847,4321
50,-30,-40,904,943,1847,4310
-110,-30,150,933,915,1848,4090
90,60,-50,916,932,1848,4231
-30,10,40,949,899,1848,4247
60,10,120,904,945,1849,3874
-150,70,160,923,927,1850,4259
20,70,10,936,914,1850,4094
90,50,-40,933,917,1850,4074
-30,-60,-110,936,915,1851,4082
-40,10,40,922,929,1851,4208
-20,50,40,937,914,1851,4175
-120,0,180,937,915,1852,4429
-120,0,-180,937,915,1852,4429
30,-10,90,928,924,1852,4161
-90,-60,-40,938,914,1852,4175
170,10,-170,921,931,1852,4282
-150,60,160,909,943,1852,4147
120,30,-90,941,912,1853,4092
50,50,10,940,914,1854,4259
-80,-80,-40,926,928,1854,4303
-90,70,100,943,911,1854,4281
30,10,90,913,941,1854,3936
70,50,0,942,912,1854,4128
-170,-40,100,913,942,1855,4002
-170,60,70,938,917,1855,4069
150,-50,80,925,930,1855,4198
90,10,100,904,952,1856,4053
-80,10,-80,918,938,1856,4085
-20,40,40,961,895,1856,4298
-120,40,20,921,936,1857,4051
-50,-10,30,942,915,1857,4269
-120,-40,140,928,929,1857,4107
-30,-40,30,936,921,1857,4250
90,30,20,922,936,1858,3912
60,-80,100,943,915,1858,4269
-50,-50,-130,932,926,1858,3990
170,50,-160,902,956,1858,4310
-100,-70,-60,936,923,1859,4251
70,-70,-10,936,923,1859,4361
-130,20,160,941,919,1860,4352
-130,40,140,917,943,1860,4369
70,-20,140,910,950,1860,4273
110,50,140,939,921,1860,4113
-160,-30,-160,933,927,1860,4358
70,-80,110,942,919,1861,4260
-140,30,40,955,906,1861,3933
-150,40,160,921,941,1862,4357
-60,-40,10,939,924,1863,4302
-80,30,80,930,933,1863,4397
130,50,120,947,916,1863,4092
-100,-10,-110,950,914,1864,4093
120,-40,60,943,921,1864,4202
60,-60,110,926,938,1864,4137
-160,-60,-140,960,904,1864,4238
-80,30,-30,939,926,1865,4194
-50,70,-40,943,922,1865,4216
140,20,100,934,932,1866,4121
120,0,-120,957,909,1866,4277
20,-80,-60,937,929,1866,4314
-100,30,100,905,961,1866,4355
80,-20,-10,931,935,1866,4256
110,-20,60,939,927,1866,4228
-170,50,-180,922,945,1867,4261
-170,50,180,922,945,1867,4261
-30,80,50,943,924,1867,4157
-130,-50,-110,937,931,1868,4218
-150,20,170,939,929,1868,4340
170,70,90,940,928,1868,4152
-150,50,50,938,930,1868,4130
110,0,90,912,957,1869,4190
100,-40,30,936,933,1869,4328
60,40,50,938,931,1869,4048
-40,60,-50,948,921,1869,4221
120,10,-110,939,930,1869,4073
-170,30,-180,935,934,1869,4321
-70,-20,20,945,924,1869,4387
-170,30,180,935,934,1869,4321
-170,-20,-170,933,937,1870,4484
90,10,-110,926,944,1870,4197
-50,-30,20,937,933,1870,4196
130,-40,170,938,932,1870,4238
-110,-40,-50,950,921,1871,4209
-120,-20,-140,934,937,1871,4283
-140,-70,-110,946,925,1871,4300
110,10,-100,928,943,1871,4107
-150,-60,-130,956,915,1871,4395
-90,-80,-50,930,941,1871,4342
70,10,130,920,952,1872,4102
-60,0,40,936,936,1872,4187
-170,20,-180,933,939,1872,4393
-170,20,180,933,939,1872,4393
-150,-90,-110,962,912,1874,4342
-50,-90,-10,962,912,1874,4342
50,-90,90,962,912,1874,4342
-160,-90,-120,962,912,1874,4342
-30,-90,10,962,912,1874,4342
70,-90,110,962,912,1874,4342
180,-90,-140,962,912,1874,4342
-170,-90,-130,962,912,1874,4342
-70,-90,-30,962,912,1874,4342
150,-90,-170,962,912,1874,4342
170,-90,-150,962,912,1874,4342
80,-90,120,962,912,1874,4342
-20,-90,20,962,912,1874,4342
-60,-90,-20,962,912,1874,4342
110,-90,150,962,912,1874,4342
-40,-90,0,962,912,1874,4342
30,60,10,952,922,1874,4294
-90,-90,-50,962,912,1874,4342
120,-90,160,962,912,1874,4342
100,-90,140,962,912,1874,4342
-10,-90,30,962,912,1874,4342
-140,-90,-100,962,912,1874,4342
90,-90,130,962,912,1874,4342
-20,0,40,951,923,1874,4223
30,-80,-50,939,935,1874,4292
-130,-90,-90,962,912,1874,4342
-100,70,110,940,934,1874,4328
10,-90,50,962,912,1874,4342
-80,-90,-40,962,912,1874,4342
130,-90,170,962,912,1874,4342
-100,-90,-60,962,912,1874,4342
40,-90,80,962,912,1874,4342
-120,-90,-80,962,912,1874,4342
-110,-90,-70,962,912,1874,4342
140,-90,180,962,912,1874,4342
20,-90,60,962,912,1874,4342
140,-90,-180,962,912,1874,4342
0,-90,40,962,912,1874,4342
60,-90,100,962,912,1874,4342
-180,-90,-140,962,912,1874,4342
160,-90,-160,962,912,1874,4342
30,-90,70,962,912,1874,4342
-80,-40,-160,942,933,1875,4187
140,80,-120,957,918,1875,4361
-110,40,10,933,942,1875,4273
-100,0,-80,961,915,1876,4195
-170,-70,110,941,935,1876,4191
150,0,-160,918,958,1876,4295
100,0,80,939,937,1876,4286
130,-10,-150,948,929,1877,4374
-170,10,180,942,935,1877,4482
80,10,-80,941,936,1877,4231
-170,10,-180,942,935,1877,4482
80,50,-20,937,941,1878,4060
30,50,20,948,930,1878,4393
90,-10,0,946,932,1878,4327
140,0,-150,932,946,1878,4346
-150,10,180,959,920,1879,4391
-90,-80,-170,957,922,1879,4317
-30,70,50,956,923,1879,4288
-90,-10,-130,933,946,1879,4208
-150,10,-180,959,920,1879,4391
-150,-10,-170,941,938,1879,4514
70,-30,-20,914,966,1880,4180
-110,-60,-70,962,918,1880,4241
-60,-10,30,943,937,1880,4301
10,30,40,938,942,1880,4317
90,20,130,954,926,1880,4187
-40,-50,20,950,930,1880,4334
50,-40,110,945,935,1880,4162
-130,70,140,945,935,1880,4321
160,-70,-170,947,934,1881,4287
-90,-50,-30,940,941,1881,4229
150,30,100,942,939,1881,4086
90,10,90,940,941,1881,4203
-100,-10,-120,946,936,1882,4188
160,40,-150,924,959,1883,4309
30,70,-110,944,940,1884,4308
-160,50,170,922,962,1884,4275
-110,0,170,961,923,1884,4455
130,20,-110,934,951,1885,4191
-130,-60,-100,953,932,1885,4385
160,-10,-170,947,938,1885,4378
60,50,10,941,944,1885,4237
-90,20,90,922,963,1885,4313
10,-80,-70,942,943,1885,4356
30,50,-100,944,942,1886,4166
40,-80,-40,953,933,1886,4345
10,-70,60,966,920,1886,4350
100,70,-70,951,935,1886,4503
-120,20,150,957,929,1886,4340
-40,40,50,965,921,1886,4334
90,80,-180,930,956,1886,4499
90,80,180,930,956,1886,4499
-100,0,120,931,955,1886,4209
-70,60,80,946,940,1886,4438
140,0,-140,948,939,1887,4377
120,-20,-150,942,946,1888,4401
120,20,110,942,946,1888,4220
-160,40,170,921,967,1888,4428
-130,-20,-150,954,934,1888,4220
140,-30,180,947,942,1889,4471
-130,50,140,938,951,1889,4306
80,-80,120,948,941,1889,4284
140,-30,-180,947,942,1889,4471
-140,50,40,962,928,1890,4013
-80,-80,-160,956,934,1890,4324
80,30,60,963,927,1890,4026
20,0,70,945,946,1891,4320
80,60,-180,957,934,1891,4105
-160,40,60,944,947,1891,3863
80,60,180,957,934,1891,4105
-120,-30,-110,937,954,1891,4269
40,70,-120,935,956,1891,4383
70,40,-170,947,945,1892,3983
150,20,-150,963,929,1892,4439
140,60,-120,950,942,1892,4512
160,20,-160,942,950,1892,4383
-60,80,-30,931,961,1892,4261
80,0,-50,930,963,1893,4105
70,-20,160,941,952,1893,4333
100,20,-60,912,981,1893,3943
-110,-70,-70,953,940,1893,4413
100,60,-60,954,939,1893,4297
-100,0,130,949,945,1894,4471
-110,70,120,950,944,1894,4355
110,70,150,945,949,1894,4343
10,30,-80,946,948,1894,4232
80,-60,0,951,943,1894,4354
-120,90,140,978,917,1895,4259
150,90,-130,978,917,1895,4259
30,90,-10,978,917,1895,4259
10,90,10,978,917,1895,4259
110,90,-90,978,917,1895,4259
-70,90,90,978,917,1895,4259
180,90,-160,978,917,1895,4259
-40,90,60,978,917,1895,4259
130,90,-110,978,917,1895,4259
100,90,-80,978,917,1895,4259
-20,90,40,978,917,1895,4259
-30,90,50,978,917,1895,4259
-130,90,150,978,917,1895,4259
50,40,-110,928,967,1895,4445
160,90,-140,978,917,1895,4259
-50,90,70,978,917,1895,4259
-140,90,160,978,917,1895,4259
-150,90,170,978,917,1895,4259
-170,90,-170,978,917,1895,4259
170,90,-150,978,917,1895,4259
80,90,-60,978,917,1895,4259
20,90,0,978,917,1895,4259
120,90,-100,978,917,1895,4259
60,90,-40,978,917,1895,4259
-90,90,110,978,917,1895,4259
-110,90,130,978,917,1895,4259
-60,90,80,978,917,1895,4259
-180,90,-160,978,917,1895,4259
-160,90,-180,978,917,1895,4259
-100,90,120,978,917,1895,4259
40,90,-20,978,917,1895,4259
90,90,-70,978,917,1895,4259
-80,90,100,978,917,1895,4259
70,90,-50,978,917,1895,4259
50,90,-30,978,917,1895,4259
-160,90,180,978,917,1895,4259
-10,90,30,978,917,1895,4259
140,90,-120,978,917,1895,4259
0,90,20,978,917,1895,4259
80,40,10,941,955,1896,4080
100,10,-100,926,970,1896,4208
90,40,-20,948,948,1896,4147
-150,50,160,929,967,1896,4266
-90,-10,60,961,936,1897,4273
90,10,-70,952,945,1897,4125
70,10,-160,924,973,1897,3984
-100,-80,180,977,920,1897,4305
-20,-50,-100,933,964,1897,4131
-100,-80,-180,977,920,1897,4305
50,10,-80,957,940,1897,4209
110,-70,150,932,966,1898,4309
90,40,-10,918,980,1898,4108
-50,-70,0,963,935,1898,4428
120,60,-90,952,946,1898,4501
-70,-80,-150,966,933,1899,4342
-110,-30,-40,947,952,1899,4124
140,70,-120,960,939,1899,4437
-110,10,140,948,951,1899,4520
-70,-30,10,955,944,1899,4355
-60,-70,-10,949,950,1899,4455
150,-40,-180,942,957,1899,4483
150,-40,180,942,957,1899,4483
-100,10,110,933,967,1900,4465
80,-50,0,942,958,1900,4536
-100,-80,-60,953,947,1900,4406
70,30,-170,947,953,1900,4129
150,30,-140,951,950,1901,4268
40,0,110,959,942,1901,4113
-50,20,50,964,938,1902,4304
130,30,110,945,957,1902,4062
-170,30,70,946,956,1902,4073
90,-80,130,957,946,1903,4309
-110,-80,170,971,932,1903,4399
150,-60,-180,945,959,1904,4234
150,-60,180,945,959,1904,4234
60,0,130,940,964,1904,4187
60,-20,-40,961,943,1904,4321
0,30,40,957,947,1904,4350
100,10,100,934,970,1904,4354
-170,40,180,941,964,1905,4416
-120,70,130,952,953,1905,4317
-170,40,-180,941,964,1905,4416
110,-20,-140,927,978,1905,4253
110,-30,170,932,973,1905,4388
-100,-10,130,952,954,1906,4312
-50,40,-50,942,965,1907,4299
-30,-50,-110,959,948,1907,4187
-130,50,30,954,953,1907,4128
130,-10,-140,955,952,1907,4282
-130,-40,-120,956,952,1908,4315
170,-20,-170,954,954,1908,4402
130,0,90,954,954,1908,4290
100,40,-50,946,962,1908,4212
-80,10,70,947,961,1908,4277
-140,50,150,926,982,1908,4259
80,-70,0,952,957,1909,4449
-60,50,70,956,954,1910,4404
170,0,-170,952,959,1911,4316
170,-30,-170,948,963,1911,4437
-100,40,0,952,959,1911,4384
0,-80,-80,954,957,1911,4447
-10,-70,40,961,950,1911,4510
50,-80,-30,970,942,1912,4363
-100,0,-50,964,948,1912,4104
10,10,50,959,953,1912,4347
-40,-50,-120,964,949,1913,4132
-40,80,60,962,951,1913,4319
0,90,-90,954,960,1914,4249
130,90,140,954,960,1914,4249
-10,90,-80,954,960,1914,4249
-20,90,-70,954,960,1914,4249
50,90,-140,954,960,1914,4249
90,90,180,954,960,1914,4249
-120,90,30,954,960,1914,4249
180,90,90,954,960,1914,4249
100,90,170,954,960,1914,4249
140,0,90,950,964,1914,4273
80,-20,-150,941,973,1914,3991
10,90,-100,954,960,1914,4249
70,90,-160,954,960,1914,4249
-90,90,0,954,960,1914,4249
60,90,-150,954,960,1914,4249
-100,90,10,954,960,1914,4249
120,90,150,954,960,1914,4249
-50,90,-40,954,960,1914,4249
80,90,-170,954,960,1914,4249
-180,90,90,954,960,1914,4249
40,90,-130,954,960,1914,4249
-80,90,-10,954,960,1914,4249
-30,90,-60,954,960,1914,4249
-160,90,70,954,960,1914,4249
170,90,100,954,960,1914,4249
-170,90,80,954,960,1914,4249
-130,90,40,954,960,1914,4249
110,90,160,954,960,1914,4249
-40,90,-50,954,960,1914,4249
160,90,110,954,960,1914,4249
-140,90,50,954,960,1914,4249
150,90,120,954,960,1914,4249
60,40,40,958,956,1914,4180
-180,-20,-170,970,944,1914,4423
-70,90,-20,954,960,1914,4249
180,-20,-170,970,944,1914,4423
30,90,-120,954,960,1914,4249
-110,90,20,954,960,1914,4249
40,-40,100,977,937,1914,4181
-60,90,-30,954,960,1914,4249
-150,90,60,954,960,1914,4249
140,90,130,954,960,1914,4249
90,90,-180,954,960,1914,4249
-120,-80,160,969,945,1914,4406
20,90,-110,954,960,1914,4249
-170,-40,-160,941,974,1915,4391
-120,40,130,941,974,1915,4340
-100,-20,180,949,966,1915,4327
-140,30,160,956,959,1915,4435
0,-10,50,960,955,1915,4461
-130,30,150,960,955,1915,4421
-30,60,50,967,948,1915,4264
-100,-20,-180,949,966,1915,4327
-90,10,90,937,979,1916,4378
110,-30,50,957,959,1916,4400
-40,-70,10,979,938,1917,4420
-110,10,150,958,959,1917,4480
70,20,-110,963,954,1917,4100
-60,-80,-140,983,935,1918,4397
70,20,-180,957,961,1918,4285
70,20,180,957,961,1918,4285
30,20,80,954,964,1918,4137
-100,20,-10,958,961,1919,4340
120,-50,160,968,951,1919,4482
110,20,-80,952,967,1919,4306
120,0,90,941,979,1920,4340
170,-40,-170,969,951,1920,4413
120,-20,-170,954,966,1920,4450
-100,10,-20,953,967,1920,4167
100,20,120,976,944,1920,4283
-160,10,180,960,961,1921,4493
0,60,30,983,938,1921,4278
90,0,-10,951,970,1921,4305
-120,10,170,978,943,1921,4410
-160,10,-180,960,961,1921,4493
-150,-20,-160,950,971,1921,4363
90,20,50,971,950,1921,4195
-100,0,-70,961,960,1921,4311
-80,60,90,980,942,1922,4412
-10,40,40,986,936,1922,4294
-140,60,150,946,976,1922,4291
-100,0,-90,960,963,1923,4286
-30,-70,20,978,945,1923,4476
170,-70,-160,975,948,1923,4469
150,80,-130,972,951,1923,4436
50,70,-130,950,973,1923,4429
-20,-20,40,979,944,1923,4451
110,30,-70,964,959,1923,4248
-30,50,-60,979,944,1923,4388
20,10,60,960,964,1924,4294
-140,10,-180,966,959,1925,4373
140,20,-130,957,968,1925,4468
-110,30,120,949,976,1925,4408
120,10,-100,969,956,1925,4231
-140,10,180,966,959,1925,4373
-120,-10,-160,969,957,1926,4442
-60,10,50,951,975,1926,4334
50,40,60,977,949,1926,4172
-130,-60,140,987,939,1926,4407
-10,-80,-90,963,963,1926,4435
130,-20,80,935,991,1926,4305
-40,-80,-120,970,957,1927,4457
-110,-20,-50,960,967,1927,4236
40,-30,-50,939,988,1927,4533
20,-70,70,975,953,1928,4455
-60,30,60,967,961,1928,4428
0,-70,50,980,948,1928,4425
-110,20,130,962,967,1929,4435
50,40,40,960,969,1929,4302
-150,-40,110,978,951,1929,4218
60,-20,130,945,984,1929,4306
-110,-80,-70,978,951,1929,4488
130,10,-120,970,960,1930,4545
-100,10,-30,963,967,1930,4157
10,-10,60,963,967,1930,4464
-20,10,-80,945,985,1930,4370
140,50,-120,974,956,1930,4633
120,10,100,975,956,1931,4376
-10,-30,-90,966,965,1931,4404
110,-40,160,958,974,1932,4312
170,-30,90,968,964,1932,4308
30,-20,90,978,954,1932,4311
100,-80,140,979,953,1932,4408
-70,-70,-20,967,966,1933,4525
-30,-50,30,970,963,1933,4569
60,60,-140,941,993,1934,4514
80,50,-10,974,960,1934,4301
170,40,-160,939,996,1935,4490
110,70,-80,970,965,1935,4665
10,50,30,981,954,1935,4251
-110,-50,160,974,961,1935,4361
80,20,140,970,965,1935,4207
-30,-80,-110,981,954,1935,4495
-150,-30,100,956,979,1935,4218
-100,0,140,981,955,1936,4525
120,40,-80,972,964,1936,4192
20,20,-80,966,970,1936,4357
-10,0,-80,970,967,1937,4457
-120,50,20,960,977,1937,4281
-180,40,-170,946,991,1937,4461
100,30,-50,945,992,1937,4206
-50,0,40,957,980,1937,4423
90,-30,10,960,977,1937,4427
70,-20,150,943,994,1937,4523
180,40,-170,946,991,1937,4461
-40,-10,-100,990,947,1937,4472
90,-50,140,963,974,1937,4368
180,-50,-160,993,945,1938,4409
120,50,-80,985,953,1938,4401
140,-30,80,965,973,1938,4398
-180,-50,-160,993,945,1938,4409
-150,-30,-150,978,960,1938,4483
-50,80,-40,955,984,1939,4339
70,0,-160,964,975,1939,4109
-20,-10,40,987,952,1939,4301
100,0,70,986,953,1939,4437
100,50,150,966,974,1940,4220
-20,-70,30,973,967,1940,4504
70,40,30,975,966,1941,3965
30,-30,90,981,960,1941,4357
-40,-20,30,988,953,1941,4423
-140,0,-170,991,950,1941,4514
-50,-80,-130,985,957,1942,4428
40,0,-70,961,981,1942,4390
-30,0,40,988,954,1942,4453
70,20,-130,937,1006,1943,4234
40,-10,110,972,971,1943,4459
80,30,160,975,968,1943,4117
-60,-40,-140,994,950,1944,4127
60,20,-100,959,985,1944,4289
-100,-10,110,959,985,1944,4271
-150,30,50,974,970,1944,4195
90,-10,-130,959,986,1945,4043
110,10,100,959,986,1945,4486
-130,10,30,979,966,1945,4177
-90,-30,0,991,954,1945,4398
50,-20,-50,980,965,1945,4553
70,40,40,984,962,1946,4099
90,10,70,989,957,1946,4288
-110,-10,-160,977,969,1946,4559
-140,20,170,976,970,1946,4560
160,20,90,981,965,1946,4296
-70,0,50,980,966,1946,4428
30,-70,80,988,958,1946,4543
-110,10,160,987,960,1947,4558
60,40,60,975,972,1947,4105
-150,0,-170,981,967,1948,4692
140,-10,-160,967,981,1948,4494
-150,-70,-120,984,964,1948,4449
-60,0,-100,983,965,1948,4422
-20,-30,40,988,961,1949,4555
110,-50,40,981,968,1949,4406
110,-80,150,991,958,1949,4429
-140,-80,140,990,959,1949,4484
70,50,-170,992,957,1949,4286
170,-10,-170,990,960,1950,4497
-90,10,-70,975,975,1950,4428
50,50,-120,952,998,1950,4508
90,10,80,1004,946,1950,4436
-90,20,-40,984,966,1950,4240
-110,0,-180,992,959,1951,4622
-120,-80,-80,986,965,1951,4553
-180,-70,-150,990,961,1951,4461
-110,0,180,992,959,1951,4622
60,0,-70,968,983,1951,4406
-90,60,100,985,966,1951,4541
180,-70,-150,990,961,1951,4461
180,10,80,964,988,1952,4204
-180,10,80,964,988,1952,4204
-120,-60,150,1001,951,1952,4399
-130,-80,150,984,968,1952,4425
-170,-70,-140,991,962,1953,4524
-100,0,-60,984,969,1953,4254
-20,-80,-100,976,977,1953,4462
180,-60,100,984,970,1954,4541
-180,-60,100,984,970,1954,4541
120,-70,160,980,974,1954,4477
20,-10,-70,986,969,1955,4536
-70,50,80,983,972,1955,4517
-130,60,140,973,982,1955,4484
-100,-10,100,967,988,1955,4307
130,30,-100,990,965,1955,4396
10,70,20,983,972,1955,4444
70,50,10,970,986,1956,4351
-20,-10,-90,966,990,1956,4359
180,70,80,961,995,1956,4365
-180,70,80,961,995,1956,4365
-80,-70,-30,984,972,1956,4579
60,-10,160,982,974,1956,4232
0,-20,-80,972,984,1956,4481
160,-20,-170,990,967,1957,4532
-110,-20,30,980,977,1957,4298
-70,30,70,980,977,1957,4480
50,40,50,976,981,1957,4366
-90,-40,-10,1000,957,1957,4453
80,80,-170,959,999,1958,4613
-120,0,20,974,984,1958,4418
-120,-10,30,999,959,1958,4186
-160,-50,110,967,991,1958,4537
150,40,100,970,989,1959,4239
100,20,-50,972,987,1959,4271
-50,80,70,995,964,1959,4439
90,-20,-140,963,997,1960,4086
130,40,-100,1009,951,1960,4564
50,-20,120,978,982,1960,4392
-100,-10,120,967,993,1960,4381
120,-60,50,983,978,1961,4482
-120,50,130,981,980,1961,4511
-70,-50,0,990,971,1961,4393
130,0,-130,998,963,1961,4476
120,-60,160,965,996,1961,4445
-120,-20,100,983,979,1962,4451
20,20,50,987,975,1962,4592
-140,-60,130,1000,963,1963,4389
-160,20,-180,972,991,1963,4562
-160,20,180,972,991,1963,4562
-100,50,110,986,977,1963,4555
60,40,-130,963,1000,1963,4363
-80,0,60,1017,947,1964,4371
180,-10,-170,986,978,1964,4678
-180,-10,-170,986,978,1964,4678
-100,-50,-40,1012,953,1965,4457
60,-80,-20,988,977,1965,4477
-120,-30,-90,972,994,1966,4210
70,-20,-30,993,973,1966,4406
-130,0,-170,990,977,1967,4550
-100,-60,-50,1010,957,1967,4360
-110,-10,10,973,994,1967,4276
-20,-40,40,1001,966,1967,4474
150,70,-130,998,969,1967,4609
100,50,-50,982,985,1967,4393
100,70,160,1001,967,1968,4496
80,10,-120,953,1015,1968,4331
-130,-10,-160,1001,968,1969,4488
120,-80,160,1005,964,1969,4489
-150,30,170,991,978,1969,4496
110,60,-70,990,979,1969,4475
80,0,-60,988,981,1969,4415
160,80,-140,1002,967,1969,4565
-100,60,110,985,984,1969,4563
30,30,-90,995,975,1970,4482
-120,60,130,976,994,1970,4528
30,0,100,977,993,1970,4174
-160,-40,-150,982,988,1970,4465
-110,-50,-60,994,977,1971,4417
140,40,-120,992,979,1971,4646
-160,-10,-170,1005,967,1972,4730
-120,30,140,978,994,1972,4526
-120,-70,-80,995,977,1972,4561
-80,20,80,983,989,1972,4502
50,-10,-60,986,986,1972,4653
150,10,-150,988,985,1973,4749
-40,0,40,999,974,1973,4565
-90,-20,40,990,983,1973,4505
90,-40,10,981,993,1974,4602
40,10,-80,1003,971,1974,4421
130,50,-100,1010,964,1974,4643
30,20,90,993,982,1975,4122
-100,-10,140,993,982,1975,4380
50,40,70,995,980,1975,4087
10,60,-90,983,992,1975,4534
-170,-30,-160,996,979,1975,4620
90,-30,-170,969,1007,1976,4365
100,-10,40,964,1012,1976,4465
-110,60,120,985,991,1976,4539
-40,70,60,1002,975,1977,4489
-110,50,120,987,990,1977,4534
-130,-80,-90,1008,969,1977,4577
40,20,-90,986,991,1977,4318
150,60,-130,976,1001,1977,4658
70,20,100,999,978,1977,4433
-150,-80,130,1001,976,1977,4569
-130,-30,-130,976,1002,1978,4549
70,70,-160,981,997,1978,4595
120,-10,-130,980,999,1979,4508
60,-40,120,970,1009,1979,4494
70,30,80,989,990,1979,4147
-100,20,110,991,988,1979,4656
140,-60,70,991,988,1979,4561
80,20,80,1025,954,1979,4272
130,-60,60,1001,978,1979,4571
110,20,110,1003,977,1980,4451
-70,-60,-10,1000,980,1980,4424
40,40,40,983,998,1981,4577
-30,30,-70,989,992,1981,4531
-80,-50,-10,1002,979,1981,4380
90,50,-30,988,993,1981,4354
-70,-10,40,978,1004,1982,4577
80,50,0,988,994,1982,4325
80,-60,130,983,999,1982,4588
-160,-70,-130,1006,976,1982,4567
140,30,-120,1011,972,1983,4590
-160,60,60,1009,975,1984,4349
-180,30,-170,998,986,1984,4632
180,30,-170,998,986,1984,4632
70,20,-120,998,987,1985,4391
50,0,-70,974,1011,1985,4560
-120,-60,-80,1006,979,1985,4513
120,20,-90,994,991,1985,4493
160,-60,-170,997,989,1986,4450
90,-60,10,987,999,1986,4469
130,-20,-170,993,993,1986,4655
-60,80,80,1005,981,1986,4455
-110,-20,40,1017,969,1986,4211
-150,-40,-140,1000,987,1987,4565
20,60,20,1004,983,1987,4508
-20,-40,-100,973,1015,1988,4497
50,-40,-40,979,1009,1988,4484
100,0,60,988,1000,1988,4321
70,20,170,979,1010,1989,4172
60,30,-120,1003,986,1989,4516
-130,10,-180,1013,977,1990,4630
-170,-10,-170,1005,985,1990,4774
-130,10,180,1013,977,1990,4630
-90,-70,-40,1002,988,1990,4659
-140,-40,-130,1012,978,1990,4645
-130,-30,110,969,1021,1990,4360
-180,20,-170,985,1006,1991,4506
160,10,-160,992,999,1991,4611
-40,70,-50,1004,987,1991,4603
-90,-30,-170,1000,991,1991,4360
-60,-60,0,994,997,1991,4519
180,20,-170,985,1006,1991,4506
-40,80,-50,985,1007,1992,4508
-40,30,50,993,999,1992,4537
90,10,-80,998,995,1993,4508
60,-40,-30,986,1007,1993,4515
140,50,110,1015,978,1993,4425
80,40,170,995,999,1994,4405
-20,-30,-100,995,999,1994,4481
-80,-40,0,1013,981,1994,4584
-100,10,120,976,1018,1994,4587
60,50,-140,978,1018,1996,4655
60,-20,170,987,1009,1996,4231
-100,0,150,1024,973,1997,4516
120,70,-90,1002,996,1998,4741
-70,80,90,1013,985,1998,4515
-50,-60,10,1017,981,1998,4665
90,30,140,985,1013,1998,4226
-150,60,50,997,1002,1999,4452
100,-30,30,984,1015,1999,4558
30,30,70,1004,995,1999,4371
80,-30,-10,988,1012,2000,4321
150,-50,-180,1006,994,2000,4635
50,30,90,983,1017,2000,4320
150,-50,180,1006,994,2000,4635
-10,-90,-90,1018,984,2002,4676
-80,-20,30,1007,995,2002,4627
-30,-90,-110,1018,984,2002,4676
-100,-90,-180,1018,984,2002,4676
-90,-90,-170,1018,984,2002,4676
-20,-90,-100,1018,984,2002,4676
-70,-10,-130,1021,981,2002,4471
150,-90,70,1018,984,2002,4676
30,-90,-50,1018,984,2002,4676
-180,-90,100,1018,984,2002,4676
-160,-90,120,1018,984,2002,4676
140,-90,60,1018,984,2002,4676
-110,-90,170,1018,984,2002,4676
0,-90,-80,1018,984,2002,4676
-140,-80,-100,1010,992,2002,4599
-120,-90,160,1018,984,2002,4676
-80,-90,-160,1018,984,2002,4676
20,-90,-60,1018,984,2002,4676
-150,-90,130,1018,984,2002,4676
-60,-90,-140,1018,984,2002,4676
-100,-90,180,1018,984,2002,4676
120,-90,40,1018,984,2002,4676
170,-90,90,1018,984,2002,4676
90,-90,10,1018,984,2002,4676
-140,-90,140,1018,984,2002,4676
100,-90,20,1018,984,2002,4676
110,-90,30,1018,984,2002,4676
160,-90,80,1018,984,2002,4676
60,-90,-20,1018,984,2002,4676
50,-90,-30,1018,984,2002,4676
70,-90,-10,1018,984,2002,4676
130,-90,50,1018,984,2002,4676
80,-90,0,1018,984,2002,4676
-70,10,60,1007,995,2002,4556
-130,-90,150,1018,984,2002,4676
-170,-90,110,1018,984,2002,4676
-50,-90,-130,1018,984,2002,4676
10,-90,-70,1018,984,2002,4676
180,-90,100,1018,984,2002,4676
-70,-90,-150,1018,984,2002,4676
40,-90,-40,1018,984,2002,4676
-40,-90,-120,1018,984,2002,4676
-110,40,120,989,1014,2003,4491
-100,10,-40,1008,996,2004,4478
150,50,-130,1005,999,2004,4728
-80,50,90,1005,999,2004,4624
50,50,20,1007,997,2004,4596
70,10,150,981,1024,2005,4393
-120,-50,-80,1017,988,2005,4501
150,-20,-170,1013,992,2005,4689
-50,40,60,1013,992,2005,4696
100,-30,170,1005,1001,2006,4811
-80,-30,10,1027,979,2006,4607
-110,50,10,1004,1002,2006,4561
70,10,-150,984,1022,2006,4292
-120,-20,-130,999,1008,2007,4752
-80,-10,50,1006,1001,2007,4438
-170,-50,-150,1012,995,2007,4501
40,-70,90,1018,989,2007,4741
110,-10,70,1011,996,2007,4627
60,-10,140,966,1042,2008,4395
-30,0,-90,1021,987,2008,4551
-90,50,100,1000,1008,2008,4712
100,-20,30,984,1024,2008,4517
40,50,-110,988,1021,2009,4606
160,0,-160,989,1020,2009,4714
90,-70,10,1001,1009,2010,4677
-130,-40,-110,999,1011,2010,4493
-70,20,-70,1008,1002,2010,4442
-80,0,-110,1016,994,2010,4418
160,30,-150,980,1030,2010,4545
70,-20,-170,1000,1010,2010,4296
-170,20,70,1016,995,2011,4302
130,-80,170,1025,986,2011,4602
150,20,-140,1014,997,2011,4689
-40,-60,20,1014,998,2012,4779
90,30,30,1020,992,2012,4266
30,10,100,1005,1008,2013,4248
-160,30,60,1002,1011,2013,4152
30,30,50,1006,1007,2013,4757
170,-40,90,1022,991,2013,4608
-10,50,40,1027,987,2014,4661
-80,-60,-20,1023,991,2014,4502
-110,30,130,998,1016,2014,4704
-70,-20,-140,1043,972,2015,4574
-80,-20,-150,999,1016,2015,4673
-120,20,160,1021,994,2015,4487
-130,-20,90,994,1021,2015,4529
-130,-50,-100,1030,986,2016,4560
70,60,-20,996,1020,2016,4565
60,-20,160,1004,1012,2016,4519
-140,-10,70,1004,1013,2017,4193
140,-20,-170,1013,1004,2017,4697
-140,60,40,1018,999,2017,4393
0,50,-80,1029,988,2017,4699
-80,20,-60,999,1018,2017,4551
40,40,70,1021,997,2018,4401
-180,-70,100,1007,1011,2018,4488
-110,-30,140,1018,1000,2018,4541
180,-70,100,1007,1011,2018,4488
-50,70,70,1015,1003,2018,4668
-20,-50,40,1015,1004,2019,4680
-40,-30,30,1026,994,2020,4587
80,10,-90,1001,1019,2020,4581
-90,0,90,994,1026,2020,4655
80,-30,170,1004,1017,2021,4700
-100,-20,170,1011,1010,2021,4423
40,50,20,1017,1005,2022,4729
-180,0,-170,1012,1010,2022,4644
-120,-40,-80,1001,1021,2022,4463
120,60,-80,1013,1009,2022,4601
140,10,-130,1022,1000,2022,4684
-140,-60,-110,1007,1015,2022,4562
180,0,-170,1012,1010,2022,4644
140,-80,-180,1035,988,2023,4667
140,-80,180,1035,988,2023,4667
-140,-30,-140,1009,1014,2023,4659
-30,50,50,1048,975,2023,4614
-20,-80,30,1026,998,2024,4632
30,40,40,1012,1012,2024,4705
150,40,-130,1022,1002,2024,4740
-160,-80,120,1027,998,2025,4639
70,10,-140,988,1037,2025,4392
-120,-30,-80,1020,1005,2025,4537
-160,-20,-160,1017,1008,2025,4761
40,10,110,1023,1002,2025,4401
-100,-30,-10,1015,1010,2025,4521
-100,-10,-130,1014,1012,2026,4600
70,0,-70,1014,1012,2026,4393
-110,-10,-80,1031,995,2026,4456
-30,60,-60,1028,998,2026,4612
130,60,-100,1039,987,2026,4756
70,-80,-10,1021,1006,2027,4554
80,-30,150,986,1041,2027,4558
0,20,-80,996,1031,2027,4694
90,20,120,991,1036,2027,4462
-110,-60,160,1020,1007,2027,4475
-100,-40,-20,1016,1011,2027,4559
70,20,160,1019,1009,2028,4253
140,40,-110,1031,997,2028,4659
130,-30,180,1008,1020,2028,4751
130,-30,-180,1008,1020,2028,4751
160,70,-140,1019,1010,2029,4763
90,-50,10,1007,1023,2030,4605
0,40,40,1036,995,2031,4641
-180,10,-170,1013,1018,2031,4826
-130,20,170,1020,1011,2031,4613
20,10,70,1014,1017,2031,4536
180,10,-170,1013,1018,2031,4826
-160,0,-170,1022,1010,2032,4911
-50,-40,20,1030,1002,2032,4701
60,60,-10,1018,1014,2032,4588
-100,-50,170,1030,1002,2032,4478
-120,0,-170,1037,996,2033,4782
30,-10,100,1010,1023,2033,4571
70,40,50,1032,1001,2033,4398
170,30,-160,1018,1016,2034,4812
70,80,-160,1000,1034,2034,4780
-110,-10,-90,1020,1015,2035,4444
100,-30,-170,989,1047,2036,4497
60,50,20,1013,1023,2036,4575
-30,80,-60,1011,1025,2036,4622
70,10,-90,1005,1031,2036,4519
-70,10,-90,1018,1019,2037,4569
80,-10,-140,991,1046,2037,4332
-10,-80,40,1034,1003,2037,4688
80,60,-30,1011,1026,2037,4714
-30,-80,20,1026,1011,2037,4623
120,-20,-140,1004,1033,2037,4613
30,-30,-60,1004,1033,2037,4682
-110,-40,-40,1017,1020,2037,4484
80,-10,-30,1012,1025,2037,4678
-140,20,40,1041,997,2038,4189
120,-20,70,1019,1019,2038,4682
40,20,100,1045,993,2038,4220
-110,-20,-40,1027,1011,2038,4416
-140,-10,-160,1026,1014,2040,4604
170,80,-150,1038,1002,2040,4652
100,30,130,1011,1029,2040,4417
-150,-80,-110,1037,1004,2041,4699
90,-30,170,1033,1009,2042,4820
-40,20,-80,1002,1040,2042,4692
140,20,-120,1033,1009,2042,4728
130,-20,-160,1025,1018,2043,4786
30,-40,90,1035,1008,2043,4665
160,60,-140,1020,1023,2043,4742
90,-30,-180,1003,1040,2043,4587
90,-30,180,1003,1040,2043,4587
110,-40,40,1015,1029,2044,4615
50,-50,110,1041,1003,2044,4513
-100,30,110,1018,1027,2045,4906
-80,80,100,1032,1013,2045,4595
120,-10,80,1002,1044,2046,4695
50,-70,100,1022,1024,2046,4872
-90,-20,-160,1022,1024,2046,4553
-90,-50,-20,1039,1008,2047,4555
90,50,160,1034,1013,2047,4520
100,-10,30,1001,1046,2047,4646
130,-70,170,1037,1010,2047,4649
100,-30,-160,1012,1035,2047,4552
-20,40,-70,1043,1004,2047,4624
-160,-80,-120,1035,1012,2047,4745
170,-60,-160,1027,1021,2048,4665
0,-80,50,1040,1008,2048,4730
70,10,140,1020,1028,2048,4553
70,-40,130,1010,1038,2048,4713
-100,-30,170,1033,1015,2048,4463
-100,-70,-50,1034,1015,2049,4737
0,0,50,1025,1024,2049,4779
-140,-50,-120,1045,1005,2050,4784
90,-30,-160,1041,1009,2050,4581
-150,10,-170,1039,1011,2050,4817
90,-30,160,1010,1040,2050,4785
-130,60,30,1029,1022,2051,4413
90,60,-40,1015,1036,2051,4789
40,-20,-60,1029,1022,2051,4804
80,-30,-170,1013,1038,2051,4485
-100,-10,-170,1018,1033,2051,4666
-40,-80,10,1033,1018,2051,4611
-110,-10,-150,1029,1023,2052,4783
100,20,-20,1030,1022,2052,4504
150,-80,-170,1048,1005,2053,4705
90,-20,0,1011,1043,2054,4505
-110,-30,-30,1028,1026,2054,4410
-60,20,60,1038,1017,2055,4801
-170,80,-170,1041,1014,2055,4834
-120,-30,120,992,1064,2056,4398
120,-30,60,1031,1025,2056,4547
-160,-50,-140,1039,1017,2056,4582
120,-50,50,1019,1037,2056,4614
-140,40,160,1023,1033,2056,4875
110,-30,-160,1002,1055,2057,4707
60,50,-150,1052,1005,2057,4642
-110,20,140,1036,1021,2057,4832
60,80,-30,1046,1011,2057,4801
80,10,-110,1017,1040,2057,4469
-170,-80,110,1047,1011,2058,4769
100,20,-10,1008,1050,2058,4441
100,-30,180,1021,1037,2058,4869
100,-30,-180,1021,1037,2058,4869
150,10,-140,1033,1025,2058,4778
130,50,-90,1056,1002,2058,4759
40,40,60,1035,1023,2058,4672
-50,-80,0,1036,1022,2058,4626
0,70,30,1028,1030,2058,4698
-180,80,-160,1045,1014,2059,4760
180,80,-160,1045,1014,2059,4760
-100,40,110,1029,1030,2059,4730
-150,-60,120,1028,1031,2059,4725
-60,-80,-10,1040,1019,2059,4694
120,-30,-180,1020,1040,2060,4892
120,-30,180,1020,1040,2060,4892
-110,-10,-70,1023,1037,2060,4633
-60,-30,20,1028,1033,2061,4717
-160,30,-180,1024,1037,2061,4825
140,-10,-150,1043,1018,2061,4771
130,-20,-150,1032,1029,2061,4730
130,20,-100,1023,1038,2061,4616
-60,-50,10,1049,1012,2061,4679
70,-10,-160,1029,1032,2061,4389
-160,30,180,1024,1037,2061,4825
50,80,-20,1043,1018,2061,4782
-90,-10,-140,1036,1025,2061,4702
-130,-70,-90,1043,1019,2062,4759
-150,40,170,1033,1029,2062,4866
-40,-20,-110,1037,1025,2062,4663
80,20,130,1014,1048,2062,4508
100,0,50,1031,1031,2062,4708
-40,20,50,1043,1020,2063,4784
150,0,-150,1035,1028,2063,4877
-170,70,70,1024,1040,2064,4804
70,80,-40,1061,1003,2064,4839
110,-20,50,1027,1037,2064,4556
40,30,90,1014,1050,2064,4387
90,0,-50,1019,1046,2065,4496
80,-30,180,1014,1051,2065,4533
80,-30,-180,1014,1051,2065,4533
160,-30,-170,1032,1034,2066,4836
-90,-10,70,1007,1059,2066,4668
-90,40,100,1045,1022,2067,4836
130,-60,170,1029,1038,2067,4861
-110,-20,-30,1017,1050,2067,4643
-30,-60,30,1052,1015,2067,4837
150,-10,-160,1045,1023,2068,4861
60,30,90,1041,1027,2068,4358
-150,20,-180,1040,1029,2069,4855
10,20,-80,1031,1038,2069,4826
100,20,-40,1015,1054,2069,4597
70,20,110,1024,1045,2069,4530
-150,20,180,1040,1029,2069,4855
90,10,-100,1015,1055,2070,4567
-60,10,-90,1017,1053,2070,4745
-130,-10,60,1032,1038,2070,4326
60,40,-140,1035,1035,2070,4621
80,40,20,1032,1038,2070,4268
-90,80,110,1039,1031,2070,4704
110,-30,180,1036,1035,2071,5027
40,80,-10,1062,1009,2071,4767
-10,-40,50,1060,1011,2071,4664
0,40,-80,1056,1015,2071,4790
90,20,60,1040,1031,2071,4693
50,60,0,1033,1038,2071,4677
110,-30,-180,1036,1035,2071,5027
-100,0,-100,1028,1043,2071,4669
100,40,-40,1036,1036,2072,4618
-150,-10,-160,1048,1024,2072,4822
60,-20,140,989,1083,2072,4588
-160,10,-170,1043,1029,2072,4783
70,-40,-20,1036,1037,2073,4608
-10,-50,50,1049,1024,2073,4719
-70,30,-50,1028,1045,2073,4674
100,10,-90,1032,1042,2074,4754
-130,40,150,1039,1035,2074,4926
-140,-20,-150,1060,1014,2074,4850
-100,10,-50,1021,1053,2074,4569
-100,80,120,1040,1035,2075,4767
30,30,60,1046,1029,2075,4661
90,0,-120,986,1090,2076,4670
40,-20,110,1034,1042,2076,4850
90,70,170,1061,1015,2076,4752
60,40,-150,1046,1030,2076,4591
-170,0,-170,1041,1036,2077,4929
140,-40,180,1030,1047,2077,4779
130,40,-90,1054,1023,2077,4777
140,-40,-180,1030,1047,2077,4779
60,-10,150,1025,1053,2078,4668
-110,-20,110,1031,1047,2078,4619
-30,-10,40,1045,1033,2078,4812
90,40,0,1019,1059,2078,4623
80,-80,0,1047,1031,2078,4638
-30,20,-80,1030,1048,2078,4674
80,20,90,1065,1013,2078,4778
-100,-10,180,1036,1043,2079,4656
-100,-10,-180,1036,1043,2079,4656
-70,-20,30,1047,1032,2079,4774
-110,80,130,1041,1039,2080,4788
40,-40,-50,1014,1067,2081,4709
10,-80,60,1062,1019,2081,4792
160,40,-140,1047,1034,2081,4852
50,10,120,1003,1078,2081,4522
80,80,-50,1065,1016,2081,4873
90,50,-20,1032,1049,2081,4609
60,10,-90,1046,1035,2081,4498
120,30,-80,1051,1030,2081,4670
0,-10,-80,1018,1064,2082,4934
100,10,90,1030,1052,2082,4620
20,-20,-70,1041,1041,2082,4875
120,-40,170,1049,1033,2082,4870
70,-30,170,1034,1048,2082,4744
20,40,-90,1049,1033,2082,4876
110,40,-60,1052,1030,2082,4750
-100,-20,50,1062,1021,2083,4692
100,0,40,1026,1057,2083,4636
-130,30,160,1039,1044,2083,4779
-170,-80,-130,1055,1028,2083,4725
-70,-80,-20,1056,1027,2083,4796
-60,70,80,1050,1033,2083,4811
-100,10,130,1033,1051,2084,4949
150,10,90,1044,1040,2084,4601
160,-80,-160,1049,1035,2084,4733
-10,10,-80,1054,1030,2084,4731
-100,20,120,1044,1041,2085,4832
20,-10,80,1052,1034,2086,4801
-110,-20,20,1020,1066,2086,4725
150,30,-130,1053,1034,2087,4893
-130,-60,-90,1060,1027,2087,4822
-80,-80,-30,1060,1027,2087,4850
130,-50,170,1047,1040,2087,4899
170,70,-150,1032,1055,2087,4897
80,70,-40,1036,1051,2087,4811
-20,20,-80,1040,1047,2087,4763
-40,60,60,1052,1036,2088,4697
-110,0,-170,1061,1027,2088,4870
180,-80,100,1056,1032,2088,4846
-180,-80,100,1056,1032,2088,4846
20,-80,70,1058,1030,2088,4844
40,-50,100,1047,1041,2088,4678
-100,-10,160,1052,1037,2089,4589
-180,-80,-140,1055,1034,2089,4741
-10,-20,-90,1037,1052,2089,4586
70,-70,120,1038,1051,2089,4791
60,70,-20,1037,1052,2089,4880
80,20,110,1017,1072,2089,4631
180,-80,-140,1055,1034,2089,4741
70,70,-30,1047,1042,2089,4873
-90,0,-110,1045,1044,2089,4616
-80,40,90,1041,1049,2090,4906
-160,80,-180,1061,1029,2090,4931
-160,80,180,1061,1029,2090,4931
100,20,110,1038,1052,2090,4605
-100,-10,170,1059,1032,2091,4655
-110,-60,-60,1066,1026,2092,4770
-120,10,180,1061,1031,2092,4798
-120,10,-180,1061,1031,2092,4798
-70,-40,10,1058,1034,2092,4759
-150,80,170,1055,1037,2092,4975
-120,80,140,1051,1042,2093,4872
130,70,-100,1059,1034,2093,4945
160,-50,-170,1046,1048,2094,4920
-70,20,70,1043,1051,2094,4895
-100,-10,-140,1045,1049,2094,4796
60,-70,110,1051,1043,2094,4832
90,80,-60,1071,1023,2094,4920
-120,-20,90,1046,1048,2094,4542
-100,50,0,1043,1052,2095,4738
-40,30,-70,1032,1063,2095,4717
-110,-10,-100,1058,1037,2095,4615
-100,-40,170,1044,1052,2096,4637
90,10,-90,1042,1054,2096,4705
-170,-20,-160,1052,1044,2096,4779
-20,80,-70,1033,1063,2096,4745
30,30,80,1053,1043,2096,4419
-50,-20,30,1058,1038,2096,4925
-80,-30,-160,1059,1038,2097,4724
-180,-30,-160,1051,1046,2097,4930
80,-30,160,1024,1073,2097,4815
180,-30,-160,1051,1046,2097,4930
-170,20,-170,1040,1058,2098,4803
-110,20,150,1068,1030,2098,4802
100,-50,150,1061,1037,2098,4897
110,-30,-170,1050,1048,2098,4933
110,50,-60,1043,1056,2099,4711
90,70,-50,1036,1063,2099,4852
-120,-10,-150,1067,1032,2099,4992
90,-10,-10,1044,1056,2100,4706
-110,10,170,1060,1040,2100,4836
150,-40,80,1043,1057,2100,4886
160,-40,-170,1032,1069,2101,4942
100,0,30,1055,1046,2101,4809
60,20,110,1023,1078,2101,4565
110,30,120,1055,1046,2101,4538
-80,10,80,1045,1056,2101,4689
-10,-30,50,1066,1035,2101,4852
30,80,0,1074,1028,2102,4857
140,30,-110,1054,1048,2102,4620
20,-30,80,1071,1031,2102,4791
-60,-20,-130,1053,1049,2102,4678
-130,80,150,1056,1047,2103,4944
100,-60,20,1049,1054,2103,4806
80,-40,140,1035,1068,2103,5059
80,20,100,1067,1036,2103,4627
140,50,-110,1080,1024,2104,4933
-110,-50,-50,1076,1028,2104,4876
-30,-40,-110,1061,1043,2104,4701
-60,-10,40,1048,1056,2104,4884
-50,10,50,1056,1048,2104,4820
-170,10,-170,1053,1052,2105,4921
20,-20,80,1068,1037,2105,4751
-120,-30,-70,1076,1029,2105,4713
70,-30,140,1035,1070,2105,4839
110,-10,-120,1058,1048,2106,4750
-10,60,40,1098,1008,2106,4754
0,30,-80,1042,1064,2106,4847
-120,60,20,1041,1066,2107,4687
-90,-60,-30,1077,1030,2107,4707
30,-10,-70,1056,1051,2107,4868
-150,-50,-130,1074,1034,2108,4923
20,50,30,1049,1059,2108,4919
170,-80,-150,1067,1041,2108,4812
-70,40,80,1056,1052,2108,4814
-20,-60,40,1074,1034,2108,4892
110,0,-110,1071,1037,2108,4721
50,60,-130,1034,1075,2109,4803
-100,-10,-150,1064,1046,2110,4835
70,-30,180,1040,1071,2111,4679
80,20,120,1050,1061,2111,4822
-140,80,160,1056,1055,2111,4954
70,-30,-180,1040,1071,2111,4679
80,-70,130,1047,1065,2112,4854
-80,0,-120,1060,1052,2112,4856
-60,-20,30,1063,1049,2112,4998
-120,-40,-70,1082,1030,2112,4749
80,-20,-20,1041,1071,2112,4883
90,0,-20,1037,1076,2113,4852
150,0,-140,1063,1050,2113,4984
-100,-60,170,1064,1049,2113,4555
-80,0,70,1053,1060,2113,4782
70,60,-170,1075,1040,2115,4785
-110,-70,-60,1061,1054,2115,4907
-40,40,-60,1064,1051,2115,4943
-140,30,170,1074,1041,2115,4716
90,-80,10,1054,1061,2115,4828
-120,40,140,1063,1053,2116,4962
100,10,10,1061,1055,2116,4573
160,50,-140,1055,1061,2116,4949
-100,-10,-160,1048,1068,2116,4887
70,-10,-50,1035,1081,2116,4929
-60,-10,-120,1078,1039,2117,4869
30,10,-80,1040,1077,2117,4880
100,30,-40,1040,1077,2117,4727
-90,30,-20,1064,1054,2118,4725
140,-70,180,1075,1044,2119,4873
140,-70,-180,1075,1044,2119,4873
30,-50,90,1075,1045,2120,4804
-140,10,-170,1067,1053,2120,4891
150,50,100,1076,1044,2120,4697
-100,10,140,1054,1067,2121,4954
60,-20,150,1028,1093,2121,4832
-150,-60,-120,1066,1055,2121,4895
50,-10,130,1028,1093,2121,4713
-140,20,-180,1072,1049,2121,4898
-140,20,180,1072,1049,2121,4898
40,40,50,1052,1070,2122,4813
-50,-40,-130,1071,1051,2122,4614
-80,10,-90,1084,1038,2122,4919
170,-80,90,1061,1061,2122,4988
-180,-40,-160,1051,1072,2123,4952
180,-40,-160,1051,1072,2123,4952
100,80,-70,1077,1046,2123,5030
-100,10,150,1075,1048,2123,4872
110,10,-90,1048,1075,2123,4787
-100,0,160,1068,1055,2123,4726
60,60,0,1055,1069,2124,5042
30,-80,80,1081,1043,2124,4993
60,30,-140,1055,1069,2124,4743
-160,40,180,1054,1071,2125,4861
100,70,-60,1054,1071,2125,4881
-160,40,-180,1054,1071,2125,4861
120,-30,-160,1043,1082,2125,4909
100,-20,-130,1043,1082,2125,4675
100,0,-110,1041,1084,2125,4815
130,-30,70,1068,1057,2125,4992
-100,-10,150,1080,1045,2125,4685
60,70,-150,1056,1070,2126,4958
-140,0,50,1081,1045,2126,4505
-90,10,-80,1075,1051,2126,4649
-30,40,50,1095,1031,2126,5009
-90,-80,-40,1079,1047,2126,4962
-100,-20,160,1055,1071,2126,4597
170,0,-160,1062,1065,2127,4987
170,50,-150,1046,1081,2127,5171
100,40,140,1064,1063,2127,4713
-10,20,-80,1052,1076,2128,4835
10,0,60,1078,1050,2128,4842
100,10,-80,1072,1056,2128,4751
-50,-10,-110,1090,1038,2128,4882
-30,70,-60,1075,1053,2128,4880
-150,0,-160,1095,1033,2128,5108
30,-20,100,1063,1066,2129,4799
-60,30,-60,1068,1061,2129,4879
50,20,-100,1083,1046,2129,4644
70,-30,160,1040,1089,2129,4927
170,60,-150,1067,1064,2131,5053
100,60,-50,1064,1067,2131,4753
90,-60,140,1049,1082,2131,4957
-70,-30,-150,1064,1067,2131,4735
-70,70,90,1080,1052,2132,4909
10,40,40,1070,1062,2132,4910
180,70,-160,1066,1066,2132,4990
140,-50,70,1063,1069,2132,5099
100,-30,20,1060,1072,2132,4718
-120,30,150,1082,1050,2132,4849
-180,70,-160,1066,1066,2132,4990
150,50,-120,1074,1059,2133,4938
50,70,-10,1051,1082,2133,4797
-50,-50,20,1074,1059,2133,5020
-170,-10,80,1070,1064,2134,4760
100,10,80,1084,1050,2134,4913
-110,-10,-140,1078,1056,2134,4939
70,30,180,1056,1078,2134,4635
70,30,-180,1056,1078,2134,4635
150,-30,-170,1078,1056,2134,5104
80,30,70,1080,1055,2135,4520
40,30,-100,1098,1037,2135,4719
170,20,-160,1059,1076,2135,4967
20,40,40,1062,1074,2136,4960
50,30,-110,1063,1073,2136,4762
20,30,50,1077,1059,2136,4943
60,60,-150,1068,1069,2137,4926
-60,40,70,1067,1070,2137,4867
-90,30,100,1064,1073,2137,4986
-110,10,0,1064,1074,2138,5054
90,20,110,1055,1083,2138,4798
70,60,-10,1062,1076,2138,4975
110,70,-70,1065,1074,2139,4963
-150,20,50,1092,1047,2139,4561
20,0,80,1068,1071,2139,4909
60,80,-150,1049,1090,2139,5024
130,60,-90,1074,1065,2139,4880
60,-10,170,1047,1092,2139,4322
0,-40,60,1100,1039,2139,4794
180,0,80,1083,1057,2140,4691
160,10,-150,1077,1063,2140,5190
-180,0,80,1083,1057,2140,4691
-150,0,60,1071,1069,2140,4685
10,10,-80,1066,1075,2141,4935
90,50,-10,1059,1082,2141,4821
-70,0,-110,1084,1057,2141,4882
80,30,150,1054,1088,2142,4561
140,60,-110,1086,1056,2142,4994
110,10,90,1055,1087,2142,4906
-80,-20,40,1058,1084,2142,4912
-150,50,170,1065,1078,2143,4911
100,30,-20,1049,1094,2143,4735
-110,60,10,1072,1071,2143,4758
10,-40,70,1085,1058,2143,4922
-160,70,60,1057,1086,2143,4982
100,50,-40,1063,1081,2144,4685
20,80,10,1092,1052,2144,4959
-80,-10,-140,1101,1044,2145,5022
-160,50,-180,1064,1081,2145,4975
-160,50,180,1064,1081,2145,4975
10,20,50,1075,1070,2145,5075
110,20,-70,1060,1086,2146,4902
-80,50,-20,1078,1068,2146,4964
90,0,-30,1067,1079,2146,5123
-140,50,160,1054,1092,2146,4986
160,20,-150,1076,1071,2147,5141
120,-40,50,1065,1082,2147,4779
80,10,-100,1040,1107,2147,4945
100,10,-50,1072,1076,2148,4534
130,60,120,1079,1069,2148,4695
100,20,-30,1067,1081,2148,4847
60,-50,120,1080,1069,2149,4917
130,-10,80,1060,1089,2149,4955
-90,-10,80,1056,1094,2150,4751
-10,-20,50,1087,1063,2150,5013
110,40,130,1072,1078,2150,4785
80,40,30,1058,1092,2150,4492
-10,80,-80,1071,1079,2150,4862
80,60,-20,1078,1073,2151,4949
40,-80,90,1086,1065,2151,5085
100,-20,20,1081,1070,2151,4778
-120,-20,-120,1067,1084,2151,5064
-90,-20,50,1085,1066,2151,4805
70,20,150,1069,1082,2151,4621
100,-70,20,1086,1065,2151,4949
60,20,-110,1079,1073,2152,4695
170,-50,90,1075,1077,2152,4843
-160,-30,-150,1083,1069,2152,5066
-160,-10,-160,1078,1074,2152,5025
110,0,80,1062,1091,2153,4954
170,10,-160,1064,1089,2153,5115
-50,20,-80,1074,1079,2153,4683
-50,-10,40,1087,1066,2153,4885
100,-30,-150,1053,1101,2154,4814
110,-10,60,1112,1042,2154,4821
-140,-70,-100,1096,1058,2154,4925
-160,20,60,1097,1057,2154,4672
-120,20,170,1097,1058,2155,4862
100,-80,20,1082,1074,2156,5001
-110,30,140,1093,1063,2156,5091
50,50,30,1079,1077,2156,4948
-80,70,100,1094,1062,2156,5006
-150,70,50,1076,1080,2156,4895
-180,40,-160,1055,1102,2157,4973
110,60,140,1090,1067,2157,4785
110,-80,30,1078,1079,2157,5061
-130,50,150,1084,1073,2157,5014
110,80,-80,1099,1058,2157,5064
180,40,-160,1055,1102,2157,4973
150,40,-120,1082,1076,2158,4880
-100,20,130,1081,1077,2158,5053
80,50,170,1085,1073,2158,4770
-90,-30,10,1090,1068,2158,5064
-70,50,-30,1091,1067,2158,4996
160,30,-140,1069,1089,2158,5056
-110,-10,-30,1082,1077,2159,4758
0,-30,60,1091,1068,2159,4849
100,60,150,1087,1073,2160,4762
-180,-60,-150,1082,1078,2160,4911
50,0,130,1054,1106,2160,4766
-110,0,0,1085,1075,2160,4759
0,0,-80,1067,1093,2160,5002
180,-60,-150,1082,1078,2160,4911
-110,-10,-40,1074,1086,2160,4749
-50,10,-90,1088,1073,2161,4818
-30,30,50,1106,1055,2161,5001
-170,40,-170,1076,1086,2162,4987
160,-80,80,1072,1090,2162,5020
80,-30,-160,1071,1091,2162,4727
20,20,60,1083,1080,2163,5030
20,60,-100,1087,1076,2163,5015
-60,0,50,1081,1082,2163,4974
80,0,-70,1076,1088,2164,4876
100,10,-70,1061,1103,2164,4781
-110,-10,-20,1092,1072,2164,4899
160,-10,-160,1076,1088,2164,5145
-90,0,100,1065,1099,2164,5173
90,-40,150,1067,1097,2164,5094
-170,30,-170,1076,1089,2165,5135
40,40,80,1084,1081,2165,4607
60,-30,170,1081,1084,2165,4865
90,-30,0,1062,1103,2165,4909
-10,-60,50,1106,1060,2166,4988
-100,-80,-50,1096,1070,2166,4994
-90,50,-10,1092,1075,2167,4993
-40,-10,40,1091,1076,2167,4960
120,50,-70,1082,1085,2167,4925
80,0,-130,1062,1105,2167,4787
-100,-50,-30,1113,1055,2168,4873
110,60,-60,1080,1088,2168,4960
100,-40,160,1088,1081,2169,4931
-140,0,-160,1115,1054,2169,5112
-170,70,-170,1083,1086,2169,5150
-10,70,40,1098,1071,2169,4907
180,-20,-160,1087,1082,2169,5009
90,0,-40,1083,1086,2169,4962
-180,-20,-160,1087,1082,2169,5009
50,20,110,1089,1080,2169,4708
-40,-40,30,1087,1083,2170,5025
40,60,10,1077,1093,2170,4917
0,-50,60,1112,1058,2170,4835
160,30,90,1093,1078,2171,4884
-110,-40,150,1097,1074,2171,4934
-50,30,60,1112,1060,2172,5030
100,-10,20,1078,1094,2172,4832
-90,10,100,1055,1117,2172,5163
10,80,20,1111,1062,2173,5061
30,-40,-60,1064,1109,2173,4907
110,-30,-150,1058,1116,2174,4882
0,10,50,1089,1085,2174,5008
170,40,-150,1068,1106,2174,4930
20,10,-80,1073,1101,2174,5186
-90,10,-90,1099,1075,2174,4857
120,-80,40,1078,1097,2175,5178
-120,-20,-110,1078,1097,2175,4882
150,20,-130,1086,1089,2175,5074
60,-30,130,1079,1096,2175,4987
-110,-10,-50,1082,1094,2176,4946
-160,0,-160,1105,1071,2176,5084
80,70,-180,1098,1078,2176,4919
180,60,-160,1088,1088,2176,5306
-110,40,130,1084,1092,2176,5023
-180,60,-160,1088,1088,2176,5306
-170,-60,-140,1101,1075,2176,4979
60,-30,160,1087,1089,2176,4948
80,70,180,1098,1078,2176,4919
120,40,120,1113,1064,2177,4875
90,-30,-150,1068,1109,2177,4757
-130,-20,-140,1089,1088,2177,5189
-90,20,100,1066,1111,2177,5113
140,-10,-140,1103,1074,2177,4974
100,10,20,1072,1105,2177,4793
150,-70,-170,1106,1071,2177,5097
-70,-10,50,1095,1082,2177,5030
140,-20,80,1088,1090,2178,5108
120,70,-80,1104,1074,2178,5065
-60,20,-80,1098,1080,2178,4695
10,-20,70,1096,1082,2178,4934
140,70,-110,1108,1070,2178,5167
120,60,130,1097,1081,2178,4739
-80,30,90,1067,1111,2178,4988
100,30,-10,1077,1102,2179,4800
120,80,-90,1111,1068,2179,5162
10,-30,70,1099,1080,2179,4871
170,-50,-160,1085,1094,2179,5102
0,80,-90,1084,1095,2179,4921
-170,50,-170,1071,1109,2180,5057
20,-40,80,1111,1069,2180,4889
-110,20,160,1112,1068,2180,5007
-140,-30,100,1065,1115,2180,4879
-30,-20,40,1111,1069,2180,4996
90,60,-30,1094,1086,2180,5011
90,-70,140,1087,1093,2180,4994
150,60,-120,1100,1080,2180,5027
130,30,-90,1098,1083,2181,4807
60,10,130,1075,1106,2181,4808
20,20,70,1100,1081,2181,4987
-20,50,-70,1101,1081,2182,4998
-160,0,70,1104,1078,2182,4899
70,10,-100,1085,1097,2182,4687
-90,20,-50,1089,1093,2182,4898
40,50,30,1084,1099,2183,5153
-110,-10,-130,1082,1101,2183,4860
170,-70,90,1090,1093,2183,4921
-90,-60,180,1100,1083,2183,4852
-90,-60,-180,1100,1083,2183,4852
100,30,-30,1060,1123,2183,4842
40,70,0,1077,1106,2183,4838
70,20,120,1084,1099,2183,4760
170,-60,90,1099,1085,2184,5022
50,-80,100,1097,1087,2184,5177
70,50,20,1101,1083,2184,4918
-100,10,-90,1085,1099,2184,4612
50,80,-140,1079,1105,2184,5093
130,-20,-140,1090,1094,2184,5045
90,60,160,1106,1079,2185,4865
-150,30,180,1090,1095,2185,5007
-150,30,-180,1090,1095,2185,5007
90,40,150,1075,1110,2185,4766
20,-50,80,1118,1067,2185,5054
-110,-10,0,1080,1106,2186,4987
-180,50,-160,1081,1105,2186,5166
100,20,10,1099,1087,2186,4808
130,-50,60,1106,1080,2186,4881
100,-50,20,1081,1105,2186,5056
-130,0,-160,1110,1076,2186,5068
-50,60,70,1113,1073,2186,5096
180,50,-160,1081,1105,2186,5166
50,50,-130,1080,1106,2186,4996
-110,-10,-120,1093,1094,2187,4882
-160,-60,-130,1102,1085,2187,5027
90,30,40,1095,1092,2187,4639
110,30,-60,1074,1113,2187,4979
-160,70,-180,1102,1086,2188,5247
180,-30,90,1086,1102,2188,4802
20,10,80,1090,1098,2188,4896
-160,70,180,1102,1086,2188,5247
130,0,-120,1099,1089,2188,5139
-180,-30,90,1086,1102,2188,4802
10,-50,70,1118,1070,2188,5042
-40,50,60,1116,1072,2188,5137
60,40,70,1082,1106,2188,4717
-90,70,110,1103,1086,2189,5106
100,10,40,1098,1091,2189,4930
-50,0,-100,1109,1081,2190,5047
-140,70,40,1087,1103,2190,4894
60,0,170,1105,1085,2190,4564
130,10,-110,1107,1084,2191,4875
-120,-40,-60,1116,1075,2191,4885
60,-30,-40,1084,1107,2191,5091
50,-30,120,1083,1108,2191,5043
120,40,-70,1088,1103,2191,4932
-110,-10,-60,1102,1089,2191,5003
-70,-30,20,1110,1082,2192,5087
-50,-70,10,1108,1084,2192,5169
0,10,-80,1096,1096,2192,5153
10,60,30,1115,1077,2192,4924
110,-20,-130,1068,1124,2192,4882
80,50,10,1093,1100,2193,4798
120,-30,-170,1093,1100,2193,5184
-110,-70,160,1109,1084,2193,4905
10,-10,70,1104,1089,2193,5024
60,50,30,1093,1101,2194,5014
-170,-10,-160,1098,1096,2194,5215
80,-40,-10,1096,1098,2194,4961
-90,-30,20,1108,1087,2195,5163
140,60,110,1110,1085,2195,4754
60,-20,180,1077,1119,2196,4626
60,-20,-180,1077,1119,2196,4626
120,0,-110,1124,1073,2197,4982
-10,-10,50,1124,1073,2197,5126
-100,-60,-40,1113,1084,2197,5086
40,0,120,1077,1120,2197,4764
60,-10,-60,1067,1130,2197,5098
130,-80,50,1085,1113,2198,5175
-40,-70,20,1122,1076,2198,5171
-130,-30,-120,1078,1121,2199,5204
40,-30,110,1102,1097,2199,5025
60,0,-180,1088,1112,2200,4562
-170,60,-170,1094,1106,2200,5398
60,0,180,1088,1112,2200,4562
-90,0,-120,1108,1092,2200,4976
-40,-40,-120,1107,1094,2201,4671
140,0,-130,1107,1094,2201,5063
60,30,-130,1089,1113,2202,4967
-160,20,-170,1086,1116,2202,5125
100,0,20,1100,1102,2202,4988
-110,-20,-20,1103,1099,2202,4868
150,-80,70,1096,1106,2202,5075
80,40,40,1123,1079,2202,4831
-150,20,-170,1120,1083,2203,5221
60,0,160,1086,1117,2203,4871
-100,30,120,1108,1095,2203,5122
-120,-50,-70,1093,1110,2203,4996
-120,-20,-100,1098,1105,2203,4970
-120,-30,-60,1101,1103,2204,4781
90,20,90,1126,1078,2204,4970
140,50,-100,1120,1084,2204,5162
-130,-40,-100,1121,1083,2204,4981
-60,60,80,1107,1098,2205,5086
170,-10,-160,1120,1085,2205,5158
100,20,0,1077,1128,2205,4623
-40,10,50,1115,1091,2206,5182
-120,50,140,1111,1095,2206,5051
-110,10,-180,1115,1091,2206,5176
160,0,-150,1096,1110,2206,5200
-130,-10,-150,1123,1083,2206,5265
-50,-20,-120,1132,1074,2206,5019
-110,10,180,1115,1091,2206,5176
-130,10,-170,1122,1084,2206,5059
100,-10,-120,1101,1106,2207,4942
-100,70,120,1094,1114,2208,5197
70,-20,-160,1105,1103,2208,4778
140,40,-100,1119,1089,2208,5003
10,80,-100,1095,1113,2208,5018
-110,-10,-110,1118,1091,2209,4902
-150,-20,-150,1116,1093,2209,5144
-130,-50,130,1108,1101,2209,4966
30,50,30,1085,1124,2209,5215
160,20,-140,1107,1102,2209,5147
-110,-20,50,1125,1085,2210,4890
60,0,-80,1114,1096,2210,4805
-130,20,-180,1143,1068,2211,5074
-130,20,180,1143,1068,2211,5074
140,-20,-150,1112,1100,2212,5023
0,-60,60,1131,1082,2213,5014
-100,10,-60,1104,1109,2213,4945
110,-30,40,1087,1126,2213,4986
-100,60,0,1109,1105,2214,5107
-120,-70,150,1115,1099,2214,4908
-110,-80,-60,1111,1103,2214,5051
-100,0,170,1107,1107,2214,5139
30,-60,90,1116,1099,2215,5240
90,20,100,1119,1096,2215,4824
50,60,10,1105,1110,2215,5243
90,20,70,1130,1085,2215,4945
120,60,-70,1105,1110,2215,5035
100,0,10,1114,1103,2217,4888
-130,-40,120,1104,1113,2217,4893
-70,0,60,1117,1100,2217,5019
-90,-50,-180,1116,1101,2217,4905
-90,-50,180,1116,1101,2217,4905
-150,70,170,1116,1102,2218,5238
170,-30,-160,1107,1111,2218,5100
-120,70,140,1098,1120,2218,5280
30,40,-100,1105,1113,2218,4916
70,0,-80,1114,1105,2219,4860
120,10,90,1093,1126,2219,5032
160,40,90,1106,1113,2219,4829
30,80,-120,1116,1103,2219,5048
30,20,-90,1120,1099,2219,5081
-150,-70,-110,1136,1083,2219,5098
130,20,100,1118,1101,2219,5139
40,80,-130,1112,1108,2220,5067
-130,70,150,1109,1111,2220,5351
60,-80,110,1105,1115,2220,5153
30,0,110,1106,1115,2221,4923
70,40,180,1105,1116,2221,4968
-160,60,180,1099,1122,2221,5497
70,40,-180,1105,1116,2221,4968
-130,70,30,1105,1116,2221,4952
-160,60,-180,1099,1122,2221,5497
-30,20,50,1122,1099,2221,5139
140,80,120,1113,1109,2222,4998
130,80,-100,1132,1090,2222,5239
-110,20,0,1141,1081,2222,5086
140,10,90,1106,1116,2222,4960
-70,60,90,1115,1107,2222,5123
-60,-70,0,1122,1101,2223,5135
-110,0,-10,1107,1116,2223,5090
70,30,90,1119,1104,2223,4863
-100,0,-180,1108,1115,2223,5165
-90,-40,0,1122,1101,2223,5186
-100,0,180,1108,1115,2223,5165
110,0,70,1119,1105,2224,5170
20,-30,-70,1087,1137,2224,5120
-110,70,130,1097,1127,2224,5279
20,30,-90,1120,1104,2224,5179
80,-10,-40,1083,1142,2225,5111
160,-70,-160,1129,1096,2225,5188
-30,-70,30,1123,1102,2225,5193
140,-20,-160,1119,1106,2225,5310
180,-10,-160,1121,1105,2226,5301
-180,-10,-160,1121,1105,2226,5301
70,60,0,1103,1123,2226,5173
100,10,30,1093,1133,2226,5039
100,10,0,1097,1130,2227,4892
140,-80,60,1114,1113,2227,5171
100,60,-40,1122,1106,2228,4976
110,50,-50,1111,1117,2228,4857
110,-70,30,1111,1117,2228,5132
10,-60,70,1146,1082,2228,5135
30,40,50,1086,1143,2229,5173
140,-50,-180,1131,1098,2229,5253
140,-50,180,1131,1098,2229,5253
40,-10,120,1107,1122,2229,5129
140,-60,180,1112,1118,2230,5268
140,-60,-180,1112,1118,2230,5268
-120,-70,-70,1129,1101,2230,5123
-100,10,160,1127,1104,2231,5209
50,50,40,1110,1121,2231,5074
50,-30,-50,1131,1101,2232,5078
150,-10,-150,1123,1109,2232,5225
-130,-70,140,1122,1110,2232,4983
-120,-60,-70,1132,1100,2232,5150
70,70,-170,1110,1122,2232,5124
130,-10,-130,1105,1128,2233,5104
70,-30,150,1082,1151,2233,5190
30,30,90,1109,1124,2233,4768
110,20,100,1102,1132,2234,5093
-140,70,160,1125,1109,2234,5266
20,0,90,1106,1128,2234,4934
20,80,-110,1128,1107,2235,5142
-80,-60,-170,1120,1115,2235,4992
-20,60,-70,1133,1102,2235,5000
40,60,-120,1100,1135,2235,5225
100,0,0,1127,1108,2235,4975
150,80,110,1123,1112,2235,5034
-70,30,80,1104,1132,2236,5175
130,10,90,1125,1111,2236,5073
170,30,-150,1096,1140,2236,5247
130,80,130,1121,1115,2236,5044
-90,-50,-10,1142,1095,2237,4936
110,-50,160,1115,1122,2237,5244
120,-30,-150,1096,1141,2237,4945
-70,10,70,1126,1111,2237,5261
30,40,70,1122,1115,2237,4981
160,40,-130,1120,1117,2237,4957
150,30,-120,1128,1109,2237,5053
160,50,-130,1119,1119,2238,5083
180,0,-160,1119,1119,2238,5221
-100,-70,170,1154,1084,2238,5003
-180,0,-160,1119,1119,2238,5221
100,10,-40,1082,1157,2239,5026
-80,20,-70,1133,1106,2239,4878
70,-80,120,1107,1132,2239,5177
120,80,140,1125,1114,2239,5057
-100,30,-10,1132,1107,2239,5209
-180,30,-160,1114,1125,2239,5379
-30,-30,40,1142,1097,2239,5088
180,30,-160,1114,1125,2239,5379
40,-60,100,1121,1118,2239,5177
130,70,-90,1130,1109,2239,5183
-150,-10,70,1117,1123,2240,4830
0,80,30,1130,1110,2240,5184
-10,0,50,1128,1112,2240,5258
-90,0,110,1127,1113,2240,5106
-120,-50,140,1133,1107,2240,5211
70,40,60,1100,1140,2240,4767
100,20,100,1116,1125,2241,5064
-110,0,-70,1116,1125,2241,5056
110,-40,170,1119,1122,2241,5313
-170,0,-160,1123,1118,2241,5175
90,0,-60,1123,1118,2241,5005
-80,20,90,1101,1141,2242,5142
60,0,140,1104,1139,2243,5081
-70,-70,-10,1130,1113,2243,5069
80,60,-10,1104,1139,2243,5091
-170,-50,100,1130,1114,2244,5213
-110,-20,80,1112,1132,2244,4913
-100,10,-70,1133,1111,2244,4969
20,-60,80,1142,1103,2245,5223
-160,10,-160,1140,1105,2245,5228
120,30,110,1131,1115,2246,4977
30,70,10,1108,1138,2246,4974
-130,-10,50,1136,1110,2246,4684
-100,20,140,1137,1110,2247,5317
-60,50,-40,1136,1111,2247,5184
50,10,-90,1134,1113,2247,5026
-30,-10,-100,1120,1127,2247,5118
-90,-20,-170,1111,1136,2247,5179
-140,-50,-110,1135,1112,2247,5167
-100,60,120,1131,1117,2248,5263
100,40,-30,1097,1151,2248,5000
140,10,-120,1134,1114,2248,5115
0,20,50,1103,1146,2249,5245
110,-10,50,1130,1119,2249,4896
110,70,-60,1122,1127,2249,5112
60,30,-150,1113,1136,2249,4939
40,40,-110,1131,1118,2249,5204
-150,-30,-140,1138,1112,2250,5125
50,40,-120,1122,1128,2250,5240
-110,-20,100,1114,1136,2250,5003
160,60,-130,1128,1122,2250,5145
-100,-30,0,1141,1110,2251,5168
-140,60,160,1113,1138,2251,5435
-20,-70,40,1144,1107,2251,5178
50,-20,140,1119,1132,2251,5119
-80,-50,0,1141,1111,2252,4952
0,50,40,1136,1116,2252,5074
-50,-30,30,1133,1120,2253,5205
-170,-40,-150,1144,1109,2253,5226
150,70,-120,1126,1127,2253,5312
-60,-40,20,1142,1111,2253,5104
-100,20,150,1137,1117,2254,5060
-130,60,150,1126,1129,2255,5462
-130,40,160,1136,1119,2255,5418
10,0,70,1130,1125,2255,5016
-80,-30,20,1137,1118,2255,5234
-140,-10,-150,1157,1098,2255,5399
100,70,-50,1122,1133,2255,5070
-90,60,110,1143,1112,2255,5261
140,-30,-170,1123,1132,2255,5393
-90,10,110,1088,1168,2256,5336
-40,40,60,1163,1093,2256,5306
60,60,10,1121,1135,2256,5401
50,-20,130,1089,1167,2256,5059
-90,20,-60,1135,1121,2256,4948
-120,0,-160,1162,1095,2257,5383
100,10,-10,1137,1120,2257,4885
-100,-20,150,1140,1117,2257,5066
110,80,150,1133,1124,2257,5137
-20,60,50,1151,1107,2258,5250
110,40,-50,1099,1159,2258,4991
160,10,-140,1130,1128,2258,5266
-180,10,-160,1136,1122,2258,5262
180,10,-160,1136,1122,2258,5262
-110,-90,-60,1138,1121,2259,5326
10,-90,60,1138,1121,2259,5326
-80,-90,-30,1138,1121,2259,5326
150,-90,-160,1138,1121,2259,5326
130,-90,-180,1138,1121,2259,5326
130,-90,180,1138,1121,2259,5326
-30,-90,20,1138,1121,2259,5326
-120,-90,-70,1138,1121,2259,5326
140,-90,-170,1138,1121,2259,5326
-20,-90,30,1138,1121,2259,5326
50,-90,100,1138,1121,2259,5326
-10,-90,40,1138,1121,2259,5326
-50,-90,0,1138,1121,2259,5326
-170,-90,-120,1138,1121,2259,5326
-160,-90,-110,1138,1121,2259,5326
-20,70,-70,1141,1118,2259,5258
70,-30,-170,1127,1132,2259,4817
-150,-90,-100,1138,1121,2259,5326
-100,-90,-50,1138,1121,2259,5326
-90,-90,-40,1138,1121,2259,5326
90,-90,140,1138,1121,2259,5326
30,-90,80,1138,1121,2259,5326
70,-90,120,1138,1121,2259,5326
20,-90,70,1138,1121,2259,5326
100,-90,150,1138,1121,2259,5326
-70,-90,-20,1138,1121,2259,5326
-140,-90,-90,1138,1121,2259,5326
100,-40,20,1109,1150,2259,5109
0,-20,60,1144,1115,2259,5072
-130,-90,-80,1138,1121,2259,5326
-180,-90,-130,1138,1121,2259,5326
0,-90,50,1138,1121,2259,5326
80,-90,130,1138,1121,2259,5326
40,-90,90,1138,1121,2259,5326
60,-90,110,1138,1121,2259,5326
170,-90,-140,1138,1121,2259,5326
-40,-90,10,1138,1121,2259,5326
120,-90,170,1138,1121,2259,5326
-60,-90,-10,1138,1121,2259,5326
180,-90,-130,1138,1121,2259,5326
110,-90,160,1138,1121,2259,5326
160,-90,-150,1138,1121,2259,5326
30,-10,110,1125,1134,2259,5115
-110,-20,10,1126,1134,2260,5100
120,20,100,1138,1122,2260,5165
-20,30,50,1167,1093,2260,5195
120,10,-90,1137,1125,2262,4922
110,-60,30,1128,1134,2262,5174
-40,-50,30,1145,1117,2262,5221
-130,30,170,1132,1130,2262,5239
-100,-30,20,1124,1139,2263,5307
100,10,-60,1124,1139,2263,4842
-150,60,170,1122,1141,2263,5409
-80,60,100,1137,1126,2263,5312
100,10,-20,1144,1119,2263,5095
-20,70,50,1151,1112,2263,5168
70,0,-150,1097,1166,2263,4821
-120,40,150,1135,1129,2264,5418
140,30,100,1160,1104,2264,5091
-120,-20,-90,1149,1115,2264,5043
-110,0,-30,1130,1135,2265,4922
-110,0,-50,1121,1144,2265,4963
140,80,-110,1145,1121,2266,5267
-110,60,130,1158,1108,2266,5223
-170,10,-160,1139,1127,2266,5174
80,-10,-50,1126,1141,2267,5142
-110,-10,-10,1145,1122,2267,5135
-90,-40,180,1127,1141,2268,5099
-90,-40,-180,1127,1141,2268,5099
-50,0,50,1136,1132,2268,5194
100,20,20,1134,1134,2268,4948
30,40,60,1136,1133,2269,5250
-110,-40,-30,1150,1119,2269,4999
-100,-30,10,1142,1127,2269,5281
160,50,90,1156,1113,2269,4958
-120,60,140,1146,1123,2269,5358
120,-10,-120,1139,1130,2269,5044
80,-80,130,1135,1134,2269,5176
50,0,-80,1139,1130,2269,5160
150,10,-130,1138,1132,2270,5339
-120,30,160,1147,1123,2270,5271
100,-60,150,1123,1147,2270,5230
-70,-20,40,1137,1133,2270,5384
170,50,-140,1135,1135,2270,5248
160,80,100,1134,1136,2270,5185
-180,20,-160,1133,1138,2271,5397
60,-30,140,1122,1149,2271,5216
180,20,-160,1133,1138,2271,5397
-150,10,-160,1173,1099,2272,5279
60,-30,150,1106,1166,2272,5290
170,-20,-160,1151,1122,2273,5386
100,-70,150,1132,1141,2273,5176
-110,50,130,1145,1128,2273,5306
-130,-50,-90,1149,1125,2274,5186
-150,-20,80,1144,1130,2274,5010
-100,30,130,1159,1115,2274,5371
10,50,-90,1128,1146,2274,5339
-60,-60,10,1160,1114,2274,5046
140,60,-100,1149,1126,2275,5291
120,-70,40,1113,1162,2275,5466
60,-20,-50,1139,1136,2275,5367
150,50,-110,1138,1137,2275,5110
-100,20,-20,1139,1137,2276,5140
70,30,170,1124,1152,2276,4828
20,20,80,1131,1145,2276,5188
70,-10,-60,1123,1153,2276,5091
-20,50,50,1166,1111,2277,5334
120,70,-70,1141,1136,2277,5207
130,-30,-170,1130,1147,2277,5326
100,40,-20,1131,1146,2277,5149
50,-10,140,1101,1177,2278,4977
90,30,50,1143,1135,2278,4971
-120,70,20,1119,1159,2278,5142
100,10,50,1134,1144,2278,5134
-120,-80,-70,1151,1127,2278,5215
80,70,-30,1121,1158,2279,5140
120,20,-80,1167,1112,2279,5334
140,20,-110,1148,1131,2279,5135
100,10,70,1156,1123,2279,5215
160,70,-130,1139,1141,2280,5346
-30,10,50,1140,1140,2280,5191
-150,-10,-150,1153,1127,2280,5352
-20,20,50,1185,1095,2280,5241
-160,-60,110,1144,1136,2280,5253
-160,-20,-150,1141,1139,2280,5354
110,0,-100,1127,1154,2281,5060
-100,50,120,1145,1136,2281,5281
90,70,-40,1127,1154,2281,5095
90,-80,140,1140,1141,2281,5218
60,0,150,1113,1168,2281,5046
70,-40,170,1141,1141,2282,5114
40,50,50,1141,1141,2282,5266
-80,-70,-20,1163,1119,2282,5151
20,10,90,1142,1140,2282,5043
60,40,-160,1146,1136,2282,4937
60,50,-160,1138,1144,2282,5207
60,10,170,1132,1151,2283,4841
80,0,-80,1134,1150,2284,5113
60,-10,-180,1130,1154,2284,4641
60,-10,180,1130,1154,2284,4641
70,10,-130,1114,1170,2284,5129
130,50,-80,1186,1099,2285,5231
-40,10,-90,1151,1134,2285,5122
-110,-20,90,1114,1171,2285,4835
100,50,-30,1158,1127,2285,5004
20,-40,-70,1139,1146,2285,5074
-140,-50,120,1147,1139,2286,5197
-70,-60,0,1172,1114,2286,5029
-160,0,-150,1158,1128,2286,5386
-10,20,50,1149,1137,2286,5284
-10,30,-80,1144,1143,2287,5310
130,-40,180,1130,1157,2287,5306
100,30,0,1101,1186,2287,4934
-110,30,150,1164,1123,2287,5347
130,-40,-180,1130,1157,2287,5306
-80,30,-40,1161,1126,2287,5059
170,10,-150,1120,1167,2287,5476
-80,-10,60,1155,1132,2287,5266
-90,-70,-180,1167,1121,2288,5061
-90,-70,180,1167,1121,2288,5061
100,80,160,1143,1145,2288,5262
-160,30,-170,1147,1142,2289,5332
50,-50,-40,1133,1156,2289,5157
100,80,-60,1158,1131,2289,5414
-170,-30,-150,1153,1137,2290,5412
-20,40,50,1168,1122,2290,5239
-180,-50,-150,1140,1150,2290,5174
10,30,50,1146,1144,2290,5343
-110,0,-40,1138,1152,2290,5065
130,-30,-150,1145,1145,2290,5073
-100,-30,160,1153,1137,2290,5209
-100,0,-110,1133,1157,2290,5168
70,60,10,1159,1131,2290,5185
-160,-70,-120,1164,1126,2290,5181
-110,40,140,1164,1126,2290,5521
-50,30,-70,1158,1132,2290,5058
-140,20,-170,1155,1135,2290,5414
180,-50,-150,1140,1150,2290,5174
-70,-50,10,1167,1124,2291,5026
20,-10,90,1133,1158,2291,5209
-90,-10,90,1138,1153,2291,5222
30,-30,100,1148,1144,2292,5179
-100,-40,-10,1164,1129,2293,5198
120,0,80,1136,1157,2293,5215
-110,0,-90,1157,1136,2293,5174
90,50,0,1140,1153,2293,4950
-60,30,70,1139,1154,2293,5247
-10,80,40,1153,1140,2293,5348
50,-60,110,1136,1158,2294,5116
-90,0,-130,1155,1139,2294,5460
180,80,80,1143,1151,2294,5315
-180,80,80,1143,1151,2294,5315
-100,40,120,1142,1152,2294,5257
-110,0,-80,1164,1130,2294,5176
-60,-30,-140,1153,1142,2295,5068
-130,-30,-110,1135,1160,2295,5079
70,-50,130,1139,1156,2295,5136
-140,-30,-130,1139,1156,2295,5258
-100,10,170,1158,1137,2295,5364
-120,-40,130,1141,1154,2295,5154
-160,-40,100,1168,1127,2295,5267
90,20,80,1162,1133,2295,5251
150,-60,-170,1152,1144,2296,5442
-100,-20,140,1159,1137,2296,5318
-90,-30,30,1149,1147,2296,5364
30,60,-110,1154,1142,2296,5477
-120,-10,-140,1177,1120,2297,5605
100,-40,170,1152,1145,2297,5381
-60,10,60,1160,1137,2297,5366
-140,-70,130,1152,1145,2297,5212
-140,-60,-100,1159,1138,2297,5259
160,30,-130,1147,1150,2297,5220
-90,50,110,1160,1137,2297,5250
170,80,90,1148,1150,2298,5347
-140,40,170,1155,1143,2298,5302
50,70,-140,1139,1160,2299,5305
-10,-70,50,1173,1126,2299,5241
40,50,40,1126,1173,2299,5284
100,10,60,1156,1144,2300,5033
80,60,0,1164,1136,2300,5127
170,-70,-150,1169,1132,2301,5294
110,60,-50,1152,1149,2301,5032
70,-30,-30,1138,1163,2301,5363
-80,0,-130,1170,1131,2301,5245
60,-50,-30,1128,1173,2301,5205
-120,-10,20,1134,1168,2302,5046
140,30,-100,1154,1148,2302,5182
70,20,140,1145,1157,2302,4998
40,-10,-70,1136,1166,2302,5565
-100,-20,60,1155,1147,2302,5131
-70,0,-120,1151,1152,2303,5383
150,80,-120,1158,1145,2303,5398
90,80,-50,1158,1145,2303,5372
80,60,170,1141,1162,2303,5166
-140,30,-180,1163,1140,2303,5265
80,40,160,1135,1168,2303,4918
-10,10,50,1171,1132,2303,5368
50,40,80,1139,1164,2303,4949
-100,-30,30,1156,1147,2303,5171
-140,30,180,1163,1140,2303,5265
10,0,-80,1151,1152,2303,5475
-160,-40,-140,1158,1146,2304,5381
30,60,20,1147,1157,2304,5295
-110,0,-20,1137,1167,2304,5104
50,-20,150,1134,1173,2307,5288
50,-20,160,1144,1163,2307,5229
90,-40,180,1147,1161,2308,5336
130,-30,-160,1158,1150,2308,5390
90,-40,-180,1147,1161,2308,5336
-50,-60,20,1179,1129,2308,5252
-100,10,-80,1155,1154,2309,5196
90,60,-20,1152,1157,2309,5197
140,70,-100,1151,1159,2310,5385
-90,-10,-150,1143,1167,2310,5399
-100,-20,70,1141,1169,2310,5070
90,-40,-170,1141,1169,2310,5183
-90,-70,-30,1167,1144,2311,5243
-70,-60,-160,1162,1149,2311,5257
150,60,100,1150,1161,2311,4869
-20,10,50,1175,1136,2311,5226
-120,-20,80,1147,1165,2312,5144
-90,-10,100,1138,1175,2313,5339
170,40,-140,1158,1155,2313,5435
70,70,-20,1132,1181,2313,5282
90,40,10,1150,1164,2314,4938
-100,30,140,1179,1135,2314,5387
150,-30,80,1137,1177,2314,5546
50,50,60,1167,1148,2315,4951
-130,-20,80,1147,1168,2315,5068
110,-40,180,1161,1154,2315,5364
110,-40,-180,1161,1154,2315,5364
60,20,120,1143,1173,2316,5147
40,60,20,1157,1159,2316,5500
70,-20,-40,1141,1175,2316,5476
-20,0,-90,1159,1157,2316,5273
-120,10,-170,1178,1138,2316,5467
90,-40,0,1142,1174,2316,5236
-50,20,60,1184,1133,2317,5414
-80,-60,-10,1182,1135,2317,5176
-110,0,-60,1148,1169,2317,5229
100,-40,-170,1147,1170,2317,5237
-80,-70,-170,1175,1143,2318,5303
-30,-30,-110,1166,1152,2318,5184
110,-30,-140,1146,1173,2319,5138
-110,0,-160,1167,1152,2319,5530
170,-40,-160,1158,1161,2319,5432
-80,50,100,1150,1169,2319,5408
-120,-20,-80,1151,1168,2319,5123
100,-80,150,1157,1163,2320,5350
130,10,-100,1151,1169,2320,5126
-80,-40,10,1166,1154,2320,5371
60,60,-160,1160,1161,2321,5181
-120,-20,-70,1171,1150,2321,5069
-90,60,-10,1159,1162,2321,5343
170,0,-150,1141,1180,2321,5509
-170,10,70,1181,1140,2321,5157
110,80,-70,1180,1141,2321,5511
70,50,180,1166,1155,2321,4956
60,-30,180,1147,1174,2321,5076
-30,-40,40,1178,1143,2321,5315
-130,0,30,1184,1137,2321,4990
60,-30,-180,1147,1174,2321,5076
70,50,-180,1166,1155,2321,4956
150,-20,-160,1159,1163,2322,5505
150,-40,-170,1157,1165,2322,5454
110,10,-80,1153,1169,2322,5308
100,-40,-180,1154,1169,2323,5263
10,10,60,1156,1167,2323,5388
100,-40,180,1154,1169,2323,5263
160,0,-140,1163,1161,2324,5362
-170,-70,-130,1172,1152,2324,5201
40,10,120,1146,1178,2324,5055
-90,10,-100,1154,1171,2325,5194
160,-70,80,1153,1172,2325,5477
-110,-20,70,1156,1169,2325,5004
40,50,60,1176,1149,2325,5260
110,-40,-170,1157,1168,2325,5287
120,-20,-130,1144,1181,2325,5218
170,10,80,1181,1144,2325,5262
160,80,-130,1173,1153,2326,5474
120,-20,60,1183,1143,2326,5151
-140,-20,80,1156,1171,2327,5136
0,-70,60,1169,1158,2327,5291
20,70,20,1151,1176,2327,5183
180,-70,-140,1173,1154,2327,5303
30,20,100,1172,1155,2327,4884
80,80,-40,1174,1153,2327,5424
-180,-70,-140,1173,1154,2327,5303
120,-10,70,1172,1156,2328,5419
50,-30,150,1155,1174,2329,5281
170,60,-140,1170,1159,2329,5445
100,-30,-140,1146,1183,2329,5144
100,10,-30,1155,1175,2330,5456
-150,0,-150,1213,1117,2330,5629
-130,-80,-80,1182,1148,2330,5430
-100,-50,-20,1188,1142,2330,5208
60,70,-10,1149,1181,2330,5401
-90,10,120,1169,1161,2330,5445
-50,50,70,1168,1163,2331,5525
80,-40,170,1154,1177,2331,5378
160,-10,-150,1164,1168,2332,5561
80,-50,140,1143,1189,2332,5393
-90,0,120,1168,1164,2332,5397
20,30,60,1167,1165,2332,5431
-20,-20,-100,1161,1172,2333,5196
-160,90,-170,1169,1164,2333,5525
130,90,-100,1169,1164,2333,5525
-20,90,50,1169,1164,2333,5525
110,90,-80,1169,1164,2333,5525
140,90,-110,1169,1164,2333,5525
180,90,-150,1169,1164,2333,5525
-50,90,80,1169,1164,2333,5525
-100,90,130,1169,1164,2333,5525
70,90,-40,1169,1164,2333,5525
40,90,-10,1169,1164,2333,5525
50,90,-20,1169,1164,2333,5525
-170,80,70,1164,1169,2333,5402
170,90,-140,1169,1164,2333,5525
150,90,-120,1169,1164,2333,5525
-10,90,40,1169,1164,2333,5525
130,40,-80,1190,1143,2333,5335
-150,90,180,1169,1164,2333,5525
-90,20,110,1154,1179,2333,5532
120,90,-90,1169,1164,2333,5525
60,90,-30,1169,1164,2333,5525
80,90,-50,1169,1164,2333,5525
-30,90,60,1169,1164,2333,5525
0,90,30,1169,1164,2333,5525
-180,90,-150,1169,1164,2333,5525
-60,90,90,1169,1164,2333,5525
160,90,-130,1169,1164,2333,5525
-150,90,-180,1169,1164,2333,5525
30,90,0,1169,1164,2333,5525
20,90,10,1169,1164,2333,5525
-140,90,170,1169,1164,2333,5525
10,90,20,1169,1164,2333,5525
20,30,70,1167,1166,2333,5445
130,20,-90,1182,1151,2333,5083
-120,90,150,1169,1164,2333,5525
-70,90,100,1169,1164,2333,5525
100,90,-70,1169,1164,2333,5525
-80,90,110,1169,1164,2333,5525
-170,90,-160,1169,1164,2333,5525
-90,90,120,1169,1164,2333,5525
-160,-10,-150,1188,1145,2333,5486
80,-40,180,1164,1169,2333,5208
-40,90,70,1169,1164,2333,5525
150,20,90,1189,1144,2333,5295
-130,90,160,1169,1164,2333,5525
150,60,-110,1175,1158,2333,5415
-110,90,140,1169,1164,2333,5525
90,90,-60,1169,1164,2333,5525
80,-40,-180,1164,1169,2333,5208
-150,40,180,1179,1155,2334,5308
-170,30,-160,1174,1160,2334,5482
-150,40,-180,1179,1155,2334,5308
180,10,-150,1172,1162,2334,5484
-180,10,-150,1172,1162,2334,5484
-100,-70,-40,1183,1152,2335,5393
150,20,-120,1166,1170,2336,5196
130,-40,60,1182,1154,2336,5243
-180,50,-150,1176,1160,2336,5487
180,50,-150,1176,1160,2336,5487
160,-20,-160,1187,1150,2337,5626
-40,-20,40,1177,1160,2337,5462
120,50,-60,1175,1163,2338,5247
180,0,-150,1178,1161,2339,5539
40,-50,-50,1144,1195,2339,5304
180,30,-150,1164,1175,2339,5448
20,0,-80,1156,1183,2339,5496
-180,30,-150,1164,1175,2339,5448
-180,0,-150,1178,1161,2339,5539
30,40,80,1170,1169,2339,5156
-110,-50,-40,1212,1127,2339,5283
-90,0,130,1193,1146,2339,5424
50,-20,-60,1150,1190,2340,5538
170,20,-150,1154,1186,2340,5708
-130,-70,-80,1187,1153,2340,5583
120,-30,-140,1159,1181,2340,5384
-70,-50,-160,1193,1147,2340,5295
-120,20,180,1211,1129,2340,5272
-120,20,-180,1211,1129,2340,5272
-110,-60,-50,1183,1157,2340,5480
-110,10,-10,1169,1172,2341,5396
70,20,130,1159,1182,2341,5209
-80,-50,-170,1178,1163,2341,5210
-90,10,140,1183,1159,2342,5367
-160,80,60,1162,1180,2342,5438
-140,-20,-140,1167,1175,2342,5683
-140,10,-160,1206,1136,2342,5596
40,-40,110,1168,1175,2343,5316
80,40,50,1167,1177,2344,4957
150,-10,-140,1192,1152,2344,5514
80,70,-20,1167,1178,2345,5411
100,70,-40,1180,1165,2345,5222
30,0,-80,1158,1187,2345,5504
-140,-10,60,1191,1154,2345,4979
-140,-40,110,1185,1160,2345,5172
90,-30,-140,1160,1185,2345,5156
60,-60,120,1181,1165,2346,5411
-90,40,110,1162,1184,2346,5364
10,-70,70,1179,1167,2346,5416
140,-40,70,1179,1167,2346,5382
90,0,-110,1147,1199,2346,5261
40,-30,-60,1193,1153,2346,5335
90,80,170,1172,1175,2347,5401
30,-70,90,1191,1156,2347,5559
160,-60,80,1167,1180,2347,5439
90,-40,160,1160,1187,2347,5448
50,50,50,1188,1159,2347,5266
50,60,20,1164,1183,2347,5622
120,60,-60,1197,1150,2347,5290
120,30,-70,1162,1186,2348,5377
-70,50,90,1170,1178,2348,5457
-140,-80,-90,1195,1153,2348,5534
170,20,-140,1166,1182,2348,5571
170,80,-140,1177,1172,2349,5632
110,-20,40,1171,1178,2349,5280
70,80,-30,1172,1177,2349,5470
-80,0,80,1164,1186,2350,5246
110,-40,-160,1171,1180,2351,5208
130,60,-80,1195,1156,2351,5336
110,-80,160,1182,1169,2351,5430
150,-20,-150,1176,1176,2352,5554
50,60,-140,1186,1166,2352,5622
100,-10,10,1148,1204,2352,5282
-120,-50,-60,1209,1143,2352,5405
120,0,-100,1171,1182,2353,5262
90,60,-10,1175,1178,2353,5168
-110,-30,-20,1189,1164,2353,5196
180,40,-150,1180,1174,2354,5563
90,70,-30,1173,1181,2354,5204
-180,40,-150,1180,1174,2354,5563
-110,70,10,1163,1191,2354,5294
-20,80,50,1181,1173,2354,5502
-140,-40,-120,1183,1172,2355,5585
-130,-20,-130,1167,1189,2356,5339
10,-10,-80,1175,1181,2356,5525
-100,-20,80,1149,1207,2356,5087
-110,20,170,1214,1142,2356,5360
-150,-40,-130,1200,1157,2357,5371
90,-40,170,1164,1193,2357,5414
20,-70,80,1185,1172,2357,5430
40,-70,100,1184,1173,2357,5622
130,70,-80,1197,1161,2358,5378
170,70,-140,1187,1171,2358,5533
110,50,-40,1180,1178,2358,5282
100,60,-30,1176,1182,2358,5270
60,30,-160,1180,1179,2359,5118
-60,0,-110,1188,1171,2359,5323
100,40,-10,1161,1198,2359,5269
60,10,-100,1166,1193,2359,5198
-140,10,40,1188,1172,2360,5011
50,-30,160,1187,1173,2360,5167
-40,-60,30,1205,1156,2361,5510
-80,10,-100,1198,1163,2361,5394
-80,10,90,1174,1188,2362,5536
100,0,-100,1167,1196,2363,5460
150,-50,-170,1187,1176,2363,5670
90,30,130,1178,1185,2363,5104
-170,20,-160,1178,1185,2363,5621
-60,50,80,1191,1172,2363,5486
-60,-50,20,1196,1167,2363,5344
120,80,-80,1195,1169,2364,5567
30,10,110,1178,1186,2364,5115
20,40,50,1178,1186,2364,5467
-70,-20,-150,1179,1185,2364,5335
50,-40,120,1179,1187,2366,5383
-10,-10,-90,1183,1183,2366,5482
120,-60,40,1181,1185,2366,5390
-40,0,50,1182,1184,2366,5427
150,40,-110,1171,1195,2366,5210
60,20,-120,1186,1180,2366,5374
70,-50,-20,1151,1216,2367,5436
110,-50,30,1178,1189,2367,5453
20,-20,90,1195,1172,2367,5518
170,30,-140,1178,1190,2368,5507
-90,10,130,1200,1168,2368,5553
40,-10,130,1168,1200,2368,5346
-150,80,50,1176,1192,2368,5383
160,50,-120,1169,1199,2368,5336
-50,50,-50,1196,1173,2369,5537
-170,0,-150,1185,1184,2369,5384
70,-40,140,1174,1195,2369,5401
100,30,120,1184,1185,2369,5161
-60,-10,50,1201,1168,2369,5376
60,80,-20,1181,1189,2370,5570
80,-10,-60,1168,1202,2370,5142
-80,-20,50,1193,1177,2370,5481
-140,0,-150,1213,1157,2370,5692
40,-20,120,1176,1195,2371,5453
90,-10,-20,1187,1184,2371,5542
-170,10,-150,1191,1180,2371,5507
-160,20,-160,1192,1179,2371,5444
-110,10,-170,1203,1168,2371,5646
-90,20,130,1203,1168,2371,5467
-170,40,-160,1192,1180,2372,5575
-160,10,60,1189,1183,2372,5289
-40,0,-100,1182,1190,2372,5449
-70,40,-40,1179,1193,2372,5543
50,30,100,1167,1205,2372,4992
160,-30,-160,1186,1187,2373,5530
160,60,-120,1194,1179,2373,5570
20,30,80,1179,1194,2373,5375
-90,0,140,1212,1162,2374,5377
110,70,-50,1204,1170,2374,5356
140,50,-90,1203,1171,2374,5425
0,-70,-90,1188,1186,2374,5392
110,20,-60,1141,1233,2374,5258
120,-40,-170,1205,1169,2374,5666
30,-20,-70,1186,1191,2377,5495
10,-50,-80,1155,1223,2378,5333
-90,-60,-20,1223,1156,2379,5343
-110,-30,130,1162,1217,2379,5283
-100,70,0,1192,1187,2379,5415
-10,30,50,1230,1149,2379,5545
-160,40,-170,1197,1182,2379,5481
-180,80,-150,1194,1186,2380,5703
120,-80,170,1204,1176,2380,5580
60,20,-140,1179,1201,2380,5294
180,80,-150,1194,1186,2380,5703
30,-50,-60,1168,1212,2380,5540
40,10,-90,1196,1185,2381,5339
160,10,-130,1209,1173,2382,5433
-30,-50,40,1218,1164,2382,5422
140,-20,-140,1172,1210,2382,5406
50,70,0,1181,1202,2383,5503
100,-40,-160,1187,1196,2383,5159
-140,80,40,1191,1193,2384,5395
100,-30,10,1187,1197,2384,5362
60,50,50,1218,1166,2384,5171
160,20,-130,1202,1183,2385,5559
150,70,-110,1203,1182,2385,5548
-40,30,60,1214,1171,2385,5523
60,50,40,1205,1180,2385,5342
-150,30,-170,1206,1179,2385,5546
60,60,20,1192,1193,2385,5398
0,-10,60,1197,1189,2386,5638
70,10,-110,1165,1221,2386,5187
110,10,80,1201,1185,2386,5462
-130,20,-170,1211,1175,2386,5557
-110,-70,-50,1222,1164,2386,5466
160,-60,-160,1197,1190,2387,5551
50,80,-10,1189,1198,2387,5599
-100,0,-170,1195,1192,2387,5609
20,20,90,1204,1184,2388,5184
-100,0,-120,1203,1186,2389,5530
-80,40,100,1201,1188,2389,5464
10,50,40,1204,1185,2389,5638
40,0,-80,1181,1208,2389,5615
80,-40,150,1187,1203,2390,5494
110,60,-40,1199,1191,2390,5199
80,30,80,1213,1177,2390,5310
-90,20,120,1182,1208,2390,5623
-110,-50,150,1203,1187,2390,5547
130,0,-110,1196,1194,2390,5465
130,-20,70,1202,1188,2390,5621
-170,-20,-150,1205,1185,2390,5711
30,-20,110,1181,1210,2391,5477
-80,-20,-160,1192,1199,2391,5502
170,0,80,1223,1169,2392,5460
100,70,150,1212,1180,2392,5330
-30,80,60,1199,1194,2393,5646
-70,60,-30,1198,1196,2394,5693
180,-30,-150,1198,1196,2394,5563
-180,-30,-150,1198,1196,2394,5563
-180,70,-150,1194,1201,2395,5628
180,70,-150,1194,1201,2395,5628
-40,80,70,1200,1195,2395,5695
-70,20,80,1195,1201,2396,5552
-130,50,160,1213,1183,2396,5661
-70,-10,-140,1220,1176,2396,5522
100,50,-20,1184,1213,2397,5316
20,0,100,1197,1200,2397,5362
-80,-40,-170,1220,1178,2398,5482
110,70,140,1212,1186,2398,5330
110,-70,160,1199,1199,2398,5488
-10,-70,-100,1198,1201,2399,5284
10,-40,-80,1176,1223,2399,5452
40,50,70,1207,1192,2399,5202
90,-20,-130,1202,1198,2400,5217
120,-30,50,1190,1210,2400,5376
-10,70,-80,1204,1196,2400,5554
90,-20,-10,1203,1197,2400,5425
20,-50,-70,1168,1233,2401,5564
70,60,20,1205,1196,2401,5435
-150,10,50,1223,1178,2401,5242
-150,-70,120,1214,1187,2401,5356
140,40,-90,1206,1195,2401,5377
150,-70,70,1198,1203,2401,5728
-80,-30,30,1216,1185,2401,5518
110,30,-50,1170,1232,2402,5398
60,-70,-30,1182,1221,2403,5385
-90,-30,180,1172,1231,2403,5507
-90,-30,-180,1172,1231,2403,5507
-170,-30,90,1199,1204,2403,5259
-90,20,140,1226,1177,2403,5525
60,10,160,1188,1216,2404,5200
60,-40,130,1191,1213,2404,5570
-80,60,-20,1208,1196,2404,5675
90,0,-70,1194,1210,2404,5446
120,-40,180,1194,1211,2405,5777
-30,40,-70,1213,1192,2405,5530
120,-40,-180,1194,1211,2405,5777
-130,-40,-90,1205,1200,2405,5418
-140,50,170,1220,1186,2406,5676
-170,50,-160,1215,1191,2406,5647
10,40,-90,1196,1210,2406,5492
-130,40,170,1215,1192,2407,5628
-170,80,-160,1212,1195,2407,5822
90,80,-40,1195,1213,2408,5625
60,-40,160,1197,1211,2408,5452
170,10,-140,1215,1193,2408,5616
-120,50,150,1211,1197,2408,5729
-160,50,-170,1215,1193,2408,5728
100,80,-50,1201,1207,2408,5584
40,80,0,1195,1213,2408,5646
-90,30,110,1208,1201,2409,5627
-30,70,60,1220,1189,2409,5671
-110,-20,0,1187,1222,2409,5418
-120,10,10,1201,1208,2409,5478
-160,10,-150,1225,1185,2410,5661
40,20,110,1185,1225,2410,5156
130,40,110,1209,1201,2410,5507
-110,-20,-10,1201,1209,2410,5470
-110,-20,60,1206,1205,2411,5317
90,0,-80,1199,1212,2411,5471
180,60,-150,1215,1197,2412,5727
60,70,0,1201,1211,2412,5668
-180,60,-150,1215,1197,2412,5727
-160,-30,90,1222,1190,2412,5413
80,80,180,1204,1209,2413,5473
120,70,130,1222,1191,2413,5322
80,80,-180,1204,1209,2413,5473
70,70,-10,1200,1213,2413,5553
30,50,40,1199,1214,2413,5642
-120,30,170,1239,1174,2413,5701
130,-70,50,1197,1216,2413,5751
-150,20,-160,1221,1193,2414,5635
130,30,-80,1228,1186,2414,5575
-150,50,-180,1214,1200,2414,5663
-150,50,180,1214,1200,2414,5663
140,-10,80,1199,1215,2414,5493
-160,-30,-140,1203,1212,2415,5635
-130,80,30,1206,1209,2415,5437
130,-80,180,1216,1200,2416,5675
0,30,50,1205,1211,2416,5620
40,70,-130,1192,1224,2416,5626
130,-80,-180,1216,1200,2416,5675
-170,-10,-150,1229,1187,2416,5688
110,-60,160,1206,1210,2416,5665
-60,-20,40,1217,1199,2416,5551
170,-10,-150,1205,1212,2417,5745
80,-30,-150,1200,1217,2417,5256
100,70,-30,1213,1204,2417,5688
60,70,-160,1216,1202,2418,5604
-170,-50,-140,1235,1183,2418,5551
50,50,-140,1208,1210,2418,5615
-20,0,50,1239,1179,2418,5480
-120,-30,-50,1225,1194,2419,5500
80,60,10,1211,1208,2419,5386
20,20,-90,1211,1208,2419,5823
90,-10,-50,1200,1219,2419,5281
40,-20,130,1212,1207,2419,5611
10,-70,-80,1206,1213,2419,5402
40,-60,-50,1201,1218,2419,5424
100,20,30,1190,1229,2419,5231
30,-60,-60,1208,1212,2420,5471
-30,0,50,1224,1196,2420,5452
80,30,140,1209,1211,2420,5226
-110,30,160,1242,1179,2421,5542
140,-30,-150,1211,1210,2421,5500
150,0,-130,1203,1218,2421,5550
-100,10,180,1220,1201,2421,5628
-100,10,-180,1220,1201,2421,5628
60,60,30,1203,1218,2421,5444
-130,-30,100,1200,1222,2422,5443
10,-30,-80,1194,1229,2423,5570
-130,10,-160,1240,1183,2423,5732
-180,20,-140,1206,1218,2424,5528
60,30,100,1203,1221,2424,5236
-170,70,-160,1228,1196,2424,5858
180,20,-140,1206,1218,2424,5528
100,-20,10,1187,1237,2424,5367
50,-70,-40,1192,1232,2424,5397
-30,-80,30,1212,1213,2425,5592
80,-20,-30,1211,1214,2425,5637
-150,-80,-100,1229,1196,2425,5679
50,60,30,1203,1222,2425,5559
-110,20,180,1230,1196,2426,5593
180,-10,80,1208,1218,2426,5554
170,30,80,1210,1216,2426,5544
-180,-10,80,1208,1218,2426,5554
80,-20,-140,1191,1235,2426,5373
50,-60,-40,1200,1226,2426,5541
-110,20,-180,1230,1196,2426,5593
-50,80,80,1211,1216,2427,5698
120,80,-70,1208,1219,2427,5610
-30,60,60,1232,1195,2427,5657
20,60,30,1197,1230,2427,5716
-10,60,-80,1197,1230,2427,5417
30,50,60,1239,1188,2427,5586
-70,-40,20,1226,1202,2428,5501
130,80,-90,1222,1206,2428,5672
120,-40,-160,1198,1231,2429,5381
140,60,-90,1243,1186,2429,5586
120,-50,170,1205,1224,2429,5675
130,-30,-140,1210,1219,2429,5441
110,80,-60,1212,1217,2429,5576
-160,30,-160,1210,1219,2429,5671
-20,-80,40,1215,1215,2430,5614
20,-10,100,1229,1201,2430,5461
150,50,-100,1216,1214,2430,5487
-130,0,-150,1233,1197,2430,5804
100,30,10,1209,1222,2431,5165
80,80,-30,1220,1211,2431,5659
-10,40,-80,1247,1184,2431,5689
-50,-80,10,1213,1218,2431,5658
160,70,-120,1232,1199,2431,5691
-120,-10,-130,1210,1221,2431,5643
-60,-30,30,1226,1205,2431,5708
-150,-50,-120,1203,1229,2432,5530
-170,60,-160,1215,1217,2432,5930
-180,20,-150,1213,1219,2432,5816
180,20,-150,1213,1219,2432,5816
80,-40,160,1188,1244,2432,5764
110,0,60,1240,1192,2432,5483
-120,40,160,1239,1193,2432,5679
-60,-80,0,1221,1212,2433,5649
70,-40,160,1189,1244,2433,5714
-130,-10,-140,1220,1213,2433,5953
-110,40,150,1216,1217,2433,5799
140,-10,-130,1209,1224,2433,5582
130,-60,50,1225,1209,2434,5615
-100,20,160,1241,1193,2434,5599
0,60,40,1227,1208,2435,5587
-120,-30,110,1206,1229,2435,5435
140,-70,60,1212,1223,2435,5724
-120,-20,-60,1204,1231,2435,5501
50,10,130,1188,1247,2435,5227
-130,-60,-80,1241,1194,2435,5626
150,-20,80,1209,1226,2435,5562
40,-80,-50,1202,1233,2435,5413
-60,80,90,1210,1226,2436,5778
-90,30,-30,1233,1203,2436,5495
30,60,30,1213,1223,2436,5842
70,0,-90,1216,1220,2436,5317
70,-60,-20,1201,1235,2436,5598
30,-70,-60,1208,1228,2436,5465
-40,-80,20,1227,1209,2436,5638
70,-60,130,1220,1216,2436,5610
-100,30,150,1254,1183,2437,5642
-100,-20,130,1203,1234,2437,5428
-20,-10,50,1238,1199,2437,5445
60,-60,-30,1214,1223,2437,5574
90,70,-20,1225,1212,2437,5631
120,40,-60,1190,1247,2437,5458
-120,-60,-60,1244,1194,2438,5682
-60,20,70,1248,1190,2438,5714
0,-50,-90,1202,1236,2438,5351
80,-50,-10,1201,1237,2438,5621
40,-70,-50,1210,1229,2439,5440
170,40,80,1211,1228,2439,5301
20,50,-100,1192,1247,2439,5546
-120,80,20,1224,1215,2439,5508
120,-50,40,1204,1235,2439,5495
-90,70,-10,1208,1231,2439,5638
140,70,-90,1241,1199,2440,5465
30,80,10,1213,1227,2440,5696
170,-60,-150,1243,1197,2440,5678
-130,30,180,1241,1199,2440,5932
-70,-70,-160,1239,1201,2440,5359
-130,30,-180,1241,1199,2440,5932
10,70,30,1209,1231,2440,5541
-70,20,-80,1212,1228,2440,5256
-10,40,50,1245,1196,2441,5596
-80,30,100,1241,1200,2441,5683
10,10,70,1228,1214,2442,5602
80,-30,-20,1213,1229,2442,5586
80,70,-10,1218,1224,2442,5673
170,0,-140,1222,1220,2442,5553
40,-20,140,1212,1230,2442,5611
20,-70,-70,1220,1222,2442,5514
20,50,40,1207,1236,2443,5867
70,-40,-180,1219,1224,2443,5484
-80,-10,-150,1223,1220,2443,5510
70,-40,180,1219,1224,2443,5484
50,70,10,1232,1211,2443,5720
0,-40,-90,1203,1240,2443,5412
70,60,-180,1228,1216,2444,5581
50,60,40,1224,1220,2444,5481
-160,80,-170,1227,1217,2444,5858
-80,40,-30,1240,1204,2444,5579
140,-30,70,1233,1211,2444,5765
70,-70,-20,1207,1237,2444,5431
-120,-40,-50,1250,1194,2444,5471
70,60,180,1228,1216,2444,5581
130,-20,-130,1195,1250,2445,5564
-50,-40,30,1241,1204,2445,5705
-120,0,10,1229,1217,2446,5420
170,20,80,1238,1208,2446,5401
40,60,30,1226,1220,2446,5920
20,10,100,1224,1222,2446,5395
-160,70,-170,1238,1209,2447,6015
110,-10,-110,1214,1233,2447,5498
-70,-40,-160,1231,1216,2447,5700
50,40,-130,1210,1238,2448,5662
50,-70,110,1213,1235,2448,5769
-50,40,70,1243,1205,2448,5848
30,50,50,1213,1235,2448,5650
-100,20,-30,1226,1222,2448,5463
170,60,-130,1224,1224,2448,5718
-60,40,-50,1221,1227,2448,5618
140,-80,-170,1235,1213,2448,5700
-100,-60,-30,1255,1194,2449,5571
100,0,-50,1196,1253,2449,5350
50,-10,-70,1200,1249,2449,5848
-160,-80,-110,1239,1211,2450,5688
180,-40,-150,1227,1223,2450,5816
180,-10,-150,1231,1219,2450,5793
160,40,-120,1234,1216,2450,5620
-90,10,150,1259,1191,2450,5615
-180,-40,-150,1227,1223,2450,5816
-180,-10,-150,1231,1219,2450,5793
40,70,10,1218,1232,2450,5625
-170,20,-150,1234,1216,2450,5680
80,-60,-10,1219,1232,2451,5606
90,-50,0,1203,1248,2451,5530
90,60,0,1247,1205,2452,5344
10,-80,-80,1213,1239,2452,5438
30,-40,100,1231,1221,2452,5493
-150,10,-150,1257,1195,2452,5770
-120,20,10,1237,1215,2452,5598
-110,10,-70,1214,1238,2452,5427
-10,-80,50,1221,1231,2452,5665
140,-40,-170,1216,1236,2452,5971
30,-80,-60,1208,1245,2453,5429
0,-80,-90,1227,1226,2453,5547
140,-30,-160,1221,1233,2454,5769
-30,-60,40,1234,1220,2454,5634
-40,70,70,1243,1211,2454,5833
90,70,160,1250,1204,2454,5466
-50,-20,40,1231,1224,2455,5676
160,-50,-160,1237,1218,2455,5889
-90,-20,60,1243,1212,2455,5649
-20,-30,50,1249,1207,2456,5561
70,40,70,1241,1215,2456,5327
0,-60,-90,1218,1239,2457,5413
150,-80,-160,1245,1212,2457,5800
-160,60,-170,1223,1234,2457,5939
30,50,70,1244,1213,2457,5319
-100,-40,160,1225,1232,2457,5637
70,50,30,1237,1220,2457,5508
130,80,-80,1226,1232,2458,5633
-20,-40,50,1234,1224,2458,5539
0,-80,60,1221,1238,2459,5714
180,-40,90,1227,1232,2459,5638
60,-10,-70,1219,1240,2459,5724
20,-80,-70,1207,1252,2459,5457
-180,-40,90,1227,1232,2459,5638
160,-20,-150,1214,1245,2459,5933
70,80,-20,1224,1235,2459,5703
50,-10,150,1226,1234,2460,5472
-70,-80,-10,1231,1229,2460,5742
-60,60,-40,1244,1216,2460,5714
120,-40,-150,1229,1232,2461,5355
50,-80,-40,1215,1246,2461,5447
-50,-30,-130,1212,1249,2461,5462
10,-20,-80,1242,1220,2462,5812
130,60,-70,1238,1224,2462,5525
-110,30,0,1231,1231,2462,5662
-100,-20,120,1218,1244,2462,5581
-100,40,130,1234,1228,2462,5831
-90,-10,110,1232,1230,2462,5411
60,10,180,1231,1231,2462,5355
60,10,-180,1231,1231,2462,5355
60,-80,-30,1211,1252,2463,5480
-90,30,130,1265,1198,2463,5831
130,50,-70,1231,1232,2463,5354
-140,-70,-90,1242,1221,2463,5866
170,20,-130,1236,1227,2463,5527
70,80,-170,1224,1240,2464,5684
70,30,160,1249,1215,2464,5284
50,-30,130,1216,1248,2464,5758
110,-40,30,1225,1239,2464,5736
-60,-60,-150,1264,1201,2465,5447
90,-10,-30,1212,1253,2465,5759
50,-30,140,1239,1226,2465,5669
80,-40,-170,1222,1243,2465,5571
10,20,60,1238,1228,2466,5835
100,20,90,1225,1241,2466,5498
-80,30,-50,1223,1244,2467,5469
-70,-30,30,1216,1251,2467,5690
70,10,-120,1205,1262,2467,5489
-20,30,-80,1229,1238,2467,5588
10,-60,-80,1216,1252,2468,5573
-70,30,-60,1231,1237,2468,5542
60,50,60,1233,1235,2468,5178
-150,-60,-110,1252,1216,2468,5781
-110,-40,-20,1246,1222,2468,5647
110,40,-40,1214,1255,2469,5651
20,-80,80,1235,1234,2469,5769
-120,20,-170,1260,1209,2469,5706
140,80,-100,1237,1232,2469,5775
130,-40,-170,1233,1236,2469,5947
30,30,-100,1242,1228,2470,5454
50,50,70,1252,1218,2470,5197
90,40,20,1228,1242,2470,5413
60,70,10,1234,1236,2470,5687
-140,80,170,1246,1225,2471,5904
-30,10,-90,1237,1234,2471,5382
70,0,-140,1191,1280,2471,5263
60,20,-150,1222,1250,2472,5441
100,-10,0,1226,1246,2472,5569
-150,80,-180,1238,1234,2472,5855
-150,80,180,1238,1234,2472,5855
-130,-50,-80,1243,1229,2472,5618
-170,0,-140,1234,1239,2473,5711
-100,0,-130,1261,1212,2473,5780
80,-70,-10,1201,1272,2473,5550
-80,-10,70,1231,1242,2473,5756
10,-80,70,1228,1246,2474,5797
-100,-30,150,1252,1222,2474,5556
-80,-80,-20,1238,1236,2474,5788
-130,-30,-100,1248,1226,2474,5655
-90,-80,-30,1247,1228,2475,5852
-170,-80,-120,1239,1236,2475,5764
130,10,-90,1235,1240,2475,5413
170,50,-130,1241,1234,2475,5644
50,30,-120,1239,1237,2476,5688
-180,30,-140,1240,1236,2476,5839
-110,80,10,1225,1251,2476,5678
20,-30,90,1256,1220,2476,5790
160,50,-110,1234,1242,2476,5593
160,60,-110,1235,1241,2476,5574
-50,-10,50,1243,1233,2476,5730
180,30,-140,1240,1236,2476,5839
140,20,-100,1229,1247,2476,5478
130,70,120,1244,1233,2477,5488
150,60,-100,1258,1219,2477,5685
120,70,-60,1248,1229,2477,5603
160,-10,-140,1249,1228,2477,5715
30,50,-110,1246,1231,2477,5874
-120,0,-150,1252,1225,2477,5980
-20,-20,50,1261,1217,2478,5711
150,-60,70,1242,1236,2478,5760
100,-40,10,1244,1234,2478,5466
-110,50,140,1246,1232,2478,5920
-20,-70,-110,1238,1240,2478,5383
-150,-50,110,1248,1230,2478,5762
40,-80,100,1242,1237,2479,5793
120,50,-50,1235,1244,2479,5637
-10,-80,-100,1251,1228,2479,5629
-110,0,-150,1257,1222,2479,5966
-160,40,-160,1257,1223,2480,5858
150,40,-100,1243,1237,2480,5569
150,80,-110,1246,1234,2480,5841
-160,-50,-130,1269,1211,2480,5872
70,70,0,1240,1240,2480,5690
20,80,20,1238,1242,2480,5802
160,-80,-150,1256,1224,2480,5931
100,50,-10,1245,1235,2480,5560
40,50,-120,1240,1240,2480,5823
-130,80,160,1231,1249,2480,5912
100,60,-20,1247,1233,2480,5528
-160,20,-150,1262,1219,2481,5772
80,0,-120,1188,1293,2481,5578
20,-60,-70,1238,1243,2481,5572
150,30,-110,1227,1255,2482,5692
130,-10,-120,1239,1243,2482,5777
60,-40,170,1247,1235,2482,5486
50,70,20,1248,1234,2482,5720
-40,-30,-120,1265,1218,2483,5581
-150,-20,-140,1247,1236,2483,5902
-100,20,-40,1238,1246,2484,5315
-60,0,60,1262,1222,2484,5744
30,-80,90,1249,1235,2484,5798
40,0,130,1230,1254,2484,5432
-150,40,-170,1272,1213,2485,5854
130,0,80,1228,1257,2485,5554
-110,-40,140,1260,1225,2485,5656
-100,-20,90,1214,1271,2485,5519
160,60,90,1250,1236,2486,5385
-90,-30,40,1244,1242,2486,5690
-100,-80,-40,1253,1233,2486,5916
90,-10,-120,1224,1263,2487,5517
-120,80,150,1236,1251,2487,5927
170,-80,-140,1251,1236,2487,5931
120,-60,170,1241,1247,2488,5914
-70,80,100,1236,1252,2488,5895
-100,-30,40,1289,1200,2489,5580
110,70,-40,1256,1233,2489,5736
-120,-70,-60,1278,1211,2489,5765
-90,-50,0,1257,1232,2489,5550
10,0,80,1259,1231,2490,5784
-140,20,-160,1257,1233,2490,5882
160,-50,80,1234,1256,2490,5839
-120,-10,-120,1258,1232,2490,5845
-180,70,-140,1252,1239,2491,5854
180,70,-140,1252,1239,2491,5854
150,-30,-160,1243,1248,2491,5904
30,40,90,1226,1265,2491,5367
-20,-60,-110,1241,1250,2491,5626
90,30,60,1257,1234,2491,5391
140,0,-120,1246,1245,2491,5690
-70,40,90,1241,1251,2492,5795
-140,40,180,1266,1226,2492,5854
-140,40,-180,1266,1226,2492,5854
-90,-20,-180,1258,1234,2492,5862
170,50,80,1245,1247,2492,5403
170,70,-130,1269,1223,2492,5771
140,30,-90,1265,1227,2492,5514
-90,-20,180,1258,1234,2492,5862
40,-30,120,1250,1243,2493,5735
30,70,-120,1231,1262,2493,5817
-110,80,140,1243,1250,2493,5899
-170,-60,100,1271,1222,2493,5798
-110,10,-40,1243,1250,2493,5508
-100,0,-160,1258,1236,2494,5928
10,40,50,1243,1251,2494,5910
120,-70,170,1239,1256,2495,5752
90,-40,-160,1228,1268,2496,5529
100,0,-20,1276,1220,2496,5691
20,40,70,1254,1242,2496,5766
140,10,-110,1262,1235,2497,5623
20,40,60,1232,1265,2497,5778
-100,10,-100,1247,1250,2497,5583
100,20,80,1267,1231,2498,5641
170,60,-120,1242,1256,2498,5648
-120,-80,150,1276,1222,2498,5728
40,60,40,1237,1262,2499,5780
-150,70,180,1259,1240,2499,5978
-150,60,-180,1257,1242,2499,5990
-150,70,-180,1259,1240,2499,5978
-150,60,180,1257,1242,2499,5990
-100,40,140,1264,1236,2500,5908
160,-40,-160,1260,1240,2500,5896
-70,0,-130,1254,1246,2500,5644
80,40,60,1244,1256,2500,5556
60,10,140,1226,1275,2501,5510
-130,-10,40,1263,1238,2501,5475
-100,80,130,1245,1256,2501,5965
180,-80,-130,1257,1245,2502,5883
180,-60,-140,1266,1236,2502,5703
-180,-80,-130,1257,1245,2502,5883
50,0,140,1210,1292,2502,5556
-180,-60,-140,1266,1236,2502,5703
-10,-60,-100,1237,1266,2503,5567
40,70,20,1269,1234,2503,5866
60,80,-10,1254,1249,2503,5733
120,60,-50,1273,1230,2503,5640
130,-50,50,1262,1241,2503,5698
-80,80,110,1237,1266,2503,5970
-70,-20,50,1263,1241,2504,5771
70,50,40,1261,1243,2504,5397
150,10,-120,1248,1257,2505,5712
140,80,-90,1261,1244,2505,5689
-70,0,70,1281,1224,2505,5704
-110,10,-60,1255,1250,2505,5583
-90,80,120,1237,1269,2506,5950
-110,0,-100,1259,1247,2506,5732
160,80,-120,1259,1247,2506,5888
-110,10,-90,1253,1254,2507,5488
50,60,-150,1254,1253,2507,5969
-30,50,60,1295,1212,2507,5926
-130,-20,-120,1244,1263,2507,5959
20,-10,110,1252,1256,2508,5639
110,0,-90,1259,1249,2508,5611
-110,-80,160,1277,1231,2508,5789
20,40,80,1259,1249,2508,5541
10,80,30,1255,1253,2508,5841
40,20,-100,1241,1267,2508,5533
100,20,40,1245,1263,2508,5633
-110,-80,-50,1269,1239,2508,6020
-80,10,-110,1255,1254,2509,5856
-180,10,-140,1253,1257,2510,5723
-170,40,-150,1266,1244,2510,5900
180,10,-140,1253,1257,2510,5723
110,-40,-150,1246,1264,2510,5418
70,-10,-70,1242,1268,2510,5709
180,40,-140,1260,1251,2511,5813
-120,10,-160,1273,1238,2511,6045
-180,40,-140,1260,1251,2511,5813
40,-50,110,1254,1257,2511,5737
-110,-50,-30,1272,1239,2511,5706
110,50,130,1264,1248,2512,5560
90,80,-30,1279,1233,2512,5624
110,10,-70,1250,1262,2512,5869
-30,-70,-120,1247,1265,2512,5453
-170,30,-150,1258,1254,2512,5923
60,40,80,1256,1256,2512,5436
-140,60,170,1262,1251,2513,6006
-90,-10,-160,1240,1273,2513,5761
-90,0,150,1269,1244,2513,5699
60,0,-90,1264,1249,2513,5365
180,-20,-150,1292,1221,2513,5863
130,40,-70,1244,1269,2513,5596
-10,50,-80,1245,1268,2513,5785
70,80,-10,1280,1233,2513,5624
-180,-20,-150,1292,1221,2513,5863
0,70,-90,1248,1265,2513,5907
110,-20,-120,1262,1251,2513,5650
-100,80,0,1263,1250,2513,5882
80,30,90,1254,1260,2514,5609
170,40,-130,1246,1268,2514,5727
60,80,0,1283,1231,2514,5639
-90,30,120,1261,1253,2514,5921
60,-70,120,1255,1259,2514,5936
-70,-10,60,1269,1245,2514,5912
50,80,10,1290,1224,2514,5704
-60,-50,-150,1255,1260,2515,5523
130,-50,-180,1266,1250,2516,5958
-140,70,170,1271,1245,2516,6000
40,60,50,1268,1248,2516,5675
30,70,20,1254,1262,2516,5756
140,60,-80,1275,1241,2516,5576
130,-50,180,1266,1250,2516,5958
10,10,80,1259,1257,2516,5761
180,60,-140,1254,1263,2517,5862
-180,60,-140,1254,1263,2517,5862
100,50,140,1255,1262,2517,5610
-60,30,-70,1249,1268,2517,5581
-100,-50,-10,1290,1227,2517,5579
-160,-20,80,1274,1243,2517,5725
170,-20,-150,1263,1255,2518,5960
-90,-10,-170,1245,1273,2518,5888
-50,-50,30,1275,1244,2519,5832
-40,-10,-110,1282,1237,2519,5831
-90,30,140,1274,1245,2519,5820
-60,-70,10,1288,1231,2519,5831
90,40,30,1281,1238,2519,5558
100,30,20,1262,1257,2519,5465
-60,-10,-130,1283,1237,2520,5765
40,70,30,1275,1245,2520,5729
150,80,-100,1265,1255,2520,5695
-60,-70,-150,1289,1231,2520,5660
80,80,-20,1288,1232,2520,5627
50,-80,110,1265,1255,2520,5871
70,-40,150,1225,1295,2520,5901
160,30,-120,1253,1267,2520,5809
100,0,-90,1263,1257,2520,5635
-100,-80,170,1280,1240,2520,5848
-140,-40,-110,1246,1275,2521,5620
150,-20,-140,1248,1273,2521,5740
0,40,50,1252,1269,2521,6075
-130,-80,140,1287,1235,2522,5807
-90,10,-110,1267,1255,2522,5799
70,70,10,1278,1244,2522,5618
120,20,-70,1239,1284,2523,5760
-70,10,-100,1284,1239,2523,5798
-20,-80,-110,1274,1249,2523,5719
-180,0,-140,1278,1245,2523,5668
70,-80,-20,1236,1287,2523,5606
-150,-70,-100,1256,1267,2523,6014
100,0,-10,1280,1243,2523,5673
150,70,-100,1270,1253,2523,5788
-50,40,-60,1267,1256,2523,5954
180,0,-140,1278,1245,2523,5668
10,-20,80,1282,1242,2524,5820
-130,-40,-80,1283,1241,2524,5682
-140,30,-170,1273,1251,2524,6081
-20,-50,50,1270,1254,2524,5694
90,-50,150,1262,1263,2525,5715
20,-20,100,1275,1250,2525,5722
-80,20,100,1258,1268,2526,5908
30,-10,120,1265,1262,2527,5773
-90,-80,180,1281,1246,2527,5902
-90,-80,-180,1281,1246,2527,5902
50,80,0,1273,1254,2527,5834
80,50,20,1263,1264,2527,5659
-50,10,60,1278,1249,2527,5828
130,-30,60,1277,1251,2528,5706
-120,-20,70,1268,1260,2528,5628
160,70,-110,1273,1255,2528,5875
170,-10,80,1276,1252,2528,5812
-100,-20,100,1256,1273,2529,5565
100,0,-80,1244,1285,2529,5820
0,0,60,1260,1269,2529,5963
-80,0,90,1255,1275,2530,6203
90,-70,0,1244,1286,2530,5667
170,80,-130,1274,1256,2530,5901
140,70,110,1268,1262,2530,5575
-170,-60,-130,1279,1253,2532,5853
40,30,100,1273,1259,2532,5526
60,10,150,1253,1279,2532,5673
-90,-10,120,1264,1268,2532,5680
130,70,-70,1284,1248,2532,5748
140,70,-80,1287,1246,2533,5683
-60,40,80,1276,1257,2533,5871
-160,-70,110,1275,1258,2533,5717
20,60,40,1277,1257,2534,5995
170,10,-130,1254,1280,2534,5785
-80,-30,-170,1275,1259,2534,5794
-90,-40,10,1267,1267,2534,5962
-100,20,-50,1256,1278,2534,5569
10,-10,80,1278,1257,2535,5742
-100,20,170,1280,1255,2535,5890
80,0,-90,1244,1291,2535,5735
-110,10,-80,1259,1276,2535,5604
130,-40,-160,1278,1258,2536,5976
-50,-70,20,1282,1254,2536,5853
80,70,170,1288,1249,2537,5759
-180,50,-140,1290,1247,2537,5890
10,30,-90,1269,1268,2537,5985
150,-10,-130,1268,1269,2537,5813
-40,-70,30,1277,1260,2537,5838
180,50,-140,1290,1247,2537,5890
110,30,110,1273,1265,2538,5654
150,-30,-150,1251,1287,2538,5907
80,70,0,1286,1253,2539,5762
120,-10,-110,1271,1268,2539,5699
140,-60,60,1281,1258,2539,5861
-90,80,-10,1276,1263,2539,6002
70,30,100,1290,1250,2540,5811
-130,60,160,1287,1253,2540,6173
100,80,-40,1292,1248,2540,5772
20,30,90,1299,1241,2540,5556
-70,-70,0,1290,1250,2540,5796
-170,70,-150,1274,1266,2540,5957
-120,-10,-70,1277,1264,2541,5797
-90,40,-20,1277,1264,2541,5907
40,-30,130,1285,1256,2541,5912
90,-60,0,1253,1289,2542,5693
30,70,30,1286,1257,2543,5854
-160,-60,-120,1294,1249,2543,5916
40,60,-130,1278,1265,2543,5836
0,80,40,1284,1259,2543,5972
20,20,100,1270,1273,2543,5561
-160,0,-140,1281,1263,2544,5853
-130,70,160,1287,1257,2544,6058
-90,20,150,1285,1260,2545,5822
160,-10,80,1277,1269,2546,5784
50,10,-100,1276,1270,2546,5547
-80,70,-20,1254,1292,2546,5884
-50,60,-50,1283,1263,2546,5809
170,50,-120,1275,1271,2546,5643
-50,-10,-120,1310,1237,2547,5870
-80,-50,10,1296,1251,2547,5655
40,-30,150,1265,1282,2547,5636
50,-10,160,1263,1284,2547,5424
-80,-70,-10,1302,1245,2547,5815
-170,-40,-140,1274,1274,2548,5953
0,70,40,1263,1285,2548,5889
-90,40,120,1289,1259,2548,6047
40,80,20,1310,1239,2549,5774
-100,0,-150,1290,1259,2549,5944
140,-30,-140,1286,1263,2549,5703
170,70,-120,1288,1263,2551,5925
-140,10,-150,1313,1238,2551,6013
160,80,-110,1282,1270,2552,5766
-150,-30,90,1271,1281,2552,5813
-40,-70,-130,1289,1263,2552,5686
-90,20,-70,1298,1255,2553,5683
60,70,20,1285,1268,2553,5669
60,20,-130,1274,1279,2553,5780
160,-40,80,1290,1263,2553,6203
-140,-50,-100,1293,1261,2554,5942
60,0,-170,1285,1269,2554,5517
30,-30,110,1274,1280,2554,5848
140,-50,60,1309,1245,2554,6005
-80,-30,40,1285,1270,2555,6048
40,-10,140,1280,1275,2555,5611
10,20,70,1295,1260,2555,5922
-70,-80,-160,1292,1264,2556,5857
10,-30,80,1291,1265,2556,5882
-10,-50,60,1310,1246,2556,5786
-100,-50,160,1293,1263,2556,5722
-80,-80,-170,1305,1251,2556,5910
-40,50,-60,1280,1277,2557,6014
-110,-60,-40,1320,1237,2557,5908
-60,0,-120,1294,1263,2557,5792
100,60,-10,1302,1255,2557,5568
180,60,-130,1265,1292,2557,5853
130,-40,-150,1272,1285,2557,5809
-120,0,-70,1293,1264,2557,5858
70,-10,-150,1273,1284,2557,5572
-80,-60,0,1280,1277,2557,5719
-180,60,-130,1265,1292,2557,5853
90,-10,-60,1265,1293,2558,5583
30,30,100,1291,1267,2558,5457
110,20,90,1266,1292,2558,5763
60,80,-160,1279,1279,2558,5927
-50,70,80,1282,1276,2558,6020
150,-10,80,1278,1280,2558,5909
50,20,120,1265,1294,2559,5563
90,30,120,1272,1287,2559,5721
-140,-80,130,1301,1258,2559,5885
30,0,120,1274,1285,2559,5743
-170,10,-140,1284,1276,2560,6008
60,-80,120,1290,1270,2560,5915
-140,-10,-140,1295,1265,2560,6171
160,20,-120,1285,1275,2560,5760
-10,-50,-100,1254,1306,2560,5735
-110,10,-50,1273,1288,2561,5777
-40,60,70,1292,1269,2561,6102
-90,-10,130,1293,1268,2561,5893
120,-10,60,1322,1240,2562,5897
-70,-60,10,1295,1267,2562,5695
-30,40,60,1318,1244,2562,6086
20,-20,110,1263,1299,2562,5920
130,30,100,1297,1265,2562,5848
-170,50,-150,1286,1276,2562,6008
180,80,-140,1300,1262,2562,6090
-180,80,-140,1300,1262,2562,6090
-80,0,-140,1312,1251,2563,5902
-110,10,-30,1277,1286,2563,5652
-120,-10,-110,1291,1272,2563,5887
-30,-80,-120,1284,1279,2563,5794
30,-50,100,1280,1283,2563,5877
100,-10,-110,1266,1297,2563,5815
150,70,-90,1300,1264,2564,5733
-130,-30,-90,1288,1276,2564,5964
80,-60,140,1278,1286,2564,5914
90,0,-100,1282,1282,2564,5778
-100,10,-170,1296,1268,2564,6152
20,70,-110,1281,1284,2565,6009
-110,60,140,1320,1246,2566,6222
-10,50,50,1295,1271,2566,5972
170,30,-130,1286,1280,2566,5739
-40,-80,-130,1273,1293,2566,5877
90,0,-90,1282,1285,2567,5996
-160,-10,70,1297,1270,2567,5872
-40,-30,40,1294,1273,2567,5905
50,-50,120,1283,1284,2567,5854
-50,-70,-140,1299,1268,2567,5844
60,40,-170,1289,1279,2568,5630
100,-50,160,1292,1277,2569,6012
-50,-60,-140,1299,1270,2569,5700
-120,-80,-60,1292,1277,2569,6145
-90,-70,-20,1305,1264,2569,5954
70,-20,-50,1262,1307,2569,5976
-10,-40,60,1290,1279,2569,5889
80,-80,-10,1259,1311,2570,5753
20,-40,90,1308,1262,2570,5964
160,0,-130,1283,1287,2570,5873
-10,80,50,1290,1280,2570,6071
-70,10,80,1303,1267,2570,6008
-170,0,70,1288,1283,2571,5916
90,-20,-20,1290,1281,2571,5789
-120,-50,-50,1334,1237,2571,5741
-90,0,-140,1293,1278,2571,5822
0,-30,70,1303,1268,2571,6039
130,0,-100,1265,1307,2572,5587
-60,-80,-150,1300,1272,2572,5904
-120,70,150,1305,1267,2572,6211
110,80,-50,1307,1265,2572,5903
60,-40,140,1261,1311,2572,6040
-120,0,-60,1293,1279,2572,5799
30,-20,120,1276,1296,2572,5875
60,-40,150,1280,1292,2572,5941
-160,50,-160,1289,1284,2573,6161
40,-20,150,1287,1286,2573,5674
-100,50,130,1296,1277,2573,6195
-110,40,160,1319,1254,2573,6130
-120,50,160,1304,1269,2573,6132
-40,-10,50,1282,1291,2573,6058
170,-10,-140,1277,1296,2573,5963
20,50,70,1304,1270,2574,5926
30,50,80,1273,1301,2574,5771
-30,-70,40,1303,1271,2574,5806
-30,-60,-120,1297,1278,2575,5707
40,80,10,1289,1286,2575,5964
70,-30,-160,1277,1299,2576,5540
-10,-60,60,1326,1250,2576,6040
100,0,-70,1259,1317,2576,5916
-80,0,100,1273,1303,2576,6140
50,20,-110,1309,1267,2576,5850
130,-70,-180,1276,1301,2577,5975
70,40,170,1276,1301,2577,5678
100,40,130,1297,1280,2577,5842
130,-70,180,1276,1301,2577,5975
110,20,-20,1302,1276,2578,5821
-90,-60,-10,1287,1291,2578,5711
150,80,-90,1310,1268,2578,5825
90,-30,-10,1261,1317,2578,6054
-80,10,100,1273,1305,2578,6082
140,-40,-160,1305,1273,2578,6177
110,20,-50,1243,1335,2578,5909
160,-90,-140,1286,1293,2579,6182
110,-90,170,1286,1293,2579,6182
130,-90,-170,1286,1293,2579,6182
10,-90,70,1286,1293,2579,6182
-130,-90,-70,1286,1293,2579,6182
170,-90,-130,1286,1293,2579,6182
-30,-90,30,1286,1293,2579,6182
70,-90,130,1286,1293,2579,6182
0,-90,60,1286,1293,2579,6182
120,-90,-180,1286,1293,2579,6182
180,-90,-120,1286,1293,2579,6182
-40,20,60,1298,1281,2579,6088
100,-90,160,1286,1293,2579,6182
-10,-90,50,1286,1293,2579,6182
20,-90,80,1286,1293,2579,6182
-70,-90,-10,1286,1293,2579,6182
-160,-90,-100,1286,1293,2579,6182
40,-90,100,1286,1293,2579,6182
90,-90,150,1286,1293,2579,6182
-170,-90,-110,1286,1293,2579,6182
-140,-90,-80,1286,1293,2579,6182
-180,-90,-120,1286,1293,2579,6182
120,-90,180,1286,1293,2579,6182
140,-90,-160,1286,1293,2579,6182
-50,-90,10,1286,1293,2579,6182
-60,-90,0,1286,1293,2579,6182
-40,-90,20,1286,1293,2579,6182
-90,-90,-30,1286,1293,2579,6182
50,-90,110,1286,1293,2579,6182
-150,-90,-90,1286,1293,2579,6182
80,-90,140,1286,1293,2579,6182
-20,-90,40,1286,1293,2579,6182
-120,-90,-60,1286,1293,2579,6182
-80,-90,-20,1286,1293,2579,6182
30,-90,90,1286,1293,2579,6182
-100,-90,-40,1286,1293,2579,6182
-110,-90,-50,1286,1293,2579,6182
60,-90,120,1286,1293,2579,6182
150,-90,-150,1286,1293,2579,6182
-180,90,-130,1301,1279,2580,5848
-130,90,-180,1301,1279,2580,5848
80,90,-30,1301,1279,2580,5848
-170,90,-140,1301,1279,2580,5848
-10,90,60,1301,1279,2580,5848
-90,90,140,1301,1279,2580,5848
40,90,10,1301,1279,2580,5848
150,90,-100,1301,1279,2580,5848
0,90,50,1301,1279,2580,5848
170,90,-120,1301,1279,2580,5848
-110,90,160,1301,1279,2580,5848
180,90,-130,1301,1279,2580,5848
-40,90,90,1301,1279,2580,5848
130,90,-80,1301,1279,2580,5848
160,90,-110,1301,1279,2580,5848
-60,90,110,1301,1279,2580,5848
100,90,-50,1301,1279,2580,5848
110,90,-60,1301,1279,2580,5848
-100,90,150,1301,1279,2580,5848
90,90,-40,1301,1279,2580,5848
20,90,30,1301,1279,2580,5848
-140,90,-170,1301,1279,2580,5848
-30,90,80,1301,1279,2580,5848
50,90,0,1301,1279,2580,5848
10,90,40,1301,1279,2580,5848
-20,90,70,1301,1279,2580,5848
110,-10,40,1266,1314,2580,5719
70,90,-20,1301,1279,2580,5848
-120,90,170,1301,1279,2580,5848
60,90,-10,1301,1279,2580,5848
-10,-40,-100,1275,1305,2580,5714
10,70,-100,1266,1314,2580,6171
-130,90,180,1301,1279,2580,5848
-80,90,130,1301,1279,2580,5848
-160,90,-150,1301,1279,2580,5848
20,0,110,1297,1283,2580,5665
140,90,-90,1301,1279,2580,5848
-50,90,100,1301,1279,2580,5848
-150,90,-160,1301,1279,2580,5848
120,90,-70,1301,1279,2580,5848
-70,90,120,1301,1279,2580,5848
30,90,20,1301,1279,2580,5848
-120,-10,-90,1284,1297,2581,5870
130,-60,180,1287,1294,2581,6128
170,-30,-150,1306,1275,2581,6071
130,-60,-180,1287,1294,2581,6128
20,70,40,1331,1250,2581,5912
70,-70,130,1296,1285,2581,6049
-40,-60,-130,1309,1273,2582,5793
-20,-60,50,1295,1287,2582,5860
-120,-20,-50,1294,1288,2582,5668
-130,50,170,1309,1273,2582,6017
10,60,40,1290,1292,2582,6112
-120,-60,140,1301,1281,2582,5901
120,10,-80,1303,1279,2582,6016
30,80,30,1329,1253,2582,5832
-30,30,-80,1279,1303,2582,5661
20,-10,-80,1290,1292,2582,5925
160,0,80,1297,1285,2582,5878
40,-30,140,1297,1286,2583,5868
170,-50,-150,1302,1281,2583,6137
110,-30,30,1303,1280,2583,5913
-130,20,-160,1310,1273,2583,6230
-60,70,90,1289,1294,2583,6126
120,80,-60,1305,1279,2584,5960
60,20,170,1296,1288,2584,5500
70,50,50,1301,1283,2584,5562
-60,-20,-140,1307,1278,2585,6000
-30,-10,50,1314,1271,2585,5958
-120,60,150,1316,1269,2585,6291
-130,-60,130,1302,1283,2585,6054
20,50,60,1284,1301,2585,5983
40,40,90,1270,1316,2586,5620
100,-40,-150,1267,1319,2586,5820
80,-40,-160,1281,1305,2586,5750
90,-80,0,1271,1315,2586,5968
160,80,-100,1316,1270,2586,5833
40,90,0,1290,1297,2587,6113
160,90,-120,1290,1297,2587,6113
-70,30,90,1299,1288,2587,6017
-50,30,70,1313,1274,2587,5942
70,90,-30,1290,1297,2587,6113
-150,90,-170,1290,1297,2587,6113
30,-30,120,1297,1290,2587,5971
-120,90,160,1290,1297,2587,6113
-130,90,170,1290,1297,2587,6113
-50,90,90,1290,1297,2587,6113
-110,90,150,1290,1297,2587,6113
-40,90,80,1290,1297,2587,6113
180,90,-140,1290,1297,2587,6113
110,90,-70,1290,1297,2587,6113
-30,90,70,1290,1297,2587,6113
-170,90,-150,1290,1297,2587,6113
-90,90,130,1290,1297,2587,6113
-140,90,-180,1290,1297,2587,6113
-180,90,-140,1290,1297,2587,6113
100,90,-60,1290,1297,2587,6113
10,90,30,1290,1297,2587,6113
170,90,-130,1290,1297,2587,6113
-140,90,180,1290,1297,2587,6113
-20,90,60,1290,1297,2587,6113
-70,90,110,1290,1297,2587,6113
130,90,-90,1290,1297,2587,6113
30,10,-90,1258,1329,2587,5954
-160,90,-160,1290,1297,2587,6113
0,90,40,1290,1297,2587,6113
30,90,10,1290,1297,2587,6113
50,-40,160,1291,1296,2587,5776
-60,90,100,1290,1297,2587,6113
60,90,-20,1290,1297,2587,6113
140,90,-100,1290,1297,2587,6113
-100,90,140,1290,1297,2587,6113
20,90,20,1290,1297,2587,6113
-10,90,50,1290,1297,2587,6113
90,90,-50,1290,1297,2587,6113
120,90,-80,1290,1297,2587,6113
150,90,-110,1290,1297,2587,6113
80,90,-40,1290,1297,2587,6113
50,90,-10,1290,1297,2587,6113
-80,90,120,1290,1297,2587,6113
90,-50,180,1282,1306,2588,5999
-160,70,-160,1296,1292,2588,6174
90,-50,-180,1282,1306,2588,5999
60,-40,-40,1282,1307,2589,5982
60,-10,-170,1288,1301,2589,5636
90,-10,-40,1289,1300,2589,5926
-10,60,50,1305,1284,2589,6044
-120,-20,30,1326,1263,2589,5680
30,60,40,1297,1292,2589,6031
40,40,-120,1281,1308,2589,5952
170,80,-110,1323,1266,2589,5817
150,-40,-160,1295,1294,2589,6015
100,-70,10,1300,1290,2590,5749
-170,80,-150,1307,1283,2590,6148
60,50,-170,1305,1285,2590,5870
120,50,120,1315,1275,2590,5748
10,30,60,1274,1317,2591,6244
90,70,-10,1307,1284,2591,5820
30,-20,130,1295,1297,2592,5953
160,-30,80,1298,1294,2592,5955
-150,-10,-140,1327,1265,2592,6206
180,70,-130,1307,1285,2592,5770
-180,70,-130,1307,1285,2592,5770
-100,20,-60,1312,1280,2592,5738
100,20,50,1294,1298,2592,5851
30,70,40,1314,1278,2592,5970
-110,20,-170,1309,1284,2593,6049
50,-30,170,1277,1316,2593,5853
50,-40,-50,1282,1311,2593,5873
30,80,20,1297,1296,2593,5977
-110,10,-20,1316,1278,2594,5918
-120,40,170,1325,1269,2594,6162
30,-30,-70,1292,1303,2595,6030
50,-20,170,1299,1297,2596,5549
100,0,-40,1275,1321,2596,5775
-100,70,130,1301,1295,2596,6354
-100,60,130,1319,1277,2596,6310
120,0,-90,1297,1300,2597,5821
110,10,70,1321,1276,2597,5738
-110,70,140,1311,1287,2598,6266
170,80,-120,1291,1307,2598,5940
-110,10,-160,1313,1285,2598,6170
-10,-30,60,1317,1281,2598,6053
90,50,150,1281,1317,2598,5816
50,70,-150,1300,1298,2598,6140
10,20,-90,1296,1303,2599,5966
-70,-30,40,1314,1285,2599,6107
-160,-10,-140,1319,1280,2599,5986
140,50,-80,1304,1295,2599,5801
-100,-40,0,1307,1292,2599,6125
100,-50,10,1304,1296,2600,5863
-160,10,-140,1308,1292,2600,6039
-160,-70,-110,1314,1286,2600,6061
140,80,-80,1308,1292,2600,5889
-150,0,-140,1328,1272,2600,6022
-130,-50,-70,1326,1274,2600,5938
160,-20,-140,1296,1305,2601,5860
10,20,80,1303,1298,2601,5946
140,-20,-130,1283,1318,2601,6127
120,70,-50,1316,1285,2601,5902
-120,-10,-80,1309,1293,2602,5985
-50,-80,-140,1308,1294,2602,6011
160,40,-110,1288,1314,2602,5883
170,-40,-150,1319,1283,2602,6064
0,-40,70,1317,1285,2602,5889
0,-30,-90,1274,1328,2602,5935
120,20,90,1293,1310,2603,5887
-120,-20,40,1335,1268,2603,5613
130,20,-80,1294,1309,2603,5872
-70,70,100,1290,1314,2604,6227
70,-80,130,1314,1290,2604,5994
-90,10,160,1335,1269,2604,6025
30,60,60,1318,1287,2605,5907
-160,80,-160,1317,1288,2605,6192
-100,0,-140,1326,1279,2605,5881
60,-20,-60,1286,1319,2605,6148
80,-50,180,1307,1299,2606,5949
-100,-20,110,1302,1304,2606,5851
80,-50,-180,1307,1299,2606,5949
-60,90,-40,1295,1312,2607,5999
-140,90,40,1295,1312,2607,5999
120,90,140,1295,1312,2607,5999
-20,-70,50,1318,1289,2607,5989
-40,90,-60,1295,1312,2607,5999
170,90,90,1295,1312,2607,5999
40,90,-140,1295,1312,2607,5999
-50,90,-50,1295,1312,2607,5999
-120,90,20,1295,1312,2607,5999
150,90,110,1295,1312,2607,5999
-30,90,-70,1295,1312,2607,5999
70,90,-170,1295,1312,2607,5999
0,90,-100,1295,1312,2607,5999
110,90,150,1295,1312,2607,5999
30,90,-130,1295,1312,2607,5999
60,90,-160,1295,1312,2607,5999
80,90,180,1295,1312,2607,5999
-10,90,-90,1295,1312,2607,5999
180,90,80,1295,1312,2607,5999
-130,90,30,1295,1312,2607,5999
-100,90,0,1295,1312,2607,5999
-80,90,-20,1295,1312,2607,5999
20,90,-120,1295,1312,2607,5999
90,90,170,1295,1312,2607,5999
10,-10,90,1307,1300,2607,6006
140,90,120,1295,1312,2607,5999
80,90,-180,1295,1312,2607,5999
-160,90,60,1295,1312,2607,5999
-180,90,80,1295,1312,2607,5999
-150,90,50,1295,1312,2607,5999
50,90,-150,1295,1312,2607,5999
130,90,130,1295,1312,2607,5999
100,90,160,1295,1312,2607,5999
-70,90,-30,1295,1312,2607,5999
-170,90,70,1295,1312,2607,5999
10,90,-110,1295,1312,2607,5999
-110,90,10,1295,1312,2607,5999
-20,90,-80,1295,1312,2607,5999
160,90,100,1295,1312,2607,5999
-90,90,-10,1295,1312,2607,5999
-30,-20,-110,1314,1294,2608,5812
-90,70,120,1309,1299,2608,6325
20,-20,120,1300,1308,2608,5791
-80,80,-20,1304,1304,2608,6134
-100,40,150,1323,1285,2608,6142
-170,20,-140,1296,1312,2608,5962
20,70,30,1301,1307,2608,5985
-170,60,-150,1306,1302,2608,5968
0,-20,70,1327,1282,2609,5891
40,50,80,1314,1295,2609,5446
-150,70,-170,1312,1297,2609,6336
-120,-40,-40,1328,1281,2609,5918
-130,-70,-70,1328,1281,2609,6019
-110,0,-120,1314,1296,2610,6038
-120,-10,-60,1321,1289,2610,5786
30,60,50,1307,1303,2610,5968
40,30,-110,1326,1285,2611,6041
120,-40,40,1282,1329,2611,6013
20,80,40,1335,1276,2611,5833
-60,-60,20,1332,1279,2611,5869
130,80,-70,1320,1291,2611,5995
-80,70,110,1302,1309,2611,6263
-170,-30,-140,1327,1284,2611,6108
-80,-40,20,1302,1310,2612,6016
-80,20,-80,1295,1317,2612,5854
150,-50,70,1304,1308,2612,6133
150,70,100,1312,1300,2612,5766
-140,-20,-130,1305,1308,2613,6152
110,20,-40,1295,1319,2614,6107
70,-40,-30,1294,1320,2614,5928
-150,50,-170,1332,1282,2614,6152
-170,30,-140,1316,1298,2614,5981
-110,-60,150,1302,1313,2615,5994
-140,50,-180,1331,1284,2615,6117
140,-50,-170,1302,1313,2615,6165
-140,50,180,1331,1284,2615,6117
-140,-30,-120,1306,1310,2616,6134
90,40,140,1314,1302,2616,5846
-130,-60,-70,1333,1283,2616,6034
-80,-10,80,1303,1313,2616,6036
-80,10,-120,1299,1317,2616,5954
-60,-20,50,1325,1291,2616,6039
110,50,-30,1295,1322,2617,5936
50,40,-140,1299,1318,2617,6077
90,40,40,1321,1296,2617,5857
0,-50,70,1324,1293,2617,5978
80,30,130,1316,1301,2617,5870
-50,60,80,1333,1285,2618,6279
-120,30,-180,1337,1281,2618,6272
110,0,50,1281,1337,2618,5732
-150,30,-160,1345,1273,2618,6054
-120,30,180,1337,1281,2618,6272
-160,-20,-140,1323,1295,2618,6121
10,-40,80,1312,1306,2618,6157
60,20,-180,1325,1294,2619,5782
60,20,180,1325,1294,2619,5782
0,10,60,1303,1316,2619,6135
100,-50,-170,1301,1318,2619,6043
-140,-60,-90,1350,1270,2620,6194
-170,60,-140,1301,1319,2620,6033
120,10,80,1301,1319,2620,5890
100,80,-30,1327,1294,2621,5973
80,80,-10,1332,1290,2622,6050
160,-30,-150,1304,1318,2622,6186
90,80,-20,1328,1294,2622,5983
-150,20,-150,1325,1297,2622,6077
-60,-40,-150,1307,1316,2623,5815
-170,-10,-140,1326,1297,2623,5984
140,20,90,1340,1283,2623,6103
-70,-50,20,1328,1295,2623,5902
0,-10,70,1324,1300,2624,5920
-130,-40,-70,1337,1287,2624,5965
-130,40,180,1336,1288,2624,6051
-130,40,-180,1336,1288,2624,6051
80,-10,-130,1297,1327,2624,5947
110,-50,170,1288,1337,2625,6090
130,-10,-110,1306,1319,2625,5767
20,-50,90,1326,1299,2625,6198
80,-50,170,1313,1312,2625,5980
20,80,30,1307,1319,2626,6080
-90,-20,70,1307,1319,2626,5983
180,-10,-140,1322,1304,2626,6126
50,70,30,1324,1302,2626,5843
150,0,80,1325,1301,2626,5987
-180,-10,-140,1322,1304,2626,6126
-170,-70,100,1316,1310,2626,5962
-170,70,-140,1310,1316,2626,5825
120,40,-50,1309,1318,2627,5772
-140,-30,90,1321,1306,2627,5905
100,40,0,1266,1362,2628,5785
140,-40,-150,1308,1320,2628,6092
-140,40,-170,1329,1299,2628,6070
-150,-80,120,1341,1287,2628,6049
-100,40,-10,1327,1301,2628,6136
120,30,-60,1285,1343,2628,6007
150,30,-100,1320,1309,2629,5926
80,-40,-20,1317,1312,2629,5870
-100,20,-180,1344,1285,2629,6143
-100,20,180,1344,1285,2629,6143
-90,10,-120,1329,1300,2629,6095
20,-30,100,1308,1322,2630,6023
-160,70,-150,1319,1311,2630,5899
110,-10,-100,1294,1337,2631,5885
-10,70,50,1315,1316,2631,6200
50,-40,150,1316,1315,2631,5922
-110,0,-110,1310,1322,2632,6018
-180,80,-130,1324,1308,2632,6035
-120,-10,-100,1312,1320,2632,5882
150,20,-110,1327,1305,2632,5789
-130,10,-150,1336,1296,2632,6279
-130,-20,70,1329,1303,2632,5822
140,40,100,1309,1323,2632,6104
-60,-40,30,1342,1290,2632,6076
60,20,-160,1305,1327,2632,5830
100,0,-30,1327,1305,2632,6172
180,80,-130,1324,1308,2632,6035
-180,30,-130,1309,1324,2633,6040
40,-40,120,1322,1311,2633,6149
180,30,-130,1309,1324,2633,6040
-180,20,-130,1314,1319,2633,5792
180,20,-130,1314,1319,2633,5792
-100,-70,-30,1335,1298,2633,6005
-150,-30,-130,1317,1317,2634,5974
150,60,-90,1308,1326,2634,5943
80,-70,140,1325,1309,2634,6173
-90,40,130,1337,1298,2635,6202
-150,-40,100,1330,1305,2635,5935
120,0,70,1319,1316,2635,6077
180,80,-120,1344,1292,2636,5755
-70,10,-110,1339,1297,2636,5988
-180,80,-120,1344,1292,2636,5755
60,-50,130,1324,1312,2636,6150
-160,60,-160,1337,1299,2636,6235
-60,10,70,1340,1296,2636,6235
60,10,-170,1297,1339,2636,6005
140,-70,-170,1303,1333,2636,6121
60,80,10,1343,1294,2637,6099
-110,50,150,1323,1314,2637,6465
-150,80,-170,1324,1313,2637,6239
-110,30,170,1354,1284,2638,6243
120,-20,50,1328,1310,2638,5980
-70,-30,-160,1330,1308,2638,6092
-90,0,160,1336,1302,2638,6013
-20,80,60,1316,1322,2638,6206
-130,-10,-130,1333,1305,2638,6219
-90,50,120,1334,1304,2638,6424
60,20,160,1307,1331,2638,5658
110,30,-40,1290,1348,2638,6142
10,30,70,1317,1322,2639,6264
50,-40,130,1309,1330,2639,6215
-120,-20,60,1329,1311,2640,5800
140,0,-110,1322,1318,2640,5987
30,-30,130,1332,1309,2641,5969
-170,80,-140,1329,1312,2641,6083
-110,-30,-10,1330,1311,2641,5943
-170,-20,80,1303,1339,2642,6129
-140,70,180,1311,1331,2642,6418
70,80,0,1342,1300,2642,6088
-140,70,-180,1311,1331,2642,6418
-110,-30,20,1306,1336,2642,5973
10,-20,90,1326,1316,2642,6181
160,10,80,1353,1289,2642,6050
-10,-20,60,1333,1309,2642,6116
70,-40,-170,1315,1328,2643,5873
160,10,-120,1343,1300,2643,6014
-100,-60,-20,1331,1312,2643,6100
70,-30,-40,1309,1334,2643,6102
20,40,90,1322,1323,2645,5890
80,30,100,1304,1341,2645,5942
10,80,50,1360,1285,2645,5994
-130,-20,-110,1315,1330,2645,6035
110,-30,-130,1302,1344,2646,5923
-120,0,-140,1332,1314,2646,6301
180,50,-130,1335,1311,2646,5969
-130,-80,-70,1336,1310,2646,6256
-180,50,-130,1335,1311,2646,5969
110,-50,-160,1326,1321,2647,6033
60,-20,-170,1320,1327,2647,5678
-90,-10,150,1334,1314,2648,5930
40,-40,-60,1310,1338,2648,5976
-100,30,160,1344,1305,2649,6052
140,20,-90,1347,1302,2649,5936
0,-20,-90,1331,1318,2649,6113
90,-50,-170,1328,1321,2649,6008
110,60,-30,1302,1347,2649,6021
-110,-30,30,1328,1321,2649,5913
-60,30,80,1343,1306,2649,6264
50,80,-150,1326,1324,2650,6135
80,-80,140,1338,1313,2651,6208
80,50,30,1326,1325,2651,5850
140,40,-80,1346,1305,2651,5907
100,-80,10,1304,1347,2651,6142
10,40,60,1315,1336,2651,6405
130,-40,50,1343,1308,2651,6113
160,70,-100,1341,1310,2651,6006
-40,-50,40,1352,1300,2652,6186
-120,30,10,1343,1309,2652,6187
70,-50,140,1331,1321,2652,6206
110,10,-60,1301,1351,2652,6138
-140,-60,120,1328,1324,2652,6323
0,60,-90,1304,1348,2652,6040
-130,-30,-80,1343,1310,2653,6101
150,-30,-140,1338,1315,2653,6020
-90,60,120,1345,1308,2653,6383
90,-60,150,1312,1341,2653,6179
100,-50,-180,1315,1339,2654,6181
-90,-10,180,1332,1322,2654,6254
-90,-10,-180,1332,1322,2654,6254
10,60,50,1352,1302,2654,6077
-140,80,180,1334,1320,2654,6297
-70,80,-30,1330,1324,2654,6227
80,50,160,1323,1331,2654,6013
-140,80,-180,1334,1320,2654,6297
100,-50,180,1315,1339,2654,6181
-70,70,-30,1324,1330,2654,6175
-120,-30,-40,1353,1302,2655,5825
60,10,-110,1333,1322,2655,5999
110,-70,20,1328,1328,2656,6007
-170,80,-130,1358,1298,2656,5791
-30,30,60,1335,1321,2656,6201
110,-50,-170,1318,1338,2656,6302
20,50,80,1311,1345,2656,5869
70,30,150,1335,1322,2657,5611
0,50,50,1344,1313,2657,6266
110,80,-40,1342,1315,2657,6029
100,-20,-120,1358,1299,2657,5912
20,50,50,1327,1330,2657,6169
-150,10,-140,1354,1303,2657,6205
-130,30,-170,1345,1312,2657,6323
150,-50,-160,1346,1312,2658,6188
20,70,50,1343,1315,2658,6171
-170,-70,-120,1335,1323,2658,6135
150,-70,-160,1332,1326,2658,6200
-170,-20,-140,1343,1315,2658,6198
10,70,50,1367,1291,2658,6006
-110,0,-140,1346,1312,2658,6191
-30,-20,50,1344,1315,2659,6129
140,-40,60,1345,1316,2661,6206
10,0,90,1322,1339,2661,6035
-110,0,-130,1340,1321,2661,6248
30,20,110,1325,1336,2661,5673
-160,30,-150,1328,1333,2661,6109
-30,80,70,1316,1346,2662,6321
180,-20,-140,1342,1320,2662,6223
-180,-20,-140,1342,1320,2662,6223
120,-20,-120,1333,1330,2663,6056
90,50,10,1321,1342,2663,6063
-120,-10,10,1346,1317,2663,6028
-10,-70,60,1332,1331,2663,6130
-130,80,170,1329,1334,2663,6342
140,-60,-170,1317,1346,2663,6365
180,-50,90,1357,1307,2664,6186
-180,-50,90,1357,1307,2664,6186
150,0,-120,1353,1311,2664,6111
10,30,80,1331,1334,2665,6144
-10,0,-90,1317,1348,2665,6050
-40,-40,40,1365,1300,2665,6248
-160,80,-140,1369,1296,2665,5852
-90,30,-40,1333,1333,2666,6024
70,30,110,1341,1325,2666,5847
-120,-60,-50,1367,1299,2666,6126
20,-10,120,1335,1332,2667,5907
-40,30,-80,1312,1355,2667,5761
60,20,-170,1317,1350,2667,5812
-80,0,110,1348,1319,2667,6226
50,80,20,1355,1312,2667,6140
130,30,-70,1320,1348,2668,5972
-120,-20,50,1359,1309,2668,5797
50,-40,140,1328,1340,2668,6202
-20,-10,-100,1336,1332,2668,6039
-70,20,90,1348,1321,2669,6299
10,80,40,1330,1339,2669,6246
110,40,-30,1287,1383,2670,6090
60,-40,180,1324,1346,2670,6048
60,-40,-180,1324,1346,2670,6048
160,-20,80,1307,1364,2671,6219
-150,40,-160,1363,1308,2671,6231
-110,-50,-20,1360,1311,2671,5940
-170,40,-140,1342,1329,2671,6263
-160,80,-150,1342,1329,2671,6141
110,-20,30,1318,1353,2671,6102
170,-20,-140,1317,1355,2672,6028
130,20,90,1327,1345,2672,6069
20,10,-90,1310,1362,2672,6257
90,-70,150,1341,1331,2672,6264
140,0,80,1324,1349,2673,6077
0,80,60,1364,1309,2673,6060
110,50,-20,1339,1334,2673,5989
20,-30,120,1349,1324,2673,5996
100,-10,-10,1338,1336,2674,6121
20,60,70,1368,1306,2674,6077
130,-10,70,1354,1321,2675,6264
120,-50,-170,1341,1334,2675,6104
180,-70,-130,1340,1336,2676,6246
-180,-70,-130,1340,1336,2676,6246
100,70,-20,1333,1343,2676,6180
60,20,130,1325,1352,2677,6005
0,-60,70,1341,1336,2677,6234
100,0,-60,1338,1339,2677,6072
80,-50,150,1347,1330,2677,6151
-150,70,-160,1347,1330,2677,6009
70,-50,170,1346,1332,2678,5891
-80,60,110,1341,1338,2679,6417
10,20,90,1350,1329,2679,5840
-80,40,110,1361,1318,2679,6372
-80,20,120,1373,1306,2679,6306
-80,30,110,1357,1322,2679,6405
40,-20,-70,1320,1359,2679,6160
170,60,80,1345,1335,2680,5934
0,20,60,1324,1356,2680,6366
-140,60,-180,1378,1302,2680,6365
-120,-10,-50,1350,1330,2680,6118
-140,60,180,1378,1302,2680,6365
170,0,-130,1349,1331,2680,5917
80,-20,-40,1332,1349,2681,6245
160,-40,-150,1354,1328,2682,6285
30,10,120,1356,1326,2682,6124
30,-10,130,1337,1345,2682,6023
-100,-60,160,1360,1322,2682,6082
0,20,-90,1329,1353,2682,5944
-150,60,-170,1355,1327,2682,6372
120,60,-40,1334,1349,2683,6151
130,-50,-170,1338,1345,2683,6359
-90,-10,140,1362,1321,2683,6008
110,0,-80,1356,1327,2683,6208
90,-90,0,1336,1348,2684,6151
-70,-90,-160,1336,1348,2684,6151
-60,-90,-150,1336,1348,2684,6151
-150,-90,120,1336,1348,2684,6151
10,-90,-80,1336,1348,2684,6151
-110,-90,160,1336,1348,2684,6151
130,-90,40,1336,1348,2684,6151
-20,-90,-110,1336,1348,2684,6151
-90,20,160,1369,1315,2684,6276
-80,20,110,1355,1329,2684,6478
100,-90,10,1336,1348,2684,6151
40,-90,-50,1336,1348,2684,6151
-180,-90,90,1336,1348,2684,6151
-130,-90,140,1336,1348,2684,6151
-50,-90,-140,1336,1348,2684,6151
-90,-90,180,1336,1348,2684,6151
120,-90,30,1336,1348,2684,6151
20,-90,-70,1336,1348,2684,6151
170,-90,80,1336,1348,2684,6151
110,-90,20,1336,1348,2684,6151
-80,-90,-170,1336,1348,2684,6151
60,-90,-30,1336,1348,2684,6151
-130,-30,-70,1356,1328,2684,6002
50,-90,-40,1336,1348,2684,6151
80,-90,-10,1336,1348,2684,6151
-90,-90,-180,1336,1348,2684,6151
-170,-90,100,1336,1348,2684,6151
-100,-90,170,1336,1348,2684,6151
30,-90,-60,1336,1348,2684,6151
160,-90,70,1336,1348,2684,6151
-160,-90,110,1336,1348,2684,6151
180,-90,90,1336,1348,2684,6151
-40,-90,-130,1336,1348,2684,6151
140,-90,50,1336,1348,2684,6151
150,-90,60,1336,1348,2684,6151
-120,-90,150,1336,1348,2684,6151
0,-90,-90,1336,1348,2684,6151
-140,-90,130,1336,1348,2684,6151
70,-90,-20,1336,1348,2684,6151
-30,-90,-120,1336,1348,2684,6151
-10,-90,-100,1336,1348,2684,6151
90,-40,-150,1330,1354,2684,6048
50,50,-150,1351,1334,2685,6133
90,-50,170,1314,1371,2685,6250
10,70,40,1333,1352,2685,6208
-140,70,-170,1365,1321,2686,6166
110,-50,180,1327,1359,2686,6230
160,-70,-150,1348,1338,2686,6311
110,-50,-180,1327,1359,2686,6230
-140,20,-150,1358,1328,2686,6382
10,-50,80,1361,1325,2686,6296
-160,-80,110,1385,1301,2686,6239
-100,50,140,1356,1330,2686,6436
50,40,90,1329,1357,2686,5793
40,70,40,1348,1339,2687,5972
-150,80,-150,1376,1311,2687,5949
90,-50,160,1340,1348,2688,6367
80,30,110,1340,1348,2688,6014
120,80,-50,1357,1332,2689,6175
100,30,110,1341,1348,2689,5897
-160,20,-140,1347,1342,2689,6154
-160,40,-150,1349,1341,2690,6344
110,40,-20,1308,1382,2690,6042
50,60,50,1359,1331,2690,6097
60,-30,-50,1315,1375,2690,6194
40,60,60,1368,1322,2690,6022
130,50,-60,1343,1348,2691,6253
-30,0,-100,1322,1369,2691,6247
-20,10,-90,1332,1359,2691,6090
90,30,110,1337,1354,2691,6132
80,0,-100,1323,1369,2692,6079
60,30,-170,1324,1368,2692,6092
10,-60,80,1364,1329,2693,6273
20,40,-100,1324,1369,2693,6115
-120,20,-160,1357,1336,2693,6408
-80,10,120,1372,1322,2694,6358
20,-30,110,1340,1354,2694,6246
100,-60,10,1325,1369,2694,5990
130,60,-60,1359,1335,2694,6068
-60,60,90,1339,1355,2694,6267
10,10,90,1355,1339,2694,5993
140,-10,-120,1355,1339,2694,6177
180,40,-130,1363,1332,2695,6225
-110,-70,-40,1392,1303,2695,6130
-180,40,-130,1363,1332,2695,6225
110,20,-30,1348,1347,2695,6176
30,-40,120,1345,1350,2695,6312
0,30,60,1345,1351,2696,6417
-40,50,70,1362,1334,2696,6502
-10,80,70,1373,1323,2696,6234
130,50,110,1378,1318,2696,5931
70,70,-180,1353,1343,2696,6186
70,70,180,1353,1343,2696,6186
-130,0,-140,1353,1344,2697,6468
-130,70,170,1347,1350,2697,6476
120,-50,-180,1340,1357,2697,6339
-50,-60,30,1357,1340,2697,6124
120,-50,180,1340,1357,2697,6339
-90,30,150,1377,1320,2697,6208
-140,0,-140,1368,1329,2697,6467
20,60,50,1348,1349,2697,6223
-50,80,100,1361,1336,2697,6256
-150,90,-150,1360,1338,2698,6240
-140,90,-160,1360,1338,2698,6240
180,90,-120,1360,1338,2698,6240
0,90,60,1360,1338,2698,6240
120,90,-60,1360,1338,2698,6240
40,80,30,1366,1332,2698,6235
150,90,-90,1360,1338,2698,6240
30,90,30,1360,1338,2698,6240
-50,90,110,1360,1338,2698,6240
50,90,10,1360,1338,2698,6240
-90,90,150,1360,1338,2698,6240
-170,90,-130,1360,1338,2698,6240
-70,90,130,1360,1338,2698,6240
-130,90,-170,1360,1338,2698,6240
-120,90,180,1360,1338,2698,6240
-60,90,120,1360,1338,2698,6240
90,90,-30,1360,1338,2698,6240
80,90,-20,1360,1338,2698,6240
110,90,-50,1360,1338,2698,6240
130,90,-70,1360,1338,2698,6240
10,90,50,1360,1338,2698,6240
100,90,-40,1360,1338,2698,6240
40,90,20,1360,1338,2698,6240
-110,90,170,1360,1338,2698,6240
-10,90,70,1360,1338,2698,6240
-80,90,140,1360,1338,2698,6240
-120,90,-180,1360,1338,2698,6240
170,90,-110,1360,1338,2698,6240
-20,90,80,1360,1338,2698,6240
-40,90,100,1360,1338,2698,6240
-30,90,90,1360,1338,2698,6240
160,90,-100,1360,1338,2698,6240
140,90,-80,1360,1338,2698,6240
160,70,90,1371,1327,2698,6006
20,90,40,1360,1338,2698,6240
-180,90,-120,1360,1338,2698,6240
10,50,50,1352,1346,2698,6342
-100,90,160,1360,1338,2698,6240
-90,-20,80,1341,1357,2698,5906
70,90,-10,1360,1338,2698,6240
-160,90,-140,1360,1338,2698,6240
60,90,0,1360,1338,2698,6240
110,30,-30,1317,1382,2699,6114
-50,-50,-140,1357,1342,2699,6098
80,0,-110,1331,1368,2699,5967
-60,-10,60,1362,1337,2699,6165
-80,-20,60,1366,1334,2700,6133
-50,0,60,1361,1339,2700,6327
40,-40,130,1374,1326,2700,6206
40,-60,110,1358,1343,2701,6313
-50,20,-90,1363,1338,2701,6159
-180,10,-130,1361,1340,2701,6029
180,10,-130,1361,1340,2701,6029
-150,80,-160,1349,1353,2702,6202
-30,80,80,1365,1337,2702,6347
140,10,-100,1353,1349,2702,6025
-160,0,60,1373,1330,2703,6088
0,0,70,1355,1348,2703,6331
-140,80,-170,1356,1348,2704,6223
-80,20,130,1384,1321,2705,6353
-120,10,-150,1361,1344,2705,6518
-90,20,-80,1346,1359,2705,6078
-40,80,80,1338,1367,2705,6497
-120,0,-80,1345,1361,2706,6101
-20,-50,-110,1349,1358,2707,5978
10,40,70,1347,1360,2707,6171
-90,0,-150,1376,1331,2707,6380
40,50,-130,1374,1333,2707,6339
160,-30,-140,1363,1344,2707,6179
-140,-20,70,1360,1347,2707,5942
130,-20,60,1363,1344,2707,6161
170,40,-120,1374,1334,2708,6049
-110,40,0,1369,1339,2708,6402
-70,50,100,1354,1354,2708,6493
-120,80,160,1352,1357,2709,6459
-90,10,-130,1371,1338,2709,6265
-70,60,100,1341,1369,2710,6295
130,70,-60,1373,1337,2710,6232
-60,80,-40,1360,1350,2710,6330
160,-10,-130,1353,1358,2711,6104
70,70,20,1359,1352,2711,5918
100,-50,-160,1343,1369,2712,6018
-90,-40,20,1361,1351,2712,6274
150,30,90,1372,1340,2712,6212
-130,60,170,1382,1330,2712,6644
-160,60,-150,1363,1349,2712,6277
100,-50,170,1347,1365,2712,6360
-100,10,-110,1376,1337,2713,6222
110,30,-20,1343,1370,2713,6172
-90,-50,170,1369,1344,2713,6160
170,-70,-140,1359,1354,2713,6378
-140,30,-160,1375,1338,2713,6339
80,-10,-70,1360,1353,2713,6027
-140,-80,-80,1363,1350,2713,6358
-50,80,90,1355,1359,2714,6557
-90,-10,160,1373,1341,2714,6286
-90,10,170,1374,1340,2714,6230
-80,80,130,1348,1366,2714,6145
0,80,50,1353,1361,2714,6316
-110,-30,120,1359,1355,2714,6142
-120,0,-50,1382,1333,2715,6124
120,-40,-140,1348,1367,2715,6188
-140,-70,-80,1388,1327,2715,6279
-40,80,90,1365,1350,2715,6339
-90,-20,170,1363,1352,2715,6374
40,80,-140,1337,1379,2716,6285
100,-20,0,1334,1382,2716,6208
-120,-20,-40,1354,1362,2716,6096
-130,80,180,1365,1351,2716,6211
-50,0,-110,1368,1348,2716,6436
-130,80,-180,1365,1351,2716,6211
-60,80,110,1366,1350,2716,6192
30,80,40,1377,1339,2716,6294
-30,-50,-120,1359,1358,2717,6060
-150,0,50,1371,1346,2717,5945
-70,80,120,1369,1348,2717,6196
-120,60,160,1375,1343,2718,6555
-30,20,60,1386,1332,2718,6597
30,-40,110,1355,1363,2718,6280
-110,80,150,1359,1359,2718,6478
-40,60,-60,1378,1341,2719,6291
-130,10,20,1355,1364,2719,6125
90,-80,150,1371,1348,2719,6356
-90,80,130,1353,1367,2720,6559
170,-20,80,1359,1361,2720,6183
180,-70,90,1369,1352,2721,6127
110,40,120,1383,1338,2721,6095
-90,80,140,1355,1366,2721,6229
-180,-50,-140,1389,1332,2721,6504
180,-50,-140,1389,1332,2721,6504
-90,-10,170,1353,1368,2721,6268
-180,-70,90,1369,1352,2721,6127
60,-10,-80,1384,1338,2722,6189
100,20,70,1361,1361,2722,6088
-160,-40,-130,1391,1331,2722,6407
170,-30,-140,1363,1359,2722,6286
-40,10,60,1390,1332,2722,6422
130,80,120,1391,1332,2723,6260
140,-50,-160,1350,1373,2723,6277
-110,20,-10,1383,1340,2723,6225
10,0,100,1384,1339,2723,5985
-80,30,120,1378,1345,2723,6409
-150,-10,60,1377,1346,2723,6009
-80,50,110,1366,1357,2723,6623
-80,10,110,1371,1353,2724,6404
-70,10,-120,1368,1356,2724,6335
-100,80,150,1346,1378,2724,6226
20,30,100,1374,1351,2725,5807
-130,20,20,1352,1373,2725,6142
-110,50,160,1390,1335,2725,6514
-20,70,60,1356,1369,2725,6438
120,-30,-130,1346,1380,2726,6095
170,70,-110,1373,1353,2726,6197
20,-60,90,1360,1367,2727,6412
-120,70,160,1367,1360,2727,6515
-120,80,170,1373,1354,2727,6199
160,30,-110,1375,1353,2728,6050
-130,80,-170,1384,1344,2728,6101
-90,0,170,1387,1341,2728,6275
-60,20,80,1389,1339,2728,6486
-20,80,70,1363,1365,2728,6357
-120,80,180,1383,1346,2729,6141
-120,80,-180,1383,1346,2729,6141
140,-20,70,1383,1346,2729,6445
-140,80,-160,1384,1345,2729,6030
20,-40,100,1362,1367,2729,6314
120,80,130,1388,1341,2729,6235
-180,40,70,1341,1389,2730,6000
0,60,60,1396,1334,2730,6331
50,0,-90,1372,1358,2730,6207
110,60,-20,1374,1356,2730,6052
60,60,40,1365,1365,2730,6178
100,-70,160,1356,1374,2730,6426
180,40,70,1341,1389,2730,6000
-90,40,140,1399,1331,2730,6234
10,40,80,1379,1352,2731,6237
-120,10,-70,1353,1378,2731,6127
-180,-60,90,1379,1352,2731,6426
-180,-30,-140,1387,1344,2731,6479
30,60,-120,1363,1368,2731,6349
180,-60,90,1379,1352,2731,6426
0,10,70,1373,1358,2731,6505
180,-30,-140,1387,1344,2731,6479
-170,-80,100,1406,1326,2732,6391
0,70,60,1406,1326,2732,6213
10,30,90,1357,1375,2732,6062
120,-50,-160,1355,1377,2732,6397
-100,80,140,1371,1362,2733,6516
150,50,-90,1372,1361,2733,6105
-110,80,160,1354,1379,2733,6212
30,70,50,1370,1363,2733,6132
110,80,140,1387,1347,2734,6311
-60,70,-40,1384,1350,2734,6332
-90,0,180,1394,1340,2734,6211
-90,0,-180,1394,1340,2734,6211
180,-20,80,1366,1369,2735,6260
-180,-20,80,1366,1369,2735,6260
110,-80,20,1359,1376,2735,6382
-60,10,-100,1386,1349,2735,6456
-80,10,130,1397,1338,2735,6328
10,50,70,1385,1350,2735,6175
-10,20,-90,1359,1376,2735,6268
150,-60,-160,1360,1376,2736,6499
-90,50,130,1369,1367,2736,6435
160,-50,-150,1374,1362,2736,6341
-120,0,-130,1386,1350,2736,6373
80,30,120,1361,1375,2736,6223
-120,0,-40,1380,1356,2736,6056
70,-10,-80,1380,1357,2737,6121
-50,-30,40,1390,1347,2737,6551
80,70,10,1361,1376,2737,6002
60,70,30,1370,1368,2738,5938
50,70,40,1375,1363,2738,6107
-100,20,-90,1352,1386,2738,6018
30,-60,100,1363,1376,2739,6335
-60,-30,40,1370,1369,2739,6507
140,80,110,1403,1337,2740,6237
80,50,40,1404,1336,2740,5959
20,80,50,1392,1348,2740,6317
-130,70,180,1394,1346,2740,6288
180,-40,-140,1386,1354,2740,6481
-130,70,-180,1394,1346,2740,6288
-180,-40,-140,1386,1354,2740,6481
150,-40,-150,1379,1361,2740,6449
-150,-50,-110,1393,1348,2741,6474
-80,-10,90,1366,1375,2741,6364
110,-60,20,1355,1386,2741,6282
70,-50,160,1368,1373,2741,6402
130,80,-60,1369,1372,2741,6308
-90,0,-170,1371,1370,2741,6657
150,10,-110,1379,1362,2741,6082
-140,-40,-100,1362,1379,2741,6424
60,60,-170,1390,1351,2741,6166
-150,-40,-120,1356,1385,2741,6400
40,70,-140,1389,1352,2741,6433
-10,80,60,1371,1370,2741,6420
-40,-20,-120,1374,1367,2741,6011
-40,40,-70,1382,1360,2742,6469
70,50,170,1399,1343,2742,6147
-120,30,-170,1386,1356,2742,6470
10,10,100,1381,1361,2742,6104
-60,80,100,1362,1380,2742,6561
100,-30,-130,1358,1385,2743,6225
-120,-10,-40,1361,1382,2743,6074
-80,30,-60,1366,1377,2743,5924
-20,80,80,1400,1343,2743,6410
-110,70,150,1378,1365,2743,6667
-30,-40,50,1399,1344,2743,6231
110,70,-30,1357,1387,2744,6383
-100,20,-70,1348,1396,2744,6058
-30,-30,50,1391,1354,2745,6264
-150,-80,-90,1388,1357,2745,6434
-180,50,70,1372,1373,2745,6199
180,50,70,1372,1373,2745,6199
-50,20,70,1390,1355,2745,6442
-70,-10,-150,1383,1363,2746,6093
0,-70,70,1362,1384,2746,6452
40,70,50,1379,1367,2746,6201
-80,80,120,1369,1378,2747,6595
20,10,110,1384,1363,2747,6105
10,-10,100,1369,1379,2748,6177
-70,80,110,1367,1381,2748,6562
50,-60,120,1382,1366,2748,6262
10,70,60,1392,1356,2748,6406
-170,50,-140,1379,1370,2749,6294
-70,-40,30,1374,1375,2749,6328
20,60,60,1390,1359,2749,6237
-50,-80,20,1384,1366,2750,6440
170,60,-110,1384,1366,2750,6166
-40,-80,30,1382,1369,2751,6526
-120,-70,-50,1407,1344,2751,6265
-50,-20,50,1376,1375,2751,6359
120,50,-40,1358,1393,2751,6243
130,-50,-160,1381,1371,2752,6256
80,40,150,1369,1383,2752,6112
170,70,80,1385,1367,2752,6139
100,20,60,1390,1363,2753,6122
80,-30,-30,1373,1380,2753,6286
-50,50,80,1383,1371,2754,6572
30,-10,-80,1354,1400,2754,6479
-60,50,90,1386,1368,2754,6460
0,70,50,1372,1383,2755,6343
30,-40,-70,1358,1397,2755,6325
-100,10,-120,1400,1355,2755,6366
-130,30,20,1388,1367,2755,6240
-130,-50,120,1396,1361,2757,6378
0,20,70,1370,1387,2757,6513
-10,-30,-100,1365,1392,2757,6029
170,30,-120,1391,1367,2758,6245
-80,30,130,1413,1345,2758,6520
130,10,80,1379,1379,2758,6273
-90,20,-90,1374,1385,2759,6156
10,-30,90,1383,1376,2759,6540
50,-30,-60,1363,1396,2759,6391
-140,-10,-130,1393,1366,2759,6601
-110,60,150,1390,1370,2760,6657
150,-20,-130,1364,1396,2760,6473
100,-60,160,1362,1399,2761,6480
-60,-50,30,1395,1366,2761,6375
30,60,70,1386,1375,2761,6150
-40,-50,-130,1405,1356,2761,6251
-120,-50,-40,1402,1359,2761,6206
-60,-80,10,1386,1375,2761,6412
10,-70,80,1373,1389,2762,6400
170,20,-120,1391,1371,2762,6245
-100,50,150,1404,1358,2762,6491
-140,-50,-90,1402,1360,2762,6478
-130,-10,-120,1360,1402,2762,6480
10,-30,110,1373,1389,2762,6147
120,-10,-100,1366,1396,2762,6110
80,-50,160,1375,1387,2762,6447
-10,-10,60,1383,1380,2763,6414
-110,80,170,1404,1359,2763,6229
170,-70,80,1392,1371,2763,6175
50,30,-130,1383,1380,2763,6403
130,0,-90,1377,1387,2764,6339
120,-50,-150,1373,1391,2764,6233
110,-40,-140,1367,1397,2764,6244
-70,30,-70,1382,1382,2764,6072
-70,-80,0,1392,1373,2765,6384
-140,0,40,1398,1367,2765,6060
90,-40,-10,1360,1405,2765,6326
-90,-50,10,1394,1372,2766,6294
100,-80,160,1388,1378,2766,6517
-160,-50,100,1406,1360,2766,6465
-70,10,90,1398,1368,2766,6553
110,-20,-110,1368,1399,2767,6206
-20,60,60,1379,1388,2767,6507
-90,-30,50,1398,1369,2767,6275
120,-30,40,1369,1398,2767,6269
30,80,-130,1370,1397,2767,6505
150,40,-90,1406,1362,2768,6213
-100,60,140,1384,1384,2768,6598
-10,70,70,1424,1344,2768,6366
-110,-30,10,1364,1404,2768,6466
180,0,-130,1405,1364,2769,6241
-140,-10,50,1418,1351,2769,6034
-180,0,-130,1405,1364,2769,6241
-110,10,-150,1405,1364,2769,6570
-80,-10,-160,1393,1376,2769,6362
-40,40,70,1403,1366,2769,6318
40,-30,160,1378,1392,2770,6169
-90,50,140,1401,1369,2770,6576
-180,70,-120,1392,1378,2770,6336
160,50,-100,1384,1386,2770,6219
180,70,-120,1392,1378,2770,6336
-160,50,-150,1412,1359,2771,6396
10,10,-90,1358,1413,2771,6368
-20,-80,50,1399,1372,2771,6472
-90,-30,170,1418,1353,2771,6391
-50,80,-50,1386,1385,2771,6507
-30,-80,40,1385,1386,2771,6495
-80,10,140,1385,1386,2771,6222
-80,0,120,1409,1362,2771,6522
60,-50,160,1393,1379,2772,6331
120,-70,30,1348,1424,2772,6570
40,-40,150,1393,1380,2773,6306
180,-80,90,1426,1348,2774,6589
170,-10,-130,1390,1384,2774,6274
-120,-50,130,1408,1366,2774,6324
130,10,-80,1390,1384,2774,6198
10,-20,110,1380,1394,2774,6273
-70,40,100,1396,1378,2774,6487
-120,-30,100,1386,1388,2774,6343
60,-30,-170,1356,1418,2774,6014
-180,-80,90,1426,1348,2774,6589
-170,-40,90,1411,1364,2775,6578
160,60,-100,1395,1381,2776,6305
-140,-30,-110,1384,1392,2776,6429
-150,-20,-130,1388,1388,2776,6498
130,-30,-130,1384,1392,2776,6452
-80,-80,-10,1403,1374,2777,6376
40,10,130,1349,1428,2777,5991
-110,-60,-30,1398,1379,2777,6293
130,-40,-140,1371,1406,2777,6093
-130,20,-150,1407,1370,2777,6579
-120,10,-80,1386,1392,2778,6040
110,-70,170,1387,1391,2778,6640
70,0,-130,1370,1408,2778,6424
-30,80,90,1422,1356,2778,6544
-100,40,160,1406,1373,2779,6549
-130,30,-160,1392,1387,2779,6623
-110,10,-100,1391,1388,2779,6360
100,30,30,1387,1392,2779,6011
0,60,50,1386,1393,2779,6331
-110,-30,0,1397,1383,2780,6397
-100,80,160,1415,1365,2780,6243
-100,-50,0,1413,1368,2781,6412
20,50,90,1381,1400,2781,6243
-160,70,-140,1412,1369,2781,6294
180,60,-120,1391,1390,2781,6252
-40,-20,50,1410,1371,2781,6631
-120,50,170,1413,1368,2781,6500
-180,60,-120,1391,1390,2781,6252
-120,-20,20,1392,1390,2782,6062
20,70,60,1404,1378,2782,6289
100,80,150,1425,1357,2782,6407
-40,-60,40,1397,1385,2782,6368
-120,-10,-30,1403,1380,2783,6300
-100,30,-20,1400,1384,2784,6497
30,40,-110,1409,1375,2784,6525
-100,-40,10,1391,1394,2785,6440
-80,-40,30,1399,1386,2785,6556
-180,30,70,1376,1409,2785,6106
180,30,70,1376,1409,2785,6106
10,50,60,1377,1408,2785,6518
-100,10,-160,1400,1385,2785,6563
-70,0,80,1388,1397,2785,6595
-90,10,180,1416,1370,2786,6592
120,-60,30,1363,1423,2786,6493
20,-40,110,1396,1390,2786,6387
-20,20,-90,1398,1388,2786,6304
20,-20,-80,1372,1414,2786,6411
-90,10,-180,1416,1370,2786,6592
-150,30,-150,1397,1389,2786,6286
-110,70,160,1412,1375,2787,6551
-90,-20,90,1393,1395,2788,6393
-90,20,170,1408,1380,2788,6391
30,0,130,1385,1404,2789,6206
50,-40,170,1385,1404,2789,6353
140,80,-70,1405,1384,2789,6409
160,-60,-150,1385,1404,2789,6629
150,20,-100,1400,1389,2789,6207
-60,20,-90,1419,1371,2790,6247
110,10,-20,1401,1389,2790,6438
60,80,20,1401,1389,2790,6412
70,80,10,1392,1398,2790,6406
-140,10,-140,1393,1397,2790,6417
-90,-40,170,1395,1396,2791,6438
-10,10,60,1389,1402,2791,6773
-10,30,60,1403,1388,2791,6580
-20,70,80,1458,1333,2791,6495
60,-60,130,1421,1371,2792,6459
10,50,80,1419,1373,2792,6354
20,-40,120,1409,1383,2792,6212
-30,-50,50,1420,1372,2792,6317
110,-30,20,1396,1396,2792,6378
80,-20,-60,1382,1411,2793,6372
-120,70,170,1404,1389,2793,6465
110,-80,170,1405,1388,2793,6619
-120,0,-120,1400,1393,2793,6620
-150,60,-160,1410,1383,2793,6509
0,40,60,1409,1385,2794,6687
-70,-10,70,1403,1391,2794,6506
150,-40,70,1405,1389,2794,6509
-160,-50,-120,1402,1392,2794,6513
40,-40,140,1400,1394,2794,6304
50,40,-150,1379,1415,2794,6487
-20,-40,-110,1409,1385,2794,6094
70,60,30,1397,1398,2795,6320
-110,30,180,1411,1384,2795,6529
150,80,-80,1417,1378,2795,6406
-110,30,-180,1411,1384,2795,6529
130,40,-60,1407,1388,2795,6265
20,60,-110,1404,1391,2795,6657
10,80,60,1412,1383,2795,6443
120,20,-60,1365,1430,2795,6432
110,-50,20,1377,1419,2796,6382
140,70,-70,1412,1384,2796,6492
120,-80,30,1397,1400,2797,6524
140,-40,-140,1379,1418,2797,6389
-30,70,70,1381,1416,2797,6493
-170,-10,-130,1413,1386,2799,6332
10,60,60,1411,1388,2799,6455
-100,-30,50,1436,1363,2799,6373
-120,40,10,1393,1406,2799,6525
70,-50,150,1400,1400,2800,6616
-150,70,-150,1420,1380,2800,6409
170,50,-110,1408,1392,2800,6373
-90,80,150,1420,1381,2801,6301
-170,50,-130,1395,1406,2801,6386
-80,-50,20,1406,1395,2801,6466
-150,50,-160,1424,1378,2802,6548
-90,-20,160,1398,1404,2802,6313
30,50,90,1394,1408,2802,6172
10,60,-100,1389,1413,2802,6620
140,60,-70,1399,1403,2802,6397
20,-70,90,1412,1390,2802,6484
60,20,150,1385,1418,2803,6096
180,-10,-130,1408,1395,2803,6215
130,-80,40,1404,1399,2803,6654
-180,-10,-130,1408,1395,2803,6215
70,-50,-180,1404,1400,2804,6351
70,-50,180,1404,1400,2804,6351
-70,30,100,1419,1385,2804,6678
-80,40,130,1429,1375,2804,6446
170,-20,-130,1409,1395,2804,6206
-130,50,-180,1429,1375,2804,6568
80,-50,-170,1391,1413,2804,6383
-130,50,180,1429,1375,2804,6568
-20,40,-80,1387,1417,2804,6568
120,-80,-180,1408,1397,2805,6641
-100,70,140,1414,1391,2805,6721
120,70,-40,1387,1418,2805,6476
120,-80,180,1408,1397,2805,6641
30,-20,140,1379,1426,2805,6227
-100,60,150,1417,1388,2805,6603
20,0,120,1406,1399,2805,6271
70,40,80,1405,1400,2805,6188
50,0,150,1394,1411,2805,6419
-10,0,60,1395,1410,2805,6764
-170,70,-130,1423,1383,2806,6263
-160,-80,-100,1410,1396,2806,6672
50,-50,130,1421,1386,2807,6784
-130,-30,90,1421,1386,2807,6258
10,20,100,1418,1389,2807,6334
-90,-80,-20,1419,1388,2807,6466
-100,20,-170,1425,1382,2807,6709
-40,70,80,1393,1414,2807,6561
-50,-20,-130,1404,1403,2807,6422
150,80,100,1432,1375,2807,6297
-130,-60,-60,1443,1365,2808,6389
30,-70,100,1414,1394,2808,6581
170,-80,80,1424,1384,2808,6780
-10,-80,60,1419,1389,2808,6442
-70,-70,10,1406,1402,2808,6540
40,20,120,1397,1412,2809,6056
180,-30,-130,1445,1364,2809,6615
90,60,150,1410,1399,2809,6373
-140,50,-170,1427,1382,2809,6614
-80,20,140,1431,1378,2809,6297
-180,-30,-130,1445,1364,2809,6615
-10,10,-90,1414,1396,2810,6433
120,10,-70,1387,1423,2810,6411
180,20,70,1421,1389,2810,6348
-150,-60,-100,1430,1380,2810,6588
-180,20,70,1421,1389,2810,6348
-20,20,60,1436,1375,2811,6578
50,80,30,1417,1394,2811,6453
140,30,-80,1422,1389,2811,6287
-110,20,-160,1430,1381,2811,6764
140,-70,50,1422,1389,2811,6687
130,-70,40,1391,1420,2811,6691
140,50,100,1422,1390,2812,6378
120,-60,-180,1403,1409,2812,6681
-170,10,-130,1409,1403,2812,6469
100,-40,-140,1379,1433,2812,6254
90,30,100,1380,1432,2812,6354
-110,40,170,1424,1388,2812,6615
170,-40,-140,1417,1395,2812,6507
120,-60,180,1403,1409,2812,6681
-80,40,120,1433,1380,2813,6680
-80,80,140,1415,1399,2814,6373
-100,70,150,1426,1388,2814,6581
-20,-30,60,1416,1398,2814,6342
10,-40,110,1404,1410,2814,6294
150,40,90,1434,1380,2814,6547
0,40,70,1402,1412,2814,6663
-80,-60,10,1400,1414,2814,6347
160,80,-90,1430,1385,2815,6457
90,30,80,1418,1397,2815,6403
-140,-60,-80,1418,1397,2815,6484
0,30,70,1394,1421,2815,6538
-130,-20,-100,1405,1410,2815,6546
180,40,-120,1403,1412,2815,6355
-20,50,60,1419,1396,2815,6703
-90,-60,0,1424,1391,2815,6268
-100,-60,-10,1424,1391,2815,6486
-180,40,-120,1403,1412,2815,6355
140,-80,50,1402,1413,2815,6826
-100,-80,-30,1423,1393,2816,6569
150,-80,60,1409,1407,2816,6885
170,-60,-140,1405,1411,2816,6690
40,-10,150,1424,1392,2816,6280
-130,-50,-60,1448,1369,2817,6354
80,80,0,1402,1415,2817,6441
-30,10,60,1432,1385,2817,6636
90,30,90,1400,1417,2817,6353
-100,20,-80,1406,1412,2818,6275
90,30,70,1430,1389,2819,6384
-170,30,-130,1417,1402,2819,6539
160,-80,70,1437,1382,2819,6847
-90,0,-160,1444,1375,2819,6704
-160,30,-140,1412,1408,2820,6463
-60,-70,20,1414,1406,2820,6544
10,40,90,1419,1401,2820,6306
-150,-60,110,1426,1394,2820,6600
10,-10,110,1406,1414,2820,6236
150,-70,60,1431,1389,2820,6724
-90,-40,30,1435,1386,2821,6514
-10,20,60,1415,1406,2821,6665
30,-40,130,1415,1406,2821,6391
-110,-30,40,1448,1373,2821,6098
-80,-70,0,1422,1399,2821,6554
130,50,-50,1415,1407,2822,6421
90,70,0,1403,1419,2822,6129
70,0,-100,1394,1428,2822,6233
-100,-40,20,1427,1395,2822,6425
0,50,60,1436,1387,2823,6687
90,80,-10,1405,1418,2823,6527
-70,80,130,1417,1406,2823,6504
60,-50,-40,1392,1432,2824,6491
-80,10,-130,1413,1411,2824,6546
130,-20,-120,1408,1416,2824,6486
-70,-20,-160,1408,1416,2824,6400
170,80,-100,1419,1405,2824,6415
110,-10,30,1404,1421,2825,6377
-90,60,140,1417,1408,2825,6786
-10,60,70,1431,1394,2825,6610
-60,-30,-150,1426,1399,2825,6320
160,0,-120,1426,1399,2825,6364
60,-50,140,1406,1420,2826,6671
-120,0,-90,1397,1429,2826,6362
130,-80,-170,1419,1407,2826,6702
0,20,80,1417,1409,2826,6456
-150,-20,70,1413,1414,2827,6287
-110,60,160,1421,1406,2827,6621
-10,70,60,1403,1426,2829,6502
-40,80,100,1447,1382,2829,6669
30,-30,140,1419,1410,2829,6428
130,-60,-170,1409,1420,2829,6662
-160,-30,-130,1429,1400,2829,6680
0,70,70,1423,1406,2829,6582
40,80,40,1434,1396,2830,6492
-170,40,-130,1411,1419,2830,6435
-20,-40,60,1431,1399,2830,6527
80,60,160,1412,1418,2830,6375
-90,-60,170,1436,1395,2831,6410
150,-40,-140,1416,1415,2831,6667
30,-50,120,1432,1399,2831,6491
110,10,-40,1402,1429,2831,6476
-40,20,-90,1413,1418,2831,6336
-170,20,-130,1402,1429,2831,6363
-80,-20,-170,1420,1411,2831,6677
60,40,90,1419,1412,2831,6232
70,-60,140,1440,1391,2831,6591
-140,70,-160,1421,1411,2832,6549
-40,80,-60,1419,1413,2832,6717
-50,70,100,1446,1387,2833,6751
60,40,-180,1441,1392,2833,6321
60,40,180,1441,1392,2833,6321
140,-30,-130,1398,1436,2834,6465
-130,-70,-60,1436,1398,2834,6480
60,10,-140,1405,1429,2834,6463
-130,40,-170,1435,1399,2834,6740
60,10,-160,1354,1480,2834,6301
-90,60,130,1410,1424,2834,6851
-40,0,60,1419,1415,2834,6632
-40,90,110,1420,1415,2835,6561
50,90,20,1420,1415,2835,6561
-180,90,-110,1420,1415,2835,6561
-30,90,100,1420,1415,2835,6561
40,90,30,1420,1415,2835,6561
-20,30,60,1447,1388,2835,6677
-120,90,-170,1420,1415,2835,6561
-60,90,130,1420,1415,2835,6561
70,90,0,1420,1415,2835,6561
-110,90,-180,1420,1415,2835,6561
-90,90,160,1420,1415,2835,6561
-170,90,-120,1420,1415,2835,6561
10,90,60,1420,1415,2835,6561
100,90,-30,1420,1415,2835,6561
180,90,-110,1420,1415,2835,6561
-80,90,150,1420,1415,2835,6561
-130,90,-160,1420,1415,2835,6561
0,90,70,1420,1415,2835,6561
-50,90,120,1420,1415,2835,6561
-160,90,-130,1420,1415,2835,6561
90,90,-20,1420,1415,2835,6561
-110,90,180,1420,1415,2835,6561
-150,90,-140,1420,1415,2835,6561
110,90,-40,1420,1415,2835,6561
60,60,50,1421,1414,2835,6351
130,90,-60,1420,1415,2835,6561
80,90,-10,1420,1415,2835,6561
90,-50,-160,1410,1425,2835,6451
-140,90,-150,1420,1415,2835,6561
20,90,50,1420,1415,2835,6561
140,50,-70,1415,1420,2835,6571
-10,90,80,1420,1415,2835,6561
110,-60,170,1414,1421,2835,6631
140,90,-70,1420,1415,2835,6561
120,90,-50,1420,1415,2835,6561
-20,90,90,1420,1415,2835,6561
30,90,40,1420,1415,2835,6561
-100,90,170,1420,1415,2835,6561
170,90,-100,1420,1415,2835,6561
-120,-30,-30,1440,1395,2835,6256
150,90,-80,1420,1415,2835,6561
60,90,10,1420,1415,2835,6561
160,90,-90,1420,1415,2835,6561
-70,90,140,1420,1415,2835,6561
160,-20,-130,1423,1412,2835,6494
60,0,-100,1420,1415,2835,6282
40,-50,120,1417,1419,2836,6521
-120,-40,120,1422,1414,2836,6429
0,-80,70,1433,1403,2836,6565
180,70,70,1432,1404,2836,6458
-180,70,70,1432,1404,2836,6458
70,-20,-150,1414,1422,2836,6547
-80,-10,100,1400,1436,2836,6541
120,-70,-180,1421,1416,2837,6741
120,-70,180,1421,1416,2837,6741
60,30,-180,1414,1423,2837,6258
60,30,180,1414,1423,2837,6258
80,-50,-20,1420,1417,2837,6415
10,-40,90,1425,1412,2837,6676
160,20,-110,1429,1408,2837,6455
0,10,80,1438,1400,2838,6569
140,-80,-160,1424,1414,2838,6769
0,10,-90,1409,1429,2838,6570
0,80,70,1435,1403,2838,6569
140,-60,50,1450,1388,2838,6623
40,-70,110,1429,1409,2838,6635
-120,-20,-30,1418,1420,2838,6440
-130,-20,-90,1423,1416,2839,6591
80,-20,-50,1378,1461,2839,6616
-140,-20,-120,1438,1401,2839,6798
-50,-10,60,1422,1417,2839,6520
10,-30,100,1420,1419,2839,6482
30,-50,110,1407,1433,2840,6613
180,50,-120,1425,1415,2840,6394
140,10,-90,1406,1434,2840,6438
-180,50,-120,1425,1415,2840,6394
0,-10,-90,1419,1421,2840,6610
160,80,90,1450,1390,2840,6414
-170,-80,-110,1425,1416,2841,6681
-130,-40,-60,1459,1382,2841,6366
0,40,-90,1415,1426,2841,6540
90,80,160,1447,1394,2841,6518
-130,-40,110,1415,1427,2842,6602
-20,40,60,1451,1391,2842,6814
130,60,-50,1419,1423,2842,6503
-150,20,-140,1431,1411,2842,6550
60,30,110,1433,1409,2842,6490
160,-70,70,1429,1414,2843,6490
0,30,80,1430,1413,2843,6608
70,-50,-30,1415,1428,2843,6458
160,20,80,1442,1401,2843,6501
100,50,0,1401,1442,2843,6607
-50,80,110,1446,1398,2844,6681
110,-40,20,1400,1444,2844,6551
120,0,60,1446,1398,2844,6414
40,-50,130,1434,1410,2844,6357
-130,0,-130,1439,1405,2844,6647
-60,80,120,1436,1408,2844,6642
-180,-20,-130,1417,1428,2845,6412
-50,10,-100,1429,1416,2845,6574
60,30,170,1439,1406,2845,6199
180,-20,-130,1417,1428,2845,6412
-170,60,-130,1424,1421,2845,6349
-70,70,120,1426,1420,2846,6496
110,10,-50,1379,1468,2847,6317
110,0,40,1413,1434,2847,6428
80,40,70,1422,1425,2847,6307
150,-50,-150,1412,1435,2847,6568
-170,-40,-130,1448,1399,2847,6748
50,60,60,1432,1416,2848,6351
20,80,-120,1421,1427,2848,6589
-170,-50,-130,1427,1421,2848,6807
-120,20,-150,1440,1408,2848,6717
150,70,-80,1433,1415,2848,6482
70,-20,-60,1379,1469,2848,6493
-50,70,90,1399,1449,2848,6796
-80,50,130,1443,1405,2848,6747
-60,70,100,1426,1423,2849,6864
130,-10,-100,1437,1412,2849,6225
-160,-20,-130,1440,1409,2849,6719
-90,70,130,1435,1414,2849,6880
40,60,-140,1456,1393,2849,6624
-120,-40,-30,1444,1405,2849,6342
-150,-30,-120,1425,1425,2850,6743
-160,0,-130,1441,1410,2851,6553
50,-10,170,1421,1430,2851,6091
10,70,70,1456,1395,2851,6408
-160,60,-140,1421,1430,2851,6414
-100,30,170,1451,1400,2851,6647
110,20,-10,1409,1442,2851,6393
-100,-30,140,1415,1438,2853,6600
30,70,60,1423,1430,2853,6471
90,40,50,1411,1442,2853,6335
-150,-10,-130,1460,1395,2855,6771
150,-80,-150,1434,1421,2855,6799
90,-20,-30,1434,1421,2855,6743
10,-80,80,1422,1433,2855,6488
10,80,-110,1433,1422,2855,6685
-70,-60,20,1426,1429,2855,6634
130,-60,40,1417,1439,2856,6759
110,-50,-150,1407,1449,2856,6344
10,50,90,1421,1435,2856,6338
180,-60,-130,1444,1412,2856,6723
-180,-60,-130,1444,1412,2856,6723
-90,70,140,1442,1414,2856,6572
80,-30,-140,1418,1438,2856,6177
100,70,-10,1410,1446,2856,6341
-80,70,130,1434,1423,2857,6499
50,-10,-80,1389,1468,2857,6592
170,-50,-140,1415,1442,2857,6653
-30,70,90,1454,1403,2857,6668
140,10,80,1440,1417,2857,6603
150,-10,-120,1435,1423,2858,6596
-130,10,-140,1413,1445,2858,6764
0,0,-90,1411,1447,2858,6552
-150,-70,-90,1448,1410,2858,6665
50,30,-140,1424,1434,2858,6616
50,-50,150,1427,1431,2858,6532
-80,-20,70,1418,1441,2859,6689
20,-80,90,1426,1433,2859,6648
110,10,60,1451,1408,2859,6663
0,40,80,1432,1427,2859,6587
-70,-20,60,1445,1415,2860,6841
50,-50,-50,1415,1445,2860,6566
10,-20,100,1436,1424,2860,6602
-160,-10,-130,1438,1423,2861,6635
60,-50,150,1427,1435,2862,6583
150,-30,70,1461,1401,2862,6773
100,60,140,1446,1416,2862,6576
-30,60,70,1411,1451,2862,6875
60,10,-120,1432,1430,2862,6655
110,-20,20,1404,1458,2862,6529
-110,-80,-40,1446,1416,2862,6648
100,30,40,1428,1435,2863,6291
-120,40,180,1443,1420,2863,6794
-60,70,110,1448,1415,2863,6591
-120,40,-180,1443,1420,2863,6794
-180,80,-110,1449,1414,2863,6399
-60,40,90,1454,1409,2863,6652
180,80,-110,1449,1414,2863,6399
-130,70,-170,1442,1422,2864,6715
-160,-60,-110,1448,1416,2864,6775
-140,60,-170,1436,1428,2864,6795
150,-30,-130,1412,1452,2864,6580
-50,-40,-140,1437,1427,2864,6382
100,-10,-100,1409,1456,2865,6605
-130,40,20,1455,1410,2865,6456
0,60,70,1467,1398,2865,6618
-50,70,-50,1443,1422,2865,6702
-30,-60,50,1436,1429,2865,6453
40,-20,160,1421,1444,2865,6254
-10,60,60,1429,1436,2865,6656
-120,0,0,1446,1419,2865,6649
120,40,-40,1412,1454,2866,6624
-20,70,70,1413,1453,2866,6630
-50,40,80,1430,1436,2866,6656
-40,30,70,1442,1425,2867,6705
10,60,70,1457,1410,2867,6456
30,-80,100,1431,1436,2867,6731
-10,40,60,1431,1436,2867,6949
80,60,20,1417,1450,2867,6524
-80,20,-90,1447,1420,2867,6598
-170,-60,-120,1461,1406,2867,6677
30,70,-130,1457,1410,2867,6732
-130,-20,-70,1428,1440,2868,6393
120,0,-80,1463,1405,2868,6525
-10,80,80,1447,1421,2868,6657
-30,70,80,1437,1431,2868,6820
-80,-30,50,1430,1438,2868,6651
-60,0,70,1442,1427,2869,6774
40,0,140,1425,1444,2869,6277
50,-50,140,1436,1433,2869,6483
20,40,100,1424,1445,2869,6109
0,0,80,1444,1425,2869,6641
170,10,-120,1443,1427,2870,6378
-140,40,-160,1455,1415,2870,6681
100,80,-20,1434,1436,2870,6601
-20,10,60,1458,1412,2870,6915
50,-70,120,1458,1413,2871,6758
10,-50,110,1447,1424,2871,6493
150,-60,60,1457,1414,2871,6477
90,-10,-70,1454,1417,2871,6504
-40,70,90,1453,1419,2872,6784
-90,-70,-10,1434,1438,2872,6601
-30,50,-70,1455,1417,2872,6660
120,30,100,1437,1435,2872,6552
170,-80,-130,1435,1438,2873,6760
-120,60,170,1443,1430,2873,6756
-160,40,-140,1429,1444,2873,6797
130,-50,-150,1405,1468,2873,6720
30,80,50,1466,1407,2873,6570
170,70,-100,1441,1432,2873,6591
140,-10,-110,1432,1441,2873,6444
-90,-20,100,1419,1454,2873,6486
90,-10,-110,1421,1452,2873,6523
130,20,-70,1427,1446,2873,6587
130,40,-50,1447,1427,2874,6417
-90,50,-20,1453,1421,2874,6768
80,-40,-150,1433,1441,2874,6422
150,60,-80,1447,1427,2874,6535
60,20,140,1437,1438,2875,6303
170,80,80,1457,1418,2875,6533
-60,40,-60,1442,1433,2875,6473
60,-50,170,1425,1450,2875,6643
-120,10,0,1454,1421,2875,6572
160,-40,-140,1475,1400,2875,6585
-50,-70,30,1427,1448,2875,6566
-180,-80,-120,1438,1438,2876,6700
180,-80,-120,1438,1438,2876,6700
0,-10,80,1460,1416,2876,6669
0,-20,80,1443,1433,2876,6749
10,-40,100,1436,1440,2876,6551
-70,70,110,1452,1424,2876,6908
-140,30,30,1452,1424,2876,6660
180,60,70,1432,1445,2877,6366
-150,40,-150,1449,1428,2877,6753
-180,60,70,1432,1445,2877,6366
-70,40,-50,1427,1450,2877,6602
-80,70,120,1458,1420,2878,6905
-100,-40,150,1457,1422,2879,6564
100,30,100,1437,1442,2879,6531
160,-80,-140,1431,1448,2879,6804
180,20,-120,1456,1424,2880,6444
-180,20,-120,1456,1424,2880,6444
-170,-30,-130,1462,1418,2880,6761
10,30,100,1440,1440,2880,6376
100,-10,-20,1457,1423,2880,6610
-120,-60,-40,1451,1430,2881,6562
130,-70,-170,1438,1443,2881,6839
150,10,80,1450,1431,2881,6741
120,-20,-110,1424,1457,2881,6623
100,-30,0,1417,1465,2882,6491
130,70,-50,1438,1444,2882,6652
-70,20,100,1476,1406,2882,6796
80,-60,150,1447,1435,2882,6741
0,50,70,1441,1441,2882,6679
-160,50,-140,1425,1457,2882,6555
140,-20,-120,1439,1444,2883,6584
170,40,-110,1446,1437,2883,6561
-20,60,80,1470,1413,2883,6827
120,30,-50,1424,1459,2883,6731
-50,-40,40,1458,1426,2884,6825
100,-10,-50,1430,1455,2885,6370
-140,30,-150,1431,1454,2885,6673
70,60,40,1462,1423,2885,6486
-120,-70,140,1445,1440,2885,6667
120,-50,30,1430,1455,2885,6673
150,30,-90,1470,1415,2885,6568
60,10,-130,1431,1455,2886,6685
-70,20,-90,1444,1442,2886,6456
10,40,100,1457,1429,2886,6586
10,-20,120,1440,1446,2886,6381
50,-20,-70,1414,1472,2886,6733
-110,-40,-10,1463,1423,2886,6605
170,-30,-130,1461,1426,2887,6597
-120,10,-60,1453,1434,2887,6535
-170,0,-130,1455,1433,2888,6768
-80,0,130,1455,1433,2888,6831
-120,30,-160,1444,1444,2888,6832
-120,-80,-50,1455,1433,2888,6733
110,60,130,1454,1434,2888,6627
-110,20,-80,1465,1423,2888,6266
-20,80,90,1461,1427,2888,6761
20,60,80,1442,1446,2888,6423
-20,-50,60,1456,1433,2889,6724
20,-40,-80,1416,1473,2889,6371
0,50,80,1470,1419,2889,6576
10,60,80,1469,1420,2889,6546
-80,-10,110,1444,1445,2889,6524
-10,-30,70,1469,1421,2890,6648
-130,-20,60,1438,1452,2890,6395
0,50,-90,1441,1449,2890,6649
40,-60,130,1456,1435,2891,6525
-100,10,-150,1467,1424,2891,6838
160,40,-100,1470,1421,2891,6530
-120,-50,-30,1461,1430,2891,6653
110,10,-30,1431,1460,2891,6580
10,-50,90,1433,1459,2892,6724
-170,70,-120,1462,1430,2892,6496
110,30,-10,1425,1468,2893,6501
-70,0,90,1458,1435,2893,6976
120,-60,-170,1432,1461,2893,6800
40,-50,-60,1426,1467,2893,6635
100,-60,180,1442,1451,2893,6770
10,-30,120,1459,1434,2893,6455
-80,60,130,1462,1431,2893,6896
100,-60,-180,1442,1451,2893,6770
60,10,-150,1412,1482,2894,6572
-10,50,60,1451,1443,2894,6986
-110,50,0,1463,1432,2895,6893
140,-60,-160,1444,1451,2895,6764
0,30,-90,1439,1456,2895,6931
40,60,70,1440,1455,2895,6369
70,30,140,1436,1460,2896,6324
20,-30,130,1472,1424,2896,6627
160,70,-90,1463,1433,2896,6525
-10,70,80,1469,1428,2897,6715
20,-50,100,1415,1482,2897,6521
50,-60,140,1455,1442,2897,6552
-70,-30,50,1449,1448,2897,6771
30,20,-100,1442,1456,2898,6584
-80,70,140,1466,1432,2898,6577
-140,40,30,1459,1440,2899,6608
-10,-20,70,1460,1439,2899,6801
70,50,60,1454,1445,2899,6355
100,-60,-170,1473,1426,2899,6740
30,-60,120,1469,1431,2900,6641
70,30,120,1448,1452,2900,6405
-170,80,-120,1477,1423,2900,6457
-80,0,-150,1474,1426,2900,6666
0,20,90,1453,1447,2900,6542
-30,20,-90,1443,1457,2900,6607
140,-50,50,1458,1442,2900,6562
-110,30,-170,1446,1454,2900,6929
90,-60,180,1471,1430,2901,6811
-140,-50,110,1477,1424,2901,6890
-120,0,-30,1473,1428,2901,6385
80,-10,-80,1457,1444,2901,6467
-170,70,60,1472,1429,2901,6617
90,-60,-180,1471,1430,2901,6811
20,-20,130,1466,1435,2901,6649
50,-60,130,1457,1445,2902,6943
20,-50,120,1474,1428,2902,6569
40,-60,120,1459,1443,2902,6797
-30,80,100,1465,1438,2903,6718
-20,0,60,1476,1427,2903,6884
20,-30,-80,1425,1478,2903,6707
-100,50,-10,1478,1426,2904,6829
50,0,170,1436,1468,2904,6166
100,40,10,1428,1476,2904,6384
0,-30,100,1461,1443,2904,6635
-100,70,160,1467,1437,2904,6666
-80,50,120,1475,1429,2904,7062
150,-50,60,1463,1442,2905,6533
-40,80,110,1477,1428,2905,6630
-170,-20,-130,1469,1436,2905,6796
-100,10,-130,1472,1433,2905,6913
40,-80,110,1446,1459,2905,6875
-10,-40,70,1481,1424,2905,6651
0,-50,80,1467,1439,2906,6787
-90,20,-180,1464,1442,2906,6696
-10,-50,70,1459,1447,2906,6748
-90,20,180,1464,1442,2906,6696
0,-40,100,1463,1444,2907,6422
50,20,-120,1455,1452,2907,6734
80,-60,-180,1473,1435,2908,6735
-30,80,-70,1456,1452,2908,6823
80,-60,180,1473,1435,2908,6735
-40,-70,40,1457,1451,2908,6653
-120,70,180,1473,1436,2909,6806
-80,50,-30,1478,1431,2909,6802
60,70,-170,1460,1449,2909,6683
120,-10,50,1460,1449,2909,6598
-120,70,-180,1473,1436,2909,6806
-130,60,-180,1463,1447,2910,6864
-130,60,180,1463,1447,2910,6864
-90,20,-100,1468,1442,2910,6610
-110,70,170,1467,1443,2910,6707
-50,30,-80,1443,1467,2910,6573
-180,70,-110,1466,1445,2911,6609
50,-80,120,1456,1455,2911,6938
-50,10,70,1468,1443,2911,6828
180,70,-110,1466,1445,2911,6609
100,-20,-10,1466,1446,2912,6560
-160,80,-130,1493,1419,2912,6482
-60,-60,30,1454,1458,2912,6857
-10,50,70,1452,1460,2912,6943
-70,-50,30,1472,1441,2913,6851
120,40,110,1480,1433,2913,6540
-30,0,60,1471,1443,2914,6869
-90,30,-50,1435,1479,2914,6325
100,-10,-30,1465,1449,2914,6641
120,60,120,1473,1441,2914,6712
110,30,100,1475,1439,2914,6567
110,-30,-120,1437,1477,2914,6396
-20,-60,60,1467,1448,2915,6691
-60,10,80,1463,1452,2915,6882
-120,0,-110,1453,1462,2915,6676
-140,0,-130,1475,1440,2915,6859
110,10,-10,1441,1475,2916,6519
90,-30,-20,1454,1462,2916,6707
60,-70,130,1475,1441,2916,6860
-70,10,100,1486,1430,2916,6994
70,-50,-170,1440,1476,2916,6613
-10,60,80,1485,1431,2916,6788
0,-30,80,1461,1455,2916,6760
10,-50,100,1449,1467,2916,6650
-120,10,-140,1460,1457,2917,7001
-30,60,90,1499,1418,2917,6971
-10,40,70,1469,1448,2917,6972
-90,10,-170,1472,1445,2917,6864
100,-20,-110,1462,1455,2917,6453
40,-50,140,1464,1454,2918,6661
90,50,20,1442,1476,2918,6499
-130,-20,-80,1461,1457,2918,6691
170,-60,80,1456,1462,2918,6800
60,50,70,1445,1473,2918,6382
-100,50,160,1475,1444,2919,6850
-90,30,160,1500,1419,2919,6938
140,0,-100,1451,1468,2919,6584
150,0,-110,1453,1466,2919,6466
20,-50,110,1467,1452,2919,6604
-150,50,-150,1457,1462,2919,6890
120,50,-30,1451,1468,2919,6605
-130,-10,30,1475,1444,2919,6301
0,-40,80,1459,1461,2920,6706
140,-50,-150,1452,1468,2920,6781
170,-40,80,1471,1449,2920,6693
40,-10,-80,1430,1490,2920,6857
80,-60,170,1472,1448,2920,6971
-110,-60,-20,1471,1449,2920,6674
-20,-30,-110,1435,1485,2920,6484
60,-80,130,1464,1457,2921,7080
110,-60,-170,1457,1464,2921,6855
-70,30,110,1491,1430,2921,6886
110,0,-70,1442,1479,2921,6818
-90,70,150,1480,1441,2921,6576
-70,70,130,1479,1442,2921,6622
-20,-20,60,1475,1447,2922,6823
0,-50,100,1476,1446,2922,6526
-160,-40,-120,1468,1454,2922,6747
-180,30,-120,1472,1451,2923,6626
-10,-60,70,1476,1447,2923,6871
90,60,10,1434,1489,2923,6607
50,-50,160,1460,1463,2923,6653
-80,30,140,1493,1430,2923,6803
180,30,-120,1472,1451,2923,6626
40,0,-90,1450,1474,2924,7000
110,-60,-180,1451,1473,2924,6735
70,60,170,1486,1438,2924,6602
110,-60,180,1451,1473,2924,6735
0,80,-100,1481,1443,2924,6854
10,0,110,1467,1458,2925,6472
-80,60,120,1478,1447,2925,7115
-70,30,120,1490,1435,2925,6766
-160,70,-130,1473,1453,2926,6609
-90,40,150,1490,1437,2927,6739
60,-60,160,1481,1446,2927,6697
-160,10,-130,1464,1463,2927,6846
-20,-10,60,1481,1446,2927,7014
130,-30,50,1463,1465,2928,6786
140,-70,-160,1458,1470,2928,6922
20,30,-100,1457,1471,2928,6624
-70,20,110,1515,1413,2928,6943
160,-30,-130,1462,1466,2928,6810
-10,30,70,1480,1448,2928,7096
-30,-40,-120,1457,1472,2929,6612
110,80,-30,1456,1473,2929,6668
80,80,170,1499,1430,2929,6751
70,-60,170,1480,1450,2930,6660
-50,80,120,1484,1446,2930,6551
0,30,90,1467,1464,2931,6731
-130,30,-150,1462,1469,2931,6850
-100,30,-180,1474,1457,2931,6916
70,-60,160,1473,1458,2931,6835
-100,30,180,1474,1457,2931,6916
-150,0,-130,1473,1459,2932,6834
10,-40,120,1498,1434,2932,6677
-70,40,120,1493,1439,2932,6795
-80,0,140,1466,1466,2932,6617
-60,70,120,1468,1464,2932,6736
-170,40,60,1463,1469,2932,6714
-150,80,-140,1498,1434,2932,6597
70,-70,140,1483,1449,2932,7055
-140,-50,-80,1495,1437,2932,6683
-70,80,140,1482,1450,2932,6646
-70,20,120,1513,1419,2932,6785
110,0,10,1449,1483,2932,6636
60,-60,150,1479,1454,2933,6623
100,-60,170,1463,1470,2933,6796
20,-40,130,1476,1457,2933,6759
-20,80,-80,1466,1467,2933,6923
70,0,-120,1445,1488,2933,6670
-70,0,-140,1490,1444,2934,6658
-130,-80,-60,1464,1470,2934,6905
-90,60,150,1488,1446,2934,6817
110,70,-20,1440,1494,2934,6567
140,40,-70,1481,1453,2934,6810
-50,-50,40,1490,1445,2935,6959
-30,-70,50,1466,1469,2935,6660
60,-60,140,1477,1458,2935,6873
70,40,160,1489,1447,2936,6363
-110,-70,150,1482,1454,2936,6592
30,-60,110,1470,1466,2936,6770
-110,-50,140,1495,1441,2936,6706
130,-60,-160,1463,1473,2936,7015
60,70,40,1483,1455,2938,6774
-130,-70,130,1482,1456,2938,6804
40,-40,160,1463,1475,2938,6550
-20,70,90,1503,1435,2938,6838
40,-30,-70,1455,1484,2939,6901
50,-60,150,1477,1462,2939,6787
-160,-70,-100,1485,1454,2939,6913
-70,50,-40,1474,1466,2940,6955
-60,80,130,1497,1443,2940,6612
90,-40,-140,1465,1475,2940,6597
60,-70,140,1470,1470,2940,6885
50,0,160,1483,1457,2940,6431
-120,50,10,1482,1458,2940,6639
-110,20,-30,1486,1454,2940,6740
-90,-40,40,1464,1477,2941,6865
-40,-30,50,1478,1463,2941,6846
-70,60,120,1479,1462,2941,6853
70,-40,-160,1468,1473,2941,6590
160,-60,70,1475,1466,2941,6728
110,40,-10,1448,1493,2941,6721
-40,60,80,1462,1480,2942,6987
-40,70,100,1494,1448,2942,6920
20,80,60,1488,1454,2942,6737
-140,20,30,1465,1477,2942,6627
-140,50,30,1496,1446,2942,6663
-110,-50,-10,1499,1443,2942,6769
-30,60,-70,1478,1464,2942,6839
-10,20,70,1472,1471,2943,6988
-30,-10,60,1478,1465,2943,7028
-80,60,140,1494,1449,2943,6842
50,30,110,1490,1453,2943,6408
0,70,80,1494,1450,2944,6747
-60,-20,60,1495,1449,2944,6867
-80,40,-40,1485,1459,2944,6840
-140,-40,-90,1487,1457,2944,6927
-60,-30,50,1505,1439,2944,6941
110,-60,-160,1485,1459,2944,6720
110,-10,20,1433,1511,2944,6571
20,-60,100,1470,1475,2945,6810
-80,-40,40,1485,1460,2945,6882
-150,60,-150,1464,1481,2945,6690
-70,-40,40,1481,1466,2947,6843
-100,-70,-20,1463,1485,2948,6725
-10,30,80,1492,1456,2948,6699
50,50,-160,1487,1462,2949,6709
-70,50,120,1507,1442,2949,6855
150,-70,-150,1478,1471,2949,6958
-10,80,-90,1491,1458,2949,6871
90,-60,160,1476,1473,2949,6741
90,-50,-10,1468,1481,2949,6554
150,-60,-150,1474,1476,2950,6860
90,-60,170,1481,1469,2950,6881
-150,70,-140,1490,1460,2950,6691
-80,-50,180,1505,1446,2951,6664
90,-20,-120,1477,1474,2951,6463
-80,-50,-180,1505,1446,2951,6664
20,-60,110,1490,1461,2951,6751
20,-60,120,1494,1457,2951,6706
-120,0,-100,1477,1474,2951,6728
80,-50,-160,1458,1494,2952,6870
-140,80,-150,1495,1457,2952,6717
-50,-60,40,1485,1467,2952,6914
50,70,50,1476,1477,2953,6700
40,10,-100,1474,1479,2953,6631
30,-40,140,1483,1470,2953,6831
-160,20,-130,1476,1477,2953,6556
-80,-40,-180,1482,1471,2953,6775
30,40,100,1476,1477,2953,6531
140,-30,60,1489,1464,2953,6756
-80,-40,180,1482,1471,2953,6775
70,-80,140,1481,1472,2953,7172
140,-10,70,1497,1456,2953,6890
-150,-40,-110,1496,1457,2953,6670
180,10,70,1497,1457,2954,6912
-70,10,110,1520,1434,2954,6958
0,40,90,1477,1477,2954,6736
-180,10,70,1497,1457,2954,6912
100,-40,0,1461,1493,2954,6517
0,-50,90,1475,1480,2955,6749
0,10,90,1480,1475,2955,6691
-60,-40,40,1487,1468,2955,6892
-170,-10,70,1513,1442,2955,6841
-130,0,-120,1489,1466,2955,7012
90,-30,-130,1459,1496,2955,6571
10,80,70,1495,1461,2956,6815
50,-70,130,1481,1475,2956,6981
-10,40,80,1492,1464,2956,6865
-40,70,-60,1491,1465,2956,7027
-60,60,100,1482,1475,2957,7133
50,-70,140,1499,1458,2957,6685
-80,-60,-180,1488,1469,2957,6792
-80,-60,180,1488,1469,2957,6792
-120,-10,-20,1496,1461,2957,6614
-130,0,20,1492,1466,2958,6628
-120,10,-90,1482,1476,2958,6665
170,-30,80,1487,1471,2958,6797
-150,-50,-100,1507,1451,2958,6971
-110,10,-140,1502,1457,2959,6781
-150,30,-140,1476,1483,2959,6706
70,70,30,1485,1474,2959,6753
0,60,80,1487,1472,2959,6774
180,-40,-130,1486,1474,2960,6858
130,80,-50,1464,1496,2960,6764
-20,-70,60,1499,1461,2960,6891
-110,20,-150,1500,1460,2960,6952
-180,-40,-130,1486,1474,2960,6858
-60,30,90,1507,1454,2961,6934
170,30,-110,1497,1464,2961,6822
-50,70,110,1481,1480,2961,6931
-120,10,-40,1500,1461,2961,6579
-30,70,100,1499,1462,2961,6922
120,80,-40,1462,1499,2961,6727
-120,10,-130,1484,1478,2962,6825
180,80,70,1499,1463,2962,6719
-180,80,70,1499,1463,2962,6719
180,-50,-130,1495,1468,2963,6829
-180,-50,-130,1495,1468,2963,6829
70,-70,160,1475,1488,2963,6694
140,20,-80,1490,1473,2963,6698
-170,50,60,1484,1479,2963,6687
-50,60,90,1488,1476,2964,6992
-140,-70,-70,1486,1478,2964,6945
-80,80,150,1504,1460,2964,6662
-130,-30,-60,1504,1460,2964,6714
-110,50,170,1509,1455,2964,6877
0,-60,80,1500,1464,2964,6922
50,-30,180,1477,1487,2964,6353
50,-30,-180,1477,1487,2964,6353
-90,-60,10,1492,1472,2964,6834
90,-60,-170,1496,1469,2965,6757
160,-50,-140,1472,1493,2965,6864
0,-30,90,1482,1483,2965,6898
110,0,30,1471,1494,2965,6749
-140,-70,120,1505,1461,2966,6921
40,70,60,1500,1466,2966,6718
-10,-20,-100,1482,1484,2966,6760
20,20,110,1484,1483,2967,6729
-170,60,-120,1495,1472,2967,6719
-70,60,110,1492,1475,2967,7237
0,-60,90,1492,1476,2968,6741
-100,20,-160,1488,1480,2968,6863
-140,20,-140,1493,1475,2968,6891
-110,20,-50,1477,1492,2969,6440
0,-30,110,1492,1477,2969,6642
80,-70,150,1493,1476,2969,7107
-90,50,150,1506,1463,2969,6992
120,60,-30,1489,1481,2970,6577
-30,50,70,1507,1463,2970,6970
30,-50,130,1472,1498,2970,6640
-80,50,140,1514,1456,2970,6878
-100,60,160,1501,1469,2970,6924
30,50,-120,1496,1474,2970,7013
-100,10,-140,1483,1488,2971,6880
20,70,70,1477,1494,2971,6696
-160,60,50,1485,1486,2971,6818
60,-50,-180,1486,1485,2971,6773
60,-50,180,1486,1485,2971,6773
-160,50,-130,1488,1484,2972,6745
-10,-10,70,1500,1472,2972,6979
30,-60,130,1499,1473,2972,6837
100,-10,-60,1460,1512,2972,6442
-10,10,70,1496,1476,2972,7104
-150,-60,-90,1492,1481,2973,7163
-90,10,-140,1494,1479,2973,7040
170,-50,80,1499,1474,2973,7149
-140,50,-160,1507,1466,2973,6916
-180,-90,-110,1472,1502,2974,7159
-120,-90,-50,1472,1502,2974,7159
130,-90,-160,1472,1502,2974,7159
170,-90,-120,1472,1502,2974,7159
0,-90,70,1472,1502,2974,7159
-50,-90,20,1472,1502,2974,7159
-150,-90,-80,1472,1502,2974,7159
20,-90,90,1472,1502,2974,7159
-170,-90,-100,1472,1502,2974,7159
140,-90,-150,1472,1502,2974,7159
90,-90,160,1472,1502,2974,7159
110,20,80,1466,1508,2974,6788
40,-90,110,1472,1502,2974,7159
0,80,80,1494,1480,2974,6842
180,-90,-110,1472,1502,2974,7159
80,-90,150,1472,1502,2974,7159
-40,-90,30,1472,1502,2974,7159
30,-90,100,1472,1502,2974,7159
-130,50,20,1475,1499,2974,6621
-30,-90,40,1472,1502,2974,7159
120,-90,-170,1472,1502,2974,7159
-60,-90,10,1472,1502,2974,7159
-10,-90,60,1472,1502,2974,7159
-130,-90,-60,1472,1502,2974,7159
-140,-90,-70,1472,1502,2974,7159
-70,-90,0,1472,1502,2974,7159
110,-90,-180,1472,1502,2974,7159
-110,-90,-40,1472,1502,2974,7159
70,-90,140,1472,1502,2974,7159
150,-90,-140,1472,1502,2974,7159
-160,-90,-90,1472,1502,2974,7159
160,-90,-130,1472,1502,2974,7159
-100,-90,-30,1472,1502,2974,7159
10,-90,80,1472,1502,2974,7159
110,-90,180,1472,1502,2974,7159
50,-90,120,1472,1502,2974,7159
60,-90,130,1472,1502,2974,7159
-80,-90,-10,1472,1502,2974,7159
100,-90,170,1472,1502,2974,7159
-90,-90,-20,1472,1502,2974,7159
-20,-90,50,1472,1502,2974,7159
-120,50,180,1508,1467,2975,6827
20,70,-120,1512,1463,2975,6973
-120,50,-180,1508,1467,2975,6827
60,-70,150,1495,1480,2975,6710
-60,-10,-140,1488,1488,2976,6788
-140,70,-150,1492,1484,2976,6785
40,30,110,1469,1507,2976,6562
-130,-10,-110,1480,1497,2977,6935
60,50,180,1515,1462,2977,6822
160,60,-90,1501,1476,2977,6694
60,50,-180,1515,1462,2977,6822
130,30,-60,1494,1483,2977,6905
60,90,20,1478,1500,2978,6789
-110,90,-170,1478,1500,2978,6789
140,90,-60,1478,1500,2978,6789
-160,90,-120,1478,1500,2978,6789
90,90,-10,1478,1500,2978,6789
0,90,80,1478,1500,2978,6789
-170,90,-110,1478,1500,2978,6789
-50,90,130,1478,1500,2978,6789
70,90,10,1478,1500,2978,6789
10,90,70,1478,1500,2978,6789
-110,20,-70,1491,1487,2978,6804
-130,90,-150,1478,1500,2978,6789
150,90,-70,1478,1500,2978,6789
-150,90,-130,1478,1500,2978,6789
130,90,-50,1478,1500,2978,6789
170,90,-90,1478,1500,2978,6789
-140,90,-140,1478,1500,2978,6789
100,90,-20,1478,1500,2978,6789
-120,90,-160,1478,1500,2978,6789
-120,40,-170,1476,1502,2978,6982
10,-60,100,1506,1472,2978,6764
-80,90,160,1478,1500,2978,6789
-70,90,150,1478,1500,2978,6789
-60,90,140,1478,1500,2978,6789
180,90,-100,1478,1500,2978,6789
-100,90,180,1478,1500,2978,6789
-90,90,170,1478,1500,2978,6789
110,90,-30,1478,1500,2978,6789
20,90,60,1478,1500,2978,6789
-10,90,90,1478,1500,2978,6789
130,0,70,1511,1467,2978,6842
80,90,0,1478,1500,2978,6789
-180,90,-100,1478,1500,2978,6789
30,90,50,1478,1500,2978,6789
-40,90,120,1478,1500,2978,6789
-20,90,100,1478,1500,2978,6789
40,90,40,1478,1500,2978,6789
160,90,-80,1478,1500,2978,6789
50,90,30,1478,1500,2978,6789
80,-80,150,1485,1493,2978,7205
120,90,-40,1478,1500,2978,6789
-30,90,110,1478,1500,2978,6789
-100,90,-180,1478,1500,2978,6789
70,30,130,1495,1484,2979,6582
40,-60,140,1502,1477,2979,6819
170,0,-120,1486,1493,2979,6888
20,0,-90,1448,1531,2979,7012
-110,-70,-30,1478,1502,2980,6806
-110,10,-110,1487,1493,2980,6993
40,40,-130,1533,1447,2980,6891
-20,50,80,1522,1458,2980,7052
100,-10,-40,1477,1504,2981,6682
0,-20,90,1498,1483,2981,7032
40,-70,130,1516,1465,2981,6816
90,50,30,1518,1463,2981,6567
-110,-30,110,1487,1494,2981,6716
-80,20,-100,1500,1481,2981,6765
20,-50,130,1477,1504,2981,6734
40,30,-120,1499,1483,2982,6883
-90,80,160,1503,1479,2982,6767
-60,60,110,1503,1479,2982,7076
60,-40,-170,1502,1480,2982,6630
20,-70,110,1517,1465,2982,6869
10,-60,90,1472,1510,2982,6885
-130,50,-170,1518,1464,2982,6885
-130,0,-70,1507,1475,2982,6744
10,0,-90,1458,1525,2983,6970
140,70,-60,1489,1494,2983,6842
70,80,180,1525,1458,2983,6901
-30,-40,60,1507,1476,2983,6846
30,0,-90,1469,1514,2983,7039
110,10,10,1481,1502,2983,6541
70,80,-180,1525,1458,2983,6901
90,-80,160,1500,1484,2984,7209
-30,-50,60,1521,1463,2984,6974
-70,40,110,1539,1446,2985,7110
-40,70,110,1504,1481,2985,6809
-20,60,90,1512,1473,2985,6908
-110,-40,130,1510,1475,2985,6963
-130,-60,-50,1511,1474,2985,6875
80,50,50,1505,1480,2985,6652
30,-70,120,1516,1469,2985,6879
-10,20,80,1501,1485,2986,6811
120,-20,-100,1476,1510,2986,6538
-40,-40,50,1498,1488,2986,6950
0,-20,100,1489,1497,2986,6853
-140,-80,-70,1488,1498,2986,7033
-10,50,80,1526,1460,2986,7028
-60,0,-130,1520,1466,2986,6728
-10,-70,70,1492,1495,2987,6805
30,-50,-70,1477,1510,2987,6889
130,-20,-110,1481,1507,2988,6700
90,-10,-80,1453,1535,2988,6777
110,0,20,1467,1521,2988,6864
0,50,90,1518,1471,2989,6819
-40,-50,50,1523,1466,2989,6969
-10,60,90,1506,1483,2989,7008
30,-70,130,1509,1480,2989,6877
-150,50,40,1515,1475,2990,6674
-40,-10,60,1489,1501,2990,7092
10,-60,110,1508,1483,2991,6903
170,-70,-130,1522,1469,2991,7061
-80,-10,-170,1502,1489,2991,6977
-100,-70,160,1506,1485,2991,6662
0,40,100,1496,1496,2992,6696
140,80,-60,1491,1501,2992,6829
160,-70,-140,1504,1488,2992,7008
-130,40,-160,1491,1501,2992,6876
-110,20,-90,1480,1513,2993,6664
170,60,-100,1519,1474,2993,6807
-110,30,-160,1500,1493,2993,7111
0,-40,90,1491,1502,2993,6928
150,50,-80,1473,1520,2993,6730
-110,10,-120,1508,1486,2994,7029
100,40,20,1537,1458,2995,6800
90,-70,160,1514,1481,2995,7080
-10,80,90,1493,1503,2996,6931
-10,0,70,1486,1510,2996,7068
-110,60,170,1503,1493,2996,6928
100,-60,-160,1510,1486,2996,6830
-160,40,-130,1500,1496,2996,6896
-40,60,90,1516,1481,2997,7140
0,0,90,1484,1513,2997,6828
50,50,80,1487,1510,2997,6503
-150,40,40,1509,1488,2997,6719
-150,10,-130,1512,1485,2997,6984
100,-80,170,1508,1490,2998,7284
70,-70,150,1520,1478,2998,6953
-20,40,80,1520,1478,2998,6983
-170,30,-120,1520,1479,2999,6842
110,-10,-90,1503,1496,2999,6997
40,-50,150,1515,1484,2999,6918
180,-70,-120,1513,1486,2999,7040
-180,-70,-120,1513,1486,2999,7040
80,-70,170,1500,1499,2999,6868
-70,60,130,1526,1474,3000,6919
-80,40,140,1519,1481,3000,7003
40,-70,140,1512,1488,3000,6899
-170,60,60,1496,1504,3000,6742
90,-20,-50,1501,1499,3000,6762
-130,80,-160,1519,1481,3000,6816
110,-40,-130,1467,1533,3000,6860
-10,-50,80,1502,1499,3001,7099
10,-50,120,1519,1482,3001,6824
30,-70,110,1493,1508,3001,7162
-50,-30,50,1504,1497,3001,7046
0,-40,110,1503,1498,3001,6673
-30,60,80,1507,1494,3001,7243
40,-70,120,1492,1510,3002,7114
-50,60,100,1515,1487,3002,7125
10,-10,120,1499,1503,3002,6655
-60,50,-50,1509,1493,3002,7027
50,30,-150,1490,1513,3003,6865
-60,-50,40,1499,1504,3003,7077
50,10,140,1487,1516,3003,6753
30,-50,140,1505,1498,3003,7014
70,-10,-90,1512,1491,3003,6595
-160,70,50,1499,1504,3003,6906
-160,-30,-120,1528,1476,3004,7101
110,70,130,1551,1453,3004,6753
180,60,-110,1516,1488,3004,6745
-180,60,-110,1516,1488,3004,6745
60,80,30,1471,1533,3004,6671
20,-60,130,1504,1500,3004,6898
-170,-70,-110,1530,1475,3005,7048
-90,-30,160,1517,1488,3005,6909
-80,20,-110,1535,1470,3005,6950
10,50,100,1514,1492,3006,6605
-140,-30,80,1528,1478,3006,6809
-150,50,-140,1495,1511,3006,6804
100,-50,-150,1487,1519,3006,6776
120,40,-30,1514,1492,3006,6736
-170,-50,-120,1524,1482,3006,6872
70,-10,-140,1477,1530,3007,6780
130,-50,-140,1489,1518,3007,6921
-70,0,100,1521,1487,3008,7018
50,10,-110,1525,1483,3008,6958
-130,-10,-70,1519,1490,3009,6985
150,10,-100,1507,1502,3009,6873
0,-60,100,1512,1497,3009,6909
100,-40,-130,1490,1520,3010,6770
-10,-60,80,1503,1507,3010,6977
150,50,90,1516,1494,3010,7029
40,-80,130,1532,1478,3010,6860
100,70,140,1543,1467,3010,6809
100,-70,170,1521,1489,3010,7044
-10,70,90,1531,1479,3010,6965
40,50,-140,1533,1478,3011,6906
-110,80,180,1519,1492,3011,6927
-90,30,170,1519,1492,3011,7024
-140,30,-140,1512,1499,3011,6865
110,50,-10,1487,1524,3011,6903
-110,80,-180,1519,1492,3011,6927
110,10,50,1506,1505,3011,6837
-20,-40,70,1528,1484,3012,6853
-140,10,-130,1500,1512,3012,7125
50,80,40,1483,1529,3012,6715
-120,80,-170,1525,1487,3012,6902
-80,-60,20,1519,1493,3012,6888
50,-70,150,1500,1512,3012,6902
-110,20,-40,1511,1501,3012,6711
-160,30,-130,1503,1510,3013,6826
50,-40,180,1489,1524,3013,6599
50,-40,-180,1489,1524,3013,6599
-160,-50,-110,1523,1490,3013,6966
-50,-20,60,1517,1497,3014,7028
0,-70,80,1500,1514,3014,6876
-70,50,110,1534,1480,3014,7289
-100,30,-30,1510,1504,3014,6984
0,50,100,1555,1459,3014,6700
-100,80,170,1525,1490,3015,6864
0,-20,110,1520,1495,3015,6716
30,-80,120,1533,1482,3015,6910
120,-30,-120,1488,1527,3015,6811
-170,30,60,1509,1506,3015,6801
-150,40,-140,1487,1528,3015,6838
-20,60,70,1487,1528,3015,7041
70,-60,150,1512,1503,3015,6902
70,-80,150,1518,1497,3015,7062
60,-10,-90,1513,1503,3016,6887
-30,-20,60,1505,1511,3016,7171
-60,70,130,1524,1492,3016,6694
70,80,20,1480,1536,3016,6705
-70,10,120,1546,1470,3016,7054
-130,20,-140,1524,1492,3016,7076
130,50,-40,1505,1511,3016,6898
-130,10,-130,1506,1510,3016,7031
80,-60,160,1495,1522,3017,7027
-20,50,70,1503,1514,3017,7240
10,10,110,1504,1513,3017,6799
150,-20,70,1530,1487,3017,7053
-20,80,100,1512,1505,3017,6971
-140,-10,-120,1502,1515,3017,6966
-140,-40,100,1526,1491,3017,7069
30,-10,140,1521,1496,3017,6584
-40,20,70,1517,1501,3018,7253
-10,-30,80,1515,1504,3019,6830
10,-70,90,1507,1512,3019,6957
100,60,0,1479,1540,3019,6814
-60,50,120,1521,1498,3019,7053
150,80,-70,1505,1514,3019,6881
-80,-10,120,1512,1507,3019,6982
-10,-60,90,1526,1493,3019,6821
-50,30,80,1508,1511,3019,7039
120,-10,-90,1495,1525,3020,6901
-100,-40,30,1509,1512,3021,6875
160,-60,-140,1514,1508,3022,7015
20,-70,100,1513,1509,3022,7065
-90,-50,20,1521,1501,3022,7000
80,60,30,1533,1489,3022,6780
-110,20,-20,1540,1483,3023,6909
110,-70,-180,1528,1495,3023,7174
160,30,-100,1506,1517,3023,6973
50,-80,140,1548,1475,3023,6768
40,20,-110,1506,1517,3023,6821
-140,-20,60,1531,1492,3023,6671
110,-70,180,1528,1495,3023,7174
110,10,20,1491,1532,3023,6850
60,-80,140,1512,1511,3023,7067
160,80,-80,1519,1505,3024,6944
130,0,-80,1521,1503,3024,6762
-110,40,180,1505,1519,3024,7158
-110,40,-180,1505,1519,3024,7158
-120,20,-140,1515,1510,3025,6921
50,-80,130,1506,1519,3025,7081
140,0,-90,1509,1516,3025,6841
120,20,-50,1482,1543,3025,6950
140,60,-60,1517,1510,3027,6929
140,30,-70,1542,1485,3027,6975
50,60,-160,1516,1511,3027,6957
-100,-60,0,1532,1495,3027,6921
110,-80,-180,1522,1505,3027,7329
-40,60,100,1542,1485,3027,7090
20,-70,120,1528,1499,3027,7018
110,-80,180,1522,1505,3027,7329
-50,70,120,1518,1510,3028,6720
30,60,80,1500,1528,3028,6813
150,-20,-120,1499,1529,3028,6997
80,-80,160,1529,1500,3029,7058
60,-80,150,1540,1489,3029,6749
80,80,10,1490,1540,3030,6727
-150,-80,-80,1506,1524,3030,7179
-170,50,-120,1526,1504,3030,6928
-110,10,-130,1501,1529,3030,7058
0,-10,90,1528,1502,3030,6975
-160,60,-130,1552,1479,3031,6830
20,50,100,1529,1502,3031,6546
-60,20,90,1532,1499,3031,7181
-40,-60,50,1529,1502,3031,6944
-50,60,110,1537,1494,3031,7168
-80,-50,30,1535,1496,3031,7043
140,50,-60,1515,1517,3032,7031
-90,-70,170,1535,1497,3032,6732
-150,60,40,1531,1501,3032,6886
40,80,50,1499,1534,3033,6790
-90,-20,150,1532,1501,3033,6936
-120,-20,-20,1515,1518,3033,7016
-170,20,60,1512,1521,3033,6681
80,70,20,1507,1527,3034,6867
-120,-20,10,1533,1501,3034,6934
-10,-50,90,1531,1503,3034,6897
-120,10,-50,1526,1508,3034,6813
-80,10,150,1524,1510,3034,7040
-40,10,-100,1505,1529,3034,6950
-10,50,90,1516,1518,3034,7139
-70,-80,10,1512,1523,3035,7154
-10,-70,90,1549,1486,3035,7066
-140,60,-160,1491,1544,3035,7013
-150,-20,-120,1533,1502,3035,7238
50,0,180,1492,1544,3036,6500
-140,40,-150,1516,1520,3036,6963
50,-20,-180,1500,1536,3036,6538
-30,60,100,1529,1507,3036,7068
120,-20,40,1511,1525,3036,7117
50,0,-180,1492,1544,3036,6500
-140,-30,-100,1527,1509,3036,7181
50,40,-160,1506,1530,3036,6922
50,-20,180,1500,1536,3036,6538
-170,40,-120,1515,1522,3037,6919
160,10,-110,1525,1512,3037,6924
160,-10,-120,1509,1528,3037,7001
-20,-70,70,1521,1517,3038,6957
90,-80,170,1534,1504,3038,7132
170,-40,-130,1534,1504,3038,7109
80,-10,-120,1506,1532,3038,6807
-170,20,-120,1526,1513,3039,7066
10,-60,120,1543,1496,3039,6959
20,-50,-80,1500,1539,3039,7138
130,-40,-130,1511,1528,3039,6989
-120,60,180,1512,1527,3039,6938
-120,60,-180,1512,1527,3039,6938
-180,0,-120,1536,1504,3040,7079
180,0,-120,1536,1504,3040,7079
-120,0,-10,1558,1482,3040,7071
-30,70,-70,1509,1531,3040,7275
10,60,90,1516,1525,3041,6656
-40,-40,-130,1537,1504,3041,6807
0,-70,90,1540,1501,3041,7018
10,50,-100,1511,1530,3041,6983
-20,-50,70,1536,1505,3041,7090
-70,-60,30,1544,1497,3041,7035
120,-80,-170,1529,1512,3041,7405
80,-70,160,1539,1502,3041,6977
160,-50,70,1538,1504,3042,7156
-100,30,-170,1532,1511,3043,7179
30,80,60,1500,1543,3043,6793
-150,-70,110,1537,1506,3043,7028
20,10,120,1521,1522,3043,6705
-90,-70,0,1520,1523,3043,7145
-20,-60,70,1522,1521,3043,7037
110,-10,10,1475,1569,3044,6876
-120,-60,-30,1539,1505,3044,6980
-30,-10,-110,1533,1511,3044,6972
-130,70,-160,1540,1504,3044,6849
-150,60,-140,1543,1501,3044,6986
-120,-30,90,1534,1511,3045,6801
60,80,-170,1550,1495,3045,7113
130,-50,40,1523,1522,3045,6942
-30,-30,60,1537,1508,3045,7083
-140,-20,-110,1509,1536,3045,7017
30,60,-130,1564,1482,3046,7041
-70,10,-130,1517,1529,3046,6797
0,20,100,1525,1521,3046,6761
-60,60,120,1532,1514,3046,7001
-10,-40,80,1513,1534,3047,7001
90,80,0,1496,1551,3047,6742
-60,10,-110,1540,1507,3047,6955
70,-80,160,1557,1490,3047,6795
-170,80,60,1540,1507,3047,6957
60,30,120,1524,1523,3047,6868
140,30,90,1541,1507,3048,7018
40,-80,120,1522,1526,3048,7166
100,-80,180,1547,1502,3049,7079
-160,-60,100,1535,1514,3049,7099
10,-70,100,1547,1502,3049,7000
100,-80,-180,1547,1502,3049,7079
60,-70,160,1520,1529,3049,7047
-120,-70,-40,1521,1528,3049,7114
-140,-40,-80,1551,1498,3049,7246
30,70,70,1518,1532,3050,6734
0,30,100,1525,1525,3050,6779
90,-70,-180,1541,1509,3050,7023
-40,50,80,1520,1530,3050,7222
30,-60,140,1511,1539,3050,7003
90,-70,180,1541,1509,3050,7023
-120,30,-150,1521,1529,3050,7029
-40,50,100,1574,1477,3051,7078
120,70,-30,1498,1553,3051,6839
10,70,80,1526,1525,3051,6912
120,-40,-130,1488,1563,3051,6966
-60,-20,-150,1549,1502,3051,6919
60,-80,160,1549,1502,3051,6942
-20,-30,70,1525,1526,3051,7053
-80,20,150,1552,1499,3051,6901
110,10,40,1512,1539,3051,6948
-130,60,-170,1502,1550,3052,7019
-90,-80,-10,1528,1524,3052,7134
-90,20,-170,1539,1513,3052,6984
-130,40,-150,1520,1532,3052,6944
-50,40,-70,1529,1523,3052,6827
-140,-60,-70,1539,1513,3052,7049
-90,10,-160,1561,1492,3053,7184
-50,-50,50,1543,1510,3053,7202
-90,-20,110,1517,1536,3053,6878
20,-80,110,1545,1508,3053,7050
-10,40,90,1542,1511,3053,7122
-80,-80,0,1523,1530,3053,7146
110,10,0,1551,1503,3054,6976
-60,-80,20,1523,1531,3054,7130
-90,40,-30,1531,1523,3054,7014
-60,50,100,1546,1509,3055,7334
90,-60,-10,1515,1540,3055,6977
-100,20,-100,1531,1524,3055,7092
110,0,0,1527,1529,3056,6938
-70,-10,80,1524,1532,3056,7192
-90,20,-120,1543,1514,3057,6992
80,-80,170,1561,1496,3057,6852
110,0,-60,1510,1548,3058,7154
-110,20,-60,1555,1503,3058,6693
-80,-70,10,1526,1532,3058,7175
180,0,70,1537,1521,3058,7065
-180,0,70,1537,1521,3058,7065
20,50,-110,1530,1528,3058,7111
-30,50,90,1574,1485,3059,7086
-10,-50,100,1537,1523,3060,6817
70,-30,-50,1515,1546,3061,7247
160,50,-90,1516,1545,3061,6949
-30,80,110,1533,1528,3061,7038
90,70,10,1503,1558,3061,6894
-10,-40,90,1532,1530,3062,7129
40,-80,140,1556,1506,3062,7083
60,0,-160,1505,1557,3062,6819
100,40,30,1552,1510,3062,6798
-70,50,130,1556,1506,3062,6989
50,70,-160,1540,1523,3063,7084
0,-50,110,1547,1516,3063,6850
-130,-20,50,1561,1502,3063,6824
-60,50,110,1556,1507,3063,7172
-40,80,120,1533,1531,3064,7083
-10,-70,80,1548,1516,3064,7049
-80,30,-70,1541,1523,3064,6819
-10,-70,100,1564,1500,3064,6784
-40,-20,60,1532,1532,3064,7270
-50,-80,30,1530,1534,3064,7095
-90,-30,60,1534,1530,3064,6936
160,20,-100,1544,1520,3064,7008
-70,0,110,1546,1519,3065,7194
10,-70,120,1554,1511,3065,6916
-60,0,80,1532,1533,3065,7226
10,-80,90,1530,1535,3065,7090
120,30,-40,1502,1563,3065,7237
70,-70,170,1550,1515,3065,7198
0,-60,110,1556,1509,3065,7027
70,0,-110,1519,1546,3065,7001
-120,40,-160,1502,1563,3065,7074
-10,-10,80,1546,1519,3065,7135
-150,40,-130,1554,1512,3066,7126
-120,-10,-10,1536,1530,3066,7121
-120,10,-120,1527,1539,3066,7243
160,-40,-130,1527,1539,3066,7252
70,-80,170,1548,1518,3066,7020
-70,-50,40,1563,1504,3067,7183
170,-10,-120,1544,1523,3067,7022
-20,-80,60,1538,1529,3067,6988
-60,60,130,1540,1527,3067,6895
140,-50,-140,1505,1562,3067,7250
100,-60,0,1529,1538,3067,6787
-50,0,-120,1535,1532,3067,6920
10,-70,110,1543,1525,3068,7133
-140,50,-150,1523,1545,3068,7142
90,70,150,1570,1498,3068,6932
60,-20,-70,1516,1552,3068,7168
-20,70,100,1553,1516,3069,7150
10,20,110,1540,1529,3069,6891
-100,-70,-10,1552,1517,3069,7146
-20,30,80,1555,1514,3069,7326
50,20,130,1502,1567,3069,7005
130,-80,-160,1542,1528,3070,7414
120,-70,-170,1557,1513,3070,7292
10,-80,100,1544,1527,3071,7158
-10,-80,90,1549,1522,3071,6915
-180,10,-120,1536,1535,3071,7076
180,10,-120,1536,1535,3071,7076
0,-80,80,1526,1545,3071,7069
20,-70,130,1565,1507,3072,7029
0,-10,100,1549,1523,3072,7118
120,10,70,1549,1523,3072,7131
10,-80,110,1566,1506,3072,7083
-30,-60,60,1535,1537,3072,6951
-70,30,130,1561,1512,3073,7058
-20,-70,90,1558,1515,3073,6877
-80,-30,-180,1548,1525,3073,7084
20,-80,100,1530,1543,3073,7152
120,-60,-160,1526,1547,3073,7143
-150,-50,100,1561,1512,3073,7191
-80,-30,180,1548,1525,3073,7084
-130,-50,-50,1558,1516,3074,7022
-80,-20,-180,1552,1522,3074,7035
-40,-40,60,1561,1513,3074,7319
-140,40,-140,1531,1543,3074,7051
-160,-10,60,1582,1492,3074,6907
-20,30,70,1569,1505,3074,7353
-160,-20,-120,1564,1510,3074,7414
-120,-10,0,1547,1527,3074,7168
30,-80,110,1532,1542,3074,7228
130,10,-70,1528,1546,3074,6996
-80,-20,180,1552,1522,3074,7035
0,60,90,1547,1527,3074,7022
-90,10,-150,1577,1498,3075,7223
100,-30,-120,1517,1558,3075,6838
130,-10,60,1552,1523,3075,7132
0,-80,90,1545,1530,3075,7228
-50,-60,50,1547,1528,3075,7067
-50,50,90,1538,1537,3075,7185
-160,-20,70,1560,1516,3076,7005
-100,-30,130,1515,1561,3076,7146
-20,-10,70,1557,1519,3076,7277
-90,20,-110,1549,1527,3076,7009
-140,60,30,1582,1494,3076,7111
-90,-20,140,1540,1537,3077,7081
170,80,-90,1542,1535,3077,6937
-40,-80,40,1539,1539,3078,7016
-10,-60,100,1533,1545,3078,6935
-160,-80,-90,1540,1538,3078,7312
100,-50,0,1548,1530,3078,6977
150,-10,-110,1531,1547,3078,7002
30,-20,-80,1505,1574,3079,7055
-100,30,-160,1565,1514,3079,7115
-60,30,-80,1535,1544,3079,6891
-100,40,170,1564,1515,3079,7363
70,-30,-150,1531,1548,3079,6818
-10,-80,80,1547,1532,3079,7242
150,70,-70,1524,1555,3079,7176
10,70,-110,1554,1525,3079,7274
-30,-40,70,1558,1522,3080,7083
0,-70,100,1548,1532,3080,7041
60,-40,-50,1527,1553,3080,7217
-10,-80,70,1541,1540,3081,7024
-50,60,120,1566,1515,3081,6922
-120,70,-170,1563,1518,3081,6884
-80,10,-140,1542,1539,3081,7171
0,-80,100,1562,1519,3081,6990
-20,-70,80,1565,1516,3081,6980
90,-80,-180,1571,1511,3082,6979
-20,-60,80,1543,1539,3082,6806
80,-70,-180,1551,1531,3082,7140
30,-70,140,1550,1532,3082,7009
90,-80,180,1571,1511,3082,6979
40,-60,150,1542,1540,3082,7115
-30,-70,60,1545,1537,3082,7053
80,-70,180,1551,1531,3082,7140
30,-80,130,1571,1511,3082,7091
140,10,-80,1546,1537,3083,7039
-110,-60,-10,1566,1517,3083,7048
50,-50,170,1529,1554,3083,7080
-50,80,130,1543,1540,3083,7158
-70,70,140,1551,1532,3083,6849
50,80,-160,1565,1519,3084,7211
-150,20,-130,1546,1538,3084,7139
-30,40,70,1545,1539,3084,7318
-60,-60,40,1539,1545,3084,7175
150,-50,-140,1533,1551,3084,7400
-60,-10,70,1529,1556,3085,7238
140,-80,-150,1540,1545,3085,7492
-180,-80,-110,1540,1545,3085,7398
180,-80,-110,1540,1545,3085,7398
80,40,140,1543,1543,3086,6977
60,-60,-40,1530,1556,3086,7224
-70,-70,20,1534,1552,3086,7136
-40,-50,60,1555,1531,3086,7162
-170,-80,-100,1546,1541,3087,7403
130,60,110,1549,1538,3087,7014
60,-60,170,1558,1529,3087,7278
120,-50,-140,1531,1556,3087,6964
180,80,-100,1542,1546,3088,7064
-20,40,70,1529,1559,3088,7337
-110,40,-170,1530,1558,3088,7092
-20,50,90,1573,1515,3088,7154
-20,-80,80,1567,1521,3088,6862
110,0,-30,1550,1538,3088,7054
-180,80,-100,1542,1546,3088,7064
-10,30,90,1555,1533,3088,7106
50,-80,150,1566,1523,3089,6977
100,30,50,1559,1530,3089,7042
-90,30,-180,1552,1537,3089,7058
-160,50,50,1559,1530,3089,6797
150,40,-80,1564,1525,3089,6998
-100,-50,10,1559,1530,3089,7185
-160,40,50,1540,1549,3089,7058
-30,-80,50,1547,1542,3089,7007
-90,30,180,1552,1537,3089,7058
-130,0,-80,1563,1527,3090,7068
110,-80,-170,1567,1523,3090,7131
140,40,-60,1529,1562,3091,7055
90,-70,170,1549,1542,3091,7183
0,-70,110,1577,1514,3091,6895
130,60,-40,1544,1547,3091,6965
70,-20,-70,1551,1540,3091,7134
130,-10,-90,1543,1548,3091,6944
120,-40,30,1547,1544,3091,7214
110,60,-10,1505,1586,3091,7009
-110,-30,100,1563,1528,3091,6921
130,30,-50,1517,1575,3092,7013
-30,-70,80,1553,1539,3092,6991
-110,70,180,1583,1509,3092,6890
-130,50,-150,1555,1537,3092,7073
-140,-50,-70,1575,1517,3092,7184
-110,70,-180,1583,1509,3092,6890
-150,30,40,1554,1538,3092,6989
90,-50,-150,1528,1564,3092,7087
-100,-50,150,1562,1531,3093,7180
140,-40,-130,1539,1554,3093,7076
80,-30,-40,1550,1543,3093,7170
-50,0,70,1557,1536,3093,7362
-100,70,170,1586,1508,3094,7028
-120,20,0,1576,1518,3094,7253
20,80,70,1539,1555,3094,6857
-150,-70,-80,1547,1547,3094,7208
170,-80,-120,1541,1553,3094,7414
100,-70,-170,1558,1536,3094,7093
-10,-20,80,1561,1533,3094,7255
160,-80,-130,1544,1550,3094,7493
-100,-80,-20,1557,1538,3095,7172
-40,60,110,1559,1536,3095,7006
-30,-80,70,1572,1523,3095,6983
30,30,-110,1538,1557,3095,6896
-20,-50,80,1545,1550,3095,7130
20,-10,130,1560,1536,3096,6980
-130,-30,80,1579,1517,3096,7030
120,-60,-150,1565,1531,3096,7073
110,10,30,1541,1555,3096,7074
140,-10,-100,1524,1573,3097,6910
150,-80,-140,1549,1548,3097,7502
-120,0,-20,1564,1533,3097,6917
80,-80,-180,1565,1532,3097,7111
130,40,-40,1546,1551,3097,7135
80,-80,180,1565,1532,3097,7111
90,-20,-40,1526,1571,3097,7011
-120,50,-170,1577,1521,3098,6994
20,-80,120,1582,1516,3098,7111
50,60,70,1546,1552,3098,6793
120,70,120,1574,1525,3099,6834
-110,-80,-30,1558,1541,3099,7180
-70,40,130,1569,1530,3099,7257
-170,0,-120,1559,1540,3099,7160
-30,20,70,1582,1517,3099,7549
-10,-30,90,1550,1549,3099,7106
-60,40,100,1579,1520,3099,7331
-80,-40,50,1552,1547,3099,7308
-50,40,90,1566,1533,3099,7154
110,20,0,1531,1569,3100,6925
-10,30,-90,1539,1561,3100,7059
-50,-70,40,1538,1562,3100,7179
-80,30,150,1573,1528,3101,7335
-10,0,80,1557,1544,3101,7105
-130,-40,-50,1555,1546,3101,7053
-150,-10,-120,1561,1540,3101,7495
-60,10,90,1564,1537,3101,7351
-10,10,80,1566,1535,3101,7181
110,-20,-100,1543,1558,3101,6953
-60,-70,30,1541,1560,3101,7129
-150,70,40,1559,1543,3102,7192
50,-10,-180,1524,1578,3102,6687
50,-10,180,1524,1578,3102,6687
-30,30,80,1581,1521,3102,7359
-160,-40,90,1606,1497,3103,7267
0,10,100,1557,1546,3103,6865
-170,10,-120,1563,1540,3103,7413
-110,40,-160,1559,1544,3103,7351
-110,30,-10,1582,1521,3103,7228
-20,-20,70,1560,1543,3103,7098
140,-60,-150,1538,1565,3103,7354
-110,-70,-20,1566,1538,3104,7160
-20,-40,80,1571,1533,3104,7166
-60,80,140,1549,1555,3104,7086
90,40,130,1548,1556,3104,7016
-20,-30,80,1552,1552,3104,7231
100,30,90,1528,1577,3105,7139
90,-80,-170,1566,1539,3105,7151
-40,-60,60,1562,1543,3105,7027
90,-20,-60,1544,1561,3105,6870
0,0,100,1550,1555,3105,7053
-30,-70,70,1570,1535,3105,6984
-100,20,-120,1564,1542,3106,7274
60,60,60,1563,1543,3106,6744
-120,40,-150,1542,1565,3107,7231
-40,50,90,1567,1540,3107,7438
170,-50,-130,1559,1548,3107,7266
-130,10,-120,1540,1567,3107,7528
-40,-70,50,1551,1556,3107,7161
-50,-70,50,1548,1559,3107,7216
130,-30,-120,1536,1571,3107,7082
-150,-30,-110,1559,1548,3107,7145
-20,20,80,1568,1539,3107,7313
50,-60,-50,1539,1569,3108,7210
-130,-10,-80,1560,1548,3108,7206
70,-60,-30,1521,1587,3108,7202
100,-10,-70,1551,1557,3108,7085
-170,-40,-120,1569,1539,3108,7086
100,80,-10,1516,1592,3108,6914
-50,50,110,1578,1530,3108,7281
30,30,110,1548,1560,3108,6897
100,-70,-180,1554,1555,3109,7272
100,-70,180,1554,1555,3109,7272
-40,40,80,1558,1551,3109,7373
80,-60,-170,1564,1546,3110,7262
-40,-80,60,1584,1526,3110,7042
-40,-70,60,1559,1551,3110,7018
-30,50,80,1555,1555,3110,7455
-50,20,80,1574,1536,3110,7346
130,-20,-100,1559,1552,3111,6972
100,-10,-90,1572,1539,3111,7143
110,-60,10,1556,1555,3111,7129
-30,-50,70,1575,1536,3111,7092
70,60,50,1564,1548,3112,6873
-90,-20,130,1529,1583,3112,7140
30,-40,150,1551,1561,3112,6959
180,-10,-120,1551,1561,3112,7127
-70,-50,-170,1554,1558,3112,7172
-80,-20,80,1558,1554,3112,7248
-180,-10,-120,1551,1561,3112,7127
-170,80,-110,1543,1570,3113,7081
-40,0,-110,1549,1564,3113,7213
110,-10,0,1558,1555,3113,7118
-80,0,-160,1581,1532,3113,7362
-160,80,50,1576,1537,3113,7160
-150,30,-130,1558,1555,3113,7071
140,50,-50,1554,1560,3114,7062
50,-60,160,1562,1552,3114,7249
-100,60,-10,1568,1546,3114,7462
30,-90,110,1555,1560,3115,7234
100,-90,-180,1555,1560,3115,7234
-60,-90,20,1555,1560,3115,7234
-180,-90,-100,1555,1560,3115,7234
-170,-90,-90,1555,1560,3115,7234
-20,-90,60,1555,1560,3115,7234
160,-90,-120,1555,1560,3115,7234
-10,-90,70,1555,1560,3115,7234
-120,-90,-40,1555,1560,3115,7234
160,30,80,1581,1534,3115,7088
170,-90,-110,1555,1560,3115,7234
40,-90,120,1555,1560,3115,7234
110,-50,10,1565,1550,3115,7081
-140,-90,-60,1555,1560,3115,7234
140,-90,-140,1555,1560,3115,7234
-30,-90,50,1555,1560,3115,7234
130,-90,-150,1555,1560,3115,7234
-70,-90,10,1555,1560,3115,7234
100,-90,180,1555,1560,3115,7234
60,-90,140,1555,1560,3115,7234
120,-90,-160,1555,1560,3115,7234
-40,-90,40,1555,1560,3115,7234
-150,-90,-70,1555,1560,3115,7234
-90,-90,-10,1555,1560,3115,7234
-160,-90,-80,1555,1560,3115,7234
-80,-90,0,1555,1560,3115,7234
150,-90,-130,1555,1560,3115,7234
-130,-90,-50,1555,1560,3115,7234
70,-90,150,1555,1560,3115,7234
-100,-90,-20,1555,1560,3115,7234
110,-90,-170,1555,1560,3115,7234
80,-90,160,1555,1560,3115,7234
-110,-90,-30,1555,1560,3115,7234
90,-90,170,1555,1560,3115,7234
10,-90,90,1555,1560,3115,7234
20,-90,100,1555,1560,3115,7234
180,-90,-100,1555,1560,3115,7234
-50,-90,30,1555,1560,3115,7234
0,-90,80,1555,1560,3115,7234
50,-90,130,1555,1560,3115,7234
130,-70,-160,1568,1548,3116,7380
-130,-80,-50,1581,1535,3116,7206
70,-60,180,1567,1549,3116,7262
-130,20,-130,1565,1551,3116,7280
-20,-60,90,1547,1569,3116,7002
60,60,-180,1582,1534,3116,7119
70,-60,-180,1567,1549,3116,7262
170,-60,-130,1562,1554,3116,7303
-30,-60,70,1557,1559,3116,6943
60,60,180,1582,1534,3116,7119
110,0,-20,1553,1563,3116,7188
10,40,-100,1546,1571,3117,6999
-70,10,130,1577,1540,3117,7118
-80,70,150,1574,1543,3117,7133
70,-40,-40,1568,1550,3118,7184
-140,50,-140,1561,1557,3118,7242
10,-10,-90,1533,1585,3118,7134
100,-80,-170,1584,1534,3118,7136
-80,20,-120,1555,1563,3118,7137
-120,50,-160,1549,1570,3119,7061
-60,40,110,1584,1535,3119,7277
150,-40,-130,1553,1566,3119,7185
110,20,10,1561,1558,3119,6926
90,-70,-170,1568,1552,3120,7128
-130,-20,-60,1573,1547,3120,7023
-140,60,-150,1573,1548,3121,7139
0,70,90,1547,1574,3121,7189
170,20,-110,1572,1549,3121,7140
-10,-40,100,1547,1574,3121,6856
-160,30,50,1544,1577,3121,7047
-110,-40,0,1550,1571,3121,7242
-130,60,20,1578,1543,3121,7065
-60,-40,50,1564,1558,3122,7390
160,40,80,1591,1531,3122,7227
-140,10,30,1562,1560,3122,7118
-20,0,70,1557,1566,3123,7333
-100,40,180,1556,1568,3124,7148
50,0,-100,1552,1572,3124,7023
100,-10,-80,1541,1583,3124,7088
-130,50,-160,1573,1551,3124,7080
30,-30,150,1544,1580,3124,6989
110,80,-20,1543,1581,3124,7045
70,-70,-30,1535,1589,3124,7012
-100,40,-180,1556,1568,3124,7148
-70,-60,-170,1564,1561,3125,6954
60,-10,-160,1537,1588,3125,6909
-160,-60,-100,1585,1540,3125,7428
150,30,-80,1562,1564,3126,6953
-20,10,70,1557,1569,3126,7532
-100,20,-150,1595,1532,3127,7234
110,-30,10,1559,1568,3127,7115
-30,40,-80,1567,1560,3127,7160
-70,60,140,1577,1550,3127,7184
110,-60,-150,1575,1552,3127,7180
110,0,-40,1566,1561,3127,7086
-130,30,-140,1568,1559,3127,7246
-150,50,-130,1550,1577,3127,7211
150,20,-90,1559,1569,3128,7194
-100,30,-40,1552,1576,3128,6993
-90,-50,30,1561,1567,3128,7193
-20,-80,70,1564,1564,3128,7293
10,-40,-90,1543,1585,3128,7095
-80,-70,-180,1596,1532,3128,6849
-90,40,160,1606,1522,3128,7397
-80,-70,180,1596,1532,3128,6849
-120,60,10,1573,1555,3128,7092
-30,-60,80,1552,1576,3128,7133
-60,10,-120,1576,1552,3128,7024
140,40,-50,1546,1582,3128,7073
-140,60,-140,1559,1570,3129,7141
170,-20,-120,1570,1559,3129,7174
-70,-40,50,1600,1529,3129,7334
-90,30,-60,1590,1539,3129,7040
-170,-50,90,1596,1533,3129,7344
-120,-80,-40,1581,1548,3129,7133
100,-80,-160,1579,1551,3130,7155
-80,-50,40,1574,1556,3130,7204
100,70,0,1528,1602,3130,6956
-170,-10,-120,1591,1540,3131,7261
-120,-70,-30,1587,1545,3132,7212
-120,-30,80,1571,1561,3132,7077
160,70,-80,1539,1593,3132,7317
-20,20,70,1572,1560,3132,7561
160,-70,60,1563,1570,3133,7163
-40,10,70,1577,1556,3133,7569
80,-60,-20,1541,1592,3133,7178
80,-20,-130,1586,1547,3133,7089
-70,-10,90,1558,1576,3134,7247
-140,0,-120,1581,1553,3134,7480
-140,-30,-90,1564,1570,3134,7516
-150,80,40,1593,1541,3134,7407
20,60,90,1572,1562,3134,7059
-80,-20,90,1558,1576,3134,7190
-20,60,100,1565,1570,3135,7417
-180,40,-110,1570,1565,3135,7267
40,-70,150,1560,1575,3135,7102
180,40,-110,1570,1565,3135,7267
-50,50,100,1587,1549,3136,7387
10,40,110,1578,1558,3136,6821
-20,0,-100,1572,1564,3136,7260
60,-20,-160,1547,1589,3136,6889
-110,-30,50,1582,1554,3136,6878
-30,0,70,1591,1545,3136,7508
20,70,80,1564,1572,3136,6899
40,-60,-60,1542,1594,3136,7203
130,70,-40,1544,1593,3137,7019
-130,60,-160,1580,1557,3137,7180
-30,30,70,1580,1558,3138,7703
70,40,90,1595,1543,3138,6969
-170,-30,-120,1585,1553,3138,7433
-100,40,-170,1564,1574,3138,7535
130,40,100,1567,1571,3138,7349
-70,20,130,1578,1561,3139,7147
-170,10,60,1587,1552,3139,7162
80,-70,-20,1557,1583,3140,6989
40,-40,170,1567,1574,3141,6869
-70,80,150,1564,1577,3141,7093
120,-80,-160,1602,1539,3141,7183
-140,-80,-60,1600,1541,3141,7210
-120,20,-130,1591,1550,3141,7029
-90,20,-130,1586,1555,3141,7353
-90,70,160,1595,1546,3141,7185
-20,-50,90,1561,1581,3142,7071
-100,-50,20,1589,1553,3142,7269
-180,-30,80,1575,1567,3142,7473
180,50,-110,1582,1560,3142,7248
-180,50,-110,1582,1560,3142,7248
10,80,80,1551,1591,3142,7019
180,-30,80,1575,1567,3142,7473
-30,-20,70,1602,1541,3143,7206
-20,40,90,1598,1545,3143,7223
50,-40,-60,1549,1594,3143,7356
110,0,-10,1585,1558,3143,7095
-120,10,-100,1573,1570,3143,7340
-130,-30,-50,1584,1560,3144,6960
-50,-40,50,1573,1571,3144,7469
170,50,-100,1565,1579,3144,7289
110,50,120,1556,1588,3144,7061
-30,40,80,1592,1552,3144,7482
160,-20,-120,1569,1575,3144,7394
-60,50,130,1581,1563,3144,7273
-40,40,90,1594,1550,3144,7465
-50,-10,-130,1597,1548,3145,6936
170,70,-90,1554,1592,3146,7293
-40,-30,60,1589,1557,3146,7435
-130,10,-80,1591,1555,3146,7035
-130,-70,-50,1580,1566,3146,7417
-20,70,-80,1559,1587,3146,7506
-140,20,-130,1593,1553,3146,7382
-140,-60,-60,1598,1548,3146,7320
-160,10,-120,1597,1549,3146,7241
-150,-10,50,1592,1555,3147,6871
-110,50,180,1588,1559,3147,7197
-90,-20,120,1567,1580,3147,7176
-110,50,-180,1588,1559,3147,7197
-30,-80,60,1573,1574,3147,7247
-90,60,-20,1570,1577,3147,7374
80,70,160,1581,1566,3147,7225
-10,-20,90,1569,1578,3147,7411
-80,-30,60,1562,1586,3148,7429
-60,30,100,1616,1532,3148,7549
-160,80,-120,1560,1588,3148,7095
-130,10,-70,1590,1558,3148,6979
-160,30,-120,1611,1537,3148,7328
150,-40,60,1597,1551,3148,7179
-160,50,-120,1571,1577,3148,7373
120,-30,-110,1548,1601,3149,7145
10,-30,-90,1548,1601,3149,7225
-10,20,90,1573,1576,3149,7236
-110,60,0,1591,1558,3149,7275
180,70,-100,1553,1596,3149,7121
-180,70,-100,1553,1596,3149,7121
-130,-10,-90,1563,1586,3149,7223
-100,-30,60,1585,1564,3149,7013
-90,80,170,1569,1581,3150,7053
110,-20,10,1547,1603,3150,7045
-10,-30,100,1591,1560,3151,7127
-60,-50,50,1577,1574,3151,7355
50,20,-140,1568,1583,3151,7341
-150,-80,-70,1600,1551,3151,7259
60,30,160,1593,1559,3152,6922
-120,60,-160,1573,1579,3152,7286
160,0,-110,1589,1563,3152,7228
110,0,-50,1553,1599,3152,7105
130,-80,-150,1612,1541,3153,7238
130,20,-60,1583,1570,3153,7333
-50,-90,40,1600,1554,3154,7216
110,-90,-160,1600,1554,3154,7216
70,-90,160,1600,1554,3154,7216
50,20,-130,1603,1551,3154,7248
-70,-90,20,1600,1554,3154,7216
-150,-90,-60,1600,1554,3154,7216
120,-90,-150,1600,1554,3154,7216
-130,-90,-40,1600,1554,3154,7216
150,-90,-120,1600,1554,3154,7216
-40,-90,50,1600,1554,3154,7216
50,-90,140,1600,1554,3154,7216
90,-90,180,1600,1554,3154,7216
-120,-90,-30,1600,1554,3154,7216
170,-90,-100,1600,1554,3154,7216
-160,-90,-70,1600,1554,3154,7216
100,-90,-170,1600,1554,3154,7216
-100,-90,-10,1600,1554,3154,7216
80,-90,170,1600,1554,3154,7216
-140,-90,-50,1600,1554,3154,7216
-80,-90,10,1600,1554,3154,7216
140,-90,-130,1600,1554,3154,7216
40,-90,130,1600,1554,3154,7216
0,-90,90,1600,1554,3154,7216
160,-90,-110,1600,1554,3154,7216
-170,-90,-80,1600,1554,3154,7216
-20,-90,70,1600,1554,3154,7216
-180,-90,-90,1600,1554,3154,7216
-10,-90,80,1600,1554,3154,7216
30,-90,120,1600,1554,3154,7216
180,-90,-90,1600,1554,3154,7216
130,-90,-140,1600,1554,3154,7216
-90,-90,0,1600,1554,3154,7216
90,-90,-180,1600,1554,3154,7216
-60,-90,30,1600,1554,3154,7216
10,-90,100,1600,1554,3154,7216
20,-90,110,1600,1554,3154,7216
-80,60,150,1597,1557,3154,7306
-30,-90,60,1600,1554,3154,7216
60,-90,150,1600,1554,3154,7216
-110,-90,-20,1600,1554,3154,7216
60,70,50,1571,1584,3155,6990
110,-80,-150,1590,1565,3155,7253
-30,-50,80,1567,1588,3155,7242
-30,30,90,1596,1559,3155,7269
-170,70,-110,1583,1572,3155,7198
-110,-30,90,1576,1579,3155,7075
-160,-30,80,1605,1551,3156,7206
40,80,-150,1601,1555,3156,7394
-30,-30,70,1598,1558,3156,7418
-50,30,90,1607,1550,3157,7623
-50,50,-60,1586,1571,3157,7432
-20,50,-80,1585,1572,3157,7475
-160,-70,-90,1598,1559,3157,7533
110,-80,-160,1606,1552,3158,7332
-10,70,-90,1550,1608,3158,7662
-130,0,-60,1594,1564,3158,7167
10,0,120,1575,1583,3158,6886
30,10,130,1560,1599,3159,7015
-60,-70,40,1586,1573,3159,7343
120,20,-40,1570,1590,3160,7230
-30,50,100,1587,1573,3160,7383
0,80,90,1559,1601,3160,7132
-160,-70,100,1592,1568,3160,7166
-40,20,80,1594,1566,3160,7423
10,70,90,1575,1585,3160,7127
-130,60,-150,1580,1580,3160,7217
-110,20,-140,1614,1547,3161,7439
140,-70,-150,1595,1566,3161,7501
140,-30,-120,1572,1589,3161,7276
120,80,-30,1561,1600,3161,7164
-70,-10,100,1585,1577,3162,7402
150,60,-70,1560,1602,3162,7219
-60,30,110,1621,1541,3162,7504
60,-30,-60,1573,1589,3162,7461
-130,-60,-40,1612,1550,3162,7203
140,20,-70,1583,1579,3162,7244
-90,20,-160,1583,1579,3162,7299
-130,-60,120,1618,1544,3162,7296
-30,-30,-120,1576,1587,3163,6960
40,-50,160,1574,1589,3163,7325
110,20,20,1580,1583,3163,7255
120,0,-70,1589,1575,3164,7182
110,-40,10,1580,1584,3164,7299
80,-10,-90,1581,1584,3165,7103
20,30,110,1598,1567,3165,7105
-30,70,110,1593,1572,3165,7216
100,50,130,1573,1592,3165,7070
100,40,120,1583,1582,3165,7388
150,20,80,1597,1568,3165,7281
-10,-60,110,1597,1568,3165,7361
120,30,-30,1552,1614,3166,7417
-30,40,90,1627,1539,3166,7312
-50,-80,50,1623,1543,3166,7145
-120,20,-80,1591,1575,3166,7140
-60,0,90,1604,1562,3166,7476
-160,-10,-120,1619,1547,3166,7431
150,-70,50,1591,1575,3166,7217
-120,-60,130,1593,1573,3166,7358
-120,60,-170,1602,1565,3167,7135
110,-70,-170,1580,1587,3167,7490
130,80,-40,1571,1596,3167,7265
-80,80,160,1576,1592,3168,7088
50,70,60,1570,1598,3168,7081
-10,50,100,1609,1559,3168,7347
90,-70,-10,1571,1597,3168,7027
140,-40,50,1592,1576,3168,7067
-130,-10,-60,1604,1564,3168,7239
100,-70,0,1560,1608,3168,7147
0,70,-100,1574,1594,3168,7534
-150,-50,-90,1583,1585,3168,7380
100,-70,-160,1589,1579,3168,7273
-160,20,-120,1611,1558,3169,7478
-70,-70,30,1597,1572,3169,7362
-150,-30,80,1609,1560,3169,7259
40,60,80,1571,1598,3169,7067
-70,-20,70,1587,1582,3169,7332
-150,80,-130,1575,1594,3169,7113
160,-40,70,1600,1570,3170,7598
-170,-30,80,1601,1569,3170,7413
140,60,100,1606,1564,3170,7264
-10,40,100,1603,1567,3170,7343
0,60,100,1603,1567,3170,6929
-70,-40,-170,1600,1570,3170,7309
-10,-10,90,1589,1581,3170,7474
110,-70,-160,1598,1573,3171,7284
-60,40,120,1596,1575,3171,7296
-160,-40,-110,1588,1584,3172,7363
-160,-80,-80,1613,1559,3172,7239
170,-70,70,1587,1586,3173,7145
10,30,110,1591,1582,3173,6989
-70,0,-150,1618,1556,3174,7339
-120,10,-10,1602,1572,3174,7164
20,20,-100,1582,1592,3174,7245
-140,80,-140,1581,1594,3175,7128
-50,-60,60,1597,1578,3175,7395
-110,60,-170,1600,1575,3175,7344
-120,30,-140,1612,1564,3176,7438
180,-70,80,1622,1554,3176,7098
-180,-70,80,1622,1554,3176,7098
-80,0,150,1612,1564,3176,7417
0,-10,110,1579,1597,3176,7133
-80,0,-170,1602,1575,3177,7371
-160,70,-120,1601,1576,3177,7406
100,90,150,1598,1580,3178,7427
-40,90,-70,1598,1580,3178,7427
150,90,100,1598,1580,3178,7427
70,90,180,1598,1580,3178,7427
40,90,-150,1598,1580,3178,7427
-90,90,-20,1598,1580,3178,7427
160,90,90,1598,1580,3178,7427
30,90,-140,1598,1580,3178,7427
-130,90,20,1598,1580,3178,7427
-20,90,-90,1598,1580,3178,7427
-120,90,10,1598,1580,3178,7427
-80,50,150,1592,1586,3178,7202
70,90,-180,1598,1580,3178,7427
-50,90,-60,1598,1580,3178,7427
110,90,140,1598,1580,3178,7427
-150,90,40,1598,1580,3178,7427
-160,90,50,1598,1580,3178,7427
20,90,-130,1598,1580,3178,7427
140,90,110,1598,1580,3178,7427
80,90,170,1598,1580,3178,7427
-70,90,-40,1598,1580,3178,7427
-110,30,-150,1583,1595,3178,7165
50,90,-160,1598,1580,3178,7427
-140,90,30,1598,1580,3178,7427
-100,90,-10,1598,1580,3178,7427
10,90,-120,1598,1580,3178,7427
-30,90,-80,1598,1580,3178,7427
-10,90,-100,1598,1580,3178,7427
-170,90,60,1598,1580,3178,7427
170,90,80,1598,1580,3178,7427
-110,90,0,1598,1580,3178,7427
-80,90,-30,1598,1580,3178,7427
-180,90,70,1598,1580,3178,7427
-60,90,-50,1598,1580,3178,7427
90,90,160,1598,1580,3178,7427
130,90,120,1598,1580,3178,7427
0,90,-110,1598,1580,3178,7427
120,90,130,1598,1580,3178,7427
180,90,70,1598,1580,3178,7427
60,90,-170,1598,1580,3178,7427
-150,-40,-100,1597,1581,3178,7331
-80,40,150,1605,1574,3179,7399
-160,40,-120,1595,1584,3179,7483
-180,-10,70,1606,1573,3179,7316
180,-10,70,1606,1573,3179,7316
0,-60,120,1617,1562,3179,7505
-100,50,-180,1585,1595,3180,7225
-100,50,180,1585,1595,3180,7225
-110,60,-180,1616,1564,3180,7062
40,40,100,1589,1591,3180,7028
-110,60,180,1616,1564,3180,7062
-20,-40,90,1594,1586,3180,7167
-40,-80,50,1582,1598,3180,7277
-110,50,-170,1584,1596,3180,7106
-80,10,160,1607,1574,3181,7309
-50,-30,-140,1597,1584,3181,7309
-40,30,80,1602,1579,3181,7470
-100,80,-180,1585,1596,3181,7070
-100,80,180,1585,1596,3181,7070
-40,-70,70,1593,1588,3181,7226
-130,80,-150,1582,1600,3182,7102
-120,10,-110,1590,1592,3182,7591
110,70,-10,1565,1617,3182,7143
-120,10,-30,1604,1578,3182,7128
-10,60,100,1605,1578,3183,7448
90,-60,-160,1623,1560,3183,7368
-60,-80,40,1632,1552,3184,7180
-20,-20,80,1602,1582,3184,7419
-70,-50,50,1600,1584,3184,7436
-100,20,-110,1605,1579,3184,7411
-40,-10,-120,1602,1583,3185,7099
50,-70,-50,1553,1632,3185,7192
-170,-80,-90,1621,1564,3185,7315
-140,70,30,1624,1561,3185,7425
-80,-60,30,1616,1569,3185,7282
-90,-60,20,1620,1566,3186,7243
-150,60,-130,1579,1607,3186,7263
90,-80,-10,1570,1616,3186,7087
120,10,-60,1576,1611,3187,7389
60,0,-110,1643,1544,3187,7568
90,-10,-100,1592,1596,3188,7212
-40,-60,70,1581,1607,3188,7280
10,-20,-90,1587,1601,3188,7276
110,-70,10,1579,1609,3188,7027
120,-80,-150,1620,1568,3188,7389
60,-70,-40,1558,1631,3189,7106
110,-30,-110,1580,1609,3189,7216
-50,-30,60,1602,1587,3189,7609
40,-30,170,1605,1585,3190,7023
50,-10,-90,1600,1590,3190,7401
160,-80,-120,1616,1574,3190,7324
40,-70,-60,1558,1632,3190,7178
-90,30,-170,1610,1581,3191,7378
-130,-10,-100,1601,1590,3191,7469
-150,-60,-80,1621,1571,3192,7512
-130,-70,-40,1619,1573,3192,7374
140,-10,-90,1608,1584,3192,7199
-30,10,70,1598,1594,3192,7480
-110,80,-170,1591,1601,3192,7096
140,-80,-140,1630,1562,3192,7292
30,-60,-70,1577,1615,3192,7374
-30,-80,80,1615,1577,3192,7006
-10,30,100,1620,1572,3192,7286
60,40,170,1593,1600,3193,7210
130,-60,-150,1593,1600,3193,7448
-20,10,80,1613,1580,3193,7432
-170,-70,90,1622,1571,3193,7212
-70,0,120,1622,1571,3193,7491
-110,20,-100,1609,1584,3193,7275
120,-80,-140,1604,1590,3194,7237
-30,-40,80,1615,1579,3194,7416
-160,20,50,1604,1590,3194,7099
-70,50,140,1632,1562,3194,7477
130,70,110,1625,1569,3194,7036
-40,0,70,1600,1594,3194,7699
-60,90,150,1591,1604,3195,7345
-180,90,-90,1591,1604,3195,7345
-170,90,-100,1591,1604,3195,7345
140,90,-50,1591,1604,3195,7345
10,90,80,1591,1604,3195,7345
-30,90,120,1591,1604,3195,7345
-100,90,-170,1591,1604,3195,7345
30,90,60,1591,1604,3195,7345
-140,90,-130,1591,1604,3195,7345
-130,90,-140,1591,1604,3195,7345
-110,90,-160,1591,1604,3195,7345
-90,90,-180,1591,1604,3195,7345
-50,90,140,1591,1604,3195,7345
170,90,-80,1591,1604,3195,7345
180,90,-90,1591,1604,3195,7345
20,90,70,1591,1604,3195,7345
70,90,20,1591,1604,3195,7345
-160,90,-110,1591,1604,3195,7345
60,90,30,1591,1604,3195,7345
-70,-80,20,1598,1597,3195,7464
150,90,-60,1591,1604,3195,7345
160,90,-70,1591,1604,3195,7345
-10,90,100,1591,1604,3195,7345
120,90,-30,1591,1604,3195,7345
40,90,50,1591,1604,3195,7345
-80,90,170,1591,1604,3195,7345
-70,90,160,1591,1604,3195,7345
-120,90,-150,1591,1604,3195,7345
-40,90,130,1591,1604,3195,7345
90,90,0,1591,1604,3195,7345
0,90,90,1591,1604,3195,7345
-90,90,180,1591,1604,3195,7345
50,90,40,1591,1604,3195,7345
-60,20,100,1647,1548,3195,7626
100,90,-10,1591,1604,3195,7345
130,90,-40,1591,1604,3195,7345
-150,90,-120,1591,1604,3195,7345
-20,90,110,1591,1604,3195,7345
110,90,-20,1591,1604,3195,7345
80,90,10,1591,1604,3195,7345
90,50,40,1597,1599,3196,7079
-100,50,170,1600,1596,3196,7349
-140,-40,-70,1631,1565,3196,7502
-90,60,160,1600,1597,3197,7191
-160,60,-120,1577,1620,3197,7392
-130,70,-150,1592,1605,3197,7507
-120,80,-160,1594,1603,3197,7150
-100,-40,40,1616,1581,3197,7190
-80,20,160,1608,1589,3197,7307
-80,-70,20,1610,1587,3197,7331
20,0,130,1572,1625,3197,7158
-90,-40,160,1596,1601,3197,7398
150,0,-100,1588,1610,3198,7482
-20,60,-80,1588,1610,3198,7552
50,10,170,1585,1613,3198,7056
150,-80,-130,1624,1574,3198,7332
-20,30,90,1614,1585,3199,7442
-70,-60,40,1630,1569,3199,7435
110,30,0,1562,1637,3199,7152
140,60,-50,1582,1617,3199,7250
-50,-80,40,1597,1603,3200,7351
120,-70,20,1592,1608,3200,7082
30,80,-140,1609,1591,3200,7447
100,50,10,1587,1613,3200,7320
40,50,90,1576,1624,3200,7074
-30,-10,70,1612,1588,3200,7533
-10,80,100,1580,1620,3200,7299
-180,-80,-100,1622,1578,3200,7308
180,-80,-100,1622,1578,3200,7308
-130,30,-130,1625,1576,3201,7474
-50,0,80,1602,1599,3201,7534
90,-10,-90,1621,1580,3201,7328
100,-80,0,1577,1624,3201,7118
-60,-80,30,1598,1603,3201,7435
-50,40,100,1616,1585,3201,7542
140,-20,-110,1576,1625,3201,7276
90,60,20,1618,1583,3201,7289
40,70,70,1587,1615,3202,7241
-50,40,110,1615,1587,3202,7494
-140,30,-130,1612,1591,3203,7423
-60,-30,60,1605,1598,3203,7635
80,-40,-30,1593,1610,3203,7291
-70,-10,-160,1613,1590,3203,7218
-170,-60,-110,1639,1565,3204,7433
-80,-10,130,1612,1592,3204,7476
-10,-80,100,1633,1571,3204,7190
-30,20,80,1612,1592,3204,7666
150,10,-90,1604,1600,3204,7369
90,50,140,1595,1609,3204,7225
10,-50,-90,1572,1633,3205,7360
20,-40,140,1597,1608,3205,7290
-130,40,-140,1601,1604,3205,7344
60,-50,-170,1594,1611,3205,7376
-20,-80,90,1630,1575,3205,7077
-150,70,-130,1601,1604,3205,7513
-40,-40,70,1610,1596,3206,7568
-80,-60,40,1603,1603,3206,7298
-50,50,120,1624,1582,3206,7287
120,20,80,1599,1607,3206,7349
-40,-80,70,1617,1589,3206,7119
-170,60,-110,1586,1620,3206,7456
-10,70,100,1588,1618,3206,7385
-30,-90,70,1629,1578,3207,7229
-40,-90,60,1629,1578,3207,7229
80,-90,180,1629,1578,3207,7229
-90,50,160,1586,1621,3207,7293
-150,-90,-50,1629,1578,3207,7229
-70,-90,30,1629,1578,3207,7229
180,-90,-80,1629,1578,3207,7229
-90,-70,10,1609,1598,3207,7278
160,-90,-100,1629,1578,3207,7229
120,-90,-140,1629,1578,3207,7229
-110,-90,-10,1629,1578,3207,7229
-60,-90,40,1629,1578,3207,7229
-10,-90,90,1629,1578,3207,7229
10,-90,110,1629,1578,3207,7229
150,-90,-110,1629,1578,3207,7229
130,-90,-130,1629,1578,3207,7229
-100,-90,0,1629,1578,3207,7229
100,-90,-160,1629,1578,3207,7229
-80,-80,10,1607,1600,3207,7443
-170,-90,-70,1629,1578,3207,7229
140,-90,-120,1629,1578,3207,7229
-90,-80,10,1636,1571,3207,7245
80,-90,-180,1629,1578,3207,7229
-20,-90,80,1629,1578,3207,7229
20,-90,120,1629,1578,3207,7229
0,-90,100,1629,1578,3207,7229
40,-90,140,1629,1578,3207,7229
50,-90,150,1629,1578,3207,7229
-140,-90,-40,1629,1578,3207,7229
170,-90,-90,1629,1578,3207,7229
-180,-90,-80,1629,1578,3207,7229
60,-90,160,1629,1578,3207,7229
-130,-90,-30,1629,1578,3207,7229
0,40,110,1617,1590,3207,7014
70,-90,170,1629,1578,3207,7229
-120,-90,-20,1629,1578,3207,7229
90,-90,-170,1629,1578,3207,7229
-160,-90,-60,1629,1578,3207,7229
110,-90,-150,1629,1578,3207,7229
-90,-90,10,1629,1578,3207,7229
-80,-90,20,1629,1578,3207,7229
30,-90,130,1629,1578,3207,7229
-50,-90,50,1629,1578,3207,7229
10,-60,130,1609,1599,3208,7509
0,-50,120,1628,1580,3208,7399
70,70,40,1591,1617,3208,7256
-120,-50,-20,1630,1578,3208,7340
50,-70,160,1601,1607,3208,7318
-170,-20,-120,1633,1575,3208,7501
-100,60,170,1620,1589,3209,7096
50,40,100,1621,1589,3210,6989
-130,-80,-40,1627,1583,3210,7415
-10,0,90,1611,1599,3210,7397
10,60,100,1623,1587,3210,7117
140,-70,40,1609,1601,3210,7339
-100,40,-160,1600,1611,3211,7297
-180,-60,-120,1619,1592,3211,7434
60,80,40,1575,1636,3211,7189
-100,-80,-10,1626,1585,3211,7462
-70,-80,30,1629,1582,3211,7240
-40,-50,70,1603,1608,3211,7505
180,-60,-120,1619,1592,3211,7434
150,80,-60,1597,1614,3211,7338
-50,-40,60,1626,1585,3211,7535
-50,-10,70,1606,1605,3211,7665
-160,10,50,1607,1604,3211,7081
170,10,-110,1613,1598,3211,7398
80,60,40,1613,1599,3212,7157
180,30,-110,1614,1598,3212,7453
-180,-20,-120,1634,1578,3212,7561
-10,10,90,1610,1602,3212,7589
-180,30,-110,1614,1598,3212,7453
-50,-50,60,1618,1594,3212,7477
-20,-10,80,1631,1581,3212,7470
180,-20,-120,1634,1578,3212,7561
-140,-70,-60,1618,1595,3213,7458
-130,0,-110,1605,1608,3213,7695
-20,80,110,1581,1632,3213,7349
160,40,-90,1602,1611,3213,7421
-170,-60,90,1615,1598,3213,7454
20,60,-120,1628,1585,3213,7633
130,-80,-130,1619,1595,3214,7276
-50,10,80,1616,1598,3214,7520
-100,20,-130,1612,1602,3214,7378
-40,30,90,1642,1572,3214,7560
-80,60,-30,1626,1588,3214,7526
-180,60,-100,1589,1626,3215,7455
-130,70,20,1639,1576,3215,7516
-140,80,30,1634,1581,3215,7554
110,-10,-80,1637,1578,3215,7431
180,60,-100,1589,1626,3215,7455
70,70,170,1613,1602,3215,7411
20,80,90,1582,1634,3216,7126
170,-80,-110,1629,1587,3216,7329
-90,-80,0,1614,1602,3216,7465
30,-80,140,1622,1594,3216,7228
30,-50,150,1616,1600,3216,7384
-110,20,-130,1603,1613,3216,7368
-70,-30,60,1596,1621,3217,7773
-120,20,-70,1620,1597,3217,7190
120,-70,-160,1606,1611,3217,7594
-40,70,120,1620,1597,3217,7259
-130,-10,-50,1628,1589,3217,7432
130,-80,-140,1626,1592,3218,7533
140,30,-60,1621,1598,3219,7253
-120,70,-160,1612,1607,3219,7592
-40,-10,70,1613,1606,3219,7645
150,50,-70,1599,1620,3219,7452
140,80,-50,1602,1617,3219,7310
-50,-60,70,1603,1616,3219,7246
110,30,20,1627,1592,3219,7239
110,-50,-140,1597,1622,3219,7451
80,70,30,1575,1645,3220,7335
-40,40,100,1635,1585,3220,7446
0,-80,110,1628,1592,3220,7207
-140,70,-140,1605,1615,3220,7549
50,30,-160,1622,1598,3220,7208
-110,20,-120,1601,1620,3221,7523
-80,-80,20,1642,1579,3221,7220
-90,-60,30,1610,1611,3221,7208
80,-80,-20,1584,1637,3221,7267
70,80,40,1592,1629,3221,7154
70,80,30,1571,1650,3221,7214
130,-20,50,1613,1608,3221,7562
-100,50,-170,1618,1603,3221,7404
120,60,-20,1582,1639,3221,7341
-30,80,120,1590,1631,3221,7357
-110,-40,10,1604,1618,3222,7345
-160,0,-120,1615,1607,3222,7559
30,20,120,1612,1610,3222,7285
-90,40,170,1621,1601,3222,7546
-40,10,80,1644,1579,3223,7441
-140,20,-120,1627,1596,3223,7481
-120,20,-120,1628,1595,3223,7474
-120,-20,-10,1637,1586,3223,7304
-180,80,-90,1617,1607,3224,7444
180,-30,-120,1631,1593,3224,7587
40,-80,150,1636,1588,3224,7271
150,-80,-120,1633,1591,3224,7554
10,-80,120,1630,1594,3224,7300
-100,60,180,1637,1587,3224,7397
180,80,-90,1617,1607,3224,7444
-100,60,-180,1637,1587,3224,7397
30,10,-100,1569,1655,3224,7365
-180,-30,-120,1631,1593,3224,7587
-50,-80,60,1635,1590,3225,7254
-100,-60,10,1647,1578,3225,7334
-80,20,170,1615,1610,3225,7252
-120,-80,-30,1639,1586,3225,7465
120,50,-20,1594,1631,3225,7371
50,80,60,1598,1628,3226,7107
30,-70,-70,1586,1640,3226,7263
180,-50,-120,1623,1604,3227,7418
50,-80,160,1633,1594,3227,7342
-180,-40,-120,1643,1584,3227,7512
180,-40,-120,1643,1584,3227,7512
-180,-50,-120,1623,1604,3227,7418
0,-40,120,1626,1602,3228,7432
50,80,50,1580,1648,3228,7186
80,80,20,1586,1643,3229,7270
-50,-70,60,1615,1614,3229,7303
10,80,100,1599,1630,3229,7234
-60,20,110,1649,1580,3229,7589
-90,70,170,1619,1610,3229,7367
70,-80,-30,1584,1645,3229,7284
140,-80,-120,1632,1597,3229,7292
40,80,70,1579,1651,3230,7128
140,-80,-130,1626,1604,3230,7530
60,80,50,1603,1628,3231,7078
170,40,-100,1622,1609,3231,7518
-30,-30,80,1620,1611,3231,7632
-50,-70,70,1595,1636,3231,7385
90,70,20,1589,1642,3231,7356
-20,70,110,1607,1624,3231,7467
160,-30,-120,1602,1629,3231,7656
-30,20,90,1618,1613,3231,7548
160,10,-100,1603,1628,3231,7542
-20,-30,90,1622,1610,3232,7386
-40,60,120,1631,1601,3232,7457
150,-70,-140,1637,1595,3232,7632
-50,70,130,1621,1612,3233,7382
-40,-30,70,1637,1596,3233,7475
-110,50,-160,1622,1611,3233,7527
-130,-50,-40,1615,1619,3234,7492
-120,-30,-20,1618,1616,3234,7470
0,80,110,1607,1627,3234,7321
-180,-80,80,1621,1613,3234,7458
-100,-80,0,1646,1588,3234,7243
180,-80,80,1621,1613,3234,7458
-60,-60,50,1644,1591,3235,7527
90,80,10,1589,1646,3235,7275
20,-80,130,1631,1604,3235,7238
-120,40,-140,1607,1628,3235,7443
-20,50,100,1628,1608,3236,7590
60,-30,-160,1619,1617,3236,7158
-50,-50,70,1622,1615,3237,7350
-70,-60,50,1613,1624,3237,7359
120,20,-30,1595,1642,3237,7482
-30,60,110,1628,1610,3238,7469
-110,40,-150,1616,1623,3239,7427
170,60,-90,1605,1634,3239,7617
-180,20,-110,1622,1617,3239,7389
180,20,-110,1622,1617,3239,7389
150,-60,-140,1628,1612,3240,7690
170,-80,70,1629,1611,3240,7395
-140,-80,-50,1637,1603,3240,7430
-140,-50,-60,1640,1600,3240,7496
70,50,160,1640,1600,3240,7222
160,80,-70,1606,1634,3240,7422
-150,-80,-60,1630,1611,3241,7466
-90,40,180,1611,1630,3241,7544
-100,-70,0,1624,1617,3241,7345
30,-20,150,1626,1615,3241,7235
-40,-20,70,1646,1595,3241,7710
120,-40,-120,1593,1648,3241,7466
-90,40,-180,1611,1630,3241,7544
140,0,-80,1589,1652,3241,7401
-130,-80,130,1614,1628,3242,7294
-170,-70,-100,1644,1598,3242,7788
100,-50,-140,1615,1627,3242,7333
70,-50,-160,1589,1653,3242,7398
-170,50,-110,1619,1623,3242,7641
40,80,60,1591,1651,3242,7167
-80,10,-160,1620,1622,3242,7627
110,-80,10,1606,1636,3242,7247
-140,10,-120,1625,1617,3242,7576
-40,50,110,1642,1601,3243,7413
-50,30,100,1640,1603,3243,7737
180,-40,80,1647,1596,3243,7686
-160,-80,100,1631,1612,3243,7336
-180,-40,80,1647,1596,3243,7686
-60,-80,50,1633,1610,3243,7311
-150,-80,110,1635,1608,3243,7401
-110,-80,-20,1641,1603,3244,7467
170,80,-80,1608,1636,3244,7440
-20,0,80,1635,1610,3245,7607
160,-30,70,1646,1599,3245,7492
-10,-20,100,1640,1605,3245,7445
110,20,70,1624,1622,3246,7476
-110,70,0,1624,1622,3246,7622
80,80,30,1603,1643,3246,7220
90,40,60,1644,1602,3246,7403
30,70,80,1606,1641,3247,7202
-130,-20,-50,1622,1625,3247,7464
-130,20,-120,1644,1603,3247,7482
-170,80,-100,1633,1614,3247,7485
-170,-80,90,1630,1617,3247,7318
100,-60,-150,1642,1605,3247,7620
-120,50,-150,1637,1611,3248,7580
-140,-60,110,1666,1582,3248,7505
-60,-60,60,1614,1634,3248,7270
0,30,110,1641,1607,3248,7283
110,-40,-120,1631,1617,3248,7280
30,80,80,1587,1661,3248,7112
80,50,150,1623,1625,3248,7273
80,-20,-70,1648,1600,3248,7384
130,-70,30,1626,1622,3248,7378
160,-10,-110,1612,1637,3249,7454
-150,-20,60,1656,1593,3249,7384
160,-80,-110,1651,1598,3249,7523
20,-50,140,1605,1645,3250,7386
-70,40,-60,1629,1621,3250,7284
-40,-30,-130,1643,1607,3250,7360
-60,-50,60,1618,1633,3251,7453
-60,-70,60,1635,1616,3251,7451
120,-80,20,1609,1642,3251,7382
130,-40,40,1631,1621,3252,7392
60,-70,170,1627,1626,3253,7470
50,-50,180,1606,1647,3253,7462
-60,10,100,1667,1586,3253,7835
50,-50,-180,1606,1647,3253,7462
10,-50,130,1627,1626,3253,7445
-100,70,180,1614,1640,3254,7519
-100,70,-180,1614,1640,3254,7519
170,-80,-100,1654,1601,3255,7590
120,0,50,1637,1618,3255,7508
130,-30,-110,1601,1654,3255,7327
-50,20,90,1672,1583,3255,7677
70,-70,-180,1631,1625,3256,7578
-120,-60,-20,1654,1602,3256,7475
140,70,-50,1608,1648,3256,7295
150,50,-60,1622,1634,3256,7501
110,20,30,1607,1649,3256,7574
-40,20,90,1667,1589,3256,7702
70,-70,180,1631,1625,3256,7578
-110,70,-170,1624,1633,3257,7592
-70,-70,40,1622,1636,3258,7447
-120,70,10,1627,1631,3258,7581
-20,-20,-110,1615,1644,3259,7203
150,20,-80,1627,1632,3259,7484
180,50,-100,1610,1649,3259,7542
-180,50,-100,1610,1649,3259,7542
-150,20,40,1624,1636,3260,7334
-80,10,170,1655,1605,3260,7597
-30,10,-100,1613,1647,3260,7347
-120,-20,0,1653,1607,3260,7657
-100,-40,140,1630,1630,3260,7592
-60,-70,50,1640,1620,3260,7369
160,60,-80,1603,1658,3261,7424
-150,-70,-70,1647,1614,3261,7607
-110,-70,-10,1652,1609,3261,7363
110,40,110,1650,1611,3261,7655
130,-60,-140,1651,1610,3261,7418
100,50,20,1641,1620,3261,7329
-140,-80,120,1636,1626,3262,7364
-140,-30,-80,1635,1627,3262,7667
0,50,110,1623,1639,3262,7229
170,-30,-120,1645,1617,3262,7677
-20,-70,100,1631,1631,3262,7291
100,80,0,1593,1670,3263,7417
10,-30,130,1639,1624,3263,7504
30,60,90,1613,1650,3263,7376
20,-30,140,1625,1639,3264,7452
140,-80,40,1626,1638,3264,7585
-10,-70,110,1651,1613,3264,7374
-60,70,140,1649,1615,3264,7488
-30,10,80,1655,1609,3264,7730
-40,10,90,1662,1602,3264,7707
20,80,80,1611,1654,3265,7257
60,-80,-40,1624,1641,3265,7389
-150,10,-120,1646,1619,3265,7495
170,50,-70,1646,1619,3265,7469
150,-80,-110,1649,1616,3265,7327
-40,80,130,1627,1638,3265,7409
160,-80,60,1646,1620,3266,7421
20,70,90,1595,1671,3266,7276
50,10,180,1618,1648,3266,7038
90,80,20,1616,1650,3266,7221
40,70,-150,1640,1626,3266,7481
50,10,150,1608,1658,3266,7391
-80,-70,40,1644,1622,3266,7448
150,-30,-120,1618,1648,3266,7737
-70,80,160,1644,1622,3266,7630
50,10,-180,1618,1648,3266,7038
110,30,90,1627,1639,3266,7466
150,0,-90,1629,1638,3267,7616
160,50,-80,1626,1641,3267,7776
40,-80,-60,1623,1644,3267,7490
110,80,0,1616,1651,3267,7172
100,80,10,1614,1654,3268,7233
-130,50,-140,1657,1611,3268,7581
-10,-50,110,1644,1624,3268,7432
30,40,-120,1651,1617,3268,7595
20,-60,140,1629,1639,3268,7544
120,-60,20,1608,1660,3268,7443
-20,-60,100,1636,1632,3268,7370
-70,60,150,1653,1615,3268,7423
120,50,110,1638,1631,3269,7465
100,70,10,1615,1654,3269,7374
10,-40,130,1622,1647,3269,7504
130,-80,30,1624,1645,3269,7602
-70,-10,110,1618,1652,3270,7430
-20,20,90,1655,1615,3270,7639
-130,0,-90,1632,1638,3270,7588
80,-70,-170,1649,1622,3271,7628
-90,50,180,1646,1625,3271,7560
130,-70,-150,1633,1638,3271,7669
-170,-80,-80,1655,1616,3271,7522
-90,60,170,1657,1614,3271,7501
-130,-10,20,1643,1628,3271,7321
-90,50,-180,1646,1625,3271,7560
-80,70,160,1621,1650,3271,7373
50,-80,-50,1624,1647,3271,7436
140,70,100,1661,1611,3272,7413
110,30,10,1644,1628,3272,7340
180,-80,-90,1674,1598,3272,7548
-180,-80,-90,1674,1598,3272,7548
-30,0,80,1672,1600,3272,7538
-120,-80,140,1647,1626,3273,7344
30,80,70,1619,1654,3273,7268
-70,-30,-170,1653,1620,3273,7394
160,-60,60,1661,1612,3273,7357
-120,-40,110,1630,1644,3274,7419
-80,-10,180,1679,1595,3274,7447
150,-20,-110,1610,1664,3274,7494
-150,20,-120,1659,1615,3274,7564
-30,-70,90,1648,1626,3274,7290
-80,-10,-180,1679,1595,3274,7447
-90,-50,160,1633,1641,3274,7572
80,40,80,1661,1613,3274,7343
20,80,-130,1659,1615,3274,7626
10,80,90,1616,1658,3274,7379
-90,50,170,1652,1623,3275,7360
30,-30,-80,1611,1664,3275,7701
-160,-80,-70,1650,1625,3275,7549
140,-50,-130,1619,1657,3276,7506
20,-10,-90,1607,1669,3276,7741
-70,-70,-170,1675,1601,3276,7301
60,-80,170,1643,1633,3276,7396
120,70,-20,1614,1662,3276,7379
150,40,-60,1635,1641,3276,7586
120,80,-10,1610,1667,3277,7140
150,-60,50,1675,1602,3277,7335
80,50,60,1661,1616,3277,7403
-150,-40,90,1670,1607,3277,7738
-110,-30,80,1625,1653,3278,7395
-90,-40,50,1664,1615,3279,7670
-120,30,-130,1657,1623,3280,7754
170,0,70,1668,1612,3280,7635
20,-70,-80,1607,1673,3280,7345
120,30,90,1628,1652,3280,7620
-110,-80,-10,1667,1613,3280,7335
-10,60,110,1660,1620,3280,7429
-110,-60,140,1644,1637,3281,7513
-70,40,140,1646,1636,3282,7725
0,70,100,1628,1654,3282,7394
-180,-70,-110,1665,1617,3282,7936
-130,80,20,1660,1622,3282,7797
100,40,40,1626,1656,3282,7300
-140,40,-130,1668,1614,3282,7632
180,-70,-110,1665,1617,3282,7936
-110,-40,20,1654,1628,3282,7552
100,-30,-10,1637,1646,3283,7566
40,30,-130,1675,1608,3283,7503
10,50,110,1661,1622,3283,7210
-120,20,-90,1646,1637,3283,7505
-100,70,-10,1642,1641,3283,7775
130,20,80,1625,1659,3284,7696
-70,70,150,1646,1638,3284,7504
-150,-20,-110,1651,1633,3284,7667
-110,20,-110,1651,1634,3285,7436
-170,50,-90,1646,1639,3285,7387
110,80,-10,1617,1668,3285,7589
-60,80,150,1651,1634,3285,7624
150,-80,50,1641,1645,3286,7543
140,-20,60,1656,1630,3286,7775
-80,80,170,1642,1644,3286,7640
-120,60,-150,1669,1617,3286,7514
-10,80,120,1627,1659,3286,7335
-50,10,90,1676,1610,3286,7740
-130,40,-130,1642,1645,3287,7682
-40,-50,80,1651,1636,3287,7437
-170,-20,70,1644,1643,3287,7663
100,-20,-20,1650,1637,3287,7655
130,20,-50,1633,1655,3288,7511
40,-40,-70,1619,1669,3288,7470
-70,20,-100,1682,1606,3288,7622
120,-70,-150,1652,1636,3288,7699
-130,-10,-40,1656,1632,3288,7527
40,40,-140,1666,1622,3288,7687
-90,-70,20,1654,1635,3289,7478
30,-80,-70,1629,1660,3289,7512
-60,10,110,1663,1626,3289,7657
150,40,-70,1641,1648,3289,7762
80,-40,-140,1647,1642,3289,7345
-110,-50,0,1655,1634,3289,7618
-80,10,-170,1660,1630,3290,7578
110,-70,-150,1656,1634,3290,7445
-110,30,-140,1669,1622,3291,7756
-80,0,180,1654,1637,3291,7691
-80,0,-180,1654,1637,3291,7691
-60,30,120,1670,1621,3291,7746
-170,40,-110,1656,1635,3291,7816
-40,-60,80,1639,1652,3291,7367
130,80,-30,1638,1654,3292,7647
-30,-20,80,1662,1630,3292,7634
120,-10,-80,1668,1624,3292,7620
0,-20,120,1654,1638,3292,7604
-70,-80,40,1645,1648,3293,7369
160,-80,-100,1653,1640,3293,7397
130,90,-20,1636,1658,3294,7436
170,90,-60,1636,1658,3294,7436
-10,90,120,1636,1658,3294,7436
-40,90,150,1636,1658,3294,7436
40,90,70,1636,1658,3294,7436
-170,90,-80,1636,1658,3294,7436
-110,90,-140,1636,1658,3294,7436
130,30,-40,1643,1651,3294,7819
160,90,-50,1636,1658,3294,7436
-90,90,-160,1636,1658,3294,7436
-180,90,-70,1636,1658,3294,7436
-120,90,-130,1636,1658,3294,7436
-170,0,60,1669,1625,3294,7617
-20,90,130,1636,1658,3294,7436
180,90,-70,1636,1658,3294,7436
10,90,100,1636,1658,3294,7436
-60,-40,60,1667,1627,3294,7759
80,90,30,1636,1658,3294,7436
60,90,50,1636,1658,3294,7436
90,90,20,1636,1658,3294,7436
100,90,10,1636,1658,3294,7436
150,90,-40,1636,1658,3294,7436
-70,20,-110,1665,1629,3294,7590
-60,90,170,1636,1658,3294,7436
30,90,80,1636,1658,3294,7436
-50,90,160,1636,1658,3294,7436
-140,90,-110,1636,1658,3294,7436
110,90,0,1636,1658,3294,7436
-80,90,-170,1636,1658,3294,7436
-130,90,-120,1636,1658,3294,7436
20,90,90,1636,1658,3294,7436
-160,90,-90,1636,1658,3294,7436
-30,90,140,1636,1658,3294,7436
-150,90,-100,1636,1658,3294,7436
70,90,40,1636,1658,3294,7436
-70,90,-180,1636,1658,3294,7436
50,90,60,1636,1658,3294,7436
120,90,-10,1636,1658,3294,7436
-100,90,-150,1636,1658,3294,7436
140,90,-30,1636,1658,3294,7436
0,90,110,1636,1658,3294,7436
160,-70,-130,1664,1630,3294,7729
-70,90,180,1636,1658,3294,7436
-150,40,-120,1666,1629,3295,7639
120,-30,30,1645,1650,3295,7826
-160,80,-110,1649,1646,3295,7584
-110,60,-160,1686,1609,3295,7496
-150,0,-120,1666,1629,3295,7661
140,0,70,1661,1635,3296,7868
130,-20,-90,1643,1653,3296,7381
-120,-30,20,1679,1617,3296,7467
70,50,70,1649,1647,3296,7442
150,-10,-100,1630,1667,3297,7680
-20,30,-90,1651,1646,3297,7530
-160,-30,-110,1665,1632,3297,7700
30,-40,160,1657,1640,3297,7418
120,80,-20,1633,1664,3297,7706
0,-70,120,1659,1638,3297,7565
-120,-30,30,1679,1619,3298,7252
-80,-70,30,1652,1646,3298,7506
150,80,-50,1623,1675,3298,7555
-50,0,90,1657,1641,3298,7937
-50,60,130,1654,1644,3298,7442
60,30,130,1645,1653,3298,7410
-150,50,-120,1672,1627,3299,7514
10,80,-120,1671,1628,3299,7786
-80,10,-150,1677,1622,3299,7675
120,-10,40,1669,1630,3299,7735
-70,30,-80,1641,1658,3299,7534
20,-60,-80,1634,1665,3299,7569
-70,-70,50,1658,1641,3299,7441
150,80,-40,1629,1671,3300,7282
130,70,-30,1622,1678,3300,7511
0,20,110,1650,1650,3300,7326
-50,-20,70,1652,1648,3300,7866
120,10,-50,1630,1670,3300,7466
-40,-70,80,1643,1658,3301,7403
170,70,-80,1646,1655,3301,7656
-30,70,120,1652,1649,3301,7470
-50,80,140,1651,1650,3301,7560
100,60,10,1644,1657,3301,7681
0,10,110,1654,1647,3301,7313
-100,30,-150,1652,1649,3301,7648
160,50,80,1680,1622,3302,7535
-10,-10,-100,1671,1631,3302,7650
-80,-20,100,1643,1659,3302,7757
-100,20,-140,1668,1634,3302,7855
-60,0,100,1685,1617,3302,7835
-90,-50,40,1670,1632,3302,7819
150,60,-60,1635,1667,3302,7548
110,70,0,1636,1667,3303,7378
120,30,-20,1638,1665,3303,7605
170,60,-70,1646,1657,3303,7450
-130,-40,-40,1676,1627,3303,7627
-90,30,-70,1659,1644,3303,7403
0,-30,120,1650,1653,3303,7546
-90,80,180,1651,1652,3303,7624
-90,80,-180,1651,1652,3303,7624
-30,-10,80,1678,1626,3304,7649
-130,0,-50,1667,1637,3304,7368
140,-60,-140,1660,1644,3304,7760
-100,-30,120,1623,1681,3304,7616
-80,50,160,1655,1649,3304,7535
-100,40,-20,1661,1643,3304,7908
-90,60,-180,1674,1631,3305,7636
-150,80,-120,1661,1644,3305,7603
-140,50,-130,1677,1628,3305,7576
160,80,-50,1630,1675,3305,7306
-90,60,180,1674,1631,3305,7636
-110,-80,150,1663,1642,3305,7423
-40,0,80,1674,1631,3305,7861
-80,-50,50,1662,1644,3306,7885
-160,-50,-100,1664,1642,3306,7739
-130,0,-40,1660,1646,3306,7360
140,80,-40,1636,1670,3306,7637
160,40,-80,1636,1670,3306,7759
-80,40,-50,1649,1657,3306,7398
-100,80,-170,1661,1646,3307,7639
-30,-50,90,1656,1651,3307,7532
-120,-40,-20,1673,1634,3307,7680
130,80,-20,1634,1673,3307,7207
10,-70,130,1652,1655,3307,7585
-130,-30,70,1679,1628,3307,7313
-90,40,-170,1644,1663,3307,7643
130,-60,30,1652,1655,3307,7462
-30,10,90,1661,1647,3308,7685
90,-70,-160,1674,1634,3308,7650
-70,60,-40,1669,1639,3308,7802
-100,-30,70,1656,1652,3308,7459
-120,-70,-20,1696,1612,3308,7522
30,-60,150,1655,1654,3309,7610
140,10,-70,1661,1648,3309,7511
0,80,100,1623,1686,3309,7445
-60,60,140,1668,1641,3309,7505
0,0,110,1643,1666,3309,7473
-10,-40,110,1656,1654,3310,7537
-10,50,110,1664,1646,3310,7480
150,70,-60,1659,1652,3311,7533
140,80,-30,1633,1679,3312,7237
-30,40,100,1671,1641,3312,7876
70,-60,-170,1652,1660,3312,7826
130,-40,-120,1627,1685,3312,7555
-140,-30,70,1700,1612,3312,7637
-100,-60,20,1640,1673,3313,7382
-140,-70,-50,1694,1619,3313,7551
-20,80,130,1648,1665,3313,7482
150,50,-50,1675,1638,3313,7538
10,70,100,1628,1686,3314,7431
-130,-20,-40,1660,1654,3314,7523
-160,50,-110,1671,1644,3315,7565
60,-60,180,1648,1667,3315,7811
170,-70,-120,1666,1649,3315,7779
60,-60,-180,1648,1667,3315,7811
120,-30,-100,1622,1693,3315,7487
140,-70,-140,1670,1646,3316,7688
-80,60,160,1677,1639,3316,7564
-70,0,130,1652,1664,3316,7757
20,-80,-80,1650,1667,3317,7693
-40,40,-80,1660,1657,3317,7500
-140,-20,50,1667,1650,3317,7558
-80,30,160,1679,1638,3317,7776
-70,70,160,1664,1654,3318,7537
20,-70,140,1667,1651,3318,7692
90,-30,-30,1673,1645,3318,7709
-20,-50,100,1666,1653,3319,7548
-130,10,-60,1638,1681,3319,7591
90,60,30,1653,1666,3319,7418
120,40,-20,1649,1670,3319,7652
-60,-20,70,1677,1643,3320,7833
-80,0,160,1683,1637,3320,7673
-140,-20,-100,1639,1681,3320,7989
-150,-40,-90,1671,1649,3320,7797
160,70,-70,1669,1652,3321,7675
-160,60,-110,1654,1667,3321,7783
-100,50,-160,1653,1668,3321,7756
-130,-20,40,1674,1647,3321,7348
-100,60,-170,1694,1627,3321,7620
180,60,-80,1662,1660,3322,7471
40,-60,160,1651,1671,3322,7686
-180,60,-80,1662,1660,3322,7471
-150,30,-120,1679,1643,3322,7798
-90,-70,30,1682,1640,3322,7548
-140,-10,-110,1661,1662,3323,7872
160,30,-90,1662,1661,3323,7738
80,-60,-160,1664,1659,3323,7715
-140,60,-130,1682,1641,3323,7728
-10,20,100,1684,1639,3323,7405
-20,40,100,1661,1662,3323,7785
170,-80,-90,1666,1657,3323,7512
-150,-60,-70,1685,1639,3324,7717
160,-50,-130,1657,1667,3324,7875
10,-60,-90,1637,1687,3324,7697
-60,70,150,1671,1654,3325,7492
-130,-40,100,1675,1650,3325,7728
-120,30,0,1693,1632,3325,7920
170,50,-90,1657,1668,3325,7803
180,60,-70,1683,1642,3325,7305
-70,10,140,1680,1645,3325,7620
50,10,-120,1686,1639,3325,7848
180,40,-100,1660,1665,3325,7771
-180,60,-70,1683,1642,3325,7305
-180,40,-100,1660,1665,3325,7771
-40,0,90,1694,1631,3325,7617
-100,-80,160,1664,1662,3326,7483
120,-60,-140,1676,1650,3326,7618
-120,80,10,1676,1650,3326,7952
-20,60,110,1671,1656,3327,7580
130,-50,-130,1652,1675,3327,7517
-120,-80,-20,1695,1633,3328,7496
-80,60,170,1686,1642,3328,7758
-110,80,-160,1675,1653,3328,7654
-10,80,110,1637,1691,3328,7462
-90,20,-140,1668,1660,3328,7956
-40,70,130,1657,1671,3328,7603
-140,80,-130,1682,1647,3329,7690
-80,20,-130,1663,1667,3330,7782
-130,-80,-30,1691,1639,3330,7476
10,-70,-90,1635,1696,3331,7487
170,30,-100,1658,1673,3331,7954
70,-80,180,1671,1660,3331,7540
70,-80,-180,1671,1660,3331,7540
40,-10,-90,1652,1679,3331,7756
160,80,-60,1646,1686,3332,7657
130,30,90,1657,1675,3332,7894
-160,-50,90,1694,1638,3332,7784
-130,60,-140,1677,1655,3332,7658
80,-50,-150,1655,1677,3332,7639
-70,20,140,1687,1645,3332,7761
170,0,-110,1676,1656,3332,7875
-60,-60,-160,1675,1658,3333,7720
150,-10,70,1660,1673,3333,7822
50,-60,170,1661,1672,3333,7697
0,80,-110,1688,1645,3333,7818
-50,-40,70,1651,1682,3333,7764
100,30,80,1668,1666,3334,7707
-90,-80,170,1672,1662,3334,7550
-180,-50,80,1673,1662,3335,7785
-160,50,-100,1674,1661,3335,7435
180,-50,80,1673,1662,3335,7785
120,-20,-90,1683,1653,3336,7600
-180,80,-70,1659,1677,3336,7375
180,80,-70,1659,1677,3336,7375
-140,50,-120,1686,1650,3336,7574
-170,60,-80,1684,1653,3337,7375
-60,-10,80,1679,1659,3338,7920
120,70,-10,1651,1687,3338,7296
40,-50,170,1676,1662,3338,7703
-10,40,-90,1657,1681,3338,8077
170,80,-70,1656,1682,3338,7652
-120,-50,120,1697,1641,3338,7788
-50,20,100,1692,1646,3338,7871
120,20,-20,1650,1689,3339,7685
10,-80,-90,1648,1691,3339,7745
130,60,-30,1660,1679,3339,7564
-20,-20,90,1682,1657,3339,7717
-10,-10,100,1682,1657,3339,7777
60,40,100,1671,1668,3339,7405
-10,40,110,1672,1668,3340,7673
-50,70,140,1674,1667,3341,7621
130,-30,-100,1669,1672,3341,7475
-30,-60,90,1673,1668,3341,7407
-170,-80,-70,1677,1664,3341,7590
-10,-30,110,1676,1665,3341,7592
40,10,140,1621,1720,3341,7433
-180,70,-90,1664,1677,3341,7667
30,50,-130,1696,1645,3341,7819
-60,40,-70,1651,1690,3341,7503
180,70,-90,1664,1677,3341,7667
170,80,-60,1663,1678,3341,7351
30,0,140,1664,1677,3341,7306
-160,70,-90,1671,1670,3341,7456
60,0,-150,1626,1716,3342,7569
-80,20,180,1675,1667,3342,7523
-100,-30,100,1659,1683,3342,7576
-80,20,-180,1675,1667,3342,7523
40,-20,-80,1666,1677,3343,7877
-90,30,-160,1684,1659,3343,7576
150,60,90,1697,1646,3343,7565
-120,80,-150,1685,1658,3343,7761
80,-10,-110,1649,1694,3343,7700
-50,-30,70,1696,1648,3344,7879
-140,-10,40,1686,1658,3344,7286
-110,-60,0,1703,1641,3344,7662
50,-30,-70,1628,1716,3344,7723
-80,-30,170,1670,1674,3344,7912
-90,20,-150,1680,1664,3344,7927
40,60,-150,1682,1662,3344,7744
-90,-30,70,1662,1683,3345,7505
-70,30,140,1694,1651,3345,7949
-160,-60,-90,1710,1635,3345,7883
-150,60,-120,1687,1658,3345,7799
-160,-70,-80,1703,1642,3345,7907
110,20,60,1671,1674,3345,7896
-130,10,-90,1675,1670,3345,7551
-130,80,-120,1666,1679,3345,7552
30,70,-140,1696,1649,3345,7934
-70,-40,60,1664,1682,3346,7883
-80,-80,180,1692,1654,3346,7620
-180,-60,80,1689,1657,3346,8004
180,-60,80,1689,1657,3346,8004
150,70,90,1712,1634,3346,7720
130,-70,-140,1689,1657,3346,7940
-80,-80,-180,1692,1654,3346,7620
-30,30,-90,1646,1700,3346,7576
40,0,150,1686,1661,3347,7318
-150,70,-100,1660,1687,3347,7417
160,60,-60,1686,1661,3347,7787
-150,-30,-100,1677,1671,3348,8081
-30,80,130,1668,1680,3348,7588
130,-40,-110,1651,1697,3348,7730
160,70,-60,1678,1670,3348,7793
0,70,110,1665,1683,3348,7511
-180,80,-80,1675,1673,3348,7587
30,-50,160,1668,1680,3348,7625
180,80,-80,1675,1673,3348,7587
140,20,-60,1694,1655,3349,7682
170,-60,70,1699,1650,3349,7769
-130,50,-130,1686,1663,3349,7689
30,-70,150,1664,1686,3350,7823
-20,80,120,1655,1695,3350,7486
120,-50,20,1680,1670,3350,7760
-60,0,110,1697,1653,3350,7761
-140,-30,-70,1691,1659,3350,7595
-110,80,-140,1671,1679,3350,7525
150,30,-70,1671,1680,3351,7925
0,60,110,1694,1657,3351,7532
-130,80,-140,1694,1657,3351,7759
-120,50,-140,1690,1661,3351,7846
170,20,-100,1670,1681,3351,8089
110,-50,-130,1650,1701,3351,7534
50,20,-150,1657,1694,3351,7650
-150,-50,-80,1702,1650,3352,7797
180,-80,-80,1676,1676,3352,7583
-180,-80,-80,1676,1676,3352,7583
-100,-70,10,1691,1662,3353,7597
10,10,120,1662,1691,3353,7357
-180,50,-80,1681,1673,3354,7483
0,-80,-100,1648,1706,3354,7774
180,50,-80,1681,1673,3354,7483
90,50,50,1671,1683,3354,7470
-160,60,-90,1675,1679,3354,7431
170,-10,-110,1681,1674,3355,7883
-20,-40,100,1668,1687,3355,7525
-10,70,110,1655,1700,3355,7550
170,10,70,1705,1650,3355,7834
-150,80,-100,1668,1688,3356,7570
50,40,-170,1676,1680,3356,7818
130,0,-70,1693,1663,3356,7741
0,-50,-100,1659,1697,3356,7767
70,-40,-150,1677,1679,3356,7364
-140,70,-130,1685,1671,3356,7545
-60,-70,-160,1709,1648,3357,7803
170,60,-60,1680,1678,3358,7603
-80,30,180,1688,1670,3358,7464
10,-20,130,1676,1682,3358,7630
-110,50,-150,1687,1671,3358,7739
-80,30,-180,1688,1670,3358,7464
130,-10,-80,1660,1699,3359,7740
10,60,-110,1694,1665,3359,7985
140,70,-40,1679,1680,3359,7715
-80,-60,50,1695,1664,3359,7584
150,-50,-130,1681,1678,3359,7924
-170,-50,-110,1697,1662,3359,7852
-130,0,-100,1688,1671,3359,7955
-60,-10,90,1706,1654,3360,7829
140,20,80,1687,1673,3360,7905
10,20,-100,1656,1705,3361,7847
20,40,-110,1699,1662,3361,7804
0,-60,-100,1656,1705,3361,7771
170,50,-80,1657,1704,3361,7890
-150,-80,-50,1703,1658,3361,7632
-130,-50,110,1695,1666,3361,7869
-140,-80,-40,1713,1649,3362,7595
-160,60,-100,1693,1669,3362,7625
-180,70,-80,1676,1686,3362,7576
140,-60,40,1686,1676,3362,7573
-70,60,160,1669,1693,3362,7720
-70,-20,80,1682,1680,3362,7852
-170,30,-110,1690,1672,3362,7837
140,30,-50,1711,1651,3362,7612
180,70,-80,1676,1686,3362,7576
-170,50,-100,1666,1696,3362,7767
-80,-80,30,1670,1692,3362,7536
-170,60,-100,1672,1691,3363,7777
-100,30,-90,1729,1635,3364,7661
140,-20,-90,1669,1695,3364,7589
-100,30,-50,1674,1690,3364,7665
-100,80,-150,1683,1681,3364,7466
170,70,-70,1684,1680,3364,7730
-120,80,-130,1668,1696,3364,7571
180,60,-90,1687,1678,3365,7819
90,-60,-150,1680,1685,3365,7889
-160,-80,-60,1705,1660,3365,7631
-70,20,-120,1716,1649,3365,7819
-70,-80,-170,1695,1670,3365,7874
-140,70,-110,1681,1684,3365,7570
-180,60,-90,1687,1678,3365,7819
-120,20,-110,1681,1684,3365,7782
60,30,150,1676,1689,3365,7392
-60,10,120,1698,1668,3366,7756
-140,70,-120,1664,1702,3366,7669
-160,40,-110,1701,1666,3367,7728
-80,-20,170,1687,1680,3367,7830
110,-20,0,1659,1708,3367,7646
-60,20,120,1721,1646,3367,7921
-30,80,140,1673,1694,3367,7620
60,50,80,1682,1685,3367,7468
-120,70,-150,1699,1669,3368,7748
170,-10,70,1703,1665,3368,8144
40,-10,160,1718,1650,3368,7285
-140,-60,-50,1719,1649,3368,7826
-10,60,-90,1668,1700,3368,8065
-140,30,-120,1723,1646,3369,7943
-80,-20,110,1677,1692,3369,7896
-160,70,-100,1692,1677,3369,7591
-20,50,110,1692,1677,3369,7698
-60,0,-140,1709,1660,3369,7584
-140,80,-110,1669,1700,3369,7583
-130,10,-110,1696,1673,3369,7950
110,20,40,1687,1683,3370,7680
-90,70,-180,1703,1667,3370,7824
-90,70,180,1703,1667,3370,7824
-10,-80,-110,1668,1702,3370,7839
-160,70,-110,1658,1712,3370,7685
110,-10,-60,1693,1678,3371,7631
-90,50,-170,1706,1665,3371,7714
-60,-50,-160,1717,1654,3371,7767
160,50,-70,1663,1708,3371,8003
-120,-30,70,1670,1702,3372,7710
-120,10,-20,1730,1642,3372,7635
-150,70,-120,1663,1709,3372,7528
-80,70,170,1703,1669,3372,7661
140,60,-40,1683,1690,3373,7697
-30,50,110,1695,1678,3373,7801
-100,80,-10,1698,1675,3373,8069
-30,-40,90,1706,1667,3373,7797
60,90,40,1675,1699,3374,7696
-50,90,150,1675,1699,3374,7696
90,90,10,1675,1699,3374,7696
-70,90,170,1675,1699,3374,7696
170,90,-70,1675,1699,3374,7696
-80,90,-180,1675,1699,3374,7696
-180,90,-80,1675,1699,3374,7696
10,90,90,1675,1699,3374,7696
130,90,-30,1675,1699,3374,7696
40,90,60,1675,1699,3374,7696
-80,10,180,1721,1653,3374,7936
140,90,-40,1675,1699,3374,7696
-10,90,110,1675,1699,3374,7696
-110,90,-150,1675,1699,3374,7696
170,60,-80,1667,1707,3374,7849
-170,90,-90,1675,1699,3374,7696
20,90,80,1675,1699,3374,7696
30,90,70,1675,1699,3374,7696
120,90,-20,1675,1699,3374,7696
-30,90,130,1675,1699,3374,7696
0,90,100,1675,1699,3374,7696
-120,90,-140,1675,1699,3374,7696
100,90,0,1675,1699,3374,7696
180,90,-80,1675,1699,3374,7696
-150,90,-110,1675,1699,3374,7696
160,50,-60,1690,1684,3374,7784
150,90,-50,1675,1699,3374,7696
-80,10,-180,1721,1653,3374,7936
-20,90,120,1675,1699,3374,7696
160,90,-60,1675,1699,3374,7696
50,90,50,1675,1699,3374,7696
-100,90,-160,1675,1699,3374,7696
110,90,-10,1675,1699,3374,7696
-140,90,-120,1675,1699,3374,7696
-160,90,-100,1675,1699,3374,7696
-60,90,160,1675,1699,3374,7696
-40,60,130,1693,1681,3374,7617
-80,90,180,1675,1699,3374,7696
-40,90,140,1675,1699,3374,7696
70,90,30,1675,1699,3374,7696
80,90,20,1675,1699,3374,7696
-90,90,-170,1675,1699,3374,7696
-130,90,-130,1675,1699,3374,7696
100,30,70,1699,1676,3375,7817
120,10,-40,1686,1689,3375,7595
50,30,120,1691,1684,3375,7534
160,30,-80,1652,1723,3375,7795
-170,60,-90,1704,1671,3375,7548
-40,50,-70,1697,1678,3375,8063
150,20,-70,1690,1685,3375,7897
160,-20,-110,1676,1699,3375,7695
100,30,60,1692,1684,3376,7730
-150,50,-110,1686,1690,3376,7484
150,70,-50,1684,1692,3376,7808
140,-40,-120,1644,1732,3376,7718
-50,60,140,1690,1687,3377,7580
150,-70,-130,1706,1672,3378,7832
-150,60,-110,1699,1679,3378,7727
-170,80,-80,1687,1691,3378,7505
130,50,-30,1687,1691,3378,7769
-50,30,110,1720,1658,3378,7921
-100,-30,90,1651,1727,3378,7796
110,60,0,1682,1697,3379,7946
110,40,0,1649,1730,3379,7654
100,-20,-50,1677,1703,3380,7571
-150,70,-110,1700,1680,3380,7613
10,30,-100,1702,1678,3380,7958
-160,20,-110,1715,1665,3380,7977
20,-90,-80,1671,1710,3381,7826
90,-90,-10,1671,1710,3381,7826
-50,-90,-150,1671,1710,3381,7826
30,-90,-70,1671,1710,3381,7826
150,-90,50,1671,1710,3381,7826
-130,-70,-30,1732,1649,3381,7691
-40,-90,-140,1671,1710,3381,7826
-110,-90,150,1671,1710,3381,7826
-60,-90,-160,1671,1710,3381,7826
-70,-90,-170,1671,1710,3381,7826
180,-90,80,1671,1710,3381,7826
80,-90,-20,1671,1710,3381,7826
-150,-90,110,1671,1710,3381,7826
-140,-90,120,1671,1710,3381,7826
-20,-90,-120,1671,1710,3381,7826
-100,-60,150,1692,1689,3381,7700
-130,-90,130,1671,1710,3381,7826
-100,-90,160,1671,1710,3381,7826
120,-90,20,1671,1710,3381,7826
170,-90,70,1671,1710,3381,7826
-30,-90,-130,1671,1710,3381,7826
130,-90,30,1671,1710,3381,7826
-50,-10,80,1695,1686,3381,7909
40,-90,-60,1671,1710,3381,7826
-90,-90,170,1671,1710,3381,7826
120,-50,-130,1681,1700,3381,7855
50,50,-170,1705,1676,3381,7750
-10,-90,-110,1671,1710,3381,7826
0,-90,-100,1671,1710,3381,7826
-120,-90,140,1671,1710,3381,7826
100,-90,0,1671,1710,3381,7826
-80,-90,-180,1671,1710,3381,7826
-10,80,-100,1721,1660,3381,8009
110,-90,10,1671,1710,3381,7826
-160,-90,100,1671,1710,3381,7826
160,-90,60,1671,1710,3381,7826
-80,-90,180,1671,1710,3381,7826
-180,-90,80,1671,1710,3381,7826
130,70,-20,1676,1705,3381,7541
70,-20,-80,1695,1686,3381,7800
-170,-90,90,1671,1710,3381,7826
10,-90,-90,1671,1710,3381,7826
50,-90,-50,1671,1710,3381,7826
140,-90,40,1671,1710,3381,7826
60,-90,-40,1671,1710,3381,7826
70,-90,-30,1671,1710,3381,7826
-60,60,-50,1679,1703,3382,8070
-20,-10,90,1708,1674,3382,7950
170,40,-90,1669,1713,3382,7751
-170,-70,-90,1704,1678,3382,7925
90,-50,-140,1678,1704,3382,7809
-110,70,-160,1711,1671,3382,7796
-170,70,-90,1701,1682,3383,7596
-110,80,0,1698,1685,3383,7961
-110,-30,70,1689,1694,3383,7505
-160,80,-90,1694,1689,3383,7539
140,-20,-100,1662,1721,3383,7808
-140,40,-120,1702,1682,3384,7771
-40,-40,80,1706,1678,3384,7874
70,40,150,1711,1673,3384,7512
-170,70,-80,1710,1674,3384,7535
-10,0,100,1696,1689,3385,7648
-130,70,-140,1698,1687,3385,7669
-130,-30,-40,1710,1675,3385,7650
-170,70,-100,1683,1702,3385,7609
-110,-40,30,1719,1666,3385,7625
-120,20,-100,1683,1702,3385,7881
110,-60,-140,1699,1687,3386,7758
70,-10,-130,1668,1719,3387,7588
90,-40,-130,1678,1709,3387,7365
-170,80,-90,1687,1700,3387,7659
0,-40,-100,1654,1733,3387,7763
-80,80,-170,1687,1701,3388,7531
160,-20,70,1717,1671,3388,7857
150,10,-80,1713,1675,3388,7899
-40,50,120,1710,1679,3389,7896
50,10,160,1704,1685,3389,7532
150,-30,60,1719,1670,3389,7866
-170,10,-110,1729,1660,3389,8044
-110,-30,60,1710,1679,3389,7719
80,-80,-170,1701,1689,3390,7678
-100,-30,80,1677,1713,3390,7654
-50,10,100,1715,1676,3391,7903
140,-30,-110,1667,1725,3392,7792
-140,80,-120,1698,1694,3392,7648
-130,-60,-30,1730,1662,3392,7792
-80,40,160,1688,1704,3392,7844
-20,10,90,1704,1688,3392,8017
-80,0,170,1724,1668,3392,8087
150,0,-80,1692,1700,3392,7882
-170,20,-110,1693,1700,3393,8019
-160,0,50,1712,1681,3393,7679
140,50,-40,1685,1708,3393,7798
-150,80,-110,1708,1685,3393,7586
-100,70,-170,1713,1680,3393,7856
-10,50,-90,1715,1678,3393,8035
60,70,-180,1713,1681,3394,7831
170,0,-80,1706,1688,3394,7751
-150,60,-100,1684,1710,3394,7587
60,70,180,1713,1681,3394,7831
-40,30,100,1723,1672,3395,8064
-80,40,180,1693,1702,3395,7545
-80,40,-180,1693,1702,3395,7545
-60,80,160,1707,1689,3396,7804
-30,60,120,1687,1709,3396,7669
-130,80,-130,1708,1688,3396,7733
-90,80,-160,1694,1702,3396,7532
60,-40,-160,1674,1722,3396,7484
-60,-80,-160,1702,1694,3396,7965
100,-30,-110,1701,1696,3397,7819
90,40,120,1705,1692,3397,7773
-110,-50,130,1708,1689,3397,7859
-130,60,-120,1708,1689,3397,7743
80,-10,-100,1685,1713,3398,7690
-60,60,150,1699,1699,3398,7648
-80,50,170,1709,1689,3398,7950
-60,40,130,1707,1692,3399,7753
-140,0,30,1694,1705,3399,7799
40,-70,160,1686,1713,3399,7919
170,-70,-110,1720,1680,3400,7960
-90,60,-170,1697,1703,3400,7870
-120,40,-130,1709,1691,3400,7777
-50,-60,80,1732,1669,3401,7647
20,40,110,1696,1705,3401,7597
120,-70,-140,1698,1703,3401,7709
170,70,-60,1697,1704,3401,7664
130,10,-60,1710,1692,3402,7958
60,-20,-80,1717,1685,3402,8038
160,70,-50,1710,1692,3402,7820
-70,80,180,1688,1714,3402,7607
-70,80,-180,1688,1714,3402,7607
-80,-10,140,1681,1721,3402,7776
-130,10,10,1718,1684,3402,7939
-150,-40,-80,1756,1647,3403,7951
180,50,-90,1706,1697,3403,7764
90,-40,-20,1693,1710,3403,7724
-180,50,-90,1706,1697,3403,7764
-130,70,-130,1694,1710,3404,7860
-20,70,120,1691,1713,3404,7607
-90,30,-100,1717,1687,3404,7782
140,-70,-130,1709,1695,3404,8057
-80,20,-170,1726,1678,3404,7824
-40,80,150,1685,1720,3405,7647
120,-20,30,1730,1675,3405,8100
-100,40,-150,1704,1701,3405,7713
-90,70,-20,1700,1706,3406,8025
160,40,-70,1685,1721,3406,7830
-80,80,-30,1721,1685,3406,8105
-140,-20,-90,1702,1704,3406,7869
-170,-60,-100,1727,1679,3406,8073
160,60,-70,1657,1749,3406,7883
20,60,100,1686,1720,3406,7535
40,-90,150,1727,1680,3407,7782
110,-90,-140,1727,1680,3407,7782
80,-90,-170,1727,1680,3407,7782
-150,-90,-40,1727,1680,3407,7782
-180,-90,-70,1727,1680,3407,7782
-20,-90,90,1727,1680,3407,7782
-140,-90,-30,1727,1680,3407,7782
140,-90,-110,1727,1680,3407,7782
180,-90,-70,1727,1680,3407,7782
-130,-90,-20,1727,1680,3407,7782
10,-90,120,1727,1680,3407,7782
70,-90,-180,1727,1680,3407,7782
-120,-90,-10,1727,1680,3407,7782
-60,-90,50,1727,1680,3407,7782
-70,-90,40,1727,1680,3407,7782
150,-90,-100,1727,1680,3407,7782
160,-90,-90,1727,1680,3407,7782
60,-90,170,1727,1680,3407,7782
100,-90,-150,1727,1680,3407,7782
130,-90,-120,1727,1680,3407,7782
100,-70,-150,1710,1697,3407,7823
20,-90,130,1727,1680,3407,7782
-80,-90,30,1727,1680,3407,7782
-100,-90,10,1727,1680,3407,7782
-160,-90,-50,1727,1680,3407,7782
-90,-90,20,1727,1680,3407,7782
30,-90,140,1727,1680,3407,7782
170,-90,-80,1727,1680,3407,7782
-50,-90,60,1727,1680,3407,7782
-40,-10,80,1737,1670,3407,7968
-110,-90,0,1727,1680,3407,7782
-170,-90,-60,1727,1680,3407,7782
90,-90,-160,1727,1680,3407,7782
0,-90,110,1727,1680,3407,7782
-40,-90,70,1727,1680,3407,7782
-10,-90,100,1727,1680,3407,7782
50,-90,160,1727,1680,3407,7782
120,-90,-130,1727,1680,3407,7782
-30,-90,80,1727,1680,3407,7782
70,-90,180,1727,1680,3407,7782
-110,30,-130,1730,1678,3408,7884
160,-60,-130,1713,1695,3408,8144
90,-80,-160,1719,1690,3409,7788
120,-40,-110,1697,1712,3409,7669
-180,70,-70,1698,1711,3409,7637
160,20,-90,1707,1702,3409,7995
30,-30,160,1722,1687,3409,7577
150,-10,-90,1710,1699,3409,8136
-100,60,-160,1715,1694,3409,7888
-150,10,40,1718,1691,3409,7677
170,-40,-120,1704,1705,3409,7942
-80,30,170,1697,1712,3409,7875
-100,-70,20,1731,1678,3409,7799
150,-40,-120,1690,1719,3409,7956
180,70,-70,1698,1711,3409,7637
40,0,-100,1703,1707,3410,7819
-70,-60,60,1713,1697,3410,7695
-110,40,-140,1706,1704,3410,7774
150,60,-50,1717,1693,3410,8012
150,-60,-130,1724,1686,3410,8063
-60,80,170,1689,1722,3411,7694
40,-20,170,1681,1730,3411,7537
-150,-70,-60,1731,1680,3411,7692
110,50,0,1699,1712,3411,8010
-20,-80,-120,1682,1730,3412,7860
40,20,-120,1720,1692,3412,7819
100,80,140,1727,1685,3412,7852
-120,70,-140,1704,1709,3413,7873
160,-40,-120,1706,1707,3413,8124
-70,-50,60,1731,1683,3414,7911
-140,-40,-60,1728,1686,3414,7761
-140,-20,-80,1709,1705,3414,8031
-110,-70,0,1733,1681,3414,7796
120,10,60,1726,1689,3415,7981
60,70,60,1724,1691,3415,7405
110,-10,-10,1699,1716,3415,7784
70,-10,-100,1722,1694,3416,7681
180,40,-80,1696,1720,3416,7585
-140,-40,90,1732,1684,3416,7839
-180,40,-80,1696,1720,3416,7585
-10,30,110,1705,1711,3416,7891
-20,-30,100,1706,1710,3416,7778
-60,-50,70,1724,1692,3416,7802
-60,-40,-160,1711,1705,3416,7750
-120,80,-140,1709,1707,3416,7855
-20,0,90,1703,1713,3416,8016
-90,-30,150,1713,1703,3416,7997
-10,10,100,1705,1712,3417,7706
40,50,-150,1713,1704,3417,7849
160,-70,-120,1727,1690,3417,7977
-90,-60,40,1716,1701,3417,7737
-70,10,-140,1706,1712,3418,7747
-170,-40,-110,1728,1691,3419,8014
-180,10,-110,1715,1704,3419,7992
-160,80,-100,1709,1710,3419,7572
180,10,-110,1715,1704,3419,7992
-50,80,150,1706,1714,3420,7805
160,10,-90,1697,1723,3420,8168
-90,-80,20,1700,1720,3420,7673
100,-60,-140,1693,1728,3421,7924
-70,80,170,1714,1707,3421,7897
-80,30,-80,1714,1707,3421,7805
-100,70,-160,1697,1724,3421,7899
-110,50,-140,1733,1689,3422,7819
-20,30,100,1712,1710,3422,7951
140,40,-40,1708,1714,3422,7857
120,10,-30,1712,1710,3422,7888
120,-40,20,1728,1694,3422,7914
-40,80,140,1690,1733,3423,7747
100,-50,-130,1703,1720,3423,7912
40,20,130,1675,1748,3423,7375
-80,-10,170,1733,1690,3423,8023
160,40,-60,1717,1706,3423,7770
-150,-60,100,1742,1681,3423,7881
-50,80,160,1708,1717,3425,7732
110,80,130,1733,1692,3425,7906
30,-10,-90,1704,1721,3425,8194
-110,80,-150,1706,1719,3425,7882
40,10,-110,1729,1696,3425,7850
-30,-80,-130,1707,1718,3425,7827
-60,-10,-150,1728,1697,3425,7823
-50,-50,80,1722,1704,3426,7607
-90,40,-40,1729,1697,3426,7778
-50,50,130,1703,1723,3426,7927
-50,40,120,1708,1718,3426,7826
-180,-60,-110,1754,1673,3427,8022
180,-60,-110,1754,1673,3427,8022
-130,10,-100,1698,1729,3427,8130
50,-20,-80,1695,1733,3428,7994
-140,10,-110,1719,1709,3428,8088
140,-60,-130,1728,1700,3428,7931
-70,-20,-170,1729,1699,3428,7873
170,-50,70,1728,1700,3428,7938
110,-10,-70,1704,1724,3428,7865
170,40,-70,1710,1718,3428,7732
170,10,-100,1715,1714,3429,8272
-120,20,-10,1756,1673,3429,7763
-70,80,-40,1720,1709,3429,8174
-90,80,-20,1735,1694,3429,8090
-40,-20,80,1738,1691,3429,7988
180,50,-70,1729,1701,3430,7449
-110,40,-10,1768,1662,3430,8072
20,70,-130,1751,1679,3430,8056
-60,-60,70,1716,1714,3430,7715
-160,10,-110,1763,1667,3430,8058
-180,50,-70,1729,1701,3430,7449
-170,40,-90,1710,1720,3430,7724
-70,-20,90,1716,1715,3431,7785
160,60,80,1731,1700,3431,7804
180,-70,-100,1731,1700,3431,7980
-110,70,-150,1712,1719,3431,7914
-180,-70,-100,1731,1700,3431,7980
170,30,70,1745,1687,3432,7819
140,70,-30,1702,1730,3432,7750
-170,-40,80,1728,1704,3432,7951
0,-30,-100,1692,1740,3432,7793
-60,-70,70,1729,1703,3432,7636
110,20,50,1721,1711,3432,7805
130,80,110,1757,1675,3432,7909
100,-80,-150,1736,1696,3432,7901
-130,30,-120,1724,1709,3433,8036
50,20,170,1718,1715,3433,7432
-100,-50,30,1719,1715,3434,8060
-140,60,-120,1731,1703,3434,7853
0,-70,-100,1692,1742,3434,7715
-80,80,180,1720,1715,3435,8000
100,-20,-100,1715,1720,3435,7862
-170,40,-100,1731,1704,3435,7934
50,-70,170,1714,1721,3435,7963
-80,80,-180,1720,1715,3435,8000
-160,40,-100,1722,1713,3435,7823
100,-40,-120,1702,1734,3436,7614
-170,-70,-80,1751,1685,3436,8014
120,80,120,1751,1685,3436,7876
30,-40,-80,1682,1755,3437,7752
-90,80,-170,1725,1712,3437,8019
-110,60,-150,1719,1719,3438,8110
160,-50,60,1749,1690,3439,7980
-150,20,-110,1731,1708,3439,8099
170,40,-80,1709,1730,3439,7800
-170,0,-110,1756,1683,3439,7965
-10,70,120,1715,1724,3439,7625
-150,-50,-70,1739,1701,3440,7975
-50,-40,80,1717,1723,3440,7828
-110,30,-20,1758,1682,3440,8064
-50,-70,80,1753,1687,3440,7583
60,-10,-100,1737,1704,3441,7815
20,20,120,1708,1733,3441,7639
-90,80,-150,1721,1720,3441,7626
-30,0,90,1725,1716,3441,8029
-80,80,-160,1717,1724,3441,7579
-130,70,-120,1736,1705,3441,7692
-180,-70,-90,1749,1692,3441,8018
180,-70,-90,1749,1692,3441,8018
-180,0,-110,1762,1680,3442,8118
160,70,80,1742,1700,3442,7932
-40,-80,-140,1710,1732,3442,7823
120,-50,-120,1716,1726,3442,7917
170,-70,-100,1737,1705,3442,7938
-80,-40,60,1708,1734,3442,8034
50,60,-170,1714,1728,3442,7903
70,-70,-170,1728,1714,3442,7953
180,0,-110,1762,1680,3442,8118
170,-60,-120,1736,1706,3442,8192
170,40,70,1752,1690,3442,7862
180,-10,-110,1746,1697,3443,8013
-180,-10,-110,1746,1697,3443,8013
-80,20,-160,1714,1729,3443,7933
-110,-50,10,1717,1726,3443,7851
130,-70,-130,1724,1719,3443,7883
-10,-70,-110,1706,1738,3444,7962
100,-20,-30,1722,1722,3444,7760
160,0,-80,1725,1719,3444,7821
-140,-70,-40,1753,1691,3444,7810
130,50,100,1746,1698,3444,7771
-150,-10,-110,1761,1683,3444,8123
150,10,-70,1739,1706,3445,7985
110,-30,-100,1710,1735,3445,7870
90,80,150,1745,1700,3445,7923
-80,30,-170,1727,1718,3445,7928
-70,50,150,1728,1717,3445,7928
-100,80,-160,1728,1717,3445,7931
-20,40,110,1745,1700,3445,7638
-150,40,-110,1729,1716,3445,7780
-40,-60,90,1728,1717,3445,7711
-120,60,-130,1730,1716,3446,7753
-30,50,120,1731,1715,3446,7812
20,-20,140,1727,1719,3446,7803
110,-10,-30,1721,1726,3447,7908
50,20,-180,1753,1694,3447,7512
50,20,180,1753,1694,3447,7512
-50,-70,-150,1724,1724,3448,7963
-30,80,-80,1746,1702,3448,8231
-100,-80,10,1713,1735,3448,7744
-50,-10,90,1745,1704,3449,7934
-120,50,-130,1738,1711,3449,7944
-170,10,-90,1717,1732,3449,7854
20,10,-100,1696,1753,3449,7881
-80,-30,70,1701,1749,3450,7863
80,40,130,1713,1737,3450,7962
-80,50,180,1726,1724,3450,7958
-80,50,-180,1726,1724,3450,7958
150,30,-60,1727,1723,3450,7821
140,-10,-80,1712,1739,3451,7985
-140,60,-110,1697,1754,3451,7820
-160,-50,-90,1758,1693,3451,8036
90,-30,-120,1740,1712,3452,7892
170,-20,-110,1731,1721,3452,7994
-160,30,-110,1746,1706,3452,8110
140,80,100,1764,1688,3452,8003
80,60,150,1746,1706,3452,7757
-100,50,-150,1738,1714,3452,7846
-110,60,-140,1721,1731,3452,7825
-10,50,120,1745,1707,3452,7771
-40,80,-70,1746,1707,3453,8320
-100,30,-60,1727,1726,3453,7934
160,0,-100,1698,1755,3453,7964
-130,20,-110,1715,1738,3453,8079
-90,70,-170,1705,1749,3454,8025
-40,-30,80,1737,1717,3454,8031
50,20,140,1695,1759,3454,7733
-70,80,-170,1723,1731,3454,7660
-10,-20,110,1709,1745,3454,7926
-160,-60,-80,1764,1690,3454,8025
-130,20,-100,1732,1722,3454,8159
60,0,-120,1731,1723,3454,7985
-130,60,-130,1745,1709,3454,8045
120,0,-60,1734,1721,3455,8224
-80,60,-180,1713,1742,3455,8023
-50,-80,-150,1718,1737,3455,7944
-80,60,180,1713,1742,3455,8023
170,-20,70,1758,1698,3456,8081
60,-70,180,1734,1722,3456,8012
60,-70,-180,1734,1722,3456,8012
-60,80,-50,1740,1716,3456,8251
-50,80,-60,1746,1711,3457,8259
-50,10,-110,1750,1707,3457,8020
-30,30,100,1745,1712,3457,8061
70,70,50,1740,1717,3457,7466
160,30,-70,1721,1736,3457,7860
-20,80,-90,1758,1700,3458,8193
-160,-70,-70,1753,1705,3458,7876
170,50,-60,1720,1738,3458,7752
0,-10,120,1749,1709,3458,7668
50,30,-170,1725,1733,3458,7790
-140,-30,-60,1718,1741,3459,7932
-120,-30,-10,1755,1704,3459,7919
160,-10,-100,1694,1765,3459,8157
30,50,100,1710,1749,3459,7662
80,70,40,1744,1715,3459,7668
70,-50,-40,1712,1747,3459,7957
110,-80,-140,1756,1703,3459,7968
150,-70,-120,1752,1707,3459,8176
-40,-80,80,1731,1729,3460,7829
160,-70,-110,1752,1708,3460,8038
-70,20,150,1720,1740,3460,7940
-80,70,-30,1725,1736,3461,8091
150,70,-40,1712,1749,3461,7914
-110,-80,0,1738,1724,3462,7865
-40,40,110,1745,1717,3462,7949
-50,80,170,1758,1705,3463,7836
-30,-70,-130,1723,1740,3463,7942
150,40,-50,1728,1735,3463,7815
150,-30,-110,1723,1741,3464,8188
160,-10,70,1738,1726,3464,7990
-40,-40,90,1732,1732,3464,8036
100,-20,-40,1728,1736,3464,7958
60,30,140,1726,1738,3464,7771
150,-50,-120,1746,1719,3465,8053
180,-20,70,1761,1704,3465,8176
140,40,90,1760,1705,3465,7974
-180,-20,70,1761,1704,3465,8176
-100,80,-140,1732,1733,3465,7767
-80,-10,150,1711,1754,3465,7888
140,-30,50,1748,1718,3466,7920
-90,30,-110,1755,1712,3467,8074
-50,20,110,1789,1678,3467,8159
-60,-10,100,1744,1723,3467,7988
-150,-30,70,1755,1712,3467,7785
-120,70,-130,1763,1704,3467,7808
-180,40,-90,1710,1757,3467,7762
60,0,-130,1731,1736,3467,7823
-120,-30,40,1755,1712,3467,7725
140,-70,-120,1744,1723,3467,8020
180,40,-90,1710,1757,3467,7762
-80,-40,170,1760,1708,3468,8072
-40,-70,90,1766,1702,3468,7614
-50,-20,90,1749,1719,3468,8018
-50,0,100,1770,1698,3468,8050
-70,-70,60,1742,1727,3469,7717
-120,20,-60,1743,1727,3470,8074
-40,-20,90,1750,1720,3470,8157
-120,-30,60,1753,1717,3470,7853
-30,70,130,1731,1739,3470,7779
-110,80,-130,1754,1717,3471,7807
160,60,-50,1729,1742,3471,7855
-140,10,-100,1734,1737,3471,8015
60,-50,-50,1720,1751,3471,8043
60,50,170,1764,1708,3472,7785
-150,30,-110,1760,1712,3472,8145
-130,20,10,1755,1717,3472,8266
-170,50,-80,1744,1728,3472,7737
-50,-20,80,1741,1731,3472,8117
120,60,-10,1713,1759,3472,8039
-20,-80,100,1739,1734,3473,7966
-40,80,160,1756,1717,3473,7825
130,10,70,1749,1724,3473,8304
110,-10,-50,1715,1759,3474,7795
-140,0,-110,1756,1718,3474,8288
-70,50,160,1726,1748,3474,8024
100,50,30,1747,1727,3474,7805
-20,60,120,1744,1730,3474,7921
80,-30,-50,1715,1760,3475,8230
170,-70,-90,1749,1726,3475,7841
80,-70,-160,1735,1740,3475,7950
-110,-40,120,1753,1723,3476,7848
-30,-20,-120,1739,1737,3476,7879
-180,30,-100,1729,1747,3476,8223
-170,30,-90,1757,1719,3476,7945
-100,-30,110,1736,1740,3476,7999
180,30,-100,1729,1747,3476,8223
-160,-20,-110,1766,1710,3476,8197
10,-10,130,1733,1743,3476,7739
-110,30,-120,1748,1728,3476,8176
130,-30,40,1736,1741,3477,7980
-150,10,-110,1773,1704,3477,8241
-100,30,-130,1734,1743,3477,8066
-160,-40,-100,1744,1733,3477,8109
130,40,-30,1732,1746,3478,8019
-60,-40,70,1754,1724,3478,8027
170,10,-90,1725,1754,3479,8157
-130,20,-90,1766,1713,3479,8005
-20,10,-100,1725,1754,3479,8084
-160,20,-100,1739,1740,3479,8143
80,-30,-130,1731,1748,3479,7913
20,-20,-90,1694,1786,3480,8091
90,60,140,1744,1736,3480,7851
100,40,110,1754,1726,3480,7983
90,-20,-110,1734,1746,3480,7953
150,-50,50,1787,1694,3481,7829
-20,-70,-120,1745,1736,3481,7946
50,0,-110,1759,1723,3482,8082
-140,20,-110,1744,1738,3482,8117
100,80,20,1762,1720,3482,7953
-60,50,140,1748,1735,3483,7950
100,60,20,1729,1754,3483,7886
80,40,90,1742,1743,3485,8005
160,-70,-100,1761,1724,3485,7977
-20,50,120,1761,1724,3485,8051
-60,80,180,1749,1736,3485,7780
-60,80,-180,1749,1736,3485,7780
-100,30,-100,1767,1718,3485,7985
180,30,-80,1766,1720,3486,7918
-30,-80,90,1735,1751,3486,7941
-180,30,-80,1766,1720,3486,7918
-130,-50,-30,1782,1705,3487,8071
-50,-80,70,1757,1730,3487,7891
70,40,100,1741,1746,3487,7896
-110,30,-80,1773,1715,3488,7871
-30,40,110,1744,1744,3488,8108
-170,-20,-110,1776,1712,3488,8463
110,80,10,1753,1735,3488,7933
-60,20,-100,1748,1741,3489,8106
-40,70,140,1753,1736,3489,7918
-80,40,170,1726,1764,3490,8010
-130,-80,-20,1751,1739,3490,8043
-140,-10,-100,1733,1757,3490,8219
-160,30,-100,1763,1727,3490,8118
-120,-80,-10,1744,1746,3490,7965
50,70,70,1750,1741,3491,7652
-60,30,130,1760,1731,3491,8123
60,0,-140,1722,1769,3491,7933
-10,-80,110,1748,1743,3491,8079
-10,-70,120,1759,1733,3492,7850
70,-30,-60,1713,1779,3492,8275
-50,-20,-140,1773,1719,3492,7985
-90,50,-160,1762,1731,3493,7953
-170,-50,-100,1767,1726,3493,8114
0,-80,120,1759,1734,3493,8129
-180,-70,-80,1769,1725,3494,7912
180,-70,-80,1769,1725,3494,7912
-170,20,-90,1731,1763,3494,8031
-100,30,-80,1755,1739,3494,8050
-70,30,150,1743,1752,3495,8168
150,-70,-110,1756,1739,3495,8105
-60,-20,80,1762,1733,3495,8275
-20,-70,110,1746,1749,3495,7722
-80,70,-180,1735,1761,3496,8153
-140,0,-70,1766,1730,3496,7929
0,60,-100,1746,1750,3496,8198
-70,-10,-170,1749,1747,3496,7986
-80,70,180,1735,1761,3496,8153
130,-30,-90,1733,1764,3497,7815
-140,-10,-80,1737,1761,3498,8166
-20,-60,110,1754,1744,3498,8001
-130,20,-80,1736,1762,3498,8018
-10,-60,-110,1733,1766,3499,8045
-140,0,-80,1738,1761,3499,8194
-20,70,130,1744,1755,3499,7722
-160,-40,-90,1775,1725,3500,8330
110,-70,-140,1751,1749,3500,8129
-120,60,-140,1742,1758,3500,8123
-70,70,-40,1751,1749,3500,8266
-40,-50,90,1786,1714,3500,7869
160,0,70,1775,1726,3501,8374
-150,10,-100,1744,1757,3501,8236
-130,30,10,1774,1727,3501,8208
160,0,-90,1724,1777,3501,8160
-30,-60,100,1734,1768,3502,7977
-30,-70,100,1773,1729,3502,7711
-150,-60,-60,1802,1700,3502,8058
170,-40,70,1779,1724,3503,8372
-40,20,100,1787,1717,3504,8312
-40,-10,90,1784,1720,3504,7977
-90,-30,80,1741,1763,3504,7871
-30,0,-110,1770,1735,3505,8329
170,-50,-120,1747,1758,3505,8136
-120,80,-120,1778,1728,3506,7817
110,-50,-120,1744,1762,3506,8137
110,-40,-110,1721,1785,3506,7927
-180,10,-90,1759,1748,3507,8308
-30,80,150,1754,1753,3507,7829
120,-80,-130,1771,1736,3507,8119
70,-20,-140,1736,1771,3507,7967
150,80,90,1793,1714,3507,8106
180,10,-90,1759,1748,3507,8308
50,-50,-60,1735,1772,3507,8126
-40,-70,-140,1752,1755,3507,7879
-110,70,-140,1776,1732,3508,7950
140,80,-20,1761,1747,3508,7941
180,20,-100,1759,1749,3508,8200
160,10,-80,1766,1742,3508,8068
-180,20,-100,1759,1749,3508,8200
-80,-80,40,1765,1744,3509,8085
-130,20,-70,1781,1728,3509,8102
160,20,-70,1754,1755,3509,8063
80,80,160,1778,1731,3509,8036
160,50,-50,1746,1763,3509,7978
150,0,70,1764,1746,3510,8207
-60,-80,60,1761,1750,3511,7962
170,20,-90,1764,1747,3511,8165
-150,90,-90,1768,1744,3512,7812
10,70,-120,1794,1718,3512,8337
-60,90,-180,1768,1744,3512,7812
-30,90,150,1768,1744,3512,7812
170,90,-50,1768,1744,3512,7812
60,90,60,1768,1744,3512,7812
130,90,-10,1768,1744,3512,7812
70,90,50,1768,1744,3512,7812
140,0,-70,1769,1743,3512,8017
150,80,-30,1767,1745,3512,7863
180,90,-60,1768,1744,3512,7812
-120,90,-120,1768,1744,3512,7812
160,90,-40,1768,1744,3512,7812
40,90,80,1768,1744,3512,7812
-160,90,-80,1768,1744,3512,7812
30,90,90,1768,1744,3512,7812
20,90,100,1768,1744,3512,7812
-20,90,140,1768,1744,3512,7812
140,90,-20,1768,1744,3512,7812
-180,90,-60,1768,1744,3512,7812
-70,90,-170,1768,1744,3512,7812
-100,60,-150,1764,1748,3512,8030
-140,90,-100,1768,1744,3512,7812
150,90,-30,1768,1744,3512,7812
-40,90,160,1768,1744,3512,7812
110,90,10,1768,1744,3512,7812
100,90,20,1768,1744,3512,7812
-90,90,-150,1768,1744,3512,7812
90,90,30,1768,1744,3512,7812
-110,90,-130,1768,1744,3512,7812
-170,90,-70,1768,1744,3512,7812
10,90,110,1768,1744,3512,7812
120,90,0,1768,1744,3512,7812
50,90,70,1768,1744,3512,7812
-10,-50,-110,1736,1776,3512,7917
170,70,70,1800,1712,3512,8092
80,90,40,1768,1744,3512,7812
-50,90,170,1768,1744,3512,7812
0,90,120,1768,1744,3512,7812
-10,90,130,1768,1744,3512,7812
-130,90,-110,1768,1744,3512,7812
-60,90,180,1768,1744,3512,7812
-80,90,-160,1768,1744,3512,7812
-100,90,-140,1768,1744,3512,7812
110,70,10,1766,1747,3513,7797
-150,-40,-70,1785,1728,3513,8284
-70,-80,50,1764,1749,3513,7992
-140,-50,-50,1771,1742,3513,8133
-60,-30,-160,1767,1746,3513,7957
170,30,-80,1750,1763,3513,7865
110,-10,-40,1751,1762,3513,8123
-170,-10,60,1769,1744,3513,8054
80,-50,-30,1757,1757,3514,8077
-90,40,-160,1754,1760,3514,7906
170,10,-80,1737,1777,3514,7923
-40,30,-90,1704,1810,3514,8216
80,-20,-80,1756,1758,3514,8004
120,80,0,1761,1754,3515,7946
-50,-30,80,1781,1734,3515,8104
-60,20,130,1784,1731,3515,8054
-80,-50,170,1735,1780,3515,8013
-130,0,10,1774,1742,3516,8174
90,80,30,1769,1747,3516,7958
130,-50,-120,1742,1774,3516,8155
130,30,-30,1752,1764,3516,8248
40,40,-150,1754,1762,3516,8162
-10,40,120,1775,1741,3516,7836
130,60,-20,1727,1790,3517,8113
120,10,-20,1732,1785,3517,8109
160,-30,-110,1778,1739,3517,8189
170,30,-90,1748,1769,3517,8110
160,20,-80,1736,1782,3518,8031
70,60,160,1764,1754,3518,7793
-160,-20,60,1781,1737,3518,7773
-60,-30,70,1763,1755,3518,8418
-150,-30,-90,1781,1738,3519,8299
130,0,60,1772,1747,3519,8252
-170,40,-80,1782,1738,3520,7793
-130,80,-110,1780,1740,3520,7871
120,-10,-70,1775,1745,3520,7978
160,-50,-120,1766,1754,3520,8401
-20,-50,110,1758,1763,3521,8013
10,-80,130,1771,1750,3521,8118
-140,-50,100,1785,1736,3521,8285
0,-60,130,1771,1750,3521,8284
140,20,-50,1774,1747,3521,8065
130,-60,-130,1750,1771,3521,8037
-70,40,150,1742,1779,3521,7861
-90,-40,150,1759,1763,3522,8138
-150,0,-110,1786,1736,3522,8455
120,-30,20,1780,1742,3522,8218
-90,30,-90,1790,1732,3522,8111
90,70,30,1752,1770,3522,7759
50,-30,-170,1740,1783,3523,7898
-40,-30,90,1796,1727,3523,8232
-20,80,140,1764,1759,3523,7845
-120,-70,-10,1781,1742,3523,7964
-60,10,-130,1771,1752,3523,8214
-170,20,-100,1776,1747,3523,8406
90,-20,-70,1748,1775,3523,8038
130,-40,-100,1742,1782,3524,7856
-110,-70,10,1781,1744,3525,8014
-140,80,-100,1774,1751,3525,7879
-170,-10,-110,1775,1750,3525,8263
-130,-10,-30,1775,1750,3525,7930
120,40,100,1770,1755,3525,8314
70,80,50,1778,1748,3526,7943
180,-20,-110,1762,1764,3526,8283
-170,-30,-110,1787,1739,3526,8253
170,20,70,1772,1754,3526,8061
-180,-20,-110,1762,1764,3526,8283
-70,0,-160,1788,1739,3527,8181
-40,50,130,1769,1758,3527,8040
-160,10,-100,1763,1764,3527,8253
-160,0,-110,1778,1749,3527,8327
0,0,120,1785,1742,3527,7863
-150,70,-90,1783,1745,3528,7801
160,80,-40,1766,1762,3528,7755
50,50,90,1730,1798,3528,7763
90,-70,-150,1747,1781,3528,7949
-80,-10,160,1771,1757,3528,8356
130,-10,50,1757,1771,3528,8339
-120,40,0,1800,1728,3528,8411
150,0,-70,1782,1746,3528,7769
-100,-40,50,1755,1774,3529,8076
-150,20,-100,1753,1776,3529,8153
-50,30,120,1788,1741,3529,8100
-140,20,-100,1772,1757,3529,8354
-140,-10,-90,1776,1753,3529,8379
50,-10,-170,1741,1788,3529,7781
-30,-10,90,1775,1755,3530,8199
-10,0,-100,1773,1757,3530,8261
60,80,60,1781,1749,3530,7993
-70,-10,120,1777,1753,3530,8224
-30,-30,90,1754,1776,3530,8154
-60,0,120,1780,1750,3530,8101
140,10,-60,1769,1761,3530,8164
160,10,-70,1772,1758,3530,8136
180,10,-80,1779,1751,3530,7997
30,-10,150,1751,1779,3530,7813
-180,10,-80,1779,1751,3530,7997
100,70,20,1767,1764,3531,7820
170,-30,70,1798,1733,3531,8290
-140,10,-70,1777,1755,3532,8005
-30,-20,90,1768,1764,3532,8234
20,-50,150,1761,1771,3532,7988
-170,10,-80,1778,1755,3533,8146
-140,-80,-30,1764,1769,3533,8098
-120,-30,10,1774,1759,3533,8197
-100,30,-140,1779,1754,3533,8155
-130,50,-120,1792,1742,3534,8131
-140,-20,-70,1773,1761,3534,8108
-100,30,-70,1769,1765,3534,8136
160,80,80,1796,1738,3534,8178
-80,40,-170,1764,1771,3535,7751
150,-20,-100,1754,1781,3535,8410
-100,70,-150,1771,1765,3536,8103
130,-80,-120,1789,1747,3536,8235
40,80,80,1759,1777,3536,7902
80,80,40,1764,1772,3536,7897
-30,70,140,1777,1760,3537,7919
-10,-60,120,1775,1762,3537,8104
120,0,40,1785,1752,3537,8242
-60,10,130,1796,1741,3537,7964
140,-40,-110,1751,1786,3537,8187
-70,-30,70,1752,1785,3537,8471
-160,50,-90,1766,1772,3538,8010
160,-60,-120,1761,1777,3538,8184
180,20,-90,1796,1742,3538,8276
-180,20,-90,1796,1742,3538,8276
-120,20,-40,1771,1767,3538,7962
140,-80,-110,1777,1761,3538,8244
-170,-70,-70,1786,1752,3538,7981
0,10,-100,1750,1788,3538,8314
150,30,80,1793,1745,3538,8168
-50,60,-60,1769,1770,3539,8237
150,-10,-80,1770,1769,3539,8221
170,50,70,1813,1726,3539,8315
-160,60,-80,1791,1748,3539,8094
10,20,120,1766,1774,3540,7986
-150,40,-100,1779,1761,3540,8077
-140,-10,-70,1787,1753,3540,8228
120,-60,-130,1780,1760,3540,7991
-90,30,-80,1775,1765,3540,8053
10,-60,140,1780,1760,3540,8108
50,80,70,1774,1766,3540,7907
-50,40,-80,1738,1803,3541,8110
110,30,30,1752,1789,3541,8231
-140,20,20,1801,1740,3541,8235
140,-50,-120,1761,1781,3542,8150
130,80,-10,1776,1766,3542,7993
20,-80,140,1777,1765,3542,8206
-60,-20,90,1794,1748,3542,8250
-160,80,-80,1798,1745,3543,7896
140,30,-40,1780,1763,3543,8217
-160,-50,-80,1800,1743,3543,8424
-150,-70,-50,1818,1725,3543,8109
-60,70,160,1766,1777,3543,8287
-10,80,130,1773,1770,3543,7878
-120,30,-120,1768,1776,3544,8361
-70,40,-70,1728,1816,3544,8265
-140,0,-90,1791,1754,3545,8370
160,0,-70,1778,1767,3545,7894
-170,80,-70,1804,1741,3545,7864
110,-20,-90,1767,1778,3545,8188
-110,-60,10,1774,1771,3545,7938
-30,-50,100,1787,1758,3545,8105
-40,10,100,1790,1755,3545,8117
-90,-60,160,1773,1772,3545,7997
180,10,-100,1782,1764,3546,8265
-180,10,-100,1782,1764,3546,8265
-50,70,150,1755,1791,3546,8169
0,80,120,1770,1776,3546,7858
-20,30,110,1780,1766,3546,7933
-90,-80,30,1779,1767,3546,8221
50,0,-170,1776,1771,3547,7991
50,20,-160,1773,1774,3547,8184
-130,-20,30,1804,1743,3547,7939
-90,-30,140,1772,1776,3548,8297
0,-70,130,1768,1780,3548,8190
-70,70,170,1770,1778,3548,8226
-150,80,-90,1790,1758,3548,7937
170,80,-50,1774,1774,3548,7794
-20,-20,100,1767,1782,3549,8233
50,-20,-170,1777,1772,3549,7814
30,80,90,1758,1791,3549,7970
-70,60,170,1768,1781,3549,8230
-80,-70,50,1790,1760,3550,7946
-80,50,-40,1771,1779,3550,8386
150,-20,-90,1755,1796,3551,8279
-160,-80,-50,1782,1769,3551,8258
-150,50,-100,1753,1798,3551,8147
-100,-50,140,1795,1756,3551,8097
150,20,-60,1781,1770,3551,8029
180,0,-80,1786,1766,3552,8017
-160,-10,-110,1786,1766,3552,8519
-180,0,-80,1786,1766,3552,8017
-50,-60,-150,1757,1795,3552,8147
30,-60,160,1762,1791,3553,8281
-120,20,-50,1782,1771,3553,7987
50,20,160,1734,1820,3554,7629
-100,30,-120,1772,1782,3554,8215
-160,-60,-70,1823,1731,3554,8100
-120,-60,-10,1793,1761,3554,8215
180,80,-60,1794,1761,3555,7833
170,0,-90,1761,1794,3555,8372
-150,-20,-100,1763,1792,3555,8440
-180,80,-60,1794,1761,3555,7833
-70,20,-130,1759,1797,3556,7852
110,40,20,1813,1743,3556,8135
-90,70,-160,1772,1785,3557,8219
-140,10,-80,1791,1766,3557,8229
-160,-60,90,1807,1750,3557,8108
170,20,-80,1774,1783,3557,8125
-50,-30,90,1805,1753,3558,8159
-40,30,110,1811,1747,3558,8204
-170,30,-80,1781,1777,3558,8165
-140,50,-110,1773,1785,3558,8036
30,60,-140,1789,1769,3558,8352
180,60,-60,1802,1756,3558,8088
140,-30,-100,1762,1796,3558,8121
-180,60,-60,1802,1756,3558,8088
-40,40,120,1804,1755,3559,8126
110,40,10,1785,1774,3559,8268
40,70,80,1782,1777,3559,7861
-10,-40,-110,1761,1798,3559,8176
-130,40,-120,1795,1764,3559,8183
120,-10,30,1826,1734,3560,8352
170,0,-100,1783,1777,3560,8440
-140,30,-110,1811,1749,3560,8420
-150,-80,-40,1768,1792,3560,8142
-160,70,-80,1794,1766,3560,7891
-40,-20,-130,1786,1775,3561,7925
-140,10,-90,1789,1772,3561,8213
-140,70,-100,1787,1774,3561,7946
20,50,-120,1818,1743,3561,8370
80,-20,-120,1787,1774,3561,8213
-10,60,120,1792,1769,3561,7935
10,10,-100,1744,1817,3561,8137
-110,30,-30,1804,1758,3562,7898
10,80,110,1781,1781,3562,7868
180,30,-90,1773,1789,3562,8184
150,60,-40,1753,1809,3562,8196
-180,30,-90,1773,1789,3562,8184
-50,10,110,1820,1742,3562,8152
20,-60,150,1777,1786,3563,8145
-120,-30,0,1797,1766,3563,8244
-50,0,-130,1774,1789,3563,8141
-60,70,-50,1778,1785,3563,8442
-100,-80,20,1781,1782,3563,8283
20,80,100,1771,1793,3564,8005
180,-50,-110,1799,1765,3564,8423
140,-30,-90,1761,1803,3564,8066
-180,-50,-110,1799,1765,3564,8423
130,-50,30,1799,1765,3564,7920
-90,-50,50,1798,1767,3565,8115
140,-10,60,1811,1754,3565,8185
0,20,-100,1760,1805,3565,8284
-160,40,-90,1781,1785,3566,8184
-170,10,-100,1794,1772,3566,8425
130,20,-40,1773,1793,3566,8337
40,-80,160,1781,1785,3566,8350
170,-30,-110,1795,1771,3566,8428
-30,-40,100,1809,1758,3567,8397
-170,30,-100,1785,1782,3567,8423
-120,-40,100,1802,1766,3568,8263
30,-80,150,1782,1787,3569,8311
40,30,-140,1800,1769,3569,8230
110,-10,-20,1784,1787,3571,8132
180,0,-90,1806,1766,3572,8474
-180,0,-90,1806,1766,3572,8474
10,60,110,1777,1795,3572,7868
-80,50,-170,1802,1770,3572,8201
140,-50,40,1808,1764,3572,8247
-50,20,-100,1770,1803,3573,8203
-110,30,-90,1800,1773,3573,8348
120,50,-10,1793,1780,3573,8372
160,-10,-90,1795,1778,3573,8256
100,-40,-10,1760,1814,3574,8371
160,10,70,1790,1784,3574,8522
-170,-50,80,1823,1751,3574,8362
160,-40,60,1804,1770,3574,8291
-60,-10,110,1796,1778,3574,8399
150,-80,-100,1789,1786,3575,8306
50,-80,170,1786,1789,3575,8423
-70,0,140,1780,1795,3575,7962
120,70,0,1789,1786,3575,8034
-160,-70,-60,1822,1753,3575,8034
-120,-30,50,1783,1793,3576,8105
110,60,120,1785,1791,3576,8390
-30,60,130,1793,1783,3576,8139
-180,-60,-90,1824,1752,3576,8277
180,-60,-90,1824,1752,3576,8277
120,-40,-100,1781,1797,3578,7969
-180,-40,-110,1792,1786,3578,8410
120,-70,-130,1796,1782,3578,8187
180,-40,-110,1792,1786,3578,8410
170,-50,-110,1781,1798,3579,8450
-40,-60,-140,1784,1795,3579,8058
-170,-60,-90,1793,1786,3579,8372
-160,10,-90,1795,1784,3579,8344
160,-80,-90,1805,1775,3580,8324
170,60,70,1821,1759,3580,8130
-150,0,40,1802,1778,3580,7996
-120,30,-10,1822,1759,3581,8324
-140,0,-100,1807,1774,3581,8569
-160,20,-90,1785,1796,3581,8106
-150,-20,50,1824,1757,3581,7898
-130,10,-50,1785,1796,3581,8236
170,-10,-100,1802,1780,3582,8407
-20,20,100,1785,1797,3582,8334
130,0,-60,1789,1793,3582,8406
30,20,-110,1789,1793,3582,8307
-150,-30,-80,1822,1760,3582,8529
-30,20,100,1822,1760,3582,8454
100,60,130,1799,1783,3582,8212
-20,-60,-120,1807,1777,3584,8151
80,40,120,1804,1780,3584,8241
-80,30,-160,1780,1805,3585,8331
70,-10,-120,1776,1809,3585,8255
170,-60,-110,1795,1791,3586,8309
-90,60,-160,1813,1773,3586,8050
160,-10,-80,1812,1775,3587,8062
-140,40,-110,1822,1766,3588,8338
-70,-20,100,1800,1788,3588,8255
130,10,-50,1779,1809,3588,8249
-160,-30,70,1830,1758,3588,8013
-150,30,-100,1809,1780,3589,8355
50,20,-170,1778,1811,3589,8006
180,-30,70,1844,1745,3589,8288
110,50,10,1777,1812,3589,8359
-180,-30,70,1844,1745,3589,8288
-100,40,-140,1804,1786,3590,8237
0,50,-100,1797,1794,3591,8366
150,-60,-120,1791,1800,3591,8360
-140,-30,60,1827,1764,3591,8011
-170,70,-70,1805,1786,3591,7928
-170,-50,-90,1824,1768,3592,8388
-20,-40,110,1793,1800,3593,8236
-90,30,-130,1789,1804,3593,8304
-90,50,-30,1801,1792,3593,8529
-80,20,-140,1807,1787,3594,8477
30,0,-100,1807,1787,3594,8301
80,40,100,1806,1789,3595,8051
-170,0,-90,1828,1767,3595,8129
170,80,70,1841,1754,3595,8289
-10,-50,120,1792,1803,3595,8171
-170,-80,-60,1788,1807,3595,8323
-30,30,110,1798,1797,3595,8304
0,40,120,1786,1809,3595,8043
-40,70,150,1783,1813,3596,8156
-150,60,-90,1799,1797,3596,8047
-160,-40,-80,1817,1780,3597,8495
-70,0,-170,1797,1800,3597,8208
-170,-40,-100,1807,1790,3597,8297
120,60,110,1804,1794,3598,8454
-130,-40,90,1830,1768,3598,8200
70,40,110,1783,1815,3598,8139
-50,50,140,1810,1789,3599,8042
-180,-30,-110,1811,1788,3599,8327
40,30,120,1781,1818,3599,7976
-100,40,-30,1802,1797,3599,8383
160,-50,-110,1821,1778,3599,8312
180,-30,-110,1811,1788,3599,8327
170,-20,-80,1802,1798,3600,7955
110,40,100,1806,1794,3600,8255
-80,40,-60,1765,1835,3600,8324
180,20,-80,1825,1775,3600,8213
-180,20,-80,1825,1775,3600,8213
-70,10,150,1816,1785,3601,8272
180,40,-70,1796,1805,3601,7890
170,30,-70,1806,1795,3601,8005
-180,40,-70,1796,1805,3601,7890
0,-20,-100,1784,1817,3601,8299
150,-60,-110,1809,1792,3601,8479
-90,30,-120,1812,1789,3601,8518
-130,70,-110,1805,1797,3602,8020
-40,60,140,1805,1797,3602,8308
-130,-30,60,1837,1765,3602,8199
60,-80,-180,1799,1804,3603,8411
60,-80,180,1799,1804,3603,8411
170,-10,-80,1816,1788,3604,8072
-100,-60,30,1818,1786,3604,8176
-60,-40,80,1800,1804,3604,8390
-110,50,-10,1846,1758,3604,8579
110,-60,-130,1799,1806,3605,8378
70,80,170,1834,1772,3606,8220
130,-50,-110,1810,1796,3606,8487
-170,-60,-80,1842,1764,3606,8353
130,-70,-120,1792,1815,3607,8285
170,-40,-110,1812,1795,3607,8321
90,40,110,1793,1815,3608,8392
50,10,-130,1814,1794,3608,8353
180,-50,-100,1832,1776,3608,8357
-180,-50,-100,1832,1776,3608,8357
-50,60,150,1820,1788,3608,8260
-170,0,-100,1836,1773,3609,8615
-50,70,160,1792,1817,3609,8222
-110,30,-100,1803,1806,3609,8229
-150,-50,-60,1838,1771,3609,8327
50,10,-170,1794,1815,3609,8204
140,60,-30,1786,1824,3610,8310
80,-30,-60,1787,1823,3610,8584
120,0,-50,1800,1810,3610,8312
-120,20,-30,1818,1792,3610,7832
-160,-30,-100,1808,1802,3610,8559
-70,-60,70,1828,1783,3611,8328
-80,-20,160,1802,1809,3611,8592
60,-40,-60,1802,1809,3611,8469
-90,40,-150,1830,1781,3611,8336
0,30,-100,1815,1796,3611,8403
50,-10,-100,1785,1826,3611,8202
-160,-10,50,1820,1792,3612,7984
-100,30,-110,1809,1803,3612,8417
30,70,90,1802,1810,3612,8056
-170,60,-70,1843,1769,3612,8214
160,-20,-100,1808,1804,3612,8517
160,-40,-110,1802,1810,3612,8396
180,-60,-100,1798,1815,3613,8376
20,-30,-90,1773,1840,3613,8445
0,70,-110,1840,1773,3613,8617
-180,-60,-100,1798,1815,3613,8376
-60,70,170,1796,1818,3614,8256
-50,-50,-150,1836,1778,3614,8399
-110,-40,40,1835,1780,3615,8183
170,-80,-80,1818,1797,3615,8402
-140,20,-90,1819,1796,3615,8497
-170,20,-80,1824,1791,3615,8315
70,-80,-170,1797,1818,3615,8487
70,60,60,1826,1790,3616,8196
-80,70,-170,1804,1812,3616,8219
180,70,-60,1823,1793,3616,8037
-130,-70,-20,1804,1812,3616,8240
-60,-50,80,1817,1799,3616,8124
130,70,-10,1802,1814,3616,8156
-180,70,-60,1823,1793,3616,8037
0,50,120,1828,1788,3616,8258
-150,20,-90,1831,1785,3616,8440
-10,30,120,1815,1802,3617,8279
70,-60,-160,1794,1823,3617,8404
-20,40,120,1827,1790,3617,8460
-180,-10,-90,1830,1787,3617,8469
-30,-60,-130,1803,1814,3617,8039
180,-10,-90,1830,1787,3617,8469
-60,50,150,1818,1799,3617,8196
60,60,70,1817,1800,3617,8056
60,-30,-70,1778,1839,3617,8508
100,-70,-140,1787,1831,3618,8065
60,-60,-170,1786,1832,3618,8605
-70,-50,70,1822,1797,3619,8354
180,-80,-70,1820,1799,3619,8405
-180,-80,-70,1820,1799,3619,8405
-80,-60,170,1810,1810,3620,8095
70,40,140,1810,1811,3621,8258
130,-20,-80,1803,1818,3621,8177
180,0,-100,1846,1775,3621,8528
-30,40,120,1825,1796,3621,8485
-180,0,-100,1846,1775,3621,8528
-120,-50,-10,1817,1804,3621,8396
-60,-30,80,1821,1801,3622,8337
-10,10,-100,1787,1835,3622,8292
-80,20,-150,1843,1780,3623,8660
-120,20,-20,1838,1785,3623,8098
-10,-10,110,1799,1824,3623,8306
170,-60,-100,1833,1791,3624,8435
-90,30,-150,1815,1809,3624,8457
-130,40,10,1823,1801,3624,8296
-70,70,180,1802,1822,3624,8267
-70,70,-180,1802,1822,3624,8267
140,-20,-80,1806,1818,3624,8193
20,-10,140,1812,1813,3625,8316
20,-40,150,1828,1798,3626,8263
90,40,70,1828,1798,3626,8285
160,30,-60,1813,1815,3628,8173
-70,50,-50,1830,1798,3628,8525
90,-50,-20,1819,1809,3628,8320
-70,-40,70,1818,1812,3630,8639
150,50,-40,1824,1806,3630,8359
170,-10,-90,1808,1822,3630,8391
-10,-40,120,1817,1814,3631,8363
140,-60,-120,1810,1821,3631,8319
110,60,10,1803,1828,3631,8370
-60,60,160,1813,1819,3632,8380
150,-40,-110,1780,1852,3632,8331
130,-60,-120,1814,1818,3632,8332
10,0,130,1812,1822,3634,8155
70,-40,-50,1823,1811,3634,8490
140,-40,-100,1793,1841,3634,8502
40,-50,-70,1786,1849,3635,8373
-80,-50,60,1836,1800,3636,8360
150,30,-50,1818,1818,3636,8150
180,70,60,1850,1787,3637,8402
170,20,-70,1847,1790,3637,8038
-10,20,110,1797,1840,3637,8342
-70,30,160,1806,1831,3637,8386
-90,-30,90,1812,1825,3637,8386
-120,-40,-10,1791,1846,3637,8589
-180,70,60,1850,1787,3637,8402
-110,-80,10,1821,1817,3638,8383
-110,40,-130,1833,1805,3638,8480
0,-50,130,1826,1812,3638,8378
50,-60,180,1799,1840,3639,8556
50,-60,-180,1799,1840,3639,8556
100,-20,-60,1791,1848,3639,8151
20,70,100,1794,1845,3639,8211
-70,10,-150,1846,1793,3639,8666
-80,-60,60,1860,1779,3639,8279
-50,-40,90,1854,1785,3639,8402
-100,-50,40,1852,1788,3640,8203
90,60,40,1828,1812,3640,8074
160,-60,-110,1831,1810,3641,8465
20,-70,150,1810,1832,3642,8635
-130,-40,-30,1853,1789,3642,8373
-50,40,130,1834,1808,3642,8501
80,60,50,1834,1808,3642,8227
160,-20,-90,1800,1842,3642,8369
0,30,120,1809,1833,3642,8311
-180,80,60,1867,1775,3642,8464
180,80,60,1867,1775,3642,8464
-90,-70,40,1826,1817,3643,8086
180,-50,-90,1858,1786,3644,8402
-160,30,-90,1825,1819,3644,8392
10,-70,140,1814,1830,3644,8453
-180,-50,-90,1858,1786,3644,8402
-100,-40,130,1809,1835,3644,8543
40,-30,-80,1786,1859,3645,8551
-150,10,-90,1830,1816,3646,8578
150,-30,-90,1800,1846,3646,8186
-130,-70,120,1833,1813,3646,8301
-90,-30,100,1816,1830,3646,8363
20,10,130,1800,1847,3647,8074
-70,10,160,1850,1797,3647,8395
-110,30,-110,1805,1842,3647,8494
-140,60,-100,1819,1828,3647,8266
-150,-10,-100,1818,1830,3648,8578
80,-80,-160,1797,1851,3648,8481
-140,-60,-40,1848,1800,3648,8353
10,-50,140,1832,1816,3648,8363
-150,-20,-90,1819,1830,3649,8642
150,-40,-100,1818,1831,3649,8500
50,30,-180,1824,1826,3650,8011
50,30,180,1824,1826,3650,8011
170,70,-50,1854,1797,3651,8091
-70,20,160,1836,1815,3651,8512
-90,30,-140,1837,1814,3651,8579
-160,0,-100,1844,1807,3651,8667
170,0,-70,1840,1812,3652,8238
40,-60,170,1788,1865,3653,8518
0,10,120,1802,1851,3653,8382
-20,-50,-120,1817,1836,3653,8192
-50,70,-60,1812,1842,3654,8653
-30,-30,100,1844,1810,3654,8490
80,-40,-40,1849,1805,3654,8645
-180,-10,-100,1836,1819,3655,8503
-80,30,-110,1869,1786,3655,8306
170,-50,-100,1828,1827,3655,8437
-150,0,-100,1833,1822,3655,8651
180,-10,-100,1836,1819,3655,8503
120,20,-10,1839,1817,3656,8518
-120,70,-120,1831,1825,3656,8025
-170,-40,-90,1826,1830,3656,8476
50,70,-170,1824,1833,3657,8454
170,60,-50,1845,1812,3657,8351
-70,-20,180,1844,1814,3658,8311
-70,-20,-180,1844,1814,3658,8311
140,-70,-110,1817,1841,3658,8331
-70,50,170,1834,1825,3659,8389
180,-40,-100,1848,1811,3659,8558
180,10,-70,1851,1808,3659,8194
-60,40,140,1843,1816,3659,8341
-180,-40,-100,1848,1811,3659,8558
-180,10,-70,1851,1808,3659,8194
170,-20,-100,1840,1820,3660,8695
-80,30,-90,1840,1820,3660,8459
90,50,130,1835,1825,3660,8499
-60,50,-60,1846,1817,3663,8673
150,-30,-100,1814,1849,3663,8806
-20,60,130,1828,1835,3663,8416
-60,0,130,1846,1817,3663,8253
120,-30,-90,1819,1847,3666,8306
-40,20,-100,1830,1836,3666,8525
-50,-10,100,1867,1799,3666,8448
-70,30,-90,1837,1829,3666,8454
150,40,-40,1831,1835,3666,8363
60,40,160,1864,1802,3666,8364
-10,0,110,1820,1846,3666,8469
150,-20,60,1857,1810,3667,8518
50,40,-180,1820,1847,3667,8318
-160,-40,80,1853,1814,3667,8701
-30,10,100,1843,1824,3667,8649
-80,60,-170,1844,1823,3667,8310
-70,40,170,1869,1798,3667,8424
50,40,180,1820,1847,3667,8318
-140,-70,-30,1831,1836,3667,8409
-160,-30,-90,1847,1820,3667,8646
-40,30,120,1827,1842,3669,8630
-70,10,-170,1844,1825,3669,8544
140,70,-20,1843,1826,3669,8289
-170,0,-80,1856,1813,3669,8514
120,-20,20,1857,1812,3669,8490
-50,-50,90,1872,1797,3669,8338
-140,10,20,1878,1792,3670,8534
140,-50,-110,1851,1819,3670,8562
-60,-20,100,1851,1819,3670,8541
20,-40,-90,1802,1868,3670,8399
140,50,90,1834,1836,3670,8570
90,-30,-40,1818,1853,3671,8456
-140,0,-60,1843,1828,3671,8465
70,50,80,1860,1811,3671,8296
-140,-20,-60,1841,1831,3672,8418
-170,-30,-90,1878,1794,3672,8599
-20,20,110,1840,1832,3672,8368
-110,40,-20,1849,1823,3672,8490
-140,30,20,1868,1804,3672,8407
100,50,40,1822,1850,3672,8236
-50,20,120,1858,1815,3673,8450
-20,-10,-110,1855,1818,3673,8571
-30,50,130,1842,1831,3673,8494
140,-60,-110,1837,1837,3674,8470
-130,0,-30,1831,1843,3674,8137
120,20,70,1834,1840,3674,8685
80,40,110,1816,1859,3675,8630
-40,0,100,1864,1811,3675,8485
0,-40,130,1858,1817,3675,8384
-20,40,-90,1832,1843,3675,8484
-90,-40,60,1819,1856,3675,8506
-140,-40,-50,1847,1830,3677,8537
-120,-70,0,1851,1826,3677,8281
-130,-20,-30,1849,1829,3678,8521
110,-70,-130,1807,1871,3678,8270
50,60,80,1825,1854,3679,8063
50,-40,-170,1837,1842,3679,8331
-130,60,-110,1833,1846,3679,8238
90,-80,-150,1808,1872,3680,8519
160,-20,-80,1850,1830,3680,8365
150,-20,-80,1828,1852,3680,8399
-110,30,-40,1852,1828,3680,8188
-80,30,-100,1869,1812,3681,8478
-10,70,-100,1873,1808,3681,8669
-110,70,-130,1848,1833,3681,8062
-40,20,110,1863,1818,3681,8659
70,40,130,1844,1838,3682,8402
180,0,-70,1862,1820,3682,8334
-100,50,-20,1870,1812,3682,8849
-180,0,-70,1862,1820,3682,8334
180,-20,-100,1873,1810,3683,8699
-180,-20,-100,1873,1810,3683,8699
-130,10,-40,1844,1839,3683,8432
180,-10,-80,1851,1833,3684,8307
-50,0,110,1852,1832,3684,8599
-180,-10,-80,1851,1833,3684,8307
-150,-70,-40,1833,1851,3684,8502
-120,-70,130,1846,1839,3685,8322
-180,-30,-100,1877,1809,3686,8670
-20,-10,100,1843,1843,3686,8552
-70,-20,110,1842,1844,3686,8500
-20,-80,110,1836,1850,3686,8303
-80,30,-120,1844,1842,3686,8594
180,-30,-100,1877,1809,3686,8670
-150,-30,-70,1868,1819,3687,8714
100,40,50,1847,1840,3687,8408
-160,10,-80,1849,1839,3688,8669
-80,-30,160,1878,1810,3688,8616
170,-90,-70,1840,1849,3689,8620
-90,-90,30,1840,1849,3689,8620
-50,-90,70,1840,1849,3689,8620
-110,-90,10,1840,1849,3689,8620
0,-90,120,1840,1849,3689,8620
170,-60,-90,1853,1836,3689,8421
60,-90,-180,1840,1849,3689,8620
80,-90,-160,1840,1849,3689,8620
160,-90,-80,1840,1849,3689,8620
50,-90,170,1840,1849,3689,8620
-30,-90,90,1840,1849,3689,8620
-80,-90,40,1840,1849,3689,8620
110,-90,-130,1840,1849,3689,8620
-130,-90,-10,1840,1849,3689,8620
-140,-90,-20,1840,1849,3689,8620
40,-90,160,1840,1849,3689,8620
-20,-90,100,1840,1849,3689,8620
150,-90,-90,1840,1849,3689,8620
30,-90,150,1840,1849,3689,8620
-120,-90,0,1840,1849,3689,8620
90,-90,-150,1840,1849,3689,8620
-150,-90,-30,1840,1849,3689,8620
120,-90,-120,1840,1849,3689,8620
140,10,70,1837,1852,3689,8668
20,-90,140,1840,1849,3689,8620
-10,-90,110,1840,1849,3689,8620
-70,-90,50,1840,1849,3689,8620
10,-90,130,1840,1849,3689,8620
130,-90,-110,1840,1849,3689,8620
140,-90,-100,1840,1849,3689,8620
-170,-90,-50,1840,1849,3689,8620
180,-90,-60,1840,1849,3689,8620
-100,-90,20,1840,1849,3689,8620
60,-90,180,1840,1849,3689,8620
-40,-90,80,1840,1849,3689,8620
-60,-90,60,1840,1849,3689,8620
-180,-90,-60,1840,1849,3689,8620
70,-90,-170,1840,1849,3689,8620
-160,-90,-40,1840,1849,3689,8620
100,-90,-140,1840,1849,3689,8620
-140,-10,-60,1852,1837,3689,8588
170,10,-70,1871,1819,3690,8234
90,-50,-130,1838,1852,3690,8257
-130,30,-110,1847,1843,3690,8672
80,-50,-140,1843,1848,3691,8293
50,30,130,1815,1876,3691,8598
-180,-60,-80,1862,1829,3691,8382
-10,10,110,1842,1849,3691,8368
180,-60,-80,1862,1829,3691,8382
80,-60,-30,1874,1818,3692,8666
-110,-50,20,1850,1842,3692,8529
10,70,110,1844,1848,3692,8178
-110,30,-70,1854,1838,3692,8449
-90,50,-150,1847,1845,3692,8541
-50,-80,80,1837,1855,3692,8315
60,80,-180,1866,1827,3693,8478
-170,-50,-80,1896,1797,3693,8652
60,80,180,1866,1827,3693,8478
-170,-60,80,1864,1829,3693,8335
-60,-80,70,1852,1841,3693,8345
-80,-20,120,1844,1849,3693,8671
150,-40,-90,1847,1847,3694,8395
-100,70,-140,1866,1828,3694,8167
10,-40,140,1851,1843,3694,8297
-50,30,130,1866,1829,3695,8611
-130,-30,50,1851,1844,3695,8317
120,30,-10,1855,1840,3695,8363
160,-30,-80,1853,1842,3695,8458
0,20,120,1821,1875,3696,8273
-40,60,-70,1849,1847,3696,8613
-10,70,130,1857,1839,3696,8164
-170,80,50,1893,1803,3696,8583
160,-60,-100,1855,1841,3696,8496
150,-10,-70,1852,1845,3697,8321
-70,-30,-180,1878,1819,3697,8590
-180,-20,-80,1849,1848,3697,8494
130,20,-30,1832,1865,3697,8517
-150,-50,90,1882,1815,3697,8565
30,30,-120,1859,1838,3697,8628
170,-30,-80,1833,1864,3697,8319
-40,-80,90,1850,1847,3697,8317
150,70,-30,1840,1857,3697,8442
-70,-30,180,1878,1819,3697,8590
180,-20,-80,1849,1848,3697,8494
160,-30,-100,1836,1861,3697,8676
-30,50,-80,1858,1841,3699,8876
10,50,-110,1874,1825,3699,8587
60,-20,-90,1854,1845,3699,8481
-130,-30,-30,1844,1855,3699,8730
-110,50,-130,1846,1853,3699,8293
-130,-20,20,1844,1855,3699,8288
80,50,70,1891,1808,3699,8376
-80,-20,150,1842,1858,3700,8583
20,60,-130,1874,1826,3700,8772
0,70,120,1855,1845,3700,8217
-120,50,0,1886,1815,3701,8538
-120,60,-120,1830,1872,3702,8103
70,-20,-90,1849,1853,3702,8591
-80,-30,80,1839,1863,3702,8668
30,40,-130,1883,1820,3703,8749
-180,40,60,1873,1830,3703,8510
30,40,110,1850,1853,3703,8407
-60,30,-90,1858,1845,3703,8657
180,40,60,1873,1830,3703,8510
50,10,-140,1866,1837,3703,8371
-60,-60,80,1886,1819,3705,8421
120,-50,-110,1887,1818,3705,8313
150,10,70,1858,1847,3705,8667
100,-80,-140,1829,1876,3705,8621
-80,70,-160,1852,1854,3706,8160
-20,0,100,1869,1837,3706,8584
150,10,-60,1868,1839,3707,8290
-60,10,-140,1862,1845,3707,8399
170,-30,-100,1863,1845,3708,8673
-180,20,-70,1870,1838,3708,8283
170,40,-60,1847,1861,3708,8455
180,20,-70,1870,1838,3708,8283
30,-70,160,1848,1861,3709,8761
-150,-30,60,1884,1826,3710,8292
110,30,40,1849,1861,3710,8556
-70,40,160,1842,1868,3710,8576
-70,70,-170,1846,1864,3710,8128
-30,-80,100,1856,1854,3710,8299
-140,-70,110,1867,1844,3711,8481
-70,60,-180,1861,1850,3711,8511
150,-50,-110,1830,1881,3711,8499
-70,60,180,1861,1850,3711,8511
150,-70,-100,1840,1871,3711,8556
120,-60,-120,1853,1859,3712,8679
0,-10,-100,1836,1876,3712,8734
20,-30,150,1854,1858,3712,8251
-160,0,-90,1867,1846,3713,8758
160,40,-50,1871,1842,3713,8528
-60,30,140,1865,1848,3713,8525
-180,-40,-90,1878,1835,3713,8501
180,-40,-90,1878,1835,3713,8501
-50,10,-120,1852,1861,3713,8367
-170,-10,-80,1879,1834,3713,8646
140,30,80,1857,1857,3714,8702
-40,0,-120,1834,1880,3714,8540
70,-50,-150,1855,1859,3714,8534
130,-20,40,1862,1852,3714,8722
160,70,-40,1877,1837,3714,8184
-150,-40,80,1897,1817,3714,8474
40,40,110,1850,1864,3714,8441
110,-30,0,1820,1894,3714,8697
130,50,-20,1840,1874,3714,8764
-20,10,100,1860,1855,3715,8735
130,60,100,1871,1844,3715,8694
-180,-30,-90,1875,1840,3715,8555
180,-30,-90,1875,1840,3715,8555
-120,30,-110,1857,1858,3715,8844
-120,-80,0,1856,1860,3716,8466
-50,30,-90,1855,1861,3716,8785
-100,50,-140,1843,1873,3716,8448
140,-40,-90,1839,1877,3716,8269
-10,-30,-110,1817,1900,3717,8410
-160,-50,-70,1875,1842,3717,8548
-170,-20,-100,1878,1839,3717,8794
80,-60,-150,1856,1861,3717,8482
130,-10,-70,1885,1832,3717,8613
-110,-70,140,1855,1863,3718,8473
60,40,110,1861,1858,3719,8474
100,40,100,1843,1876,3719,8663
10,30,120,1849,1870,3719,8556
-170,-30,-100,1868,1851,3719,8757
0,-80,130,1868,1852,3720,8473
110,-40,0,1845,1875,3720,8664
-20,70,-90,1881,1839,3720,8791
-10,-80,120,1848,1872,3720,8360
-70,-80,60,1864,1857,3721,8409
120,60,0,1878,1843,3721,8499
-80,40,-160,1866,1855,3721,8503
-160,-70,-50,1863,1859,3722,8439
70,-10,-110,1876,1846,3722,8670
-90,-60,50,1870,1852,3722,8370
50,-60,-60,1836,1887,3723,8773
70,-30,-70,1853,1870,3723,8729
170,-40,-100,1861,1863,3724,8637
120,0,-30,1857,1868,3725,8576
-140,-40,80,1894,1831,3725,8371
-150,-60,-50,1887,1839,3726,8637
-90,40,-50,1853,1873,3726,8686
-180,-20,-90,1877,1850,3727,8729
-170,-40,-80,1897,1830,3727,8764
60,-60,-50,1867,1860,3727,8736
180,-20,-90,1877,1850,3727,8729
-160,80,40,1914,1813,3727,8719
170,-20,-90,1854,1873,3727,8513
-150,0,-90,1855,1873,3728,8638
-130,-10,10,1859,1869,3728,8694
150,-40,50,1890,1838,3728,8565
160,-40,-100,1867,1861,3728,8668
-150,30,-90,1868,1861,3729,8721
-150,-10,-90,1877,1852,3729,8712
-170,-30,70,1894,1835,3729,8590
180,30,-70,1891,1838,3729,8246
-180,30,-70,1891,1838,3729,8246
-120,30,-80,1892,1837,3729,8675
-50,10,120,1886,1843,3729,8512
140,0,-60,1886,1844,3730,8502
120,40,-10,1848,1883,3731,8518
90,40,100,1826,1905,3731,8576
100,70,130,1879,1853,3732,8525
-150,-40,-60,1878,1854,3732,8673
-70,20,170,1897,1835,3732,8569
160,-30,-90,1892,1840,3732,8595
50,20,150,1844,1889,3733,8362
-160,20,-80,1867,1866,3733,8671
-150,-20,-80,1876,1858,3734,8766
70,40,120,1862,1872,3734,8579
-120,30,-70,1900,1834,3734,8384
-10,20,-100,1837,1897,3734,8572
160,-40,-90,1876,1859,3735,8687
-140,-20,40,1873,1862,3735,8475
-70,-10,-180,1915,1821,3736,8615
-40,40,130,1881,1855,3736,8562
170,-40,-90,1877,1859,3736,8528
-70,-10,180,1915,1821,3736,8615
-140,40,20,1893,1843,3736,8586
-180,-50,70,1914,1823,3737,8676
160,-50,-100,1895,1842,3737,8814
-20,-30,110,1874,1863,3737,8721
70,-60,-40,1887,1850,3737,8517
180,-50,70,1914,1823,3737,8676
100,50,120,1883,1854,3737,8766
-90,70,-150,1875,1863,3738,8232
-170,70,50,1924,1814,3738,8690
-130,20,-60,1869,1870,3739,8630
-170,-10,-90,1868,1871,3739,8803
60,-50,-160,1862,1877,3739,8561
130,-40,30,1881,1859,3740,8732
100,-50,-10,1862,1879,3741,8856
-160,-30,-80,1909,1832,3741,8939
-30,20,110,1848,1894,3742,8635
-160,-10,-80,1873,1869,3742,8911
-160,0,-80,1891,1851,3742,8775
-70,10,180,1894,1848,3742,8752
120,-70,-120,1828,1914,3742,8468
-70,10,-180,1894,1848,3742,8752
20,30,-110,1869,1873,3742,8501
110,30,80,1846,1897,3743,8578
-130,10,0,1906,1837,3743,8671
-60,-30,90,1894,1850,3744,8625
170,-50,-90,1890,1854,3744,8860
-60,20,140,1869,1875,3744,8660
-40,70,-70,1876,1869,3745,8910
-70,10,-160,1896,1849,3745,8652
160,-10,-70,1877,1869,3746,8392
100,-30,-20,1878,1868,3746,8804
-160,70,40,1900,1847,3747,8881
-60,-20,-160,1884,1863,3747,8606
-60,70,-180,1896,1852,3748,8327
-70,20,-170,1885,1863,3748,8654
-60,70,180,1896,1852,3748,8327
-180,60,60,1896,1853,3749,8750
-170,-20,-90,1899,1850,3749,8759
180,60,60,1896,1853,3749,8750
-120,30,-90,1894,1855,3749,8784
-50,-20,100,1890,1859,3749,8591
-170,-10,-100,1901,1851,3752,8729
-110,60,-130,1871,1881,3752,8328
-160,-20,-100,1884,1868,3752,8892
-70,10,170,1895,1857,3752,8611
160,-70,-90,1844,1909,3753,8613
-140,20,-80,1888,1866,3754,8783
-100,-70,150,1887,1867,3754,8541
120,0,-40,1865,1889,3754,8536
-80,40,-70,1877,1877,3754,8637
40,60,90,1862,1893,3755,8478
-20,30,120,1887,1869,3756,8810
-150,-10,40,1922,1834,3756,8563
-70,-40,-180,1901,1856,3757,8722
-70,-40,180,1901,1856,3757,8722
-170,-70,-60,1880,1877,3757,8497
140,-10,-70,1891,1866,3757,8656
110,70,120,1885,1873,3758,8616
-30,30,120,1883,1875,3758,8673
-60,20,-120,1911,1847,3758,8827
40,50,-160,1907,1851,3758,8805
150,40,80,1891,1867,3758,8692
-130,-40,80,1911,1847,3758,8336
-140,10,-60,1884,1874,3758,8514
140,-50,-100,1894,1865,3759,8602
-70,-50,-180,1908,1851,3759,8545
-70,-50,180,1908,1851,3759,8545
140,50,-30,1868,1891,3759,8637
10,0,-100,1877,1882,3759,8738
-60,40,150,1909,1850,3759,8634
90,40,80,1881,1879,3760,8612
80,50,140,1899,1861,3760,8632
-100,-70,30,1880,1880,3760,8371
0,40,-100,1872,1889,3761,8916
40,-70,170,1874,1887,3761,8887
-120,30,-100,1888,1873,3761,8664
-150,10,-70,1854,1907,3761,8858
-50,-40,-150,1885,1876,3761,8735
-130,20,-10,1916,1846,3762,8776
60,60,170,1905,1857,3762,8492
-30,70,-80,1896,1866,3762,8893
0,-30,130,1906,1856,3762,8685
30,-20,160,1871,1892,3763,8273
110,-80,-130,1866,1897,3763,8703
120,10,50,1870,1893,3763,8775
-40,-50,-140,1869,1894,3763,8451
30,-20,-90,1845,1918,3763,8849
-20,20,-100,1841,1923,3764,8653
30,50,-140,1888,1876,3764,8935
-150,0,-70,1885,1879,3764,8623
-160,-40,-70,1898,1867,3765,8758
-150,10,-80,1903,1862,3765,8779
-150,-10,-80,1892,1874,3766,8937
170,-70,-80,1874,1892,3766,8679
-150,-70,100,1899,1867,3766,8654
-70,-10,130,1858,1908,3766,8886
10,-80,140,1869,1897,3766,8764
-170,-60,-70,1903,1863,3766,8526
-20,-40,-120,1890,1876,3766,8471
90,-60,-140,1878,1888,3766,8771
-80,-80,50,1881,1886,3767,8544
0,60,120,1887,1880,3767,8373
-120,40,-10,1913,1854,3767,9005
150,-50,-100,1913,1855,3768,8775
-150,-10,-70,1873,1895,3768,8750
30,-40,170,1891,1878,3769,8336
-90,-30,130,1846,1923,3769,8916
90,70,140,1910,1859,3769,8612
90,-60,-20,1899,1870,3769,8785
130,40,90,1896,1873,3769,8796
110,-50,0,1891,1878,3769,8740
180,-70,-70,1882,1888,3770,8669
100,60,30,1872,1898,3770,8482
-180,-70,-70,1882,1888,3770,8669
-90,-70,160,1881,1889,3770,8533
140,-30,-80,1874,1896,3770,8311
-180,-50,-80,1896,1875,3771,8632
180,-50,-80,1896,1875,3771,8632
-60,10,140,1879,1892,3771,8772
-100,60,-140,1910,1861,3771,8505
50,80,-170,1902,1870,3772,8710
170,-30,-90,1908,1864,3772,8653
70,-30,-140,1905,1868,3773,8622
-30,20,-100,1873,1900,3773,8716
140,20,-40,1891,1882,3773,8595
-160,-20,-90,1921,1852,3773,8737
-120,-50,110,1925,1848,3773,8719
-60,20,-110,1931,1843,3774,8779
90,-30,-50,1878,1896,3774,8699
-30,70,150,1903,1871,3774,8430
-70,0,-180,1923,1851,3774,8769
-70,0,180,1923,1851,3774,8769
-120,30,-20,1913,1861,3774,8490
120,-50,10,1880,1895,3775,8689
-150,80,30,1927,1848,3775,8846
-50,-10,-140,1925,1850,3775,8531
0,-20,130,1875,1900,3775,8644
110,-20,-10,1877,1898,3775,8683
-70,40,-180,1881,1895,3776,8503
-70,40,180,1881,1895,3776,8503
-110,-40,110,1893,1884,3777,8876
-110,30,-60,1888,1889,3777,8726
0,0,-100,1853,1924,3777,8695
-140,-10,-50,1900,1878,3778,8684
50,-40,-70,1866,1913,3779,8824
110,40,30,1894,1886,3780,8752
-70,20,180,1915,1865,3780,8658
-70,20,-180,1915,1865,3780,8658
-120,-60,120,1909,1871,3780,8286
-20,70,140,1889,1891,3780,8309
100,-60,-10,1889,1892,3781,8968
-70,30,-170,1902,1879,3781,8629
30,-50,-80,1853,1928,3781,8694
-180,-30,-80,1903,1879,3782,8854
180,-30,-80,1903,1879,3782,8854
110,50,20,1907,1875,3782,8573
100,-40,-110,1900,1882,3782,8297
20,30,120,1887,1895,3782,8575
-40,-10,100,1923,1859,3782,8808
-160,30,-80,1874,1909,3783,8628
150,-60,-100,1907,1876,3783,8886
-160,-20,-80,1882,1902,3784,8875
180,30,60,1910,1874,3784,8695
-180,30,60,1910,1874,3784,8695
-140,30,-100,1905,1880,3785,8839
-30,0,100,1927,1858,3785,8996
40,-60,-70,1886,1900,3786,8948
-80,-40,160,1876,1911,3787,8691
130,60,-10,1908,1879,3787,8650
20,0,-100,1873,1914,3787,8632
30,20,130,1836,1951,3787,8292
-70,30,170,1896,1891,3787,8643
-160,50,-80,1911,1877,3788,8541
-80,-30,90,1860,1928,3788,8681
-90,40,-60,1884,1905,3789,8990
120,-80,-120,1879,1910,3789,8746
-70,50,-180,1891,1899,3790,8654
20,50,110,1864,1926,3790,8621
-40,10,-110,1916,1874,3790,9069
-70,50,180,1891,1899,3790,8654
-40,50,140,1901,1890,3791,8809
-120,40,-120,1915,1876,3791,8838
-70,0,170,1913,1879,3792,8917
-10,-30,120,1890,1902,3792,8923
120,70,110,1921,1871,3792,8695
-50,-60,90,1916,1877,3793,8458
-20,50,130,1891,1902,3793,8561
-130,30,-100,1890,1904,3794,8970
60,50,90,1899,1895,3794,8433
120,-10,-60,1903,1891,3794,8630
-170,-50,-70,1902,1892,3794,8747
-150,20,-80,1913,1882,3795,8857
-110,30,-50,1891,1904,3795,8798
-150,70,30,1946,1849,3795,8928
-70,0,150,1891,1904,3795,8904
-40,-50,100,1896,1899,3795,8641
30,10,140,1877,1920,3797,8328
-180,50,60,1936,1861,3797,8695
180,50,60,1936,1861,3797,8695
-70,-60,180,1893,1905,3798,8401
-70,-60,-180,1893,1905,3798,8401
140,10,-50,1908,1890,3798,8654
-160,-60,-60,1935,1864,3799,8538
50,30,170,1913,1886,3799,8329
-120,50,-120,1914,1885,3799,8526
-140,-10,30,1904,1897,3801,8716
130,-70,-110,1875,1928,3803,8701
180,50,-60,1911,1892,3803,8512
-180,50,-60,1911,1892,3803,8512
-170,0,-70,1929,1874,3803,8780
-100,60,-20,1906,1897,3803,8946
150,-30,-80,1888,1915,3803,8444
90,-70,-20,1911,1893,3804,8729
120,0,30,1922,1882,3804,9045
-170,10,-70,1917,1887,3804,8724
-180,-40,-80,1939,1865,3804,8810
-30,-50,-130,1911,1893,3804,8556
180,-40,-80,1939,1865,3804,8810
-180,-10,-70,1929,1876,3805,8669
-50,50,-70,1899,1906,3805,8760
-30,60,140,1905,1900,3805,8798
-170,-20,-80,1911,1894,3805,8806
-170,-30,-80,1937,1868,3805,8721
150,20,-50,1904,1901,3805,8595
180,-10,-70,1929,1876,3805,8669
20,0,140,1902,1903,3805,8356
-130,10,-10,1924,1882,3806,8705
-130,-80,-10,1904,1902,3806,8601
-140,-20,-50,1932,1874,3806,8742
-150,50,-90,1903,1903,3806,8757
-130,-60,-20,1923,1883,3806,8656
-140,-50,-40,1936,1871,3807,8776
-40,-30,100,1917,1890,3807,8757
-130,0,0,1923,1885,3808,8843
-130,20,0,1934,1875,3809,9025
40,20,-130,1948,1861,3809,8620
-40,-40,100,1922,1887,3809,8929
160,60,-40,1913,1897,3810,8590
170,-40,-80,1935,1875,3810,8732
130,10,-40,1891,1919,3810,8697
-160,-10,-100,1928,1882,3810,9213
130,30,80,1921,1889,3810,8993
110,-60,0,1911,1899,3810,8894
-110,-60,20,1901,1910,3811,8622
-70,0,160,1921,1890,3811,8965
90,-80,-20,1910,1902,3812,8536
120,-20,-80,1908,1905,3813,8859
-60,40,-80,1893,1920,3813,8688
50,-50,-170,1900,1913,3813,8741
-70,-30,80,1859,1955,3814,8912
-50,40,140,1926,1888,3814,8833
-140,0,-50,1920,1894,3814,8744
-30,-20,100,1916,1898,3814,8989
-170,30,50,1934,1881,3815,8650
10,-30,140,1917,1898,3815,8695
20,-50,160,1919,1897,3816,8530
90,-20,-80,1891,1925,3816,8752
-80,50,-160,1923,1893,3816,8534
-60,50,160,1909,1907,3816,8726
-80,-20,130,1893,1924,3817,8754
170,-70,60,1928,1889,3817,8565
60,40,120,1909,1909,3818,8839
-130,-60,110,1935,1883,3818,8475
160,20,-60,1949,1869,3818,8607
40,30,-150,1928,1890,3818,8724
20,90,-140,1944,1875,3819,8979
130,90,110,1944,1875,3819,8979
-20,90,-100,1944,1875,3819,8979
-180,90,60,1944,1875,3819,8979
40,90,-160,1944,1875,3819,8979
-30,90,-90,1944,1875,3819,8979
-90,90,-30,1944,1875,3819,8979
60,90,-180,1944,1875,3819,8979
-60,90,-60,1944,1875,3819,8979
-10,90,-110,1944,1875,3819,8979
60,90,180,1944,1875,3819,8979
0,90,-120,1944,1875,3819,8979
-150,0,-80,1936,1883,3819,8789
170,90,70,1944,1875,3819,8979
160,90,80,1944,1875,3819,8979
120,90,120,1944,1875,3819,8979
90,90,150,1944,1875,3819,8979
-40,90,-80,1944,1875,3819,8979
140,90,100,1944,1875,3819,8979
-100,90,-20,1944,1875,3819,8979
30,90,-150,1944,1875,3819,8979
-170,90,50,1944,1875,3819,8979
-120,90,0,1944,1875,3819,8979
-50,90,-70,1944,1875,3819,8979
150,90,90,1944,1875,3819,8979
180,90,60,1944,1875,3819,8979
100,90,140,1944,1875,3819,8979
-80,90,-40,1944,1875,3819,8979
10,90,-130,1944,1875,3819,8979
50,90,-170,1944,1875,3819,8979
-140,90,20,1944,1875,3819,8979
110,90,130,1944,1875,3819,8979
70,90,170,1944,1875,3819,8979
-160,90,40,1944,1875,3819,8979
80,90,160,1944,1875,3819,8979
-130,90,10,1944,1875,3819,8979
-150,90,30,1944,1875,3819,8979
-110,90,-10,1944,1875,3819,8979
-70,90,-50,1944,1875,3819,8979
130,-70,20,1916,1904,3820,8664
-90,60,-150,1939,1881,3820,8625
-120,-60,0,1917,1903,3820,8735
-160,40,-80,1931,1889,3820,8778
-90,-50,150,1915,1906,3821,8632
-150,40,-90,1910,1911,3821,8754
180,-40,70,1955,1866,3821,8821
-180,-40,70,1955,1866,3821,8821
-60,30,150,1908,1913,3821,8583
140,60,90,1931,1891,3822,8880
-90,-30,110,1909,1913,3822,8913
80,-70,-30,1900,1922,3822,8757
50,-70,-180,1891,1931,3822,9105
50,-70,180,1891,1931,3822,9105
120,-10,20,1902,1921,3823,8892
-70,30,180,1925,1898,3823,8742
-70,30,-180,1925,1898,3823,8742
-170,60,50,1937,1886,3823,8732
50,40,110,1906,1917,3823,8613
-70,-30,90,1875,1948,3823,8844
110,-40,-100,1898,1925,3823,8656
-90,60,-30,1952,1874,3826,9092
-50,-30,100,1948,1878,3826,8917
-60,-70,80,1941,1885,3826,8572
-30,40,-90,1911,1916,3827,8647
40,-50,-180,1898,1930,3828,8828
130,-60,-110,1927,1901,3828,8803
40,-50,180,1898,1930,3828,8828
40,-10,170,1913,1916,3829,8476
-120,-40,90,1940,1890,3830,8669
-160,-10,-90,1932,1898,3830,8987
160,-50,-90,1948,1882,3830,8892
160,-70,50,1928,1903,3831,8549
-50,20,130,1915,1916,3831,8937
-140,30,-90,1934,1897,3831,8899
60,-10,-150,1877,1955,3832,8866
30,30,120,1902,1931,3833,8646
40,60,-160,1934,1899,3833,8879
-160,-70,90,1919,1915,3834,8820
-70,-70,70,1935,1899,3834,8726
160,-60,-90,1927,1907,3834,8948
100,-80,-10,1938,1896,3834,8480
140,-20,50,1923,1911,3834,8950
70,-70,-40,1911,1924,3835,8815
-180,-70,70,1946,1890,3836,8636
-60,60,170,1932,1904,3836,8822
-50,-70,90,1942,1894,3836,8543
180,-70,70,1946,1890,3836,8636
-140,40,-100,1944,1893,3837,8684
90,-40,-120,1912,1925,3837,8630
-50,70,170,1924,1913,3837,8581
50,-20,-90,1925,1913,3838,9104
130,-40,-90,1898,1940,3838,8592
-100,40,-40,1946,1892,3838,8770
-170,20,-70,1927,1913,3840,8558
-40,10,110,1951,1889,3840,9020
110,50,110,1927,1914,3841,9089
-90,-80,40,1908,1933,3841,8706
-40,20,120,1922,1919,3841,9020
-10,20,120,1905,1936,3841,8748
-20,-70,120,1931,1910,3841,8657
40,-20,-90,1918,1924,3842,8964
-140,-30,-50,1923,1919,3842,8814
-60,0,-150,1917,1925,3842,8671
-10,-20,-110,1908,1935,3843,8933
80,70,150,1939,1904,3843,8665
50,30,140,1906,1937,3843,8660
130,-80,-110,1916,1928,3844,8829
-130,50,-110,1922,1922,3844,8926
120,30,80,1912,1932,3844,8958
100,-50,-120,1931,1913,3844,8578
-90,40,-140,1912,1932,3844,8940
180,10,60,1943,1902,3845,8832
-140,-80,-20,1913,1932,3845,8618
-180,10,60,1943,1902,3845,8832
-60,-10,120,1931,1915,3846,8929
-140,50,20,1964,1882,3846,9207
90,-20,-100,1899,1947,3846,9032
160,20,70,1925,1921,3846,8938
130,70,100,1947,1899,3846,8794
-180,-60,70,1963,1883,3846,8716
180,-60,70,1963,1883,3846,8716
120,-70,10,1954,1893,3847,8596
-130,30,-10,1958,1890,3848,8777
-130,40,-10,1954,1894,3848,8659
40,50,100,1912,1936,3848,8722
-130,-50,100,1959,1889,3848,8899
40,80,-160,1938,1910,3848,9036
-10,-20,120,1922,1928,3850,8896
-180,20,60,1944,1906,3850,9076
180,20,60,1944,1906,3850,9076
150,60,-30,1944,1906,3850,8744
-120,40,-20,1951,1900,3851,8605
-160,-10,-70,1932,1920,3852,8881
-150,-20,-70,1940,1912,3852,9046
-130,50,10,1962,1891,3853,8908
-130,-70,-10,1929,1924,3853,8881
-30,-70,110,1941,1912,3853,8571
140,40,-30,1927,1926,3853,8910
-40,-20,100,1942,1911,3853,8917
-80,60,-160,1925,1929,3854,8614
-110,60,-10,1965,1889,3854,8883
-130,30,-70,1928,1926,3854,8881
-180,0,60,1952,1903,3855,9107
180,0,60,1952,1903,3855,9107
-20,40,130,1921,1934,3855,8895
-50,0,120,1939,1916,3855,8768
-20,-20,110,1907,1948,3855,9035
-80,30,-150,1951,1905,3856,8991
-170,-80,80,1932,1924,3856,8878
-20,10,110,1933,1923,3856,9062
-140,-30,50,1949,1908,3857,8657
110,-80,0,1926,1931,3857,8449
150,-50,-90,1922,1935,3857,8788
-140,50,-100,1923,1934,3857,8805
-30,-10,100,1955,1902,3857,9008
130,-30,-80,1911,1947,3858,8577
150,50,80,1945,1913,3858,9016
120,90,10,1950,1909,3859,8526
160,90,-30,1950,1909,3859,8526
80,90,50,1950,1909,3859,8526
-100,90,-130,1950,1909,3859,8526
100,90,30,1950,1909,3859,8526
-40,90,170,1950,1909,3859,8526
-10,90,140,1950,1909,3859,8526
0,90,130,1950,1909,3859,8526
140,90,-10,1950,1909,3859,8526
70,90,60,1950,1909,3859,8526
40,90,90,1950,1909,3859,8526
-20,90,150,1950,1909,3859,8526
-170,90,-60,1950,1909,3859,8526
180,90,-50,1950,1909,3859,8526
-80,90,-150,1950,1909,3859,8526
50,90,80,1950,1909,3859,8526
-50,90,180,1950,1909,3859,8526
-50,90,-180,1950,1909,3859,8526
-140,90,-90,1950,1909,3859,8526
-130,90,-100,1950,1909,3859,8526
130,90,0,1950,1909,3859,8526
-40,70,160,1932,1927,3859,8561
170,90,-40,1950,1909,3859,8526
90,90,40,1950,1909,3859,8526
60,90,70,1950,1909,3859,8526
110,90,20,1950,1909,3859,8526
20,90,110,1950,1909,3859,8526
-160,90,-70,1950,1909,3859,8526
-90,90,-140,1950,1909,3859,8526
-180,90,-50,1950,1909,3859,8526
-70,90,-160,1950,1909,3859,8526
-150,90,-80,1950,1909,3859,8526
-110,90,-120,1950,1909,3859,8526
10,90,120,1950,1909,3859,8526
-70,-30,170,1960,1899,3859,8907
-170,50,-70,1935,1924,3859,8620
-120,90,-110,1950,1909,3859,8526
150,90,-20,1950,1909,3859,8526
30,90,100,1950,1909,3859,8526
-30,90,160,1950,1909,3859,8526
-60,90,-170,1950,1909,3859,8526
40,70,-160,1944,1916,3860,9088
-110,-60,130,1947,1913,3860,8508
100,-60,-130,1917,1943,3860,9076
-170,-70,80,1929,1931,3860,8718
170,-10,-70,1921,1940,3861,8767
170,50,-50,1918,1943,3861,8763
20,-80,150,1929,1932,3861,9047
160,-30,60,1939,1922,3861,9046
120,0,-20,1897,1965,3862,8790
-50,-30,-150,1938,1924,3862,8848
120,-80,10,1929,1934,3863,8536
170,-50,-80,1970,1893,3863,8939
30,0,150,1955,1908,3863,8798
160,-40,-80,1942,1921,3863,8750
-120,-40,20,1961,1902,3863,8847
90,40,90,1940,1924,3864,8826
-100,50,-30,1944,1920,3864,9052
-130,-10,-20,1946,1918,3864,9129
-30,-10,-120,1943,1921,3864,8987
130,-50,-100,1932,1933,3865,8782
-130,30,-90,1949,1917,3866,8828
-130,40,-110,1957,1910,3867,9064
-160,0,-70,1927,1940,3867,8870
-140,0,20,1959,1908,3867,8919
150,-70,40,1934,1934,3868,8668
-120,-40,0,1925,1943,3868,8928
-40,-70,100,1944,1924,3868,8605
-150,50,30,1974,1894,3868,9094
180,-80,70,1925,1944,3869,8972
-180,-80,70,1925,1944,3869,8972
-140,80,20,1981,1889,3870,9086
-160,60,40,1972,1900,3872,8963
-10,-10,120,1939,1933,3872,9037
-160,-50,-60,1958,1915,3873,8946
120,10,-10,1928,1945,3873,8991
120,10,40,1973,1900,3873,9098
90,50,60,1965,1908,3873,8735
-80,-20,140,1942,1932,3874,8944
-50,30,140,1964,1910,3874,8843
60,-70,-170,1915,1959,3874,9211
100,-70,-10,1948,1927,3875,8804
100,-20,-90,1975,1900,3875,9077
140,-80,-100,1925,1951,3876,8813
30,-50,170,1935,1941,3876,8779
130,-80,20,1939,1937,3876,8701
40,-40,180,1941,1935,3876,8588
-10,30,-100,1926,1950,3876,8932
40,-40,-180,1941,1935,3876,8588
-30,40,130,1953,1923,3876,9077
0,-10,130,1944,1933,3877,8881
-40,-10,-130,1940,1937,3877,8907
110,-70,0,1945,1932,3877,8777
40,-10,-100,1928,1949,3877,8876
-130,0,-10,1954,1923,3877,8696
-50,-10,110,1945,1932,3877,9251
120,-40,10,1941,1937,3878,8930
-160,-50,80,1963,1916,3879,8790
60,-70,-50,1946,1933,3879,8929
-80,-70,60,1946,1934,3880,8986
-130,10,-30,1923,1958,3881,8643
-80,60,-40,1990,1891,3881,9304
-110,-50,120,1942,1939,3881,9004
80,-80,-30,1946,1935,3881,8687
100,-20,-70,1931,1950,3881,8784
-10,10,120,1936,1945,3881,8917
-170,-40,-70,1967,1915,3882,8967
-40,30,130,1942,1940,3882,8954
-100,-60,40,1956,1926,3882,8730
70,-80,-40,1939,1943,3882,8767
-110,-70,20,1941,1942,3883,8679
-100,40,-130,1931,1952,3883,9048
140,60,-20,1961,1922,3883,8773
90,-40,-30,1947,1937,3884,9174
20,-60,160,1933,1951,3884,9006
-110,50,-20,1972,1913,3885,9174
-60,-40,90,1960,1925,3885,8892
-70,-10,170,1974,1912,3886,9005
70,50,150,1973,1913,3886,8993
-50,60,160,1932,1955,3887,9029
60,40,150,1954,1933,3887,8816
20,-40,160,1947,1941,3888,8578
40,0,-110,1955,1933,3888,8910
-160,-80,90,1947,1942,3889,8904
-130,50,-10,1971,1918,3889,8940
120,20,0,1940,1949,3889,9279
-10,-60,130,1976,1914,3890,8924
-10,60,130,1963,1927,3890,8928
-170,-20,60,1992,1898,3890,9139
30,-80,160,1941,1950,3891,9131
40,10,-120,1947,1946,3893,9043
-110,-50,30,1948,1946,3894,8916
-30,20,120,1947,1947,3894,9109
130,-30,30,1924,1970,3894,9231
-170,-10,-70,1948,1947,3895,8932
120,50,0,1943,1952,3895,9033
110,30,70,1965,1931,3896,9122
120,0,20,1929,1967,3896,9032
90,70,40,1943,1953,3896,9108
170,-20,-70,1933,1963,3896,8677
140,-70,-100,1940,1957,3897,8841
90,-30,-60,1951,1946,3897,8970
-80,-30,100,1970,1928,3898,9001
50,50,180,1958,1940,3898,8924
10,-20,140,1971,1927,3898,9051
150,60,80,1996,1902,3898,9042
40,40,-160,1953,1945,3898,9053
-150,40,30,1992,1906,3898,9013
50,50,-180,1958,1940,3898,8924
-150,-80,-30,1937,1962,3899,8832
50,0,-120,1982,1918,3900,9039
-70,-10,140,1940,1960,3900,9092
0,-60,140,1941,1960,3901,9021
-70,-20,170,2008,1893,3901,9023
170,-60,60,1986,1915,3901,8825
10,10,130,1930,1972,3902,8799
170,-80,60,1944,1958,3902,8915
30,80,-150,1965,1937,3902,9224
130,10,-30,1905,1997,3902,8817
140,-80,30,1960,1942,3902,8846
-100,-60,140,1961,1942,3903,8929
110,50,30,1952,1951,3903,8795
-80,-40,70,1938,1965,3903,9179
-110,40,-30,1975,1928,3903,8851
-30,-40,-130,1949,1955,3904,8878
110,30,50,1968,1937,3905,8836
70,-40,-140,1969,1936,3905,8866
10,-60,150,1960,1945,3905,8822
60,40,140,1965,1940,3905,8817
-150,60,30,1990,1915,3905,9106
-10,-70,130,1966,1939,3905,8868
60,-20,-150,1942,1963,3905,8823
-150,-80,100,1958,1948,3906,8938
-30,60,-80,1976,1930,3906,9011
60,-80,-50,1938,1968,3906,8892
180,-20,-70,1938,1969,3907,8663
-70,50,-170,1966,1941,3907,8658
-70,40,-170,1987,1920,3907,8712
-180,-20,-70,1938,1969,3907,8663
-100,-80,30,1940,1967,3907,8873
-170,20,50,1953,1954,3907,8735
-90,-30,120,1944,1963,3907,9246
30,10,-110,1974,1934,3908,9085
-30,-60,110,1988,1920,3908,8885
30,60,100,1966,1942,3908,8930
-60,-20,110,1959,1949,3908,9079
10,-30,-100,1944,1964,3908,9087
120,-10,-50,1923,1985,3908,8770
150,0,-60,2013,1895,3908,8908
-40,60,150,1952,1958,3910,8868
50,-30,-80,1910,2000,3910,9225
60,40,130,1942,1968,3910,8969
-140,20,-70,1981,1929,3910,9023
70,-70,-160,1925,1985,3910,9263
-170,40,50,1964,1947,3911,9105
50,-70,-60,1949,1962,3911,8969
-140,70,20,1994,1917,3911,9121
-120,-80,130,1951,1960,3911,8852
170,30,-60,1970,1942,3912,8942
-150,-30,-60,1969,1943,3912,8976
40,0,160,1974,1938,3912,8983
-20,-60,120,1991,1921,3912,8931
-150,30,30,2006,1907,3913,9097
-80,-70,170,1954,1959,3913,8924
-30,10,110,1962,1952,3914,9281
150,20,70,1964,1950,3914,9120
140,70,90,1987,1927,3914,8926
-50,50,150,1956,1959,3915,9003
80,60,60,1977,1938,3915,8992
-120,-50,0,1959,1956,3915,9135
-20,-30,-120,1950,1965,3915,8897
140,-70,30,1951,1964,3915,8792
140,-40,40,1962,1953,3915,9077
-80,30,-130,1957,1959,3916,8960
-20,0,-110,1972,1944,3916,9179
130,0,-50,1956,1960,3916,9242
120,-60,10,1949,1967,3916,9055
-120,50,-20,1997,1920,3917,8891
-150,-50,-50,1986,1931,3917,9024
120,40,90,1947,1971,3918,9129
-140,-40,70,1967,1951,3918,8776
120,10,10,1932,1986,3918,8820
160,-60,50,1975,1944,3919,8935
80,-30,-70,1962,1957,3919,9200
20,-20,150,1941,1979,3920,8547
10,60,-120,2010,1910,3920,9305
150,30,-40,1976,1944,3920,9003
-160,-30,-70,1995,1926,3921,9286
50,10,-160,1933,1988,3921,8862
-160,-20,50,1997,1925,3922,8759
-140,-80,110,1960,1962,3922,8859
-120,50,-10,1970,1953,3923,9277
10,40,120,1945,1978,3923,9189
-130,-80,120,1964,1959,3923,8810
40,-70,-70,1950,1973,3923,8969
-120,60,0,1986,1937,3923,9297
150,-80,40,1975,1949,3924,8910
30,-60,-80,1952,1972,3924,9173
-70,20,-160,1952,1972,3924,8944
-50,10,130,1972,1953,3925,9071
110,-20,-80,1976,1949,3925,9044
60,-30,-150,1965,1962,3927,8884
-130,0,-20,1983,1944,3927,8904
-130,-20,10,1968,1959,3927,9035
-180,-10,60,1998,1929,3927,9288
80,70,50,1958,1969,3927,9067
180,-10,60,1998,1929,3927,9288
-170,30,-70,1954,1974,3928,8627
-60,-10,-160,1966,1962,3928,8968
-90,-40,140,1960,1969,3929,9122
-40,10,120,1985,1944,3929,9224
-130,-20,-20,1984,1946,3930,8956
-100,-40,60,1968,1962,3930,8936
180,-30,-70,1969,1962,3931,8921
90,-30,-110,1958,1973,3931,9168
-60,-30,100,1966,1965,3931,9156
120,10,0,1974,1957,3931,9096
-180,-30,-70,1969,1962,3931,8921
-10,0,120,1938,1994,3932,9054
-120,-40,80,1967,1965,3932,9002
-50,20,140,1959,1974,3933,9011
10,-50,150,1994,1939,3933,8780
60,-30,-80,1939,1994,3933,9247
150,-80,-90,1947,1987,3934,9017
-160,10,-70,1934,2000,3934,9202
80,-40,-130,1997,1937,3934,8799
70,60,70,1967,1968,3935,8918
130,40,-20,1970,1965,3935,9416
-140,60,20,2009,1926,3935,9143
-70,20,-140,1959,1977,3936,8940
-20,-10,110,1974,1962,3936,9347
-30,-50,110,1973,1964,3937,8891
-40,-60,100,1998,1939,3937,8761
-130,-10,0,1992,1945,3937,9093
-130,80,10,2019,1918,3937,9225
-140,-10,-40,1977,1961,3938,9009
70,70,160,1965,1973,3938,8790
110,80,20,1966,1972,3938,8885
-110,40,-120,1977,1961,3938,9149
-60,20,150,1983,1957,3940,8850
40,-80,170,1969,1973,3942,9276
-110,-80,140,1964,1978,3942,8913
-140,-60,100,1983,1959,3942,8863
-130,20,-50,1981,1961,3942,9082
-130,10,-20,1986,1957,3943,8881
60,-10,-110,2032,1911,3943,9391
80,-20,-90,1975,1968,3943,9198
160,30,-50,1977,1967,3944,9196
-80,-50,160,1952,1992,3944,9095
140,30,-30,1960,1984,3944,9198
-70,60,-170,1974,1971,3945,8799
-160,-80,-40,1944,2001,3945,8978
80,-20,-110,1983,1963,3946,9279
-90,50,-40,1986,1960,3946,9226
-110,-40,100,1951,1996,3947,9092
110,-50,-110,1991,1957,3948,8700
40,10,150,1979,1969,3948,8934
160,50,-40,1996,1953,3949,9108
160,10,-60,2006,1943,3949,8917
-70,30,-100,1973,1976,3949,9067
10,40,-110,1990,1960,3950,9222
50,30,160,1974,1976,3950,8682
-170,-40,70,2038,1912,3950,9217
-80,30,-140,1975,1975,3950,9080
140,-60,-100,1974,1977,3951,9130
100,80,30,1964,1987,3951,8892
160,-80,50,1987,1964,3951,8901
20,80,-140,1986,1966,3952,9388
-120,-40,10,1986,1966,3952,9283
120,10,20,1966,1986,3952,9121
110,-20,-40,1971,1982,3953,9036
50,10,-150,1958,1996,3954,9270
-170,40,-70,1972,1982,3954,8838
-170,80,-60,2005,1949,3954,8842
50,-80,-60,1969,1985,3954,9045
120,10,30,1984,1971,3955,9130
20,-50,-90,1940,2016,3956,9107
20,80,110,1995,1961,3956,8903
40,80,90,1992,1964,3956,9104
-180,-50,-70,1982,1974,3956,9152
180,-50,-70,1982,1974,3956,9152
-130,60,10,1990,1966,3956,9328
-20,0,110,1977,1980,3957,9394
-70,60,-50,2014,1943,3957,9313
-180,-40,-70,1996,1961,3957,9122
-70,20,-150,1986,1971,3957,9232
130,80,0,1971,1986,3957,9064
-30,80,160,1984,1973,3957,9027
180,-40,-70,1996,1961,3957,9122
0,80,130,2012,1946,3958,8941
100,-20,-80,1961,1997,3958,9104
-140,-50,90,2017,1941,3958,9094
170,-60,-80,1992,1967,3959,9178
10,80,120,2006,1954,3960,8892
30,80,100,1986,1974,3960,8954
130,30,-20,1983,1977,3960,9467
150,-60,40,1967,1993,3960,9075
100,-30,-100,1981,1980,3961,9093
-60,50,170,1976,1986,3962,9154
0,-70,140,1983,1979,3962,9160
-10,80,140,2009,1954,3963,8973
120,0,10,1972,1992,3964,8985
90,80,40,1984,1981,3965,8975
-20,30,130,1990,1975,3965,9276
60,80,70,1979,1987,3966,9100
-140,40,0,2020,1947,3967,8922
-150,20,30,2023,1944,3967,9263
-130,30,-80,1965,2002,3967,9117
-30,30,130,1992,1975,3967,9199
70,80,60,1972,1996,3968,9023
10,-10,-100,1960,2008,3968,9210
140,0,60,1990,1978,3968,9326
-70,-40,80,1977,1992,3969,9298
130,-10,-60,1956,2013,3969,8840
-160,80,-70,2009,1960,3969,8791
120,80,10,1995,1974,3969,8994
-10,50,130,1983,1987,3970,8993
-140,-40,-40,2001,1970,3971,9323
-130,30,0,2027,1944,3971,9475
-20,20,120,2006,1965,3971,9333
-30,0,110,1994,1977,3971,9491
-120,40,-110,1993,1979,3972,9204
80,80,50,1984,1988,3972,9018
-150,80,-80,2015,1958,3973,8851
-170,-30,-70,2016,1957,3973,9289
110,-20,-50,1948,2025,3973,8842
100,50,110,2021,1952,3973,9318
-70,50,-60,1998,1976,3974,9221
-170,-20,-70,2008,1967,3975,9187
-150,30,-80,2007,1968,3975,9043
30,-30,-90,1988,1987,3975,9524
30,-70,-80,1977,1998,3975,9028
30,70,-150,2008,1968,3976,9332
-20,60,-90,2034,1942,3976,9387
130,20,-20,1977,1999,3976,9464
-110,-40,80,1984,1992,3976,8981
-100,-80,150,1971,2006,3977,9038
-60,40,160,2016,1961,3977,9072
-20,80,150,2001,1976,3977,8978
170,80,-40,1981,1997,3978,9132
-10,40,130,1970,2008,3978,9167
160,-80,-80,1954,2024,3978,9174
-170,50,50,2020,1959,3979,9380
-110,60,-20,2018,1961,3979,9250
130,-60,20,2011,1969,3980,9080
-140,0,-40,1983,1997,3980,9218
-150,-40,70,2047,1935,3982,9097
50,-80,-180,1983,1999,3982,9319
50,-80,180,1983,1999,3982,9319
90,50,120,2007,1975,3982,9280
-30,10,120,2005,1978,3983,9387
-40,0,120,2004,1979,3983,9357
-90,-70,50,2001,1983,3984,9181
-140,-60,-30,2016,1968,3984,9065
100,70,30,1993,1992,3985,9203
120,30,0,1994,1991,3985,9261
140,80,-10,1988,1997,3985,9061
10,-10,140,1969,2016,3985,8992
-90,70,-30,2012,1974,3986,9300
-40,80,170,1996,1990,3986,9124
170,-50,60,2045,1941,3986,9007
-120,-40,70,2028,1958,3986,9091
-100,60,-30,2020,1966,3986,9331
40,-80,-70,1990,1997,3987,9160
120,-30,10,1979,2008,3987,9240
-140,-20,-40,1995,1992,3987,9173
50,80,80,2001,1986,3987,9137
-70,-40,170,1989,1998,3987,8988
-80,40,-150,2010,1978,3988,9302
-70,30,-120,2023,1965,3988,9154
-80,-30,110,2009,1980,3989,9241
10,80,-130,2013,1976,3989,9579
0,0,130,2014,1975,3989,9223
110,-20,-30,1979,2010,3989,9170
150,70,80,2017,1973,3990,9381
-120,30,-60,1979,2011,3990,9362
-130,-30,40,1992,1998,3990,8895
-170,0,50,1993,1997,3990,8717
-80,50,-50,2013,1978,3991,9201
-140,80,-90,2017,1974,3991,9006
-40,0,110,2010,1981,3991,9309
150,-40,-80,1983,2009,3992,8956
-130,50,0,2007,1985,3992,9432
120,-50,-100,2001,1991,3992,8727
-130,-40,70,2006,1987,3993,9162
120,50,100,2012,1981,3993,9404
40,-30,180,1975,2019,3994,8791
40,-30,-180,1975,2019,3994,8791
-60,10,150,2010,1984,3994,9222
-150,0,-60,1998,1997,3995,9100
110,40,90,2005,1990,3995,9397
-60,20,160,2021,1975,3996,9194
-70,-10,160,2024,1972,3996,9295
-30,-40,110,2013,1984,3997,9082
110,30,60,2002,1996,3998,9249
60,60,80,1991,2007,3998,9033
-40,20,130,2004,1995,3999,9346
110,60,20,1999,2000,3999,9077
-40,-10,110,2018,1981,3999,9448
-130,80,-100,2030,1970,4000,9124
70,70,60,2006,1994,4000,9218
80,-70,-150,1958,2042,4000,9254
-20,-50,120,1990,2010,4000,9204
90,60,50,2006,1995,4001,8996
-110,80,-10,2057,1944,4001,9360
160,80,-30,2003,1998,4001,9167
70,-40,-60,1987,2015,4002,9630
-120,80,0,2046,1956,4002,9363
-130,20,-20,2009,1993,4002,9080
-120,-40,30,2005,1998,4003,9139
-130,-10,-10,2030,1974,4004,9193
-180,80,-50,2007,1998,4005,9006
180,80,-50,2007,1998,4005,9006
-130,70,10,2013,1992,4005,9383
20,40,-120,2043,1963,4006,9274
-120,80,-110,2017,1989,4006,9144
-170,-80,-50,1975,2031,4006,9131
-170,10,50,1984,2023,4007,9014
30,-10,-100,1998,2010,4008,9200
-50,-20,110,1990,2018,4008,9347
-140,-70,-20,2001,2007,4008,9154
180,-60,-70,2014,1994,4008,9199
-180,-60,-70,2014,1994,4008,9199
160,30,70,2023,1985,4008,9287
-80,70,-40,2023,1986,4009,9317
-30,50,140,1984,2025,4009,9380
-160,-20,-70,2013,1996,4009,9208
-60,50,-70,2014,1995,4009,9208
130,10,60,1999,2011,4010,9569
50,30,150,1987,2023,4010,9082
160,-20,60,2021,1989,4010,9563
170,-80,-70,1969,2042,4011,9203
150,80,-20,2013,1998,4011,9088
30,-60,170,2012,1999,4011,9384
-30,-30,110,2014,1998,4012,9331
160,60,70,2038,1974,4012,9336
160,0,-60,2037,1976,4013,9216
90,-20,-90,2044,1969,4013,9379
180,40,-60,2027,1987,4014,8972
-180,40,-60,2027,1987,4014,8972
130,0,50,1988,2026,4014,9583
120,20,20,2000,2015,4015,9231
-40,40,140,2010,2005,4015,9366
150,-10,60,2027,1988,4015,9482
120,-10,10,1986,2030,4016,9296
-60,20,-130,2025,1991,4016,9198
140,-60,30,2026,1990,4016,9150
40,-40,-80,1974,2042,4016,9379
-80,-30,150,2008,2009,4017,9416
60,70,70,1994,2023,4017,9334
30,-80,-80,2006,2011,4017,9140
-70,30,-110,2023,1995,4018,9147
-110,-40,50,2026,1993,4019,9092
50,50,100,2017,2002,4019,8966
30,60,-150,2026,1994,4020,9525
30,40,-140,2022,1998,4020,9362
-70,40,-80,2015,2005,4020,9311
-140,-30,-40,2028,1993,4021,9251
-60,40,170,2009,2012,4021,9035
-160,20,-70,1993,2029,4022,9091
40,20,-140,2032,1990,4022,9228
-40,40,-90,1991,2032,4023,9332
-100,-50,50,2026,1997,4023,9161
-130,40,0,2051,1972,4023,9413
180,-80,-60,1974,2050,4024,9197
160,40,70,2029,1995,4024,9218
-110,-80,20,1998,2026,4024,9205
-180,-80,-60,1974,2050,4024,9197
-100,-50,130,1998,2026,4024,9358
-160,-30,60,2041,1983,4024,9133
-10,-50,130,2000,2024,4024,9236
-50,80,-180,2036,1989,4025,9208
-50,80,180,2036,1989,4025,9208
150,-70,-90,2018,2007,4025,9126
-100,40,-100,2054,1971,4025,9325
-70,30,-160,2016,2009,4025,9435
-40,-20,110,1995,2031,4026,9604
-80,80,-40,2039,1987,4026,9641
170,-40,60,2038,1988,4026,9344
130,-20,30,2024,2003,4027,9456
140,20,70,2034,1993,4027,9420
120,20,60,2027,2001,4028,9407
-110,40,-90,2046,1983,4029,9333
-50,-40,100,2029,2000,4029,9235
-100,40,-50,1995,2035,4030,9435
-140,30,0,2037,1993,4030,9164
100,60,40,1990,2041,4031,9106
-50,0,-140,2023,2009,4032,8914
100,-30,-40,2029,2003,4032,9442
100,50,50,2026,2006,4032,9151
130,-10,40,2006,2026,4032,9438
-40,-40,-140,2026,2006,4032,9201
10,-70,150,2010,2023,4033,9516
-130,-50,-20,2023,2010,4033,9532
-70,80,-50,2038,1995,4033,9625
170,-30,-70,2029,2005,4034,8979
20,-70,-90,2016,2018,4034,9142
-110,80,-120,2028,2006,4034,9191
140,-10,-60,2036,1999,4035,9351
-100,40,-90,2064,1971,4035,9278
-60,80,-170,2042,1993,4035,9246
-150,-10,-60,2022,2013,4035,9201
130,20,70,2000,2036,4036,9310
-110,40,-100,2028,2008,4036,9290
-60,-40,-170,2034,2002,4036,9350
160,50,70,2069,1968,4037,9466
60,50,160,2041,1996,4037,9147
120,70,10,2031,2006,4037,9259
150,-30,50,2037,2001,4038,9202
-160,50,40,2062,1976,4038,9362
-160,-40,-60,2022,2016,4038,9358
50,40,170,2030,2009,4039,9153
-170,-60,-60,2056,1983,4039,9421
-150,-30,50,2074,1965,4039,9036
40,-20,-180,2016,2023,4039,8998
-90,80,-30,2050,1989,4039,9684
40,-20,180,2016,2023,4039,8998
-100,80,-20,2062,1978,4040,9570
-70,-10,150,2006,2034,4040,9443
110,70,20,2014,2026,4040,9268
-60,-50,-170,2039,2001,4040,9286
120,-40,-90,1994,2046,4040,9066
-60,30,160,2029,2011,4040,9291
100,60,120,2034,2007,4041,9508
120,20,10,2015,2027,4042,9277
170,20,-60,2018,2024,4042,9225
20,-60,-90,2021,2021,4042,9418
-140,30,10,2081,1961,4042,9388
-120,30,-30,2030,2013,4043,9069
60,-80,-170,1997,2046,4043,9410
140,-50,-90,2036,2007,4043,9085
-100,70,-20,2050,1993,4043,9438
120,0,0,1996,2048,4044,9317
-30,10,-110,2029,2015,4044,9625
-140,40,-90,2029,2015,4044,9524
-120,-90,130,2022,2023,4045,9312
150,-90,40,2022,2023,4045,9312
120,-90,10,2022,2023,4045,9312
180,-90,70,2022,2023,4045,9312
110,-90,0,2022,2023,4045,9312
100,-90,-10,2022,2023,4045,9312
130,-90,20,2022,2023,4045,9312
-180,-90,70,2022,2023,4045,9312
140,-90,30,2022,2023,4045,9312
160,-90,50,2022,2023,4045,9312
170,-90,60,2022,2023,4045,9312
-170,-90,80,2022,2023,4045,9312
50,-90,-60,2022,2023,4045,9312
80,-90,-30,2022,2023,4045,9312
-100,-90,150,2022,2023,4045,9312
-20,-90,-130,2022,2023,4045,9312
-30,-90,-140,2022,2023,4045,9312
70,-90,-40,2022,2023,4045,9312
-90,-60,150,2029,2016,4045,9309
90,-90,-20,2022,2023,4045,9312
20,-90,-90,2022,2023,4045,9312
-50,-90,-160,2022,2023,4045,9312
-160,-90,90,2022,2023,4045,9312
-70,-90,-180,2022,2023,4045,9312
0,-90,-110,2022,2023,4045,9312
-60,-90,-170,2022,2023,4045,9312
40,-90,-70,2022,2023,4045,9312
-40,-90,-150,2022,2023,4045,9312
-150,-90,100,2022,2023,4045,9312
30,-90,-80,2022,2023,4045,9312
60,-90,-50,2022,2023,4045,9312
-10,-90,-120,2022,2023,4045,9312
-70,-90,180,2022,2023,4045,9312
10,-90,-100,2022,2023,4045,9312
-120,60,-10,2049,1996,4045,9266
-90,-90,160,2022,2023,4045,9312
-110,-90,140,2022,2023,4045,9312
-130,-90,120,2022,2023,4045,9312
-80,-90,170,2022,2023,4045,9312
-140,-90,110,2022,2023,4045,9312
-60,30,-100,2029,2016,4045,9325
160,-20,-70,2042,2004,4046,9160
-150,-60,90,2036,2011,4047,9285
0,-50,140,2022,2025,4047,9201
100,-30,-30,2013,2034,4047,9513
-130,40,-100,2040,2009,4049,9391
-70,50,-70,2009,2040,4049,9252
-20,60,140,2024,2026,4050,9259
-20,50,-90,2015,2035,4050,9627
50,60,-180,2049,2002,4051,9318
50,60,180,2049,2002,4051,9318
-140,20,-60,2035,2016,4051,9167
-90,40,-100,2075,1976,4051,9377
-160,20,40,2058,1993,4051,9328
-110,70,-10,2057,1994,4051,9679
-110,50,-30,2050,2002,4052,9201
-40,10,130,2032,2020,4052,9363
160,-50,-80,2054,1998,4052,9149
-30,40,140,2022,2032,4054,9383
0,60,-110,2075,1979,4054,9584
-160,70,-70,2056,1999,4055,9143
-150,10,-60,2024,2031,4055,9209
110,-20,-20,2033,2022,4055,9456
-140,20,10,2070,1985,4055,9562
-20,-40,120,2031,2024,4055,9374
-140,30,-80,2037,2019,4056,9291
110,60,110,2028,2028,4056,9416
40,20,140,1986,2070,4056,9336
-70,-30,100,2013,2043,4056,9446
-140,10,-50,2023,2033,4056,9234
70,-20,-130,2016,2040,4056,9323
-60,60,-180,2018,2038,4056,9165
-60,60,180,2018,2038,4056,9165
0,80,-120,2056,2000,4056,9615
-20,30,-100,2018,2039,4057,9570
40,-60,-180,2034,2023,4057,9308
40,-60,180,2034,2023,4057,9308
-90,40,-70,2031,2027,4058,9499
-140,-10,20,2055,2003,4058,9378
-90,-50,60,2043,2015,4058,9245
-120,70,0,2049,2009,4058,9653
-50,-10,120,2028,2031,4059,9497
-70,70,-50,2059,2001,4060,9574
-150,70,-80,2054,2006,4060,9309
-30,80,-90,2060,2000,4060,9734
60,-40,-150,2041,2020,4061,8882
80,50,130,2055,2007,4062,9472
140,40,80,2051,2012,4063,9476
-170,-10,50,2067,1996,4063,9013
-70,-20,120,2038,2025,4063,9546
-50,80,-70,2043,2021,4064,9701
-70,80,-160,2054,2010,4064,9315
20,-80,-90,2035,2030,4065,9313
-30,-30,-130,2010,2056,4066,9215
-110,-40,90,2041,2025,4066,9331
-20,80,-100,2061,2005,4066,9717
150,-60,-90,2038,2028,4066,9311
-40,80,-80,2047,2020,4067,9716
-30,-10,110,2034,2034,4068,9610
-10,40,-100,2039,2030,4069,9368
30,-30,170,2043,2026,4069,9066
-60,80,-60,2051,2018,4069,9657
-10,60,-100,2085,1984,4069,9519
100,40,60,2026,2044,4070,9466
-110,40,-80,2052,2018,4070,9500
170,10,-60,2047,2023,4070,9096
-60,40,180,2074,1996,4070,8868
-60,40,-180,2074,1996,4070,8868
-130,30,-60,2051,2019,4070,9218
60,-60,-160,2031,2040,4071,9485
-160,-40,70,2082,1989,4071,9397
10,-40,-100,2016,2056,4072,9507
-90,-80,160,2031,2041,4072,9322
90,60,130,2057,2015,4072,9493
-60,-60,-170,2047,2026,4073,9306
100,40,90,2021,2052,4073,9202
-110,-60,30,2055,2018,4073,9338
10,-40,150,2049,2025,4074,9197
130,-40,20,2045,2030,4075,9320
-80,80,-150,2056,2019,4075,9410
-60,50,180,2064,2011,4075,9006
-60,50,-180,2064,2011,4075,9006
-160,30,40,2066,2010,4076,9354
-10,80,-110,2059,2017,4076,9594
-70,-70,-180,2036,2040,4076,9389
-160,40,40,2077,1999,4076,9272
-70,-70,180,2036,2040,4076,9389
130,50,-10,2044,2032,4076,9460
-100,-40,120,2036,2041,4077,9594
130,70,0,2050,2027,4077,9398
150,30,70,2060,2017,4077,9574
70,-30,-80,2035,2042,4077,9534
-160,60,-70,2044,2034,4078,9397
-60,-10,130,2043,2036,4079,9450
170,40,-50,2045,2034,4079,9373
-80,50,-60,2028,2051,4079,9548
70,-60,-150,2033,2046,4079,9469
-30,0,120,2053,2026,4079,9613
-50,-20,-150,2055,2025,4080,9334
90,-70,-140,2006,2074,4080,9417
110,-60,-120,2001,2080,4081,9535
20,-10,150,2061,2020,4081,9291
120,30,10,2022,2059,4081,9235
-140,50,0,2071,2010,4081,9121
-150,20,-70,2045,2037,4082,9578
80,-40,-50,2029,2053,4082,9586
-120,-40,60,2075,2010,4085,9092
-150,-20,-60,2054,2031,4085,9485
130,-50,20,2063,2022,4085,9303
-130,-30,30,2038,2047,4085,9249
50,70,80,2031,2054,4085,9528
-110,70,-20,2070,2015,4085,9416
-100,50,-40,2084,2002,4086,9264
-50,40,150,2053,2033,4086,9394
60,-50,-60,2033,2053,4086,9472
110,40,40,2036,2051,4087,9321
20,20,-110,2043,2044,4087,9637
-50,0,130,2054,2034,4088,9473
110,-20,-60,2044,2044,4088,9242
-180,-20,60,2100,1988,4088,9324
180,-20,60,2100,1988,4088,9324
-170,70,-60,2049,2040,4089,9138
50,-20,-160,2053,2036,4089,9421
120,40,0,2043,2047,4090,9644
150,10,-50,2059,2031,4090,9433
140,20,-30,2025,2065,4090,9342
20,-90,150,2049,2042,4091,9347
100,-90,-130,2049,2042,4091,9347
0,-90,130,2049,2042,4091,9347
130,-90,-100,2049,2042,4091,9347
-40,-90,90,2049,2042,4091,9347
-80,-90,50,2049,2042,4091,9347
140,-90,-90,2049,2042,4091,9347
60,-90,-170,2049,2042,4091,9347
50,60,90,2048,2043,4091,9494
-170,-90,-40,2049,2042,4091,9347
-90,-90,40,2049,2042,4091,9347
50,-90,180,2049,2042,4091,9347
-160,10,40,2059,2032,4091,9454
160,-90,-70,2049,2042,4091,9347
40,-90,170,2049,2042,4091,9347
120,-90,-110,2049,2042,4091,9347
10,-90,140,2049,2042,4091,9347
-10,-90,120,2049,2042,4091,9347
30,-90,160,2049,2042,4091,9347
-150,-90,-20,2049,2042,4091,9347
180,-90,-50,2049,2042,4091,9347
-20,10,120,2028,2063,4091,9761
-100,-90,30,2049,2042,4091,9347
-150,-60,-40,2043,2048,4091,9421
110,-90,-120,2049,2042,4091,9347
-180,-90,-50,2049,2042,4091,9347
70,-90,-160,2049,2042,4091,9347
50,-90,-180,2049,2042,4091,9347
80,-90,-150,2049,2042,4091,9347
-50,-90,80,2049,2042,4091,9347
150,-90,-80,2049,2042,4091,9347
-130,-90,0,2049,2042,4091,9347
-110,-90,20,2049,2042,4091,9347
-70,-90,60,2049,2042,4091,9347
90,-90,-140,2049,2042,4091,9347
-120,-90,10,2049,2042,4091,9347
-30,-90,100,2049,2042,4091,9347
-20,-90,110,2049,2042,4091,9347
-60,-90,70,2049,2042,4091,9347
-140,-90,-10,2049,2042,4091,9347
170,-90,-60,2049,2042,4091,9347
-160,-90,-30,2049,2042,4091,9347
70,-80,-160,2020,2072,4092,9534
-130,-40,-20,2056,2036,4092,9718
-120,40,-100,2047,2045,4092,9558
-90,50,-140,2058,2035,4093,9244
-60,0,140,2042,2052,4094,9613
30,50,-150,2077,2018,4095,9561
50,-30,-160,2041,2054,4095,9285
-40,50,-80,2054,2042,4096,9542
-90,80,-140,2056,2040,4096,9294
150,-20,-70,2056,2040,4096,9264
-160,-10,-60,2051,2045,4096,9474
140,70,-10,2083,2015,4098,9455
-120,40,-90,2058,2041,4099,9399
-40,30,140,2069,2030,4099,9536
-90,-40,70,2021,2079,4100,9532
20,50,-130,2058,2042,4100,9456
160,-50,50,2076,2024,4100,9503
70,-50,-50,2033,2070,4103,9486
-70,40,-160,2050,2053,4103,9237
140,-20,-70,2054,2049,4103,9484
120,-10,-30,2052,2052,4104,9326
-140,70,-90,2095,2009,4104,9435
-100,-70,40,2031,2073,4104,9493
-170,-50,-60,2047,2058,4105,9646
120,20,30,2055,2050,4105,9390
-50,10,140,2078,2027,4105,9467
170,0,-60,2117,1989,4106,9152
120,-20,10,2027,2080,4107,9724
50,-10,-110,2062,2046,4108,9505
-160,-60,-50,2059,2049,4108,9512
10,-20,-100,2031,2077,4108,9598
-150,-40,-50,2061,2047,4108,9458
100,-30,-50,2075,2034,4109,9695
50,40,120,2046,2063,4109,9379
-60,70,-60,2084,2026,4110,9728
-100,40,-60,2038,2072,4110,9558
-120,-80,10,2033,2077,4110,9464
110,60,30,2044,2067,4111,9324
140,-40,-80,2059,2052,4111,9209
40,30,-160,2064,2047,4111,9414
20,70,-140,2071,2040,4111,9665
-100,80,-130,2076,2036,4112,9253
-60,30,-180,2069,2043,4112,9199
-60,30,180,2069,2043,4112,9199
-100,70,-30,2089,2025,4114,9535
-50,50,160,2071,2043,4114,9486
110,-30,-90,2048,2066,4114,9455
120,60,100,2059,2055,4114,9407
-130,-30,-20,2078,2037,4115,9613
-130,-30,20,2088,2027,4115,9330
-140,40,-10,2073,2042,4115,9300
-160,-30,-60,2085,2030,4115,9457
-60,20,170,2080,2037,4117,9290
10,-60,-100,2041,2076,4117,9518
-90,50,-50,2057,2061,4118,9525
-100,40,-110,2047,2072,4119,9568
170,-20,60,2076,2043,4119,9564
-20,-10,120,2061,2059,4120,9757
-10,30,130,2057,2064,4121,9542
50,-60,-170,2064,2057,4121,9396
-60,-30,-170,2104,2017,4121,9403
-60,30,170,2053,2068,4121,9396
-70,-20,160,2101,2021,4122,9710
80,-80,-150,2032,2090,4122,9557
-70,-50,80,2066,2056,4122,9675
-150,-20,40,2075,2047,4122,9493
70,50,140,2087,2036,4123,9523
-130,-20,0,2097,2026,4123,9504
-70,-50,170,2048,2075,4123,9540
-40,-30,110,2089,2034,4123,9714
120,0,-10,2032,2091,4123,9488
-30,-10,120,2070,2054,4124,9591
-130,40,-90,2084,2040,4124,9700
80,-40,-60,2062,2062,4124,9526
-50,-80,90,2071,2054,4125,9270
-40,-10,120,2056,2069,4125,9554
10,-80,-100,2058,2067,4125,9391
-110,40,-110,2073,2052,4125,9470
160,70,70,2073,2053,4126,9575
-60,10,160,2082,2045,4127,9591
-110,-40,70,2060,2067,4127,9254
-30,20,130,2078,2049,4127,9703
-140,50,10,2108,2022,4130,9563
30,20,-120,2082,2049,4131,9529
20,60,110,2056,2076,4132,9649
-120,30,-50,2063,2069,4132,9516
-90,40,-130,2070,2062,4132,9228
160,40,-40,2044,2088,4132,9693
-130,30,-20,2097,2036,4133,9296
-90,40,-110,2086,2047,4133,9176
-130,60,-10,2087,2046,4133,9333
-20,-20,-120,2046,2088,4134,9542
170,-30,60,2099,2035,4134,9548
150,50,-30,2068,2067,4135,9377
-100,50,-130,2062,2073,4135,9368
80,-30,-120,2077,2058,4135,9615
-120,60,-20,2094,2041,4135,9376
-40,20,140,2076,2059,4135,9619
110,50,100,2083,2053,4136,9729
-30,-20,110,2071,2065,4136,9860
80,-20,-100,2104,2032,4136,9734
-180,70,-50,2073,2063,4136,9332
-40,50,150,2075,2061,4136,9699
180,70,-50,2073,2063,4136,9332
40,0,170,2056,2081,4137,9274
120,40,10,2046,2092,4138,9552
-170,-20,-60,2078,2061,4139,9344
-60,60,-60,2100,2040,4140,9867
-30,30,140,2069,2072,4141,9596
-160,-20,-60,2100,2041,4141,9564
140,0,-50,2083,2059,4142,9610
-100,40,-120,2068,2074,4142,9420
-20,20,130,2097,2046,4143,9548
-130,-40,60,2104,2039,4143,9380
-130,60,0,2087,2057,4144,9499
-110,-50,40,2066,2078,4144,9504
60,-40,-70,2073,2071,4144,9824
-60,-80,80,2069,2075,4144,9408
20,40,120,2051,2094,4145,9584
-30,30,-100,2068,2077,4145,9597
-120,40,-30,2101,2044,4145,9325
140,50,-20,2087,2058,4145,9569
-50,70,-70,2100,2045,4145,9750
-140,50,-90,2063,2082,4145,9470
150,-10,-60,2090,2055,4145,9501
-40,-80,100,2068,2078,4146,9368
30,30,-130,2113,2034,4147,9738
130,60,90,2104,2043,4147,9506
130,50,90,2097,2050,4147,9695
-80,50,-150,2091,2056,4147,9439
-130,40,-20,2123,2024,4147,9386
-160,0,-60,2088,2059,4147,9456
100,40,80,2067,2082,4149,9684
130,0,-40,2059,2091,4150,9449
0,-80,-110,2069,2081,4150,9454
-140,30,-70,2073,2077,4150,9686
60,-20,-100,2070,2080,4150,9702
-140,30,-10,2098,2052,4150,9564
100,-70,-130,2046,2105,4151,9654
110,-30,-10,2047,2104,4151,9621
120,30,20,2050,2101,4151,9377
-150,10,30,2119,2032,4151,9481
130,40,80,2083,2069,4152,9786
-10,-30,130,2070,2082,4152,9553
-120,-50,100,2083,2069,4152,9405
-120,-70,10,2076,2076,4152,9312
-10,-80,-120,2059,2093,4152,9580
-130,20,-40,2082,2071,4153,9537
60,-10,-120,2108,2045,4153,9825
160,-70,-80,2088,2065,4153,9506
-120,-50,10,2059,2094,4153,9824
120,60,10,2081,2073,4154,9427
60,70,170,2080,2074,4154,9303
-30,-80,110,2066,2088,4154,9403
170,-40,-70,2089,2065,4154,9697
-80,-80,170,2084,2071,4155,9534
-10,-20,130,2081,2074,4155,9519
40,70,90,2064,2091,4155,9581
80,50,120,2100,2055,4155,9482
140,-30,40,2088,2067,4155,9792
110,-20,-70,2070,2085,4155,9540
-170,60,-60,2066,2090,4156,9445
10,-70,-100,2081,2075,4156,9425
70,50,130,2123,2033,4156,9231
-30,60,150,2094,2062,4156,9360
0,-40,140,2092,2064,4156,9263
10,-50,-100,2063,2093,4156,9600
-90,60,-40,2114,2042,4156,9787
10,70,120,2091,2066,4157,9660
10,-30,150,2084,2073,4157,9362
-130,70,-100,2102,2055,4157,9538
40,-10,-180,2104,2053,4157,9213
40,-10,180,2104,2053,4157,9213
80,60,140,2105,2052,4157,9603
-140,20,0,2129,2029,4158,9608
-80,-50,70,2090,2068,4158,9664
-140,10,10,2123,2035,4158,9877
160,-10,60,2086,2072,4158,9794
-50,60,170,2095,2064,4159,9579
20,-70,160,2085,2074,4159,9889
-50,30,150,2096,2064,4160,9454
0,-30,140,2086,2074,4160,9328
-150,60,-80,2061,2099,4160,9469
-80,40,-80,2086,2074,4160,9792
-140,20,-10,2122,2038,4160,9583
-150,-70,-30,2070,2090,4160,9418
-160,50,-70,2068,2093,4161,9275
120,50,10,2051,2111,4162,9571
100,40,70,2098,2064,4162,9725
-130,50,-100,2058,2105,4163,9559
20,-10,-100,2082,2082,4164,9762
-140,10,0,2114,2050,4164,9495
30,70,100,2094,2070,4164,9565
-130,-50,90,2113,2052,4165,9257
80,-60,-140,2064,2101,4165,9588
170,-10,60,2088,2077,4165,9707
-140,40,10,2103,2063,4166,9738
-60,-60,90,2090,2076,4166,9254
-140,-20,30,2102,2064,4166,9573
-20,-80,120,2069,2098,4167,9525
-10,-10,130,2080,2087,4167,9437
150,70,-20,2098,2069,4167,9620
-60,-50,90,2091,2076,4167,9302
70,-20,-100,2100,2067,4167,9981
-100,-40,70,2066,2102,4168,9338
170,0,60,2100,2068,4168,9569
-60,0,-160,2107,2062,4169,9558
160,70,-30,2112,2057,4169,9479
-70,50,-160,2124,2045,4169,9293
170,60,60,2107,2063,4170,9569
-70,30,-130,2108,2062,4170,9468
170,50,60,2117,2054,4171,9696
-160,0,40,2099,2072,4171,9530
-130,20,-30,2093,2078,4171,9501
-90,50,-60,2087,2085,4172,9548
-50,-30,110,2067,2105,4172,9738
-70,-60,80,2133,2039,4172,9297
-130,-60,-10,2097,2075,4172,9450
50,0,-160,2078,2094,4172,9632
-150,40,-80,2066,2106,4172,9699
100,-40,-20,2062,2111,4173,9852
50,-10,-160,2072,2101,4173,9641
-160,30,-70,2069,2104,4173,9416
20,70,110,2116,2058,4174,9594
-120,-60,10,2100,2075,4175,9478
160,-30,-70,2086,2089,4175,9334
-20,0,120,2085,2091,4176,9910
80,60,70,2102,2074,4176,9417
80,-50,-40,2092,2085,4177,9762
-90,70,-40,2107,2070,4177,9719
10,50,120,2073,2104,4177,9747
90,-60,-130,2094,2083,4177,9622
90,-80,-140,2061,2117,4178,9691
-50,10,-130,2106,2072,4178,9521
0,10,130,2087,2091,4178,9363
-170,-30,-60,2096,2083,4179,9521
140,-50,30,2083,2096,4179,9689
-120,70,-110,2102,2077,4179,9614
-60,0,-170,2098,2081,4179,9421
-70,-80,-180,2089,2091,4180,9654
-40,60,160,2094,2086,4180,9539
0,-60,-110,2084,2096,4180,9591
-70,-80,180,2089,2091,4180,9654
120,80,110,2104,2077,4181,9695
60,-10,-130,2094,2087,4181,9518
-110,70,-120,2096,2085,4181,9607
160,-10,-60,2085,2097,4182,9579
-20,-20,120,2107,2075,4182,9848
-110,50,-120,2061,2121,4182,9679
90,50,110,2103,2079,4182,9574
-180,30,-60,2099,2084,4183,9449
-150,-50,80,2141,2042,4183,9606
180,30,-60,2099,2084,4183,9449
-50,20,-110,2108,2075,4183,9745
-70,-80,70,2097,2086,4183,9608
-50,50,-80,2097,2087,4184,9698
170,20,60,2110,2074,4184,9600
-90,40,-90,2109,2075,4184,9876
-60,10,170,2114,2070,4184,9478
-110,-40,60,2064,2121,4185,9423
50,-50,-70,2078,2107,4185,9765
-160,-30,50,2131,2055,4186,9352
-40,70,-80,2133,2053,4186,9855
-20,-30,120,2086,2100,4186,9515
-20,-80,-130,2068,2119,4187,9634
90,-50,-120,2136,2051,4187,9179
50,40,130,2102,2086,4188,9547
110,80,120,2094,2094,4188,9642
-100,-40,90,2067,2122,4189,9502
-30,10,130,2095,2094,4189,9746
-120,70,-10,2109,2080,4189,9593
-150,50,-80,2087,2102,4189,9365
140,30,70,2124,2066,4190,9816
-150,0,30,2131,2060,4191,9555
170,40,60,2131,2060,4191,9816
-140,60,-90,2088,2103,4191,9647
140,60,80,2120,2072,4192,9715
0,-20,140,2102,2091,4193,9494
-120,30,-40,2072,2121,4193,9842
130,-30,20,2078,2115,4193,9587
70,50,90,2116,2078,4194,9776
-170,-10,-60,2119,2076,4195,9489
120,-60,-110,2071,2126,4197,9814
-110,60,-30,2139,2058,4197,9704
40,20,-150,2125,2072,4197,9610
-100,-40,110,2092,2106,4198,9575
70,-40,-70,2108,2090,4198,9791
-10,-40,130,2090,2109,4199,9744
140,10,-40,2076,2123,4199,9734
-120,50,-110,2087,2113,4200,9816
-10,-80,130,2097,2103,4200,9690
-130,-80,0,2084,2116,4200,9676
170,70,-40,2095,2105,4200,9439
60,-30,-90,2083,2117,4200,10068
120,20,40,2119,2082,4201,9857
130,80,100,2113,2088,4201,9689
20,-30,160,2105,2096,4201,9498
-140,-40,60,2126,2076,4202,9358
-150,40,10,2109,2094,4203,9641
-120,40,-80,2117,2086,4203,9755
-140,-30,40,2128,2076,4204,9539
170,70,60,2122,2082,4204,9939
-170,50,-60,2093,2112,4205,9658
-160,-60,80,2137,2068,4205,9547
-60,10,-180,2176,2030,4206,9618
-70,-30,110,2101,2105,4206,9753
-60,10,180,2176,2030,4206,9618
30,-10,160,2099,2107,4206,9469
-60,-10,-170,2103,2103,4206,9533
-50,-50,100,2106,2100,4206,9510
-90,-40,130,2126,2081,4207,9819
-170,-30,60,2172,2035,4207,9569
-140,60,10,2146,2063,4209,9689
-40,0,130,2104,2105,4209,9626
100,80,130,2103,2106,4209,9779
170,30,60,2126,2084,4210,9705
-110,40,-50,2112,2098,4210,9812
20,20,130,2070,2141,4211,9551
-60,0,150,2104,2107,4211,9890
-60,50,-80,2122,2089,4211,9734
-80,-30,140,2120,2092,4212,9927
-110,40,-40,2131,2082,4213,9703
-130,-20,-10,2136,2077,4213,9752
-50,20,150,2096,2117,4213,9842
150,-50,40,2106,2107,4213,9798
-40,-40,110,2118,2095,4213,9769
60,-10,-140,2073,2141,4214,9959
0,70,130,2117,2097,4214,9606
-80,-60,70,2133,2081,4214,9643
-140,60,0,2133,2082,4215,9729
-100,50,-50,2108,2107,4215,9530
-100,70,-130,2121,2094,4215,9543
120,-10,-40,2064,2153,4217,9563
160,20,-50,2127,2090,4217,9711
160,-60,-80,2134,2083,4217,9651
120,-10,0,2072,2146,4218,9801
-50,20,-120,2106,2112,4218,9974
-160,-70,-40,2100,2119,4219,9614
-170,-50,70,2140,2080,4220,9411
-10,20,130,2087,2133,4220,9823
130,-50,-90,2101,2120,4221,9521
-60,-80,-170,2117,2104,4221,9822
50,-20,-100,2082,2140,4222,9872
-60,0,-180,2150,2073,4223,9634
-60,0,180,2150,2073,4223,9634
140,50,80,2126,2097,4223,9996
-150,-30,-50,2118,2107,4225,9617
-30,70,-90,2170,2055,4225,10000
-60,20,-140,2104,2122,4226,9470
70,60,80,2124,2102,4226,9597
-60,-20,-170,2141,2085,4226,9649
130,60,0,2130,2097,4227,9805
140,-10,50,2122,2105,4227,9908
-50,40,160,2147,2080,4227,9716
-90,70,-140,2125,2102,4227,9610
120,30,30,2087,2141,4228,9614
-30,-80,-140,2104,2124,4228,9782
40,30,130,2113,2116,4229,9560
90,80,140,2103,2126,4229,9789
-80,70,-50,2119,2111,4230,9823
170,10,60,2125,2105,4230,9901
-60,10,-150,2097,2133,4230,9833
-140,40,-80,2132,2098,4230,9955
-130,70,0,2143,2087,4230,9781
-100,-40,100,2094,2137,4231,9788
30,50,110,2108,2123,4231,9920
150,-50,-80,2106,2126,4232,9733
-10,-10,-110,2125,2108,4233,10030
-150,-40,60,2167,2066,4233,9551
-30,-60,120,2143,2091,4234,9459
-100,-40,80,2062,2172,4234,9707
30,-40,-90,2072,2163,4235,9804
-140,0,10,2134,2102,4236,10005
140,80,90,2122,2114,4236,9830
-50,-60,100,2087,2149,4236,9442
120,-10,-20,2119,2117,4236,9853
-170,0,-60,2145,2092,4237,9757
-170,-20,50,2150,2087,4237,9388
-130,60,-100,2114,2123,4237,9760
-120,40,-70,2137,2101,4238,9910
-120,50,-30,2162,2076,4238,9823
-150,-10,-50,2105,2133,4238,9935
-30,-20,120,2123,2115,4238,9706
50,0,-130,2127,2112,4239,9780
40,-30,-90,2107,2133,4240,10007
120,20,50,2113,2127,4240,9978
0,-80,140,2113,2127,4240,9849
-30,-20,-130,2090,2150,4240,9669
70,60,150,2171,2070,4241,9912
-180,10,-60,2148,2093,4241,9439
180,10,-60,2148,2093,4241,9439
180,-30,60,2165,2076,4241,9954
-180,-30,60,2165,2076,4241,9954
-50,30,-100,2125,2117,4242,9932
-10,70,140,2120,2123,4243,9521
-140,30,-60,2148,2096,4244,9413
-80,-80,60,2124,2120,4244,9705
-80,70,-150,2120,2124,4244,9588
-60,20,180,2144,2100,4244,9759
-60,20,-180,2144,2100,4244,9759
-180,30,50,2165,2080,4245,9962
-40,0,-130,2108,2137,4245,9563
180,30,50,2165,2080,4245,9962
100,-50,-110,2158,2088,4246,9524
40,50,-170,2143,2103,4246,9934
-170,-40,-60,2117,2129,4246,9666
-50,-80,-160,2136,2110,4246,9881
-170,-70,-50,2114,2133,4247,9605
-150,40,0,2157,2090,4247,9462
170,-70,-70,2113,2134,4247,9775
110,-70,-120,2111,2136,4247,10028
180,0,-60,2172,2076,4248,9673
-120,60,-110,2102,2146,4248,10043
-180,0,-60,2172,2076,4248,9673
90,70,50,2124,2124,4248,9754
0,70,-120,2161,2088,4249,10059
-140,-50,-30,2153,2096,4249,9971
-80,40,-140,2119,2130,4249,9468
-140,50,-10,2143,2107,4250,9365
50,-40,-160,2130,2120,4250,9521
-70,-20,150,2143,2107,4250,9841
100,-80,-130,2092,2158,4250,9848
-30,-40,120,2109,2141,4250,9682
150,-30,-70,2131,2120,4251,9576
30,-70,170,2129,2122,4251,9960
-40,-60,110,2114,2138,4252,9473
-50,60,-70,2144,2109,4253,10373
130,10,-20,2107,2146,4253,9852
-40,10,-120,2133,2121,4254,10058
-80,-40,150,2131,2123,4254,10116
-40,-80,-150,2128,2126,4254,9817
150,0,60,2149,2106,4255,10063
-80,-40,80,2102,2153,4255,9887
-20,50,140,2148,2108,4256,9820
-110,-50,110,2136,2120,4256,9652
-80,60,-150,2148,2109,4257,9730
90,-40,-40,2127,2131,4258,10003
-80,-60,160,2145,2113,4258,9571
-150,60,20,2181,2078,4259,9933
-60,-20,-180,2159,2101,4260,9874
-50,50,170,2169,2091,4260,9829
-60,-20,180,2159,2101,4260,9874
-40,40,150,2156,2104,4260,10000
-130,40,-80,2145,2116,4261,9896
-50,-20,120,2147,2114,4261,10039
-70,-40,90,2117,2144,4261,9860
-90,-50,140,2145,2117,4262,9932
50,40,160,2142,2121,4263,9723
-140,-80,-10,2100,2163,4263,9748
180,-70,-60,2135,2129,4264,9722
-180,-70,-60,2135,2129,4264,9722
150,20,-40,2130,2134,4264,9749
70,70,70,2143,2122,4265,9959
-70,30,-150,2173,2092,4265,9886
-10,-60,140,2174,2091,4265,9630
10,70,-130,2137,2128,4265,10115
-140,-20,20,2151,2114,4265,9947
0,-70,-110,2152,2114,4266,9813
-40,20,-110,2134,2132,4266,9781
-110,50,-40,2148,2119,4267,9793
-120,-40,40,2143,2126,4269,9816
-130,-50,80,2147,2122,4269,9646
80,-50,-130,2147,2122,4269,9735
-20,70,-100,2172,2098,4270,10177
180,50,50,2179,2091,4270,9996
-180,50,50,2179,2091,4270,9996
-150,-20,-50,2129,2142,4271,9981
90,-30,-70,2128,2143,4271,10024
120,40,20,2122,2150,4272,9696
120,50,20,2119,2153,4272,9815
-140,10,-10,2190,2082,4272,9691
40,0,-180,2149,2124,4273,9450
80,50,110,2132,2141,4273,9820
100,50,100,2173,2100,4273,9911
40,0,180,2149,2124,4273,9450
-150,50,10,2161,2113,4274,9811
-60,-40,100,2123,2151,4274,9981
-80,50,-70,2136,2138,4274,9925
10,0,140,2125,2149,4274,9551
50,70,-180,2150,2125,4275,9908
-180,60,-50,2132,2143,4275,9782
180,60,-50,2132,2143,4275,9782
160,50,60,2160,2115,4275,9939
50,-30,-90,2133,2142,4275,9833
50,70,180,2150,2125,4275,9908
-70,70,-160,2144,2131,4275,9619
-150,30,-70,2127,2148,4275,9975
160,40,60,2138,2138,4276,9817
80,80,150,2147,2129,4276,9844
-30,0,130,2151,2125,4276,9809
-140,0,0,2166,2110,4276,9732
150,40,-30,2167,2109,4276,10120
-60,-20,120,2151,2125,4276,9950
-70,60,-160,2172,2105,4277,9671
-130,50,-20,2158,2119,4277,9804
-180,-10,-60,2161,2116,4277,9759
180,-10,-60,2161,2116,4277,9759
-80,60,-50,2164,2113,4277,10156
-150,30,0,2170,2107,4277,9581
-40,30,-100,2129,2149,4278,9963
130,-40,-80,2150,2128,4278,9558
-30,0,-120,2103,2176,4279,10040
-140,-10,10,2154,2125,4279,9932
70,-20,-120,2150,2129,4279,9990
80,-30,-80,2127,2153,4280,10153
40,10,170,2149,2131,4280,9407
-100,80,-30,2203,2077,4280,10153
180,40,50,2178,2102,4280,9960
-180,40,50,2178,2102,4280,9960
-110,-70,30,2127,2154,4281,9819
-90,60,-50,2185,2096,4281,9815
150,40,70,2148,2133,4281,10125
-40,-20,120,2139,2142,4281,9937
-150,-80,-20,2118,2163,4281,9878
50,40,140,2162,2120,4282,9591
160,30,60,2149,2133,4282,10123
-100,60,-130,2149,2134,4283,9995
-110,80,-20,2186,2097,4283,10130
40,10,160,2119,2165,4284,9621
90,-40,-50,2139,2145,4284,10021
80,50,80,2147,2138,4285,9920
10,20,130,2124,2161,4285,9861
0,-50,-110,2117,2168,4285,10122
10,30,-110,2135,2150,4285,10142
-10,70,-110,2175,2111,4286,10158
-50,40,-90,2136,2150,4286,10075
-140,10,-40,2135,2151,4286,9681
130,-20,-70,2148,2138,4286,9854
-60,0,170,2193,2094,4287,9951
20,10,140,2158,2130,4288,9411
-90,80,-40,2202,2086,4288,10207
-100,60,-40,2204,2084,4288,9756
-180,60,50,2163,2126,4289,10057
-50,40,170,2185,2104,4289,9711
180,60,50,2163,2126,4289,10057
-60,-30,110,2136,2154,4290,9953
-150,40,20,2173,2117,4290,9982
180,20,-60,2155,2135,4290,9693
-180,20,-60,2155,2135,4290,9693
-20,40,-100,2147,2144,4291,9982
-60,-10,180,2181,2110,4291,9637
-40,-50,110,2161,2130,4291,9789
-20,-60,130,2148,2143,4291,9548
-60,-10,-180,2181,2110,4291,9637
150,50,70,2152,2140,4292,9877
80,70,60,2143,2150,4293,9705
-40,-30,-140,2169,2124,4293,9920
150,80,80,2168,2125,4293,9969
-70,-30,160,2169,2125,4294,9972
-50,-70,100,2153,2141,4294,9739
-60,-30,180,2169,2125,4294,9868
-60,-30,-180,2169,2125,4294,9868
150,60,70,2163,2132,4295,9941
110,50,40,2151,2144,4295,9933
-140,-50,80,2171,2125,4296,9636
-90,-40,80,2103,2193,4296,9819
-120,80,-10,2181,2115,4296,10210
90,60,60,2156,2141,4297,9528
-90,60,-140,2163,2134,4297,9773
10,-80,150,2151,2147,4298,10073
110,-80,-120,2118,2181,4299,10014
-100,40,-80,2148,2151,4299,10151
-70,60,-60,2160,2139,4299,10112
30,40,-150,2160,2139,4299,9684
-60,70,-170,2146,2154,4300,9810
40,60,100,2152,2148,4300,9924
-110,60,-120,2132,2169,4301,10096
-40,-70,110,2154,2148,4302,9735
-30,-30,120,2140,2162,4302,9782
-20,70,150,2158,2145,4303,9726
-10,50,-100,2154,2149,4303,10167
-60,0,160,2177,2126,4303,10146
-140,70,10,2164,2139,4303,10124
40,60,-170,2186,2117,4303,9915
40,40,-170,2152,2152,4304,9913
0,30,130,2122,2183,4305,9952
-90,-80,50,2160,2145,4305,9895
-140,20,-50,2146,2159,4305,10095
-90,40,-80,2134,2171,4305,10105
10,60,120,2150,2156,4306,10058
-70,40,-90,2160,2146,4306,9936
-180,70,50,2186,2121,4307,10178
180,70,50,2186,2121,4307,10178
-30,-70,120,2153,2154,4307,9665
-160,-50,-50,2161,2147,4308,9964
-60,-70,90,2154,2154,4308,9760
-70,-20,130,2154,2154,4308,9972
100,-60,-120,2168,2141,4309,9851
-130,-30,10,2173,2136,4309,9871
-60,-70,-170,2149,2160,4309,10013
140,-80,-90,2137,2172,4309,10013
70,50,120,2166,2143,4309,9708
-10,0,130,2150,2159,4309,9843
-130,70,-10,2181,2128,4309,9902
20,-80,160,2154,2156,4310,10211
90,-50,-30,2169,2142,4311,10018
-80,40,-100,2179,2132,4311,10112
-40,10,140,2143,2170,4313,10029
-40,70,170,2140,2174,4314,9956
100,70,40,2160,2155,4315,9911
-80,-30,120,2162,2153,4315,10167
-130,40,-70,2186,2130,4316,10084
-150,70,20,2186,2130,4316,10114
-70,70,-60,2188,2128,4316,10096
-110,60,-40,2194,2123,4317,10154
-60,10,-170,2202,2116,4318,10126
-140,0,-30,2149,2170,4319,9834
-90,40,-120,2141,2178,4319,10145
140,10,60,2142,2178,4320,10001
-150,50,20,2194,2127,4321,10094
120,-80,-110,2117,2204,4321,10179
-50,70,-180,2148,2173,4321,9991
-50,70,180,2148,2173,4321,9991
160,-40,-70,2170,2151,4321,10151
0,-40,-110,2132,2189,4321,10092
0,20,130,2149,2172,4321,9984
-150,30,20,2175,2147,4322,10087
-150,30,10,2188,2134,4322,9955
-120,60,-30,2194,2130,4324,10138
-20,-50,130,2173,2151,4324,9826
20,60,-140,2180,2145,4325,10163
-130,-40,50,2189,2136,4325,9859
60,60,90,2165,2160,4325,10058
-40,30,150,2162,2163,4325,10046
-80,40,-110,2186,2139,4325,9930
170,-10,-60,2176,2150,4326,9828
-160,-80,-30,2133,2193,4326,9901
-80,80,-50,2221,2105,4326,10102
-120,-50,20,2165,2161,4326,10074
-120,-50,90,2180,2147,4327,9775
180,-20,-60,2171,2157,4328,9784
-60,40,-90,2154,2174,4328,9975
-180,-20,-60,2171,2157,4328,9784
-90,-60,60,2172,2156,4328,9848
60,50,140,2225,2103,4328,9569
-40,60,-80,2176,2152,4328,10394
150,-80,-80,2143,2185,4328,10038
0,-10,140,2201,2129,4330,9819
40,-70,-180,2154,2176,4330,9977
120,-30,-80,2172,2158,4330,9847
70,-50,-140,2203,2127,4330,9692
40,-70,180,2154,2176,4330,9977
130,10,50,2167,2164,4331,10448
170,-50,-70,2173,2158,4331,9956
130,-80,-100,2129,2202,4331,10107
120,60,20,2136,2196,4332,9981
130,-60,-100,2156,2176,4332,10117
50,40,150,2178,2155,4333,9640
-20,-70,130,2181,2152,4333,9713
-60,-40,-180,2178,2155,4333,9931
-60,-40,180,2178,2155,4333,9931
-170,20,-60,2186,2148,4334,9694
-130,-70,0,2185,2149,4334,10018
-70,30,-140,2151,2184,4335,9778
-20,10,-110,2179,2156,4335,10210
-80,60,-60,2199,2136,4335,9979
50,50,170,2190,2145,4335,10013
60,-40,-80,2213,2123,4336,10052
10,-20,150,2183,2154,4337,9642
70,80,160,2182,2155,4337,10027
-80,40,-90,2167,2170,4337,9979
130,0,-30,2154,2183,4337,10211
-130,30,-30,2190,2148,4338,9989
160,80,70,2190,2148,4338,10113
40,50,110,2165,2174,4339,9986
-150,0,-50,2209,2131,4340,10022
160,-40,50,2190,2150,4340,10167
-80,-50,150,2149,2191,4340,9872
-60,80,-70,2216,2124,4340,10156
-150,-50,-40,2191,2150,4341,10071
120,30,70,2162,2179,4341,10356
-120,-60,110,2177,2165,4342,9609
60,50,150,2218,2124,4342,9956
-120,70,-20,2193,2149,4342,10041
-160,40,-70,2186,2157,4343,9812
-150,20,20,2188,2156,4344,10046
-160,-10,40,2206,2139,4345,9805
-140,50,-80,2176,2169,4345,10044
-150,10,20,2204,2142,4346,10043
-120,-40,50,2188,2159,4347,9916
140,10,-30,2162,2185,4347,9960
-160,70,30,2209,2138,4347,10167
-70,80,-60,2230,2117,4347,10050
80,-40,-70,2227,2120,4347,9937
-150,80,20,2178,2170,4348,10319
-70,-70,80,2198,2151,4349,9842
-100,40,-70,2162,2187,4349,10268
-50,-40,110,2155,2194,4349,9939
180,-40,60,2186,2164,4350,10017
-50,30,160,2175,2175,4350,10266
-180,-40,60,2186,2164,4350,10017
-10,-70,-120,2192,2159,4351,10123
110,70,110,2187,2164,4351,9727
-60,50,-170,2227,2124,4351,9719
-60,30,-110,2173,2178,4351,10057
-30,-50,120,2178,2174,4352,9865
-170,-80,-40,2149,2204,4353,10007
-30,70,160,2202,2152,4354,9863
180,50,-50,2175,2179,4354,9900
-180,50,-50,2175,2179,4354,9900
30,60,-160,2222,2133,4355,10046
-130,80,0,2202,2153,4355,10384
50,-70,-170,2173,2182,4355,10057
60,70,80,2193,2163,4356,10249
-160,60,30,2200,2156,4356,10410
-100,-80,40,2169,2187,4356,9947
50,-40,-80,2162,2194,4356,10284
-160,10,-60,2177,2180,4357,9905
-100,-50,120,2186,2171,4357,9888
-130,50,-70,2203,2154,4357,10024
30,-80,170,2165,2192,4357,10224
10,20,-110,2148,2210,4358,10115
-20,10,130,2173,2185,4358,10164
40,-80,180,2172,2186,4358,10222
120,50,90,2203,2155,4358,10277
40,-80,-180,2172,2186,4358,10222
170,60,-40,2178,2181,4359,9939
-50,10,-140,2172,2187,4359,9782
140,-40,30,2166,2194,4360,10328
20,10,-110,2184,2176,4360,10307
-10,-50,140,2212,2148,4360,9790
100,70,120,2209,2152,4361,9748
-10,0,-110,2186,2175,4361,10344
120,-20,-70,2197,2164,4361,10358
-120,40,-40,2191,2170,4361,10164
140,60,-10,2174,2188,4362,10274
0,50,-110,2226,2136,4362,10540
110,-60,-110,2183,2179,4362,9985
40,70,-170,2210,2153,4363,10061
80,80,60,2180,2184,4364,9858
-100,50,-60,2186,2178,4364,10056
-10,-50,-120,2149,2216,4365,10427
60,50,100,2190,2175,4365,10173
-50,80,-80,2239,2126,4365,10273
-110,70,-30,2217,2149,4366,10109
130,-10,30,2180,2186,4366,10304
110,70,30,2185,2181,4366,10270
-140,80,10,2200,2167,4367,10363
70,50,110,2173,2194,4367,10004
-100,70,-40,2233,2134,4367,10228
-110,-60,120,2192,2176,4368,9787
120,-10,-10,2185,2183,4368,10149
-20,-40,130,2210,2158,4368,9868
170,-60,-70,2186,2182,4368,10087
160,-80,-70,2165,2203,4368,10094
-140,0,-10,2222,2147,4369,9956
-20,40,140,2193,2176,4369,10119
160,0,60,2185,2185,4370,10273
120,70,100,2214,2156,4370,9774
170,-80,-60,2164,2206,4370,10171
-30,20,140,2192,2179,4371,10163
130,40,-10,2172,2199,4371,10295
-120,-60,20,2219,2153,4372,10034
-150,20,-60,2198,2174,4372,10010
-130,-30,-10,2213,2160,4373,10046
-120,50,-80,2214,2159,4373,10079
20,-20,-100,2153,2220,4373,10281
-160,80,30,2194,2179,4373,10331
120,-20,0,2139,2234,4373,10120
170,80,60,2208,2165,4373,10337
-90,-40,90,2150,2224,4374,10216
160,20,60,2207,2168,4375,10245
20,0,150,2195,2180,4375,9494
-60,20,-170,2204,2173,4377,10222
-60,-10,170,2241,2137,4378,10236
0,-30,-110,2157,2221,4378,10333
60,80,80,2204,2174,4378,9897
140,-30,-70,2178,2200,4378,10042
-90,-40,100,2185,2193,4378,10345
140,50,70,2191,2187,4378,10183
130,70,90,2204,2175,4379,9995
60,80,170,2197,2183,4380,10082
-60,60,-70,2198,2182,4380,10141
-170,10,-60,2223,2157,4380,9904
-90,60,-60,2209,2172,4381,10170
60,-50,-150,2192,2189,4381,9905
70,80,70,2206,2175,4381,9869
130,-10,-50,2181,2200,4381,10023
140,-20,40,2194,2187,4381,10415
100,-30,-60,2196,2185,4381,10171
50,80,90,2205,2177,4382,9937
110,-40,-10,2173,2209,4382,10145
-100,60,-50,2192,2191,4383,10188
-130,-50,-10,2185,2198,4383,10252
-130,50,-90,2207,2177,4384,10242
-150,20,0,2230,2155,4385,9877
-10,-20,140,2216,2170,4386,9833
-180,20,50,2236,2150,4386,10220
0,-60,150,2206,2180,4386,10097
180,20,50,2236,2150,4386,10220
-10,-70,140,2189,2198,4387,9993
-150,50,0,2210,2177,4387,9958
170,50,50,2211,2177,4388,10228
110,80,30,2210,2178,4388,9853
-140,50,-60,2223,2165,4388,10100
-10,-60,-120,2175,2214,4389,10083
40,-20,-100,2199,2191,4390,10405
-60,30,-120,2219,2171,4390,10126
120,40,80,2198,2192,4390,10251
130,50,0,2206,2185,4391,10261
100,80,40,2195,2196,4391,9927
-50,-10,130,2193,2198,4391,10179
-120,50,-90,2205,2186,4391,9925
140,40,-20,2215,2177,4392,10355
-20,-10,130,2198,2194,4392,10180
-110,50,-90,2221,2171,4392,10036
70,-40,-80,2230,2163,4393,9873
180,-80,-50,2181,2212,4393,10083
-180,-80,-50,2181,2212,4393,10083
160,60,-30,2212,2181,4393,9946
-130,-60,100,2222,2172,4394,9946
-40,-70,-150,2183,2211,4394,10353
-110,-50,90,2184,2210,4394,10053
-170,70,40,2232,2162,4394,10402
40,40,120,2192,2202,4394,10199
170,30,50,2226,2168,4394,10213
40,20,150,2186,2209,4395,10207
-170,80,40,2212,2184,4396,10337
10,-50,160,2217,2179,4396,10056
130,-20,20,2179,2217,4396,10310
-180,80,50,2208,2188,4396,10307
180,80,50,2208,2188,4396,10307
130,50,80,2212,2185,4397,10464
-130,30,-50,2212,2186,4398,10249
40,10,180,2184,2214,4398,9673
130,30,-10,2194,2204,4398,10307
40,10,-180,2184,2214,4398,9673
90,80,50,2204,2195,4399,9915
-140,-60,-20,2208,2191,4399,10420
140,40,70,2221,2178,4399,10495
70,-20,-110,2211,2188,4399,10165
10,-10,150,2208,2191,4399,9847
110,-50,-100,2207,2193,4400,9880
-10,-30,140,2223,2177,4400,9857
-50,10,150,2181,2219,4400,10180
-60,60,-170,2219,2182,4401,10085
-40,40,160,2234,2167,4401,9941
-100,-60,50,2197,2205,4402,9993
30,40,120,2182,2220,4402,10067
-80,-40,140,2222,2181,4403,10239
130,0,40,2194,2209,4403,10500
60,-70,-160,2172,2231,4403,10056
-50,-70,-160,2185,2219,4404,10360
-110,50,-50,2194,2210,4404,10184
-160,-50,70,2206,2198,4404,9983
-70,-40,160,2198,2206,4404,10105
-150,30,-10,2213,2192,4405,9854
0,-50,150,2217,2188,4405,9953
-140,-10,-30,2220,2185,4405,10115
40,10,-130,2224,2181,4405,10057
120,-70,-110,2194,2212,4406,10331
50,80,-180,2229,2178,4407,10171
-150,-10,20,2241,2166,4407,10149
-40,50,160,2222,2185,4407,10084
130,30,70,2198,2209,4407,10401
50,80,180,2229,2178,4407,10171
40,-50,-80,2214,2194,4408,10471
-170,-60,70,2207,2202,4409,10047
160,60,60,2224,2185,4409,10349
-150,-10,30,2237,2172,4409,10235
-30,-10,-130,2171,2238,4409,10024
60,60,160,2249,2161,4410,10278
-40,80,-90,2266,2144,4410,10434
170,40,50,2198,2212,4410,10132
-160,20,-60,2191,2219,4410,10121
-50,0,140,2211,2199,4410,10185
130,20,60,2205,2205,4410,10380
-20,-30,130,2192,2219,4411,9903
-20,-70,-130,2193,2219,4412,10386
30,0,-110,2202,2210,4412,10248
110,40,50,2218,2195,4413,10429
-140,20,-40,2193,2220,4413,10104
50,-80,-170,2203,2210,4413,10291
-60,40,-170,2194,2219,4413,9916
-110,-80,30,2192,2221,4413,10169
90,60,120,2239,2174,4413,10247
-130,60,-20,2247,2167,4414,10027
-70,-30,150,2236,2178,4414,10079
-130,40,-60,2217,2198,4415,10245
40,30,-170,2219,2196,4415,10132
-150,50,-70,2225,2190,4415,10104
-80,-70,70,2220,2195,4415,10039
120,70,20,2220,2195,4415,10255
50,70,90,2239,2177,4416,10377
20,-50,170,2218,2199,4417,9874
-120,50,-40,2222,2195,4417,10100
40,80,100,2218,2199,4417,10087
-60,30,-170,2219,2198,4417,10055
90,70,130,2248,2171,4419,9938
-60,-10,140,2216,2203,4419,10522
-140,60,-80,2193,2226,4419,10103
30,10,150,2210,2209,4419,9892
-130,40,-30,2228,2192,4420,10348
-130,-70,110,2198,2222,4420,10215
-140,40,-70,2243,2177,4420,10273
150,60,-20,2215,2206,4421,10256
-160,-20,40,2244,2179,4423,10005
-140,-40,50,2246,2177,4423,10221
-60,-10,160,2247,2176,4423,10425
-120,-50,80,2217,2207,4424,9908
-30,50,150,2214,2211,4425,10180
120,80,20,2229,2196,4425,9926
-30,-70,-140,2201,2224,4425,10336
-140,20,-20,2221,2205,4426,10295
70,-30,-90,2225,2202,4427,10433
-160,-40,-50,2216,2211,4427,10159
-10,10,130,2202,2225,4427,10219
-130,50,-30,2220,2207,4427,10272
-150,-30,40,2262,2165,4427,10088
100,60,50,2201,2227,4428,10000
-10,80,-120,2263,2165,4428,10511
-60,10,-160,2223,2205,4428,10452
150,10,60,2199,2229,4428,10454
-50,-60,-160,2206,2223,4429,10435
-180,10,50,2239,2191,4430,9904
-80,40,-120,2228,2202,4430,10280
180,10,50,2239,2191,4430,9904
90,-40,-60,2262,2169,4431,10074
110,50,90,2245,2186,4431,10419
100,-50,-20,2222,2209,4431,10368
150,-20,50,2244,2187,4431,10333
-50,-10,-150,2244,2187,4431,10214
0,30,-110,2211,2221,4432,10320
-140,70,0,2253,2180,4433,10337
80,50,100,2205,2228,4433,10153
-30,80,-100,2278,2155,4433,10461
180,-60,-60,2220,2214,4434,10296
80,60,130,2240,2194,4434,10192
30,80,-160,2246,2188,4434,10376
10,50,-120,2265,2169,4434,10517
-180,-60,-60,2220,2214,4434,10296
170,30,-50,2224,2211,4435,9979
-150,60,10,2226,2209,4435,10492
-60,70,-70,2243,2193,4436,10339
-10,-40,140,2216,2220,4436,9816
180,-40,-60,2239,2198,4437,10278
-180,-40,-60,2239,2198,4437,10278
-50,-50,-160,2231,2206,4437,10295
150,0,-50,2237,2201,4438,10367
120,40,30,2198,2240,4438,10232
0,60,130,2234,2205,4439,10432
-20,0,130,2209,2230,4439,10363
-90,50,-70,2248,2191,4439,10303
150,-40,-70,2231,2210,4441,10146
140,-50,-80,2226,2215,4441,10097
-40,-30,120,2194,2247,4441,10398
-130,50,-80,2237,2205,4442,10154
30,20,140,2203,2239,4442,10020
-150,40,-70,2217,2225,4442,10395
-70,50,-80,2246,2197,4443,10294
-30,50,-90,2239,2205,4444,10662
0,40,130,2202,2242,4444,10446
130,90,100,2240,2205,4445,10544
-130,90,0,2240,2205,4445,10544
120,90,110,2240,2205,4445,10544
-60,90,-70,2240,2205,4445,10544
-150,90,20,2240,2205,4445,10544
0,90,-130,2240,2205,4445,10544
20,90,-150,2240,2205,4445,10544
-30,90,-100,2240,2205,4445,10544
-160,90,30,2240,2205,4445,10544
140,90,90,2240,2205,4445,10544
110,-50,-10,2226,2219,4445,10304
-40,90,-90,2240,2205,4445,10544
-10,90,-120,2240,2205,4445,10544
110,90,120,2240,2205,4445,10544
-50,90,-80,2240,2205,4445,10544
100,90,130,2240,2205,4445,10544
-180,90,50,2240,2205,4445,10544
150,90,80,2240,2205,4445,10544
-140,-40,-30,2219,2226,4445,10215
10,90,-140,2240,2205,4445,10544
-110,90,-20,2240,2205,4445,10544
-20,90,-110,2240,2205,4445,10544
30,90,-160,2240,2205,4445,10544
160,90,70,2240,2205,4445,10544
40,90,-170,2240,2205,4445,10544
-80,40,-130,2216,2229,4445,10320
-140,90,10,2240,2205,4445,10544
90,90,140,2240,2205,4445,10544
-80,90,-50,2240,2205,4445,10544
-170,90,40,2240,2205,4445,10544
170,90,60,2240,2205,4445,10544
-90,90,-40,2240,2205,4445,10544
70,90,160,2240,2205,4445,10544
60,90,170,2240,2205,4445,10544
50,90,-180,2240,2205,4445,10544
-120,90,-10,2240,2205,4445,10544
-100,90,-30,2240,2205,4445,10544
50,90,180,2240,2205,4445,10544
-70,90,-60,2240,2205,4445,10544
-170,40,-60,2223,2222,4445,10291
180,90,50,2240,2205,4445,10544
80,90,150,2240,2205,4445,10544
-130,-30,0,2254,2192,4446,10649
40,0,-120,2223,2223,4446,10247
40,-20,-170,2218,2228,4446,9997
0,80,-130,2265,2182,4447,10507
-140,20,-30,2223,2224,4447,10269
-40,50,-90,2202,2245,4447,10250
-140,-10,0,2227,2220,4447,10237
-110,40,-70,2221,2226,4447,10433
0,-70,150,2231,2217,4448,10125
-140,-70,100,2218,2230,4448,10206
-20,80,-110,2275,2173,4448,10517
-150,60,-70,2231,2217,4448,10217
30,80,110,2252,2197,4449,10237
-140,10,-30,2206,2243,4449,9938
-110,-50,100,2264,2185,4449,10038
-110,40,-60,2239,2211,4450,10445
40,-30,-170,2223,2227,4450,10000
70,50,100,2219,2231,4450,10406
20,80,-150,2239,2211,4450,10417
50,-50,-160,2225,2225,4450,10255
-50,20,-130,2216,2234,4450,10260
-120,-70,120,2226,2225,4451,10261
-90,70,-50,2286,2165,4451,10477
-170,60,40,2274,2178,4452,10590
-100,-70,140,2218,2234,4452,10145
-70,60,-70,2244,2208,4452,10317
50,0,-140,2224,2229,4453,10317
-120,50,-100,2241,2212,4453,10463
0,-20,-110,2205,2248,4453,10635
-80,60,-70,2256,2198,4454,10285
-150,0,20,2254,2200,4454,10351
-130,30,-40,2227,2227,4454,10401
-30,60,-90,2276,2179,4455,10696
180,-30,-60,2235,2221,4456,10130
-180,-30,-60,2235,2221,4456,10130
60,50,120,2233,2224,4457,10142
30,70,-160,2267,2190,4457,10375
-70,-20,140,2231,2227,4458,10441
40,80,-170,2256,2202,4458,10256
-50,-40,-160,2240,2218,4458,10411
40,20,-160,2205,2254,4459,10122
10,80,-140,2255,2204,4459,10528
-90,-40,120,2236,2224,4460,10584
-150,10,0,2280,2180,4460,10163
90,50,100,2246,2214,4460,10531
20,-30,-100,2191,2269,4460,10520
110,-30,-30,2211,2250,4461,10417
20,30,-120,2259,2202,4461,10581
30,60,110,2231,2231,4462,10472
150,50,60,2244,2218,4462,9994
-130,-60,0,2250,2212,4462,10343
130,80,10,2254,2209,4463,9971
70,-70,-150,2228,2237,4465,10360
-130,-50,70,2263,2202,4465,10025
150,40,60,2247,2219,4466,10349
90,50,70,2226,2240,4466,10563
-140,60,-10,2261,2205,4466,10237
150,-40,40,2240,2226,4466,10428
150,20,60,2234,2232,4466,10538
-80,-30,130,2213,2253,4466,10607
140,-60,-90,2230,2236,4466,10485
100,-40,-40,2244,2223,4467,10443
100,60,110,2274,2195,4469,10418
30,30,130,2244,2225,4469,10183
-70,-60,170,2222,2247,4469,10264
-40,-20,-140,2256,2213,4469,10294
120,-20,-40,2217,2252,4469,10016
160,30,-40,2230,2240,4470,10561
120,-20,-60,2223,2247,4470,10134
-60,-20,170,2291,2181,4472,10416
-140,10,-20,2258,2214,4472,10009
-140,30,-20,2247,2225,4472,10126
30,-20,170,2220,2253,4473,9972
40,-10,-110,2239,2234,4473,10468
170,20,50,2251,2223,4474,10027
-150,20,10,2247,2228,4475,10162
-140,-70,-10,2243,2232,4475,10393
-30,-10,130,2238,2237,4475,10238
30,30,-140,2266,2210,4476,10424
-80,-40,90,2197,2279,4476,10511
-140,40,-60,2268,2208,4476,10334
-160,-40,60,2283,2193,4476,10215
-110,50,-100,2245,2232,4477,10285
-110,-70,130,2229,2248,4477,10312
-20,-10,-120,2237,2240,4477,10691
80,70,140,2246,2232,4478,10151
150,30,60,2251,2227,4478,10612
-140,-30,30,2244,2234,4478,10170
160,10,60,2224,2254,4478,10553
170,50,-40,2233,2246,4479,10222
-150,50,-60,2247,2232,4479,10077
140,80,0,2251,2228,4479,10203
-60,30,-130,2279,2200,4479,10296
-20,-20,130,2224,2255,4479,10235
-30,10,140,2239,2242,4481,10350
60,-80,-160,2218,2263,4481,10440
-170,-40,60,2253,2229,4482,10374
60,50,130,2242,2242,4484,10055
160,10,-50,2264,2220,4484,10287
-150,-40,50,2260,2225,4485,10106
-140,-50,70,2293,2194,4487,9924
-50,30,170,2276,2211,4487,10130
-120,40,-50,2225,2262,4487,10343
80,-60,-40,2256,2232,4488,10700
-140,0,-20,2235,2255,4490,10052
-140,-20,-30,2257,2234,4491,10430
-180,-60,60,2233,2258,4491,10449
-60,-20,160,2282,2209,4491,10527
-170,20,40,2264,2227,4491,10285
-100,-60,130,2256,2235,4491,10027
90,-40,-110,2264,2227,4491,10383
180,-60,60,2233,2258,4491,10449
-50,30,-110,2245,2246,4491,10396
-90,-40,110,2252,2240,4492,10490
-110,50,-110,2256,2237,4493,10472
120,50,30,2240,2253,4493,10394
20,50,-140,2266,2228,4494,10424
-120,-80,20,2227,2267,4494,10349
-150,-20,30,2281,2214,4495,10407
130,70,10,2267,2228,4495,10363
150,80,-10,2263,2232,4495,10255
-70,-30,120,2271,2224,4495,10736
110,-30,-40,2263,2233,4496,10526
-80,70,-60,2301,2195,4496,10674
110,40,80,2241,2255,4496,10680
30,50,-160,2271,2226,4497,10490
-150,-50,70,2276,2221,4497,10305
20,70,-150,2263,2235,4498,10613
90,70,60,2232,2266,4498,10167
-50,60,-80,2257,2242,4499,10608
70,-50,-60,2245,2254,4499,10361
-170,-80,70,2256,2244,4500,10258
140,0,50,2246,2254,4500,10732
-70,40,-150,2267,2234,4501,10186
10,-60,160,2240,2261,4501,10427
-140,50,-70,2234,2268,4502,10181
40,70,100,2266,2236,4502,10478
-50,20,160,2262,2241,4503,10337
-140,50,-20,2284,2220,4504,10271
-170,30,40,2262,2242,4504,10530
-150,-70,90,2239,2265,4504,10339
-170,50,40,2296,2209,4505,10639
50,-30,-100,2250,2255,4505,10396
-70,-50,160,2213,2293,4506,10074
120,-50,0,2244,2262,4506,10377
-50,60,180,2254,2253,4507,10323
-50,60,-180,2254,2253,4507,10323
140,70,80,2263,2244,4507,10456
70,70,80,2257,2250,4507,10299
-50,-50,110,2257,2250,4507,10255
-40,-10,130,2241,2267,4508,10289
-140,-60,90,2264,2244,4508,10310
30,-20,-100,2246,2262,4508,10499
-160,-80,80,2277,2231,4508,10405
-160,50,-60,2241,2267,4508,10320
-40,-60,-150,2249,2259,4508,10655
-130,60,-90,2250,2258,4508,10531
-150,-40,-40,2259,2250,4509,10488
130,20,-10,2224,2286,4510,10431
0,50,130,2237,2273,4510,10540
50,60,100,2260,2250,4510,10492
40,20,170,2272,2238,4510,10039
100,-40,-30,2258,2253,4511,10801
-180,-50,60,2256,2255,4511,10469
180,-50,60,2256,2255,4511,10469
-140,-20,10,2286,2226,4512,10278
120,-60,-100,2256,2256,4512,10460
80,50,90,2255,2257,4512,10575
-160,50,30,2285,2227,4512,10689
180,-80,60,2245,2268,4513,10256
-60,-30,170,2281,2232,4513,10389
-150,30,-60,2266,2247,4513,10048
-50,50,-90,2252,2261,4513,10275
70,-60,-50,2243,2270,4513,10559
-180,-80,60,2245,2268,4513,10256
40,30,140,2253,2261,4514,10521
170,-70,50,2242,2272,4514,10359
110,40,70,2282,2232,4514,10570
130,0,-20,2222,2292,4514,10481
80,-70,-140,2232,2282,4514,10657
-140,40,-20,2274,2241,4515,10463
-160,-70,80,2249,2267,4516,10417
60,50,110,2259,2257,4516,10546
50,0,-150,2259,2257,4516,10719
-130,-90,10,2228,2289,4517,10504
-110,-90,30,2228,2289,4517,10504
-40,-90,100,2228,2289,4517,10504
110,-90,-110,2228,2289,4517,10504
160,-90,-60,2228,2289,4517,10504
140,-90,-80,2228,2289,4517,10504
40,-90,-180,2228,2289,4517,10504
150,-90,-70,2228,2289,4517,10504
-160,-90,-20,2228,2289,4517,10504
-70,-90,70,2228,2289,4517,10504
30,-90,170,2228,2289,4517,10504
80,-90,-140,2228,2289,4517,10504
-30,-90,110,2228,2289,4517,10504
100,-90,-120,2228,2289,4517,10504
-140,-90,0,2228,2289,4517,10504
60,-90,-160,2228,2289,4517,10504
-170,30,-60,2256,2261,4517,10290
80,70,70,2262,2255,4517,10179
-10,-90,130,2228,2289,4517,10504
-90,-90,50,2228,2289,4517,10504
40,-90,180,2228,2289,4517,10504
180,-90,-40,2228,2289,4517,10504
-50,-90,90,2228,2289,4517,10504
-60,-90,80,2228,2289,4517,10504
90,-90,-130,2228,2289,4517,10504
-120,-90,20,2228,2289,4517,10504
-150,-90,-10,2228,2289,4517,10504
-160,-20,-50,2258,2259,4517,10379
-80,-90,60,2228,2289,4517,10504
20,-90,160,2228,2289,4517,10504
0,-90,140,2228,2289,4517,10504
-100,-90,40,2228,2289,4517,10504
-170,-90,-30,2228,2289,4517,10504
130,-90,-90,2228,2289,4517,10504
140,-30,30,2256,2261,4517,10539
120,-90,-100,2228,2289,4517,10504
-180,-90,-40,2228,2289,4517,10504
-20,-90,120,2228,2289,4517,10504
70,-90,-150,2228,2289,4517,10504
50,-90,-170,2228,2289,4517,10504
170,-90,-50,2228,2289,4517,10504
10,-90,150,2228,2289,4517,10504
120,-20,-50,2222,2297,4519,10147
-130,-40,20,2263,2256,4519,10549
120,30,40,2257,2262,4519,10484
80,-50,-50,2241,2278,4519,10539
-30,40,150,2275,2244,4519,10429
70,-30,-130,2270,2250,4520,10708
120,-50,-90,2256,2265,4521,10256
-110,50,-80,2261,2260,4521,10543
-180,-10,50,2277,2245,4522,10172
180,-10,50,2277,2245,4522,10172
-160,-30,-50,2266,2256,4522,10228
160,40,50,2281,2241,4522,10203
10,10,-110,2232,2290,4522,10731
-70,40,-100,2274,2249,4523,10531
20,80,120,2282,2241,4523,10397
-130,-80,10,2244,2279,4523,10430
0,-40,150,2279,2245,4524,10173
110,-30,-20,2266,2258,4524,10614
40,-40,-170,2258,2266,4524,10195
-170,10,40,2271,2254,4525,10239
-10,60,140,2256,2269,4525,10453
130,-70,-100,2241,2284,4525,10806
120,30,60,2253,2273,4526,10818
110,60,100,2288,2239,4527,10713
-170,40,40,2299,2228,4527,10677
-130,60,-30,2288,2239,4527,10450
-170,-70,70,2240,2288,4528,10532
-40,10,-130,2259,2269,4528,10438
-90,-70,150,2267,2261,4528,10192
90,-30,-80,2264,2264,4528,10428
-150,10,-50,2269,2260,4529,10587
140,20,60,2260,2269,4529,10736
120,-20,-30,2254,2277,4531,10603
20,50,120,2276,2255,4531,10619
-180,0,50,2287,2244,4531,10446
180,0,50,2287,2244,4531,10446
40,30,180,2261,2270,4531,10226
40,30,-180,2261,2270,4531,10226
100,-30,-90,2258,2274,4532,10723
10,60,-130,2296,2237,4533,10716
-40,-40,120,2232,2301,4533,10211
-140,30,-50,2277,2256,4533,10379
-50,50,180,2279,2255,4534,10253
-120,50,-70,2288,2246,4534,10571
-50,50,-180,2279,2255,4534,10253
-90,-70,60,2269,2266,4535,10369
-60,20,-150,2289,2246,4535,10402
-10,-40,-120,2253,2282,4535,10694
-60,-50,-180,2276,2260,4536,10289
-150,-80,90,2269,2267,4536,10309
-20,-60,-130,2287,2249,4536,10646
-60,40,-100,2291,2245,4536,10529
-60,-50,180,2276,2260,4536,10289
40,20,160,2267,2270,4537,10305
-80,50,-80,2304,2235,4539,10406
70,-80,-150,2231,2308,4539,10559
-170,50,-50,2261,2278,4539,10479
-160,60,-60,2259,2280,4539,10347
-140,30,-30,2283,2257,4540,10634
-130,-40,-10,2278,2262,4540,10526
120,50,80,2301,2239,4540,10673
-110,-50,70,2270,2271,4541,10521
-140,-30,-30,2240,2303,4543,10747
100,-40,-100,2283,2260,4543,10275
40,40,-180,2281,2263,4544,10291
40,40,180,2281,2263,4544,10291
-50,-30,120,2282,2263,4545,10433
-60,-10,150,2272,2273,4545,10573
120,-30,0,2268,2277,4545,10544
-50,70,-80,2311,2235,4546,10776
-90,-60,140,2276,2272,4548,10202
40,20,-180,2259,2289,4548,10278
-130,-40,40,2281,2267,4548,10523
40,20,180,2259,2289,4548,10278
-170,-60,-50,2273,2275,4548,10573
-10,10,-110,2275,2273,4548,10558
90,-70,-130,2253,2296,4549,10748
160,20,50,2262,2287,4549,10618
-60,60,-80,2274,2275,4549,10657
-40,-10,-140,2271,2279,4550,10404
-150,0,0,2302,2248,4550,10581
-20,30,140,2272,2278,4550,10703
-30,20,-110,2308,2243,4551,10792
150,-20,-60,2320,2231,4551,10397
130,40,0,2275,2276,4551,10657
-90,-50,130,2301,2251,4552,10284
-150,40,-10,2281,2271,4552,10119
-120,-70,20,2267,2285,4552,10346
-100,50,-100,2266,2287,4553,10487
0,20,-110,2244,2309,4553,10570
180,-50,-60,2278,2276,4554,10606
-180,-50,-60,2278,2276,4554,10606
-60,-50,100,2278,2276,4554,10597
20,60,-150,2316,2238,4554,10554
-100,50,-110,2297,2257,4554,10493
-90,50,-130,2246,2309,4555,10410
30,-50,180,2297,2258,4555,10327
30,-50,-180,2297,2258,4555,10327
130,60,10,2265,2291,4556,10554
30,70,110,2285,2271,4556,10712
-150,10,10,2311,2245,4556,10583
50,-40,-90,2326,2230,4556,10790
160,80,-20,2289,2267,4556,10430
-100,50,-120,2265,2292,4557,10527
110,60,40,2259,2298,4557,10339
-120,-50,30,2295,2262,4557,10337
90,-30,-100,2306,2251,4557,10822
20,-60,170,2306,2251,4557,10451
-160,50,-50,2297,2261,4558,10099
-70,40,-110,2293,2267,4560,10561
20,-20,160,2292,2269,4561,10395
-20,60,150,2276,2286,4562,10511
-150,50,-50,2303,2259,4562,10494
-40,20,150,2277,2287,4564,10624
170,10,50,2302,2263,4565,10553
10,-70,160,2290,2275,4565,10401
-70,60,-80,2299,2266,4565,10372
160,-50,-70,2263,2302,4565,10568
170,-80,50,2274,2291,4565,10423
70,70,150,2295,2271,4566,10468
100,-40,-50,2336,2230,4566,10525
-160,40,30,2334,2232,4566,10704
-170,90,-50,2298,2269,4567,10418
-10,90,150,2298,2269,4567,10418
-60,90,-160,2298,2269,4567,10418
100,90,40,2298,2269,4567,10418
110,90,30,2298,2269,4567,10418
80,90,60,2298,2269,4567,10418
40,90,100,2298,2269,4567,10418
10,90,130,2298,2269,4567,10418
-130,90,-90,2298,2269,4567,10418
-20,20,140,2288,2279,4567,10393
-150,-60,-30,2256,2311,4567,10767
60,90,80,2298,2269,4567,10418
-50,90,-170,2298,2269,4567,10418
130,90,10,2298,2269,4567,10418
-80,90,-140,2298,2269,4567,10418
0,90,140,2298,2269,4567,10418
180,90,-40,2298,2269,4567,10418
150,90,-10,2298,2269,4567,10418
-180,90,-40,2298,2269,4567,10418
-30,90,170,2298,2269,4567,10418
-110,90,-110,2298,2269,4567,10418
-160,90,-60,2298,2269,4567,10418
-20,90,160,2298,2269,4567,10418
-40,90,-180,2298,2269,4567,10418
-90,90,-130,2298,2269,4567,10418
50,90,90,2298,2269,4567,10418
170,90,-30,2298,2269,4567,10418
90,90,50,2298,2269,4567,10418
-100,90,-120,2298,2269,4567,10418
-40,90,180,2298,2269,4567,10418
70,90,70,2298,2269,4567,10418
160,90,-20,2298,2269,4567,10418
140,90,0,2298,2269,4567,10418
-120,90,-100,2298,2269,4567,10418
-150,90,-70,2298,2269,4567,10418
120,90,20,2298,2269,4567,10418
-140,90,-80,2298,2269,4567,10418
30,90,110,2298,2269,4567,10418
-70,90,-150,2298,2269,4567,10418
20,90,120,2298,2269,4567,10418
-150,-20,-40,2309,2259,4568,10695
-60,-20,130,2287,2281,4568,10749
170,80,-30,2294,2274,4568,10554
-40,-50,120,2285,2284,4569,10335
0,-30,150,2315,2254,4569,10194
-100,-50,100,2282,2287,4569,10243
140,0,-40,2271,2298,4569,10631
-120,60,-40,2310,2260,4570,10644
-150,20,-10,2303,2267,4570,10353
-140,-30,20,2302,2268,4570,10604
60,-60,-60,2265,2305,4570,10685
60,-40,-90,2306,2265,4571,10395
-40,60,170,2273,2298,4571,10424
-60,-40,170,2270,2301,4571,10489
160,-70,40,2274,2297,4571,10632
0,0,140,2297,2275,4572,10551
100,70,50,2269,2303,4572,10164
-130,40,-40,2280,2292,4572,10708
-30,40,-100,2280,2292,4572,10637
160,50,-30,2289,2284,4573,10545
-160,40,10,2320,2254,4574,10179
180,40,-50,2289,2286,4575,10563
-180,40,-50,2289,2286,4575,10563
10,80,130,2301,2274,4575,10580
70,-50,-70,2316,2259,4575,10581
-180,-70,60,2269,2306,4575,10606
180,-70,60,2269,2306,4575,10606
-140,-80,100,2291,2285,4576,10385
140,50,-10,2266,2311,4577,10841
-140,-40,40,2330,2247,4577,10380
90,50,90,2295,2283,4578,10644
60,70,90,2276,2302,4578,10359
-120,70,-30,2312,2267,4579,10696
-140,80,-80,2305,2274,4579,10834
140,-10,-50,2303,2278,4581,10548
170,-20,-60,2321,2260,4581,10475
-30,60,160,2298,2283,4581,10547
-80,-40,100,2300,2282,4582,10741
120,-40,0,2280,2303,4583,10803
-100,50,-90,2285,2298,4583,10661
-30,-60,-140,2310,2273,4583,10716
-150,-30,-40,2289,2294,4583,10603
-50,30,-120,2304,2279,4583,10506
-140,60,-20,2314,2270,4584,10739
50,50,160,2321,2263,4584,10531
30,10,-120,2291,2293,4584,10427
-120,40,-60,2295,2289,4584,10717
170,60,50,2315,2270,4585,10892
-120,60,-100,2313,2272,4585,10832
-60,50,-90,2283,2302,4585,10754
-50,-30,-160,2321,2265,4586,10682
-20,60,-100,2332,2254,4586,11134
180,-20,50,2311,2275,4586,10236
-180,-20,50,2311,2275,4586,10236
-80,-70,160,2280,2307,4587,10546
150,30,-30,2297,2290,4587,10849
-150,-20,20,2324,2263,4587,10322
110,-30,-50,2290,2298,4588,10600
-150,80,-70,2301,2288,4589,10925
180,80,-40,2292,2297,4589,10672
30,-50,-90,2297,2292,4589,10952
-180,80,-40,2292,2297,4589,10672
10,70,-140,2330,2260,4590,10730
-170,-30,50,2341,2249,4590,10295
0,70,-130,2358,2232,4590,10728
-150,40,-60,2342,2249,4591,10679
-10,-10,140,2300,2291,4591,10318
-100,-50,110,2295,2296,4591,10420
-110,70,-40,2307,2284,4591,10803
-110,60,-50,2307,2285,4592,10818
-40,-60,120,2321,2271,4592,10350
130,50,10,2301,2291,4592,10478
40,-10,-170,2290,2302,4592,10402
130,-50,10,2306,2287,4593,10628
-70,-40,150,2300,2293,4593,10429
90,-60,-30,2314,2279,4593,10775
140,-10,40,2291,2302,4593,10681
140,70,0,2299,2295,4594,10678
150,70,70,2303,2291,4594,10905
-30,-50,130,2308,2286,4594,10364
120,60,90,2308,2286,4594,10817
40,-50,-170,2311,2283,4594,10472
-160,30,30,2329,2266,4595,10649
130,0,30,2316,2279,4595,11049
130,60,80,2288,2307,4595,10534
-150,60,0,2284,2312,4596,10622
160,-20,-60,2301,2295,4596,10461
-160,30,10,2339,2258,4597,10537
-160,50,20,2318,2279,4597,10812
-160,30,-60,2326,2272,4598,10593
-50,20,170,2325,2273,4598,10611
-150,70,-70,2296,2302,4598,10750
0,40,-110,2307,2291,4598,11125
-160,40,20,2325,2274,4599,10674
100,-30,-70,2310,2289,4599,10628
20,60,120,2330,2269,4599,10869
-170,-10,40,2308,2292,4600,10564
110,40,60,2320,2280,4600,10846
-10,20,-110,2284,2316,4600,10634
-140,-80,0,2282,2319,4601,10609
180,50,40,2334,2267,4601,10524
-130,-40,10,2324,2277,4601,10740
-180,50,40,2334,2267,4601,10524
-130,80,-90,2308,2293,4601,10803
-140,30,-40,2307,2294,4601,10542
-10,-30,-120,2283,2320,4603,10666
-60,60,-90,2340,2263,4603,10700
-100,60,-60,2333,2271,4604,10853
60,-20,-110,2321,2283,4604,10757
-70,70,-70,2359,2245,4604,10869
-70,-50,90,2317,2288,4605,10796
-140,60,-60,2316,2289,4605,10463
-130,60,-70,2296,2309,4605,10471
-110,-50,80,2300,2306,4606,10525
-60,20,-160,2322,2285,4607,10716
110,70,40,2272,2336,4608,10228
-160,80,-60,2304,2304,4608,10883
-140,40,-30,2314,2295,4609,10761
-160,-60,-40,2300,2309,4609,10793
-30,-20,130,2274,2335,4609,10598
90,-60,-120,2332,2277,4609,10393
-30,-80,120,2309,2301,4610,10700
-180,40,40,2352,2259,4611,10672
-50,20,-140,2322,2289,4611,10362
180,40,40,2352,2259,4611,10672
-70,-40,100,2270,2342,4612,10650
-90,-50,70,2293,2319,4612,10807
-120,80,-100,2307,2305,4612,10835
-160,-30,40,2348,2265,4613,10438
-150,-70,-20,2278,2335,4613,10654
80,-40,-120,2298,2315,4613,10638
-20,-50,140,2350,2263,4613,10426
-170,0,40,2326,2287,4613,10391
160,-80,40,2298,2316,4614,10569
70,60,140,2323,2291,4614,10621
-40,20,-120,2311,2303,4614,10709
-150,10,-10,2362,2252,4614,10527
50,-10,-120,2327,2288,4615,10827
40,-30,-100,2348,2267,4615,10726
50,-60,-70,2292,2323,4615,10797
160,30,50,2331,2285,4616,10461
50,50,110,2322,2294,4616,10674
40,10,-140,2325,2291,4616,10669
10,30,130,2281,2336,4617,10777
160,-30,50,2313,2304,4617,11083
-100,80,-40,2350,2267,4617,10872
-100,-50,60,2281,2336,4617,10836
150,50,-20,2316,2302,4618,10536
-160,70,-60,2307,2311,4618,10678
140,60,70,2325,2293,4618,10663
60,-50,-70,2283,2336,4619,10772
20,70,120,2342,2277,4619,10832
-40,30,160,2321,2299,4620,10559
-30,-60,130,2342,2279,4621,10506
-110,80,-30,2333,2288,4621,10921
80,-80,-140,2265,2356,4621,10736
-130,50,-40,2321,2300,4621,10792
150,-70,30,2288,2333,4621,10825
-120,-50,70,2343,2279,4622,10563
-20,-50,-130,2277,2345,4622,10842
170,-60,50,2296,2328,4624,10706
-130,-80,110,2320,2304,4624,10525
0,10,-110,2281,2343,4624,10923
130,-40,10,2328,2297,4625,10769
-60,-80,90,2291,2335,4626,10663
40,50,-180,2325,2301,4626,10655
-160,60,20,2347,2279,4626,10900
-40,40,-100,2293,2333,4626,10974
40,50,180,2325,2301,4626,10655
-160,40,-60,2331,2296,4627,10660
140,-20,30,2315,2312,4627,10839
150,-60,-80,2310,2317,4627,10811
130,30,0,2292,2336,4628,10723
40,-40,-90,2307,2321,4628,10731
130,40,70,2310,2318,4628,10849
170,20,-50,2327,2301,4628,10627
20,40,-130,2344,2284,4628,10708
-100,70,-50,2335,2293,4628,10904
80,-50,-60,2344,2285,4629,10889
50,-60,-160,2331,2298,4629,10689
170,-30,-60,2333,2296,4629,10641
-180,70,-40,2288,2342,4630,10620
-110,-60,40,2301,2329,4630,10545
180,70,-40,2288,2342,4630,10620
-40,50,170,2344,2287,4631,10661
-150,70,10,2325,2306,4631,10987
20,0,-110,2303,2328,4631,10825
120,30,50,2365,2266,4631,10874
90,-50,-40,2323,2309,4632,10987
140,-70,-90,2296,2337,4633,11085
-30,-40,130,2300,2333,4633,10424
-130,70,-20,2346,2287,4633,10931
100,-60,-20,2322,2311,4633,10714
140,-70,20,2317,2316,4633,10790
50,50,150,2352,2281,4633,10413
-130,50,-60,2331,2302,4633,10836
80,-30,-110,2331,2303,4634,10909
-80,-50,80,2333,2301,4634,10844
20,-70,170,2327,2307,4634,10691
-150,-10,-40,2328,2306,4634,10797
0,-20,150,2329,2306,4635,10235
-120,-50,60,2346,2289,4635,10737
-140,40,-50,2323,2313,4636,10821
-50,40,-100,2309,2327,4636,10726
0,0,-110,2309,2328,4637,10676
-170,80,-50,2325,2313,4638,10883
10,-40,160,2339,2299,4638,10491
120,-20,-10,2289,2349,4638,10804
-20,70,-110,2363,2275,4638,11105
130,10,40,2322,2316,4638,11082
40,30,170,2347,2291,4638,10534
-50,10,160,2307,2332,4639,10725
-30,10,-120,2321,2318,4639,10837
170,70,-30,2294,2345,4639,10695
50,60,170,2342,2297,4639,10919
0,60,-120,2349,2290,4639,11085
20,-40,-100,2312,2328,4640,11080
-110,80,-110,2312,2328,4640,10895
-50,0,-150,2348,2293,4641,10436
40,-70,-170,2332,2309,4641,10756
-120,-80,120,2336,2305,4641,10660
40,30,160,2341,2300,4641,10375
-90,80,-50,2359,2283,4642,10870
-150,60,-60,2319,2323,4642,10256
-40,-80,110,2302,2340,4642,10724
-10,30,-110,2303,2339,4642,10858
-140,70,-80,2332,2310,4642,10672
-50,-80,100,2290,2352,4642,10663
-150,0,10,2347,2296,4643,10901
80,-60,-130,2342,2301,4643,10435
-150,20,-30,2321,2322,4643,10473
-150,-20,10,2373,2270,4643,10593
-50,-60,110,2339,2305,4644,10383
140,30,-20,2316,2329,4645,11074
-60,-30,120,2321,2324,4645,10860
150,-80,30,2322,2323,4645,10720
-10,60,-110,2360,2285,4645,11102
150,0,50,2319,2327,4646,10863
50,70,100,2328,2318,4646,10665
-180,20,40,2396,2250,4646,10680
-170,70,-50,2314,2332,4646,10611
-160,-40,50,2377,2269,4646,10292
-130,40,-50,2301,2345,4646,11001
40,20,-170,2325,2321,4646,10530
180,20,40,2396,2250,4646,10680
-80,50,-140,2326,2320,4646,10519
30,-70,-180,2350,2297,4647,10763
30,-70,180,2350,2297,4647,10763
-100,-70,50,2320,2327,4647,10808
-100,50,-70,2369,2278,4647,10920
130,-10,20,2310,2338,4648,10955
-120,80,-20,2346,2303,4649,10973
-30,30,150,2324,2325,4649,10661
-50,0,150,2342,2308,4650,10853
-50,70,-90,2353,2298,4651,11171
-60,-30,160,2332,2319,4651,10818
-40,70,-90,2377,2274,4651,11103
-10,70,-120,2368,2283,4651,10950
-90,50,-80,2357,2295,4652,10832
-60,70,-80,2360,2293,4653,11137
180,30,40,2358,2295,4653,10772
100,50,60,2331,2322,4653,10806
-40,30,-110,2340,2313,4653,10943
-180,30,40,2358,2295,4653,10772
60,-20,-140,2301,2353,4654,10971
150,70,-10,2316,2339,4655,10646
-150,0,-40,2327,2328,4655,10863
0,80,140,2340,2315,4655,10706
-10,50,140,2312,2343,4655,10844
-80,80,-60,2370,2286,4656,10903
-130,-40,30,2321,2336,4657,10618
-110,50,-60,2353,2304,4657,10731
30,40,-160,2365,2293,4658,10570
130,-60,-90,2331,2327,4658,10790
-130,60,-80,2317,2341,4658,10494
-140,-10,-20,2367,2292,4659,10810
-120,50,-50,2331,2328,4659,10851
40,-60,-170,2341,2319,4660,10629
170,40,-40,2336,2324,4660,10967
150,10,-40,2315,2346,4661,10884
30,-30,-100,2329,2332,4661,10996
-30,0,-130,2341,2321,4662,10952
-150,-80,-10,2310,2352,4662,10803
-60,-20,150,2368,2294,4662,11121
120,60,30,2313,2350,4663,10680
-90,50,-100,2340,2323,4663,10908
-20,20,-110,2322,2341,4663,10782
10,10,140,2324,2340,4664,10471
140,30,60,2317,2347,4664,10929
-140,-10,-10,2387,2277,4664,10828
-50,-20,130,2338,2326,4664,11141
-150,-10,10,2365,2300,4665,10869
-80,-40,110,2353,2312,4665,10959
-40,0,140,2325,2341,4666,10743
-20,-80,130,2344,2322,4666,10818
-170,-50,60,2348,2318,4666,10723
-30,70,-100,2367,2299,4666,11148
-90,70,-60,2367,2300,4667,11044
-20,50,-100,2345,2323,4668,11161
-150,-30,30,2369,2300,4669,10701
160,10,50,2338,2334,4672,10845
-140,60,-70,2303,2369,4672,10348
40,40,130,2324,2348,4672,10783
30,-40,180,2318,2354,4672,10504
30,-40,-180,2318,2354,4672,10504
40,-60,-80,2328,2345,4673,11072
-40,-20,130,2358,2315,4673,10817
150,-10,50,2326,2348,4674,11015
-70,-80,80,2317,2357,4674,10794
30,20,-130,2391,2283,4674,11108
-100,-50,90,2339,2336,4675,10852
60,70,160,2348,2327,4675,10848
-60,-60,100,2363,2313,4676,10493
-70,80,-70,2371,2305,4676,10911
110,-60,-10,2313,2364,4677,10798
-160,-10,-50,2363,2315,4678,10760
-140,-20,0,2367,2312,4679,10809
-90,60,-70,2367,2312,4679,11203
-50,40,-180,2353,2326,4679,10426
-10,-80,140,2345,2334,4679,10806
-50,40,180,2353,2326,4679,10426
-100,-50,80,2322,2358,4680,10576
-90,80,-130,2357,2323,4680,10946
-120,60,-90,2339,2341,4680,10486
-110,-50,50,2334,2347,4681,10939
180,10,40,2383,2298,4681,10678
170,-50,50,2331,2350,4681,10667
-180,10,40,2383,2298,4681,10678
-100,80,-120,2347,2334,4681,10952
-70,50,-90,2384,2298,4682,10911
100,-70,-120,2313,2369,4682,10931
160,-60,40,2323,2360,4683,11028
30,-60,180,2369,2315,4684,10517
-110,-80,130,2362,2322,4684,10778
-130,-50,0,2371,2313,4684,11026
30,-60,-180,2369,2315,4684,10517
90,60,110,2352,2333,4685,10836
-80,-50,140,2350,2335,4685,10467
60,-50,-80,2353,2332,4685,10791
80,80,70,2318,2368,4686,10537
-40,60,-90,2345,2342,4687,11117
160,70,-20,2335,2352,4687,10784
-150,50,-10,2362,2325,4687,10661
40,60,110,2360,2328,4688,10921
-130,-40,0,2374,2314,4688,11193
-50,10,170,2359,2329,4688,10940
20,30,130,2343,2345,4688,10936
130,-70,10,2350,2338,4688,10760
-140,-50,60,2379,2309,4688,10504
-150,30,-20,2366,2322,4688,10662
-30,-30,130,2362,2327,4689,10758
40,0,-170,2327,2362,4689,10656
160,0,-50,2352,2338,4690,11007
90,50,80,2374,2316,4690,10961
30,30,-150,2339,2351,4690,10567
120,70,30,2316,2375,4691,10433
140,10,50,2342,2349,4691,11175
-140,50,-30,2368,2323,4691,10858
60,-30,-100,2333,2358,4691,11038
140,60,0,2348,2344,4692,10894
110,-40,-90,2341,2351,4692,10702
130,-10,-30,2309,2383,4692,10838
-100,-50,70,2340,2353,4693,10646
150,20,-30,2357,2336,4693,10904
-130,70,-90,2359,2334,4693,10786
30,0,160,2351,2342,4693,10775
20,-40,170,2353,2340,4693,10664
-160,20,30,2363,2331,4694,10983
100,50,90,2368,2327,4695,11224
50,-20,-110,2323,2372,4695,11159
-140,-60,-10,2336,2360,4696,10899
-110,60,-110,2349,2347,4696,10961
170,-40,-60,2356,2341,4697,10991
20,50,-150,2388,2310,4698,10715
80,-30,-90,2384,2314,4698,11111
0,-10,-110,2355,2343,4698,11260
70,80,80,2334,2364,4698,10590
-40,-50,-150,2363,2335,4698,11140
60,80,90,2335,2364,4699,10623
-30,50,160,2388,2311,4699,10845
140,-60,20,2334,2365,4699,10896
-60,-40,110,2346,2353,4699,10992
150,-70,-80,2342,2358,4700,11081
130,20,50,2343,2358,4701,11181
-50,0,160,2365,2336,4701,11010
-150,20,-50,2381,2320,4701,10852
-150,40,-50,2394,2309,4703,10899
130,-20,-60,2309,2394,4703,10639
-160,50,-40,2360,2343,4703,10625
50,-70,-160,2358,2345,4703,10755
-60,80,-80,2389,2316,4705,11028
-120,70,-100,2357,2348,4705,10900
-170,-20,40,2357,2348,4705,10565
120,-20,-20,2330,2376,4706,10733
90,-50,-60,2383,2323,4706,10702
140,20,-20,2345,2362,4707,10800
-150,-30,20,2372,2335,4707,10838
100,60,100,2360,2347,4707,10938
140,-20,-60,2319,2389,4708,10942
80,60,120,2356,2352,4708,11002
-160,40,-50,2410,2299,4709,10937
-40,0,-140,2345,2364,4709,10826
-150,-10,0,2400,2310,4710,10700
160,-10,50,2358,2353,4711,11018
-170,60,-50,2364,2348,4712,10788
-50,-20,-160,2371,2341,4712,10858
90,-80,-130,2339,2373,4712,10991
60,60,150,2361,2351,4712,11084
-80,-80,70,2326,2387,4713,10962
-50,60,-90,2345,2368,4713,11002
-30,50,-100,2350,2364,4714,10920
-160,10,30,2405,2309,4714,10898
60,-60,-150,2385,2329,4714,10980
-130,80,-10,2372,2342,4714,11227
-140,-50,-20,2380,2334,4714,11327
-20,-30,140,2362,2353,4715,10548
40,-20,-110,2370,2346,4716,11018
-150,-60,80,2367,2349,4716,10729
-120,60,-70,2402,2314,4716,10941
50,80,100,2359,2357,4716,10662
160,40,-30,2372,2345,4717,10874
-150,0,-10,2409,2308,4717,10686
150,10,50,2377,2341,4718,10764
-160,-70,-30,2317,2401,4718,10872
140,-80,20,2370,2348,4718,10897
120,-80,0,2380,2339,4719,11064
130,-80,10,2376,2343,4719,10930
-40,10,150,2349,2370,4719,10995
-170,50,-40,2392,2328,4720,10698
-160,30,0,2370,2350,4720,10689
-40,60,-100,2363,2358,4721,11078
-120,-60,100,2366,2356,4722,10779
-150,-40,40,2400,2322,4722,11025
-20,0,-120,2355,2367,4722,10933
-40,70,-100,2389,2333,4722,11175
-20,50,150,2357,2365,4722,10938
70,-60,-140,2388,2335,4723,10677
-170,50,30,2373,2351,4724,11306
160,70,60,2409,2315,4724,11283
0,-80,150,2362,2362,4724,10818
-160,-80,-20,2352,2372,4724,10925
-80,70,-70,2363,2362,4725,11021
120,-60,0,2333,2393,4726,10920
-100,-80,140,2372,2354,4726,10848
140,0,40,2378,2348,4726,11259
-20,-20,140,2363,2363,4726,10708
-120,60,-80,2360,2366,4726,10846
-80,80,-140,2372,2354,4726,11061
-140,40,-40,2382,2344,4726,11017
-180,50,-40,2358,2369,4727,10887
150,-30,40,2346,2381,4727,11031
-50,80,-90,2402,2325,4727,10938
180,50,-40,2358,2369,4727,10887
-90,-50,120,2349,2379,4728,10944
-150,20,-40,2370,2358,4728,10582
-70,-60,90,2355,2373,4728,10788
40,10,-170,2364,2365,4729,10791
-150,40,-40,2388,2341,4729,11039
50,50,120,2376,2353,4729,10898
90,80,60,2353,2377,4730,10580
-70,40,-120,2384,2346,4730,10776
160,50,50,2379,2351,4730,10938
140,0,-30,2351,2380,4731,10809
-10,80,150,2379,2352,4731,10874
130,-60,10,2345,2386,4731,10960
160,20,-40,2361,2371,4732,11162
-30,0,140,2378,2354,4732,11090
-170,-40,-50,2379,2354,4733,11049
90,-50,-50,2391,2343,4734,11022
-20,-40,140,2383,2351,4734,10577
160,0,40,2363,2372,4735,10714
110,-40,-20,2384,2352,4736,11141
130,20,0,2347,2389,4736,10811
110,60,90,2377,2359,4736,10863
-140,-30,10,2385,2352,4737,11117
150,-60,30,2383,2354,4737,11049
-160,0,-50,2379,2358,4737,11088
10,0,150,2386,2352,4738,10556
10,70,130,2390,2348,4738,10924
170,30,40,2396,2343,4739,10815
160,-20,50,2384,2355,4739,10970
-60,30,-160,2396,2345,4741,11078
-170,40,-50,2366,2375,4741,11032
-160,0,30,2405,2336,4741,11052
150,20,50,2356,2385,4741,11182
-20,-40,-130,2367,2374,4741,10984
-160,50,10,2406,2336,4742,10797
-20,10,140,2365,2378,4743,10928
-30,20,150,2404,2339,4743,10927
-40,50,-100,2366,2377,4743,11018
-90,-80,60,2346,2397,4743,10918
160,-70,-70,2374,2369,4743,11187
-50,30,180,2392,2351,4743,10774
-50,30,-180,2392,2351,4743,10774
-60,-60,180,2380,2364,4744,10819
60,-70,-150,2380,2364,4744,10966
-60,-60,-180,2380,2364,4744,10819
-90,50,-90,2375,2370,4745,11230
120,-70,0,2361,2384,4745,11198
-70,50,-150,2388,2358,4746,10705
-110,50,-70,2384,2362,4746,11326
30,-60,-90,2378,2368,4746,11167
30,50,120,2384,2363,4747,10993
150,-10,-50,2357,2390,4747,11122
140,-40,20,2360,2387,4747,10947
130,10,30,2405,2343,4748,11157
140,-40,-70,2398,2350,4748,10850
140,40,-10,2373,2376,4749,11303
170,20,40,2395,2356,4751,10642
-160,20,0,2383,2368,4751,10710
10,0,-110,2340,2412,4752,11156
100,80,50,2378,2374,4752,10602
-90,-50,110,2377,2376,4753,11000
130,-10,-40,2344,2409,4753,10544
-150,40,-20,2401,2352,4753,10884
-70,80,-150,2385,2369,4754,11140
-160,40,0,2390,2364,4754,10939
-150,10,-40,2362,2392,4754,10866
-130,-70,10,2369,2386,4755,10864
10,-80,160,2382,2373,4755,11055
-80,-60,150,2374,2382,4756,10609
-130,-60,90,2408,2349,4757,10777
-70,70,-80,2387,2371,4758,11105
10,60,-140,2415,2343,4758,11316
140,50,0,2370,2388,4758,10913
-20,-30,-130,2361,2397,4758,11041
-40,10,-140,2364,2395,4759,10914
80,60,80,2405,2354,4759,11193
-150,30,-50,2401,2358,4759,10746
-50,80,-170,2375,2385,4760,11250
-110,-60,110,2388,2372,4760,10857
110,-80,-10,2394,2367,4761,11094
100,50,80,2388,2373,4761,11144
100,-60,-110,2410,2351,4761,10687
-90,-80,150,2394,2367,4761,10994
140,-50,20,2365,2396,4761,11038
40,30,150,2383,2378,4761,10780
130,-50,-80,2392,2370,4762,10560
-140,80,0,2395,2367,4762,11345
-160,60,-50,2397,2365,4762,10684
170,0,50,2382,2380,4762,10804
90,-40,-70,2372,2391,4763,11019
-110,60,-80,2412,2351,4763,10992
-60,80,-160,2390,2373,4763,11186
-90,-50,80,2379,2384,4763,10834
-170,-50,-50,2350,2413,4763,11118
-110,-50,60,2374,2389,4763,11031
-100,50,-80,2398,2368,4766,11489
-100,60,-120,2367,2399,4766,11310
-140,70,-10,2412,2354,4766,11228
110,-40,-40,2403,2364,4767,10983
150,60,60,2402,2365,4767,10967
100,-80,-20,2392,2375,4767,11185
-160,-50,60,2402,2365,4767,10902
140,-30,20,2392,2376,4768,10910
-170,-30,-50,2412,2357,4769,11077
-130,-60,10,2418,2351,4769,10925
130,50,70,2392,2377,4769,11192
-50,60,-100,2433,2336,4769,11296
-40,80,-100,2404,2365,4769,11104
-130,-50,60,2414,2356,4770,10946
-150,-30,10,2428,2342,4770,10790
50,-50,-80,2366,2404,4770,11249
170,10,40,2389,2382,4771,10773
-180,60,40,2411,2360,4771,11309
180,60,40,2411,2360,4771,11309
160,-30,-60,2380,2392,4772,10997
-150,60,-50,2401,2371,4772,10868
-160,70,20,2395,2377,4772,11340
150,0,40,2378,2394,4772,11108
130,0,20,2383,2390,4773,11144
0,-10,150,2378,2395,4773,10692
-90,-50,100,2398,2375,4773,11028
-150,-20,0,2455,2318,4773,10692
-130,60,-60,2432,2341,4773,11047
-90,-50,90,2376,2397,4773,11036
-110,60,-100,2390,2384,4774,10936
40,70,110,2379,2395,4774,11044
-140,-20,-20,2427,2348,4775,11149
-150,20,-20,2404,2371,4775,10925
-60,40,-110,2426,2350,4776,11222
-30,-70,130,2406,2370,4776,10982
170,-20,50,2372,2404,4776,11042
110,80,40,2386,2390,4776,10712
-50,-10,140,2376,2400,4776,11031
80,60,110,2403,2374,4777,11034
150,-50,-70,2409,2368,4777,10804
-70,-70,170,2379,2398,4777,11071
100,-30,-80,2381,2397,4778,11192
-100,-80,50,2366,2412,4778,11019
-150,70,-60,2382,2396,4778,10866
-170,-80,-30,2394,2385,4779,11033
-130,60,-40,2412,2368,4780,11107
-10,40,140,2390,2390,4780,10865
-50,0,170,2417,2363,4780,11151
70,60,130,2402,2378,4780,11202
-150,50,-20,2430,2350,4780,11087
-80,50,-90,2421,2360,4781,11100
-50,-70,110,2392,2390,4782,10871
-20,30,-110,2387,2395,4782,11097
-150,30,-30,2389,2394,4783,11211
-110,70,-110,2407,2377,4784,11116
150,60,-10,2384,2400,4784,11026
-40,40,170,2409,2375,4784,10917
110,-40,-30,2422,2362,4784,11040
-90,80,-60,2405,2380,4785,11131
150,-50,30,2375,2410,4785,11192
-20,80,160,2400,2385,4785,11113
-50,-40,120,2391,2394,4785,10976
-60,30,-140,2409,2376,4785,10809
20,-50,-100,2400,2386,4786,11347
-80,-60,80,2419,2367,4786,10880
-140,70,-70,2388,2398,4786,10888
80,-40,-80,2385,2401,4786,11043
50,50,130,2390,2396,4786,10680
0,70,140,2411,2375,4786,11077
170,0,40,2399,2388,4787,10887
80,-50,-70,2437,2350,4787,10866
180,0,40,2431,2357,4788,10779
-40,-70,120,2404,2384,4788,10874
-170,60,30,2410,2378,4788,11370
10,60,130,2415,2373,4788,11130
40,-80,-170,2376,2412,4788,11195
-180,0,40,2431,2357,4788,10779
-90,50,-110,2417,2371,4788,11100
10,-80,-110,2413,2376,4789,11107
-50,20,180,2421,2369,4790,10954
-50,20,-180,2421,2369,4790,10954
110,-70,-110,2354,2436,4790,11273
100,-80,-120,2391,2399,4790,11208
-170,-70,-40,2389,2402,4791,11091
90,-30,-90,2396,2395,4791,11297
-100,80,-50,2402,2389,4791,11171
140,-10,30,2391,2401,4792,11139
-30,60,-100,2381,2411,4792,11359
170,-40,50,2408,2384,4792,11242
-50,50,-100,2410,2382,4792,11400
-150,-50,60,2442,2351,4793,10848
100,-40,-60,2447,2346,4793,11078
130,10,-10,2363,2430,4793,11116
-150,60,-10,2421,2372,4793,11319
160,10,40,2405,2388,4793,10949
20,-80,170,2397,2397,4794,11086
130,-10,-20,2380,2414,4794,11029
20,20,140,2401,2393,4794,10825
-10,0,140,2418,2376,4794,10936
10,40,130,2390,2405,4795,11026
-10,40,-110,2384,2411,4795,11402
-40,80,180,2405,2391,4796,11333
-40,80,-180,2405,2391,4796,11333
-80,80,-70,2408,2388,4796,11265
160,-50,40,2414,2382,4796,11384
-90,50,-120,2418,2379,4797,11160
90,60,100,2428,2369,4797,11019
-50,30,-130,2390,2407,4797,11231
60,-80,-60,2424,2373,4797,11088
-70,-30,140,2418,2379,4797,11478
170,10,-50,2408,2389,4797,10967
-20,-60,140,2444,2354,4798,10965
20,-80,-100,2416,2382,4798,11101
-70,-40,110,2395,2404,4799,11217
-50,40,-110,2433,2366,4799,11423
120,40,40,2376,2424,4800,11199
40,40,170,2420,2380,4800,10860
-150,10,-20,2425,2375,4800,10993
50,-70,-70,2421,2379,4800,11509
30,-80,-180,2382,2419,4801,11137
-110,-70,40,2389,2412,4801,11173
30,-80,-90,2418,2383,4801,11110
30,-80,180,2382,2419,4801,11137
-80,-80,160,2416,2385,4801,11103
160,0,50,2403,2399,4802,11230
100,-50,-30,2417,2385,4802,11222
-140,50,-50,2437,2365,4802,11333
20,20,-120,2398,2405,4803,11251
20,10,150,2435,2368,4803,10915
80,-70,-40,2397,2406,4803,11247
70,-70,-50,2409,2394,4803,11186
40,80,110,2403,2401,4804,10815
-80,-40,130,2398,2406,4804,11405
90,-80,-30,2421,2383,4804,11163
-80,50,-100,2420,2385,4805,11356
-80,-40,120,2394,2411,4805,11258
-80,60,-80,2434,2371,4805,11446
170,-30,50,2419,2386,4805,11160
-160,20,-10,2424,2382,4806,10860
-120,80,-30,2423,2383,4806,11183
30,-10,-110,2381,2426,4807,11650
120,-30,-10,2403,2404,4807,11296
160,-60,-70,2383,2425,4808,11302
-30,60,-110,2422,2386,4808,11273
-110,80,-40,2411,2397,4808,11149
170,-10,50,2387,2422,4809,11153
20,-10,160,2411,2398,4809,10787
40,40,140,2422,2387,4809,10956
-30,-90,-150,2424,2386,4810,11102
110,-90,-10,2424,2386,4810,11102
-60,-90,-180,2424,2386,4810,11102
-60,-90,180,2424,2386,4810,11102
100,-90,-20,2424,2386,4810,11102
-140,-90,100,2424,2386,4810,11102
-90,-90,150,2424,2386,4810,11102
140,-90,20,2424,2386,4810,11102
-130,-90,110,2424,2386,4810,11102
-160,-90,80,2424,2386,4810,11102
50,-90,-70,2424,2386,4810,11102
-170,-30,40,2435,2375,4810,10880
40,-90,-80,2424,2386,4810,11102
-150,-90,90,2424,2386,4810,11102
20,-90,-100,2424,2386,4810,11102
160,-90,40,2424,2386,4810,11102
-70,-90,170,2424,2386,4810,11102
-50,-90,-170,2424,2386,4810,11102
30,-90,-90,2424,2386,4810,11102
60,-90,-60,2424,2386,4810,11102
80,-90,-40,2424,2386,4810,11102
-10,-90,-130,2424,2386,4810,11102
-20,-90,-140,2424,2386,4810,11102
90,-90,-30,2424,2386,4810,11102
130,-90,10,2424,2386,4810,11102
10,-90,-110,2424,2386,4810,11102
-40,-90,-160,2424,2386,4810,11102
170,-90,50,2424,2386,4810,11102
-180,-90,60,2424,2386,4810,11102
-120,-90,120,2424,2386,4810,11102
0,-90,-120,2424,2386,4810,11102
-100,-90,140,2424,2386,4810,11102
-110,-90,130,2424,2386,4810,11102
180,-90,60,2424,2386,4810,11102
70,-90,-50,2424,2386,4810,11102
120,-90,0,2424,2386,4810,11102
150,-90,30,2424,2386,4810,11102
-100,60,-90,2408,2402,4810,11247
-80,-90,160,2424,2386,4810,11102
-170,-90,70,2424,2386,4810,11102
130,70,20,2384,2427,4811,10845
-70,40,-130,2433,2378,4811,11302
40,-80,-80,2414,2398,4812,11143
120,40,70,2406,2406,4812,11706
-160,-60,70,2403,2409,4812,10956
70,-70,-140,2432,2381,4813,11176
20,-60,-100,2411,2402,4813,11303
130,-30,-70,2404,2410,4814,11131
80,-30,-100,2415,2399,4814,11315
-60,70,-90,2399,2416,4815,11226
-10,-40,150,2420,2395,4815,10715
-30,80,170,2421,2394,4815,11167
-140,-40,30,2455,2361,4816,10852
130,-30,10,2387,2429,4816,11271
-160,30,20,2431,2385,4816,11155
-50,-10,-160,2421,2395,4816,11080
-130,80,-20,2417,2400,4817,11351
50,-40,-150,2432,2385,4817,10961
50,50,140,2396,2421,4817,10767
-120,60,-50,2420,2397,4817,11427
-30,70,-110,2427,2391,4818,11494
50,-80,-70,2419,2399,4818,11107
-60,-30,130,2418,2400,4818,11175
-100,70,-120,2417,2402,4819,11279
180,-80,-40,2398,2421,4819,11174
40,-70,-80,2424,2395,4819,11507
-40,20,-130,2402,2417,4819,11135
-180,-80,-40,2398,2421,4819,11174
180,40,-40,2421,2399,4820,11102
-180,40,-40,2421,2399,4820,11102
150,-40,30,2375,2445,4820,11041
150,10,40,2406,2414,4820,11157
60,-70,-60,2439,2382,4821,11464
170,40,40,2440,2381,4821,11260
-150,80,10,2421,2400,4821,11543
-180,-30,50,2416,2405,4821,11023
90,-70,-30,2387,2434,4821,11449
180,-30,50,2416,2405,4821,11023
-150,30,-40,2456,2365,4821,11262
140,40,60,2422,2399,4821,11379
50,70,170,2442,2380,4822,11215
-120,50,-60,2441,2381,4822,11279
170,-70,-60,2409,2414,4823,11279
40,10,-150,2426,2397,4823,11215
-180,60,-40,2411,2414,4825,11084
-50,10,-180,2479,2346,4825,11356
110,50,80,2431,2394,4825,11296
-120,-60,90,2483,2342,4825,10960
180,60,-40,2411,2414,4825,11084
-150,40,-30,2430,2395,4825,11262
70,-40,-90,2402,2423,4825,10974
-110,60,-90,2430,2395,4825,11052
-50,10,180,2479,2346,4825,11356
-70,-30,130,2440,2385,4825,11477
-50,70,-100,2398,2428,4826,11294
120,80,30,2405,2421,4826,10800
-40,-30,130,2416,2411,4827,11302
70,-80,-50,2431,2397,4828,11176
70,60,120,2421,2408,4829,11183
70,-40,-130,2415,2414,4829,10981
180,30,-50,2428,2402,4830,11227
-60,-70,100,2425,2405,4830,11003
-180,30,-50,2428,2402,4830,11227
80,-80,-40,2435,2396,4831,11170
150,30,50,2438,2393,4831,11073
-20,-20,-130,2403,2428,4831,11137
130,60,20,2398,2433,4831,11145
100,-70,-20,2393,2438,4831,11463
-140,-60,80,2426,2406,4832,11043
130,50,20,2388,2444,4832,11229
-90,-60,70,2439,2393,4832,11131
-20,0,140,2410,2422,4832,11257
-30,80,-110,2434,2399,4833,11271
-160,80,20,2418,2415,4833,11548
130,30,60,2403,2430,4833,11403
-130,-50,50,2438,2395,4833,11272
-110,-60,100,2443,2390,4833,10981
110,-70,-10,2392,2442,4834,11362
-60,-30,150,2455,2380,4835,11312
-50,-10,160,2450,2385,4835,11255
90,60,70,2436,2399,4835,11281
-30,30,-110,2391,2444,4835,11156
-170,-20,-50,2432,2403,4835,11209
130,40,10,2429,2407,4836,10992
-10,-80,150,2422,2415,4837,11039
70,60,90,2437,2400,4837,11148
-10,30,140,2416,2421,4837,10983
-50,10,-150,2436,2401,4837,11129
-20,-10,140,2436,2402,4838,11034
100,50,70,2410,2428,4838,11447
-70,80,-80,2427,2411,4838,11343
-130,70,-80,2428,2410,4838,10980
-100,-60,120,2422,2417,4839,11018
-160,30,-50,2424,2415,4839,10806
30,80,120,2436,2404,4840,11028
110,-80,-110,2405,2435,4840,11478
-10,-20,-120,2394,2446,4840,11346
50,-40,-100,2442,2398,4840,11124
100,-50,-40,2459,2382,4841,11220
120,80,100,2454,2387,4841,11219
0,-80,-120,2438,2403,4841,11158
-120,-50,40,2380,2462,4842,11248
-80,50,-110,2424,2419,4843,11296
-40,30,-120,2434,2409,4843,11360
140,-60,-80,2435,2410,4845,11341
100,-50,-50,2438,2407,4845,10978
120,60,80,2418,2428,4846,11183
-180,-70,-50,2413,2433,4846,11271
180,-70,-50,2413,2433,4846,11271
150,-20,40,2423,2423,4846,11491
-10,-10,150,2420,2427,4847,10884
130,80,90,2454,2393,4847,11161
-70,-50,150,2405,2443,4848,11079
-10,70,150,2438,2410,4848,11216
-110,-80,40,2415,2433,4848,11125
-110,70,-50,2443,2406,4849,11378
0,10,140,2420,2430,4850,11205
-80,-50,100,2422,2429,4851,11213
-160,60,10,2414,2437,4851,11244
110,80,110,2451,2400,4851,11313
-170,70,30,2426,2427,4853,11537
-90,60,-130,2406,2448,4854,11396
-140,-50,50,2460,2395,4855,11018
50,-10,-150,2401,2454,4855,11534
-20,80,-120,2449,2407,4856,11480
-60,-50,170,2410,2446,4856,11029
130,80,20,2423,2433,4856,10966
-10,-30,150,2452,2404,4856,10795
110,-30,-80,2423,2437,4860,11481
-80,-50,90,2443,2417,4860,11246
170,70,50,2434,2426,4860,11623
-150,-10,-10,2476,2384,4860,11074
-10,60,-130,2472,2388,4860,11435
-150,-40,30,2470,2391,4861,11057
140,20,50,2422,2439,4861,11502
0,-80,160,2440,2421,4861,11013
0,80,-140,2459,2402,4861,11543
160,60,-20,2427,2434,4861,11260
50,-80,-160,2405,2457,4862,11293
-20,60,-120,2492,2370,4862,11325
-150,90,10,2469,2394,4863,11412
0,90,-140,2469,2394,4863,11412
90,90,130,2469,2394,4863,11412
-160,90,20,2469,2394,4863,11412
10,90,-150,2469,2394,4863,11412
160,90,60,2469,2394,4863,11412
20,90,-160,2469,2394,4863,11412
-140,90,0,2469,2394,4863,11412
-40,90,-100,2469,2394,4863,11412
80,90,140,2469,2394,4863,11412
-30,90,-110,2469,2394,4863,11412
120,90,100,2469,2394,4863,11412
-170,90,30,2469,2394,4863,11412
50,90,170,2469,2394,4863,11412
-20,90,-120,2469,2394,4863,11412
60,90,160,2469,2394,4863,11412
-60,90,-80,2469,2394,4863,11412
-130,90,-10,2469,2394,4863,11412
-10,90,-130,2469,2394,4863,11412
40,90,-180,2469,2394,4863,11412
150,90,70,2469,2394,4863,11412
-110,90,-30,2469,2394,4863,11412
-100,90,-40,2469,2394,4863,11412
140,90,80,2469,2394,4863,11412
-90,90,-50,2469,2394,4863,11412
180,90,40,2469,2394,4863,11412
70,90,150,2469,2394,4863,11412
-180,90,40,2469,2394,4863,11412
30,90,-170,2469,2394,4863,11412
-50,90,-90,2469,2394,4863,11412
40,90,180,2469,2394,4863,11412
-70,90,-70,2469,2394,4863,11412
-80,90,-60,2469,2394,4863,11412
110,90,110,2469,2394,4863,11412
130,90,90,2469,2394,4863,11412
100,90,120,2469,2394,4863,11412
170,90,50,2469,2394,4863,11412
-120,90,-20,2469,2394,4863,11412
30,-70,-90,2470,2394,4864,11368
-60,80,-90,2436,2428,4864,11482
-120,-60,30,2419,2446,4865,11305
-150,-50,-30,2444,2421,4865,11399
-10,80,-130,2448,2417,4865,11493
-130,70,-30,2423,2443,4866,11269
70,-50,-80,2483,2384,4867,11230
-130,-60,80,2470,2397,4867,11072
-30,40,160,2439,2428,4867,11190
170,-80,-50,2421,2446,4867,11285
-160,-50,-40,2428,2439,4867,11429
-70,-60,160,2415,2453,4868,11019
110,70,100,2442,2426,4868,11395
-150,10,-30,2411,2457,4868,10961
-20,-80,140,2437,2431,4868,11140
-160,-20,30,2436,2432,4868,11341
130,10,20,2423,2445,4868,11262
-120,-90,30,2438,2431,4869,11275
-20,-90,130,2438,2431,4869,11275
-150,-90,0,2438,2431,4869,11275
20,-90,170,2438,2431,4869,11275
-170,-90,-20,2438,2431,4869,11275
140,80,10,2427,2442,4869,11200
-30,-90,120,2438,2431,4869,11275
170,-90,-40,2438,2431,4869,11275
0,-90,150,2438,2431,4869,11275
-40,-90,110,2438,2431,4869,11275
-10,-90,140,2438,2431,4869,11275
130,-90,-80,2438,2431,4869,11275
110,-90,-100,2438,2431,4869,11275
80,-90,-130,2438,2431,4869,11275
-70,-90,80,2438,2431,4869,11275
-80,-90,70,2438,2431,4869,11275
-110,-90,40,2438,2431,4869,11275
30,-90,180,2438,2431,4869,11275
70,-90,-140,2438,2431,4869,11275
10,-90,160,2438,2431,4869,11275
60,-90,-150,2438,2431,4869,11275
180,-90,-30,2438,2431,4869,11275
120,-90,-90,2438,2431,4869,11275
150,-90,-60,2438,2431,4869,11275
160,-90,-50,2438,2431,4869,11275
30,-90,-180,2438,2431,4869,11275
-70,-80,170,2457,2412,4869,11251
-50,-90,100,2438,2431,4869,11275
90,-90,-120,2438,2431,4869,11275
-100,-90,50,2438,2431,4869,11275
-130,-90,20,2438,2431,4869,11275
50,-90,-160,2438,2431,4869,11275
-60,-90,90,2438,2431,4869,11275
-140,-90,10,2438,2431,4869,11275
-160,-90,-10,2438,2431,4869,11275
100,-90,-110,2438,2431,4869,11275
140,-90,-70,2438,2431,4869,11275
40,-90,-170,2438,2431,4869,11275
-90,-90,60,2438,2431,4869,11275
-180,-90,-30,2438,2431,4869,11275
140,70,10,2458,2412,4870,11078
90,80,130,2456,2414,4870,11397
-70,40,-140,2427,2444,4871,11241
-100,70,-60,2455,2416,4871,11466
-160,20,-50,2462,2409,4871,11213
-140,-70,0,2436,2435,4871,11193
-60,-20,140,2447,2424,4871,11788
-70,-70,90,2421,2450,4871,11179
90,60,90,2434,2438,4872,11230
10,-30,160,2475,2397,4872,11108
-130,-50,10,2445,2428,4873,11379
120,-30,-30,2447,2426,4873,11136
-140,80,-10,2441,2433,4874,11493
-150,70,0,2440,2434,4874,11385
40,-40,-100,2460,2414,4874,11389
40,40,160,2470,2404,4874,11137
-30,-50,-140,2446,2429,4875,11626
10,-30,-110,2422,2453,4875,11596
-140,60,-30,2446,2429,4875,11388
150,40,-20,2415,2460,4875,11406
-70,-50,100,2451,2425,4876,11248
80,60,100,2417,2460,4877,11121
-140,-40,-20,2443,2434,4877,11411
160,-40,-60,2430,2448,4878,11253
-140,60,-50,2462,2416,4878,11328
-160,70,-50,2428,2450,4878,11015
-120,-50,50,2433,2445,4878,11221
10,40,-120,2460,2419,4879,11800
60,60,140,2440,2439,4879,11282
-170,80,30,2438,2441,4879,11548
-70,60,-90,2453,2426,4879,11642
0,60,-130,2479,2401,4880,11653
40,60,-180,2435,2445,4880,11361
-60,50,-160,2446,2434,4880,11119
100,80,120,2461,2419,4880,11379
40,60,180,2435,2445,4880,11361
-50,-10,150,2469,2411,4880,11367
-120,70,-40,2456,2424,4880,11378
-150,-50,50,2479,2401,4880,11039
-60,50,-100,2475,2406,4881,11839
80,80,140,2475,2407,4882,11399
-160,-40,40,2490,2392,4882,10895
150,-10,40,2456,2426,4882,11610
-170,40,30,2442,2441,4883,11455
160,-80,-60,2430,2453,4883,11502
150,80,0,2443,2440,4883,11338
100,70,110,2438,2446,4884,11477
-20,70,-120,2474,2410,4884,11663
-160,-10,30,2467,2417,4884,11272
10,-70,-110,2488,2396,4884,11281
-170,40,-40,2489,2396,4885,11295
-10,20,140,2432,2453,4885,11250
-120,70,-90,2418,2468,4886,11133
-30,-80,130,2449,2437,4886,11102
160,80,-10,2448,2439,4887,11356
-130,50,-50,2460,2427,4887,11487
-10,10,140,2442,2446,4888,11475
-40,-80,120,2446,2442,4888,11044
-180,70,40,2445,2444,4889,11608
100,60,90,2452,2437,4889,11337
180,70,40,2445,2444,4889,11608
-40,40,-110,2473,2417,4890,11387
40,10,-160,2431,2459,4890,11139
130,20,40,2471,2420,4891,11642
130,10,0,2409,2482,4891,11457
-160,10,0,2475,2416,4891,11121
20,-70,-100,2482,2409,4891,11442
120,-40,-80,2422,2470,4892,11186
-160,30,-10,2488,2404,4892,11170
-50,-80,110,2443,2449,4892,11146
-160,40,-30,2464,2428,4892,11299
40,70,180,2505,2388,4893,11400
40,70,-180,2505,2388,4893,11400
-90,70,-130,2450,2444,4894,11451
110,-30,-60,2437,2457,4894,11108
-50,90,-160,2475,2420,4895,11057
170,90,-20,2475,2420,4895,11057
-70,90,-140,2475,2420,4895,11057
140,90,10,2475,2420,4895,11057
70,90,80,2475,2420,4895,11057
-30,90,180,2475,2420,4895,11057
130,90,20,2475,2420,4895,11057
-120,90,-90,2475,2420,4895,11057
-40,90,-170,2475,2420,4895,11057
-150,90,-60,2475,2420,4895,11057
90,90,60,2475,2420,4895,11057
-90,90,-120,2475,2420,4895,11057
160,90,-10,2475,2420,4895,11057
-110,90,-100,2475,2420,4895,11057
180,90,-30,2475,2420,4895,11057
-180,90,-30,2475,2420,4895,11057
-10,90,160,2475,2420,4895,11057
40,90,110,2475,2420,4895,11057
110,90,40,2475,2420,4895,11057
80,90,70,2475,2420,4895,11057
30,90,120,2475,2420,4895,11057
100,90,50,2475,2420,4895,11057
-80,90,-130,2475,2420,4895,11057
-100,90,-110,2475,2420,4895,11057
-140,90,-70,2475,2420,4895,11057
0,90,150,2475,2420,4895,11057
150,90,0,2475,2420,4895,11057
20,90,130,2475,2420,4895,11057
120,90,30,2475,2420,4895,11057
10,90,140,2475,2420,4895,11057
-30,90,-180,2475,2420,4895,11057
50,90,100,2475,2420,4895,11057
-160,90,-50,2475,2420,4895,11057
60,90,90,2475,2420,4895,11057
-130,90,-80,2475,2420,4895,11057
-170,90,-40,2475,2420,4895,11057
-20,90,170,2475,2420,4895,11057
-60,90,-150,2475,2420,4895,11057
-60,40,-160,2454,2442,4896,11217
20,40,-140,2462,2434,4896,11546
60,-20,-120,2463,2433,4896,11301
10,80,-150,2476,2421,4897,11552
-180,-10,40,2472,2425,4897,11054
180,-10,40,2472,2425,4897,11054
-20,-70,140,2462,2435,4897,11244
180,-40,50,2478,2420,4898,11117
-180,-40,50,2478,2420,4898,11117
-10,-80,-130,2458,2440,4898,11190
60,-40,-100,2483,2415,4898,11234
120,-80,-100,2427,2471,4898,11662
60,60,100,2486,2413,4899,11388
-160,10,-50,2446,2454,4900,11523
90,70,120,2471,2429,4900,11464
-160,20,10,2500,2400,4900,11190
-40,60,-110,2473,2428,4901,11399
-30,20,-120,2473,2428,4901,11346
170,0,-50,2463,2438,4901,11700
-110,60,-60,2472,2429,4901,11658
-30,-10,140,2478,2424,4902,11361
-100,-60,60,2462,2440,4902,11419
-170,60,-40,2450,2453,4903,11108
130,30,10,2429,2474,4903,11396
-140,-20,-10,2500,2403,4903,11502
10,-10,-110,2436,2468,4904,11568
0,0,150,2455,2449,4904,10927
-160,40,-40,2503,2401,4904,11383
-60,-40,160,2475,2429,4904,11159
40,50,120,2468,2437,4905,11225
150,0,-40,2450,2455,4905,11479
10,-80,170,2446,2459,4905,11138
40,-30,-110,2458,2447,4905,11343
130,20,30,2453,2454,4907,11475
130,20,10,2434,2473,4907,11191
10,50,130,2475,2432,4907,11425
-140,70,-20,2472,2436,4908,11374
10,-60,-110,2451,2457,4908,11383
170,-50,-60,2435,2473,4908,11646
-150,80,-60,2455,2453,4908,11047
120,70,90,2454,2454,4908,11414
-60,-80,100,2452,2457,4909,11235
-100,-60,110,2482,2427,4909,11310
-150,-60,-20,2449,2460,4909,11433
-70,-40,120,2467,2442,4909,11592
-110,80,-100,2450,2460,4910,11122
-100,60,-110,2462,2448,4910,11436
150,40,50,2454,2457,4911,11401
-170,-40,50,2490,2421,4911,11276
110,-60,-100,2466,2445,4911,11169
150,-80,-70,2445,2466,4911,11578
20,80,-160,2509,2403,4912,11526
-130,80,-80,2439,2473,4912,11083
70,80,150,2486,2426,4912,11456
40,50,170,2468,2445,4913,11620
-50,-50,120,2462,2451,4913,11429
-120,-80,30,2458,2455,4913,11271
-170,80,-40,2449,2464,4913,11251
-40,70,-110,2463,2451,4914,11469
-160,20,-30,2494,2421,4915,11371
-50,0,-180,2477,2438,4915,11319
170,80,-20,2464,2451,4915,11395
-50,0,180,2477,2438,4915,11319
-160,50,0,2449,2466,4915,11495
150,50,-10,2459,2457,4916,11374
170,-10,40,2447,2469,4916,11081
-60,40,-120,2478,2439,4917,11562
60,-30,-140,2490,2427,4917,11537
70,60,110,2435,2482,4917,11293
-10,50,-110,2490,2427,4917,11990
160,-40,40,2447,2470,4917,11472
-60,-70,180,2467,2451,4918,11322
-150,0,-20,2496,2422,4918,11185
-140,50,-40,2484,2434,4918,11471
-170,70,-40,2454,2464,4918,11217
-50,-30,130,2476,2442,4918,11480
-60,-70,-180,2467,2451,4918,11322
-90,80,-120,2452,2466,4918,11223
140,80,80,2475,2444,4919,11378
-170,40,-30,2466,2453,4919,11414
160,-10,40,2432,2488,4920,11116
120,-70,-100,2437,2483,4920,11664
-160,80,-50,2464,2456,4920,11162
20,80,130,2465,2455,4920,11208
-40,-40,130,2461,2459,4920,11327
-20,50,-110,2447,2474,4921,11705
80,70,130,2485,2436,4921,11671
10,-20,-110,2449,2472,4921,11756
60,-80,-150,2448,2474,4922,11461
-140,80,-70,2453,2469,4922,11043
140,-80,-80,2438,2484,4922,11577
-80,70,-140,2471,2451,4922,11495
130,-80,-90,2447,2476,4923,11690
-180,80,-30,2466,2457,4923,11393
180,80,-30,2466,2457,4923,11393
30,80,-170,2505,2419,4924,11568
-40,20,160,2468,2456,4924,11551
30,20,-140,2472,2453,4925,11663
130,-20,10,2450,2475,4925,11519
-90,70,-70,2481,2444,4925,11663
70,-80,-140,2463,2462,4925,11476
-150,-50,40,2503,2422,4925,11342
50,60,160,2472,2454,4926,11486
-160,-30,30,2478,2448,4926,11364
-110,-60,90,2492,2435,4927,11120
-50,-30,-170,2493,2434,4927,11764
60,-40,-140,2517,2412,4929,11470
-10,-20,150,2452,2477,4929,10838
-70,70,-150,2459,2470,4929,11405
-170,50,-30,2452,2477,4929,11249
110,50,50,2457,2473,4930,11515
180,80,40,2460,2471,4931,11671
40,40,150,2491,2440,4931,10934
-180,80,40,2460,2471,4931,11671
-20,70,160,2452,2479,4931,11358
150,-30,-60,2467,2465,4932,11371
140,10,40,2436,2497,4933,11583
-60,-80,-180,2488,2445,4933,11552
-60,-80,180,2488,2445,4933,11552
70,-30,-120,2465,2469,4934,11622
-150,50,-40,2484,2450,4934,11563
-80,-50,130,2477,2459,4936,11368
-160,60,-40,2460,2477,4937,11434
40,0,-130,2496,2441,4937,11847
-50,-40,-170,2492,2445,4937,11497
10,-40,-110,2449,2488,4937,11740
-120,80,-90,2458,2480,4938,11148
130,0,-10,2451,2487,4938,11429
-80,60,-140,2466,2472,4938,11485
30,70,120,2471,2467,4938,11334
80,-70,-130,2459,2480,4939,11482
140,-20,20,2456,2483,4939,11574
60,80,160,2508,2431,4939,11555
-50,-10,170,2481,2458,4939,11504
-140,-30,-20,2488,2451,4939,11536
170,60,-30,2468,2473,4941,11414
10,50,-130,2504,2437,4941,11892
-170,-60,60,2496,2445,4941,11441
-140,-50,40,2518,2424,4942,11415
-160,20,20,2496,2446,4942,11491
-100,60,-70,2503,2439,4942,11723
-20,40,150,2498,2444,4942,11241
-20,-80,-140,2487,2456,4943,11362
-100,80,-110,2474,2469,4943,11279
-30,70,170,2453,2491,4944,11551
-150,50,-30,2458,2486,4944,11651
160,20,40,2476,2468,4944,11224
-80,-50,110,2473,2471,4944,11491
170,30,-40,2489,2456,4945,11614
-60,40,-130,2477,2468,4945,11361
120,-40,-10,2454,2492,4946,11573
150,70,0,2485,2463,4948,11305
130,40,60,2470,2478,4948,11744
130,60,70,2476,2472,4948,11534
140,50,60,2471,2477,4948,11572
-160,40,-10,2500,2448,4948,11350
-70,-80,90,2468,2480,4948,11376
10,-50,-110,2466,2482,4948,11740
-10,70,-130,2500,2449,4949,11596
-60,-50,110,2484,2466,4950,11363
50,80,170,2530,2420,4950,11520
40,80,180,2519,2432,4951,11574
40,80,-180,2519,2432,4951,11574
-20,30,150,2489,2462,4951,11355
-160,10,-10,2501,2450,4951,11188
-40,0,150,2503,2448,4951,11419
180,10,-50,2477,2475,4952,11596
-130,-50,20,2488,2464,4952,11365
-40,20,-140,2481,2471,4952,11488
-180,10,-50,2477,2475,4952,11596
30,-30,180,2484,2469,4953,11189
30,70,-170,2511,2442,4953,11561
60,-20,-130,2493,2460,4953,11696
30,-30,-180,2484,2469,4953,11189
-150,-40,20,2511,2443,4954,11209
130,10,10,2447,2507,4954,11422
30,-20,-110,2504,2450,4954,11540
-20,60,-110,2477,2478,4955,11731
-140,-50,-10,2494,2461,4955,11748
50,-50,-90,2528,2427,4955,11563
-160,30,-30,2527,2429,4956,11576
170,-60,-60,2463,2493,4956,11796
50,-30,-150,2535,2422,4957,11481
-160,20,-20,2504,2453,4957,11092
-80,-80,80,2471,2486,4957,11369
-10,-50,150,2501,2457,4958,11290
150,80,70,2473,2485,4958,11470
-130,-80,20,2481,2478,4959,11258
-50,0,-170,2502,2457,4959,11476
-160,40,-20,2500,2459,4959,11531
140,60,10,2483,2476,4959,11449
130,40,20,2462,2499,4961,11559
-20,40,-110,2456,2505,4961,11694
-50,80,-100,2487,2474,4961,11618
-180,20,-50,2468,2494,4962,11469
70,80,90,2479,2483,4962,11045
20,-80,180,2471,2491,4962,11193
120,50,70,2500,2462,4962,11640
-30,50,-110,2494,2468,4962,11837
180,20,-50,2468,2494,4962,11469
-80,80,-130,2465,2497,4962,11357
-150,80,0,2483,2479,4962,11728
20,-80,-180,2471,2491,4962,11193
-50,-20,170,2486,2476,4962,11375
120,-30,-20,2496,2467,4963,11650
150,-30,30,2482,2481,4963,11349
-160,70,10,2485,2478,4963,11711
-60,30,-150,2514,2449,4963,11577
130,70,80,2487,2477,4964,11492
-30,60,-120,2497,2467,4964,11318
50,-10,-130,2515,2449,4964,11317
-10,60,-120,2517,2447,4964,11999
0,70,-140,2531,2433,4964,11554
-140,-70,90,2493,2472,4965,11265
-120,-70,30,2490,2475,4965,11468
80,80,80,2468,2498,4966,11079
-30,-10,-140,2486,2480,4966,11219
20,-10,-110,2495,2471,4966,11691
40,-40,-160,2534,2433,4967,11312
-150,-70,-10,2496,2471,4967,11592
-100,60,-100,2483,2484,4967,11436
110,-30,-70,2475,2492,4967,11510
-120,-60,80,2520,2447,4967,11262
0,-70,-120,2516,2451,4967,11547
130,20,20,2464,2504,4968,11275
-80,-70,80,2472,2496,4968,11492
-40,50,-110,2540,2429,4969,11625
30,60,120,2502,2467,4969,11519
70,-30,-100,2496,2473,4969,11946
-40,-10,140,2464,2505,4969,11425
150,20,40,2485,2485,4970,11542
170,50,40,2493,2477,4970,11636
120,40,60,2493,2477,4970,11608
10,80,140,2494,2476,4970,11238
110,-50,-20,2487,2483,4970,11600
110,-40,-50,2523,2448,4971,11485
-50,-20,-170,2502,2469,4971,11410
160,-10,-50,2507,2464,4971,11675
150,10,-30,2481,2490,4971,11283
-70,-50,110,2492,2479,4971,11422
-70,60,-150,2491,2480,4971,11374
30,-30,-110,2495,2477,4972,11579
-140,-80,10,2482,2493,4975,11443
160,80,60,2472,2503,4975,11604
160,70,-10,2479,2496,4975,11267
-60,-40,120,2499,2476,4975,11864
-20,50,-120,2504,2471,4975,11632
-160,30,-40,2518,2458,4976,11623
-60,70,-160,2459,2517,4976,11578
0,60,-140,2519,2457,4976,11703
130,-20,-30,2484,2493,4977,11251
-140,-60,70,2509,2468,4977,11352
-110,70,-100,2474,2503,4977,11274
-30,40,-110,2482,2496,4978,11674
-170,-10,-50,2489,2489,4978,11584
90,-50,-110,2491,2489,4980,11401
70,-50,-130,2520,2460,4980,11399
60,-50,-140,2536,2444,4980,11237
130,-10,10,2445,2536,4981,11523
20,70,-160,2504,2477,4981,11542
160,60,50,2504,2477,4981,11626
80,-50,-120,2501,2480,4981,11526
90,80,70,2471,2510,4981,11158
-140,-30,0,2497,2484,4981,11783
170,80,50,2482,2500,4982,11705
-70,50,-110,2529,2453,4982,11848
-50,-50,-170,2519,2464,4983,11807
-90,60,-100,2492,2492,4984,11458
-50,-20,160,2549,2436,4985,11427
170,70,-20,2489,2497,4986,11390
-170,30,-50,2503,2483,4986,11486
-50,-10,180,2513,2473,4986,11596
-50,-10,-180,2513,2473,4986,11596
-120,-70,110,2488,2499,4987,11336
40,-10,-120,2494,2493,4987,11851
60,60,130,2497,2490,4987,11434
-60,80,-150,2496,2492,4988,11251
-30,10,-130,2509,2479,4988,11727
-70,-40,140,2499,2490,4989,11645
20,-20,-110,2510,2479,4989,11894
0,-50,-120,2511,2478,4989,11786
-120,60,-60,2514,2476,4990,11433
-40,30,170,2544,2446,4990,11333
100,60,60,2486,2504,4990,11594
30,30,-160,2524,2467,4991,11266
180,70,-30,2483,2508,4991,11275
-110,-70,120,2480,2511,4991,11391
0,60,140,2519,2472,4991,11471
-90,-60,130,2483,2508,4991,11358
-180,70,-30,2483,2508,4991,11275
-150,-40,10,2522,2470,4992,11442
60,70,100,2522,2470,4992,11319
10,70,-150,2533,2459,4992,11589
-80,70,-80,2507,2485,4992,11722
-60,60,-160,2504,2489,4993,11462
40,-20,-160,2528,2465,4993,11317
120,-30,-40,2497,2496,4993,11572
20,30,-130,2526,2468,4994,11761
-130,-70,100,2502,2493,4995,11367
130,-70,-90,2490,2506,4996,11883
-30,-80,-150,2506,2490,4996,11501
100,80,60,2486,2510,4996,11348
-180,-20,40,2508,2489,4997,11556
50,-50,-150,2530,2467,4997,11474
180,-20,40,2508,2489,4997,11556
30,-80,-170,2509,2489,4998,11297
-70,80,-140,2506,2492,4998,11334
160,30,-30,2506,2493,4999,11578
-40,-20,140,2500,2499,4999,11572
-40,70,-180,2489,2510,4999,11800
-50,80,-160,2493,2506,4999,11240
-40,70,180,2489,2510,4999,11800
50,-20,-150,2495,2504,4999,11558
160,30,40,2523,2476,4999,11554
-50,40,-120,2560,2439,4999,11649
-160,-60,-30,2508,2492,5000,11681
90,60,80,2484,2516,5000,11698
-40,-40,-150,2530,2470,5000,11695
-150,-60,70,2495,2505,5000,11595
30,0,-120,2495,2506,5001,11800
-160,10,10,2533,2469,5002,11547
-100,-60,100,2523,2479,5002,11346
80,-80,-130,2498,2504,5002,11689
-90,-80,70,2485,2518,5003,11460
-30,-40,140,2533,2470,5003,11301
-10,-70,-130,2507,2496,5003,11533
-150,0,-30,2512,2491,5003,11400
-50,-80,-170,2497,2506,5003,11624
30,60,-170,2507,2497,5004,11498
20,-30,170,2505,2499,5004,11520
-50,-10,-170,2551,2454,5005,11214
60,80,100,2514,2491,5005,11111
-150,-70,80,2493,2512,5005,11406
-180,-60,-50,2494,2512,5006,11863
-60,60,-100,2507,2499,5006,11955
-60,-40,150,2516,2490,5006,11370
180,-60,-50,2494,2512,5006,11863
0,80,150,2523,2483,5006,11354
-80,-50,120,2517,2489,5006,11560
-140,-40,20,2504,2502,5006,11512
-180,-50,50,2504,2503,5007,11327
180,-50,50,2504,2503,5007,11327
140,10,-20,2499,2508,5007,11730
110,80,50,2484,2523,5007,11444
40,50,130,2490,2518,5008,11576
60,-50,-90,2536,2472,5008,11421
-160,30,-20,2541,2467,5008,11497
130,30,20,2476,2532,5008,11657
-70,50,-100,2543,2466,5009,11788
70,60,100,2499,2510,5009,11577
-170,-60,-40,2492,2517,5009,11842
-130,60,-50,2504,2507,5011,11579
30,20,150,2515,2496,5011,11434
100,70,60,2490,2521,5011,11311
-130,-50,40,2529,2483,5012,11677
150,-20,30,2499,2513,5012,11534
120,-60,-90,2535,2477,5012,11527
40,-30,-160,2542,2470,5012,11616
-50,0,-160,2525,2488,5013,11610
-170,60,20,2517,2496,5013,11800
-30,-20,-140,2517,2497,5014,11628
-140,60,-40,2518,2496,5014,11569
-50,50,-110,2549,2466,5015,11709
50,-30,-110,2479,2537,5016,11746
-20,-10,-130,2502,2514,5016,11522
30,50,-170,2517,2499,5016,11643
30,-10,170,2509,2508,5017,11697
-150,-80,0,2521,2496,5017,11543
-160,50,-30,2511,2506,5017,11478
80,-60,-50,2502,2516,5018,11626
-170,50,20,2532,2487,5019,11643
30,-20,-120,2518,2502,5020,11726
-10,-60,150,2531,2489,5020,11528
-60,-40,130,2550,2470,5020,11727
-150,60,-20,2523,2497,5020,11718
-160,-70,70,2528,2492,5020,11410
-50,20,-170,2507,2514,5021,11673
-160,-40,30,2552,2470,5022,11429
-150,-10,-30,2525,2497,5022,11415
-30,70,-120,2519,2503,5022,11956
-170,20,-50,2523,2499,5022,11610
-130,70,-70,2519,2504,5023,11501
-10,0,150,2558,2465,5023,11363
-110,60,-70,2534,2490,5024,11482
-50,10,-170,2543,2481,5024,11910
10,-20,160,2554,2470,5024,11238
80,60,90,2502,2522,5024,11614
-10,-70,150,2530,2494,5024,11275
-30,80,-180,2519,2507,5026,11429
130,0,10,2468,2558,5026,11499
-30,30,-120,2537,2489,5026,11840
-30,80,180,2519,2507,5026,11429
140,-10,-40,2519,2507,5026,11379
-30,0,-140,2501,2525,5026,11401
-30,10,150,2526,2501,5027,11500
-160,0,0,2543,2484,5027,11547
-170,-70,60,2499,2529,5028,11458
-60,-30,140,2553,2475,5028,11961
60,60,120,2517,2512,5029,11402
180,60,-30,2518,2512,5030,11585
160,50,-20,2508,2522,5030,11882
-180,60,-30,2518,2512,5030,11585
-110,90,-90,2528,2503,5031,11236
-10,90,170,2528,2503,5031,11236
-180,90,-20,2528,2503,5031,11236
110,90,50,2528,2503,5031,11236
30,90,130,2528,2503,5031,11236
-90,90,-110,2528,2503,5031,11236
70,90,90,2528,2503,5031,11236
-120,90,-80,2528,2503,5031,11236
-80,90,-120,2528,2503,5031,11236
170,90,-10,2528,2503,5031,11236
-140,90,-60,2528,2503,5031,11236
-150,90,-50,2528,2503,5031,11236
-50,90,-150,2528,2503,5031,11236
-30,90,-170,2528,2503,5031,11236
-170,90,-30,2528,2503,5031,11236
140,90,20,2528,2503,5031,11236
-100,90,-100,2528,2503,5031,11236
-60,90,-140,2528,2503,5031,11236
90,90,70,2528,2503,5031,11236
70,70,90,2522,2509,5031,11417
180,90,-20,2528,2503,5031,11236
10,90,150,2528,2503,5031,11236
-130,90,-70,2528,2503,5031,11236
-10,50,-130,2533,2498,5031,11743
0,90,160,2528,2503,5031,11236
-70,90,-130,2528,2503,5031,11236
-20,90,180,2528,2503,5031,11236
50,90,110,2528,2503,5031,11236
160,90,0,2528,2503,5031,11236
40,90,120,2528,2503,5031,11236
-40,90,-160,2528,2503,5031,11236
-20,90,-180,2528,2503,5031,11236
120,90,40,2528,2503,5031,11236
60,90,100,2528,2503,5031,11236
20,90,140,2528,2503,5031,11236
130,90,30,2528,2503,5031,11236
150,90,10,2528,2503,5031,11236
80,90,80,2528,2503,5031,11236
-160,90,-40,2528,2503,5031,11236
100,90,60,2528,2503,5031,11236
-170,30,30,2518,2514,5032,11798
50,80,110,2518,2514,5032,11288
-150,60,-40,2541,2492,5033,11716
30,-70,-170,2550,2483,5033,11431
-160,-70,-20,2503,2531,5034,11819
-40,-50,130,2535,2499,5034,11494
-20,-70,-140,2506,2528,5034,11500
-40,-80,-160,2528,2506,5034,11658
-10,80,160,2542,2493,5035,11457
-30,40,-120,2543,2492,5035,11808
-160,10,-20,2533,2502,5035,11512
120,-40,-20,2575,2461,5036,11685
130,30,50,2514,2522,5036,11972
-30,10,-140,2513,2523,5036,11677
-140,-40,10,2530,2506,5036,11715
180,-60,50,2543,2493,5036,11606
-180,-60,50,2543,2493,5036,11606
-160,-20,-40,2536,2500,5036,11776
-20,-20,150,2532,2505,5037,11377
-50,-30,180,2516,2521,5037,11512
-100,-70,130,2501,2536,5037,11638
-50,-30,-180,2516,2521,5037,11512
40,-50,-90,2519,2519,5038,11933
-140,70,-60,2526,2512,5038,11601
10,50,-140,2548,2490,5038,11817
100,-50,-100,2543,2495,5038,11830
-10,-10,-120,2519,2520,5039,11946
170,40,-30,2512,2527,5039,11830
-30,30,160,2543,2496,5039,11628
-70,-40,130,2537,2503,5040,12090
-100,-80,60,2526,2514,5040,11458
-150,-50,30,2540,2501,5041,11570
50,60,110,2560,2481,5041,11555
140,70,70,2530,2511,5041,11761
60,60,110,2529,2513,5042,11565
-20,10,-120,2553,2489,5042,12078
-160,-10,20,2546,2497,5043,11711
70,-60,-60,2507,2536,5043,11821
-70,-60,100,2514,2530,5044,11644
-40,80,-170,2516,2528,5044,11368
-150,-30,0,2553,2491,5044,11501
120,80,40,2518,2526,5044,11465
110,-50,-30,2526,2518,5044,11556
-90,-70,70,2514,2530,5044,11627
-50,70,-170,2527,2517,5044,11894
-160,-20,10,2543,2502,5045,11693
-160,60,0,2571,2474,5045,11829
90,-70,-120,2507,2538,5045,11655
40,-80,-160,2562,2483,5045,11426
80,70,80,2517,2529,5046,11506
-20,-10,150,2508,2538,5046,11409
100,60,80,2523,2524,5047,11784
70,70,140,2556,2491,5047,11756
-90,60,-80,2548,2499,5047,12020
-20,80,170,2554,2494,5048,11485
180,40,-30,2555,2493,5048,11657
-180,40,-30,2555,2493,5048,11657
110,70,50,2493,2555,5048,11394
30,40,130,2537,2512,5049,11787
140,0,30,2499,2550,5049,11855
130,80,30,2541,2508,5049,11499
110,50,70,2492,2557,5049,11883
120,40,50,2536,2513,5049,11868
10,60,-150,2544,2506,5050,11755
90,70,70,2526,2525,5051,11494
-130,-60,70,2573,2478,5051,11331
-40,80,-110,2516,2535,5051,11773
-100,70,-110,2520,2532,5052,11411
-50,-20,-180,2564,2488,5052,11416
-50,-20,180,2564,2488,5052,11416
20,60,-160,2566,2486,5052,11607
-90,-70,140,2531,2521,5052,11603
-70,-50,140,2534,2519,5053,11465
-40,20,170,2573,2480,5053,11501
130,0,0,2476,2577,5053,11885
-30,-40,-140,2524,2529,5053,12058
-50,50,-170,2567,2487,5054,11713
140,-70,-80,2513,2541,5054,11982
-170,-70,-30,2496,2558,5054,11933
-30,50,-120,2540,2515,5055,11858
150,-10,30,2526,2529,5055,11707
-90,-60,120,2539,2516,5055,11559
0,20,140,2538,2517,5055,11681
-100,60,-80,2546,2511,5057,11687
-50,30,-140,2555,2502,5057,11701
110,60,80,2541,2517,5058,11821
-90,70,-120,2532,2526,5058,11556
140,30,-10,2534,2524,5058,11936
0,30,140,2556,2503,5059,11923
-60,-50,120,2561,2498,5059,11690
-160,80,10,2532,2528,5060,11968
-70,70,-90,2533,2527,5060,12025
-130,-50,30,2525,2535,5060,11849
160,-50,-60,2536,2524,5060,11675
-150,70,-10,2546,2514,5060,11627
90,-60,-40,2534,2528,5062,11828
-50,40,-170,2545,2517,5062,11739
-170,10,-50,2525,2538,5063,11911
-160,-30,-40,2556,2507,5063,11768
-160,50,-10,2560,2503,5063,11653
-80,-60,90,2519,2544,5063,11744
160,-20,40,2528,2535,5063,11732
-160,-80,-10,2531,2533,5064,11697
110,60,50,2499,2565,5064,11657
150,60,0,2524,2540,5064,11532
-30,-70,-150,2548,2517,5065,11758
-90,-60,110,2569,2496,5065,11747
-30,-30,-140,2526,2539,5065,11645
-170,30,-30,2548,2517,5065,11605
110,50,60,2533,2532,5065,11967
-160,-10,0,2564,2501,5065,11705
-50,-70,-170,2526,2540,5066,11927
20,40,-150,2555,2512,5067,11411
150,80,10,2536,2531,5067,11633
110,-50,-40,2537,2530,5067,11762
10,30,-120,2531,2537,5068,12184
30,30,140,2532,2536,5068,11858
170,50,-30,2517,2551,5068,11835
-70,50,-120,2531,2538,5069,11497
40,50,160,2557,2512,5069,11677
90,-80,-120,2529,2541,5070,11774
140,80,20,2537,2533,5070,11617
30,20,-150,2526,2544,5070,11818
60,-60,-70,2531,2539,5070,11851
0,-60,-120,2516,2555,5071,11663
160,80,0,2524,2547,5071,11644
-150,-40,-30,2512,2559,5071,11921
160,-30,40,2528,2543,5071,11782
-10,50,-120,2549,2524,5073,12017
30,-30,-120,2546,2527,5073,11711
10,20,140,2546,2527,5073,11570
-110,-80,50,2539,2535,5074,11561
30,-20,180,2522,2553,5075,11530
-50,-20,150,2586,2489,5075,12144
30,-20,-180,2522,2553,5075,11530
-170,70,20,2537,2539,5076,12024
160,10,-40,2560,2517,5077,11880
140,40,0,2542,2535,5077,11678
40,-40,-110,2549,2529,5078,11795
-80,70,-130,2533,2545,5078,11667
-80,50,-130,2543,2536,5079,11907
140,60,60,2515,2564,5079,11869
-160,-20,0,2583,2496,5079,11735
-160,-40,-40,2545,2535,5080,11756
20,-30,-110,2543,2537,5080,12108
-160,-30,10,2557,2523,5080,11398
150,50,50,2524,2556,5080,11706
10,-70,170,2544,2536,5080,11466
-50,-40,130,2557,2524,5081,11742
-20,-90,140,2533,2548,5081,11719
-80,-90,80,2533,2548,5081,11719
-10,-90,150,2533,2548,5081,11719
-120,-90,40,2533,2548,5081,11719
-30,-90,130,2533,2548,5081,11719
-40,-90,120,2533,2548,5081,11719
140,-90,-60,2533,2548,5081,11719
-70,-90,90,2533,2548,5081,11719
-60,-90,100,2533,2548,5081,11719
180,-90,-20,2533,2548,5081,11719
160,-90,-40,2533,2548,5081,11719
-180,-90,-20,2533,2548,5081,11719
-130,-90,30,2533,2548,5081,11719
-140,-90,20,2533,2548,5081,11719
150,-90,-50,2533,2548,5081,11719
170,-90,-30,2533,2548,5081,11719
-50,-90,110,2533,2548,5081,11719
-90,-90,70,2533,2548,5081,11719
20,70,130,2545,2536,5081,11638
110,-90,-90,2533,2548,5081,11719
80,-90,-120,2533,2548,5081,11719
0,-90,160,2533,2548,5081,11719
-170,-90,-10,2533,2548,5081,11719
130,-90,-70,2533,2548,5081,11719
-150,-90,10,2533,2548,5081,11719
10,-90,170,2533,2548,5081,11719
20,-70,180,2546,2535,5081,11354
20,-70,-180,2546,2535,5081,11354
60,-90,-140,2533,2548,5081,11719
-100,-90,60,2533,2548,5081,11719
20,-90,180,2533,2548,5081,11719
20,-90,-180,2533,2548,5081,11719
50,-10,-140,2591,2490,5081,12200
90,-90,-110,2533,2548,5081,11719
40,-90,-160,2533,2548,5081,11719
50,-90,-150,2533,2548,5081,11719
70,-90,-130,2533,2548,5081,11719
100,-90,-100,2533,2548,5081,11719
120,-90,-80,2533,2548,5081,11719
30,-90,-170,2533,2548,5081,11719
-110,-90,50,2533,2548,5081,11719
-160,-90,0,2533,2548,5081,11719
-170,0,-50,2531,2551,5082,11972
50,60,150,2564,2518,5082,11785
0,-70,160,2553,2530,5083,11516
-130,-60,20,2520,2563,5083,11840
-170,20,30,2555,2528,5083,11817
0,-40,-120,2537,2546,5083,11867
-50,-20,140,2562,2521,5083,12189
-160,-50,30,2581,2503,5084,11653
0,50,-120,2549,2535,5084,12265
30,40,-170,2545,2539,5084,11578
20,-60,180,2600,2484,5084,11379
-160,-30,0,2612,2472,5084,11601
-40,-70,-160,2555,2529,5084,11937
20,-60,-180,2600,2484,5084,11379
30,10,160,2539,2545,5084,11568
-120,-60,70,2563,2522,5085,11795
-170,40,20,2561,2524,5085,11811
130,-10,-10,2545,2540,5085,11865
-160,-40,10,2567,2519,5086,11464
170,60,-20,2539,2547,5086,11728
-180,0,-50,2568,2519,5087,11988
180,0,-50,2568,2519,5087,11988
-60,-60,110,2545,2543,5088,11738
-150,-60,40,2566,2522,5088,11586
-120,70,-80,2531,2557,5088,11498
-20,60,-130,2546,2543,5089,11584
-170,80,20,2558,2531,5089,12081
-20,70,-130,2556,2533,5089,12171
40,80,120,2560,2530,5090,11428
-40,10,160,2547,2543,5090,11672
20,40,130,2557,2534,5091,11710
-110,-60,50,2536,2555,5091,11868
180,-30,-50,2573,2520,5093,11943
-180,-30,-50,2573,2520,5093,11943
-150,-10,-20,2569,2524,5093,11768
-50,-60,-170,2551,2543,5094,11937
-130,-70,20,2545,2549,5094,11704
30,10,-130,2581,2513,5094,12108
30,-40,-100,2570,2524,5094,12084
-180,-70,50,2544,2551,5095,11861
180,-70,50,2544,2551,5095,11861
30,-10,-120,2546,2549,5095,11995
-160,0,20,2575,2520,5095,11855
-160,-20,20,2565,2530,5095,11802
160,60,-10,2550,2546,5096,11743
-20,40,-120,2552,2544,5096,11901
40,-50,-160,2570,2526,5096,11518
150,-60,-70,2539,2558,5097,11932
140,20,40,2536,2561,5097,12105
50,70,110,2565,2533,5098,11511
-50,30,-170,2553,2545,5098,11697
-40,30,-130,2557,2541,5098,11820
-50,20,-150,2548,2551,5099,11667
-160,10,20,2578,2521,5099,11954
-160,-40,20,2582,2517,5099,11863
130,-20,-50,2518,2582,5100,11598
20,10,-120,2557,2543,5100,12041
-110,70,-90,2549,2551,5100,11543
-40,40,-120,2606,2494,5100,12266
-80,-60,140,2545,2556,5101,11841
-30,-30,140,2556,2547,5103,11705
-60,-60,170,2511,2593,5104,11859
-150,-50,20,2568,2536,5104,11779
100,-80,-110,2556,2548,5104,11817
-100,-60,90,2576,2529,5105,11792
40,-10,-160,2560,2545,5105,11825
-90,-60,80,2535,2570,5105,12054
-90,60,-90,2586,2521,5107,12013
-150,60,-30,2568,2540,5108,11631
80,-60,-60,2532,2577,5109,11712
-150,-20,-30,2575,2534,5109,11978
-140,-40,0,2565,2544,5109,12007
120,-40,-30,2547,2562,5109,11888
160,-20,-50,2552,2558,5110,11964
-30,80,-120,2542,2568,5110,12021
-40,50,-120,2580,2531,5111,12119
-40,0,-150,2594,2518,5112,12003
-160,0,-10,2597,2515,5112,11730
40,-70,-160,2585,2527,5112,11699
30,-60,-170,2584,2528,5112,11399
-50,40,-130,2567,2545,5112,11875
-100,80,-100,2521,2593,5114,11545
-180,-50,-50,2552,2562,5114,12022
-80,80,-120,2520,2594,5114,11468
180,-50,-50,2552,2562,5114,12022
-10,80,170,2558,2556,5114,11431
-120,-80,40,2547,2567,5114,11831
-160,-50,20,2605,2510,5115,11838
-90,60,-120,2559,2556,5115,11857
50,-40,-110,2595,2521,5116,11693
120,50,40,2531,2585,5116,11937
-160,-50,40,2604,2512,5116,11336
-40,50,180,2576,2541,5117,11764
-40,50,-180,2576,2541,5117,11764
140,30,50,2545,2572,5117,12031
-50,60,-110,2573,2544,5117,12075
150,70,10,2551,2566,5117,11762
-150,-20,-10,2637,2480,5117,11789
-180,-70,-40,2538,2580,5118,11877
-60,-50,160,2565,2553,5118,11922
-80,50,-120,2588,2530,5118,11862
180,-70,-40,2538,2580,5118,11877
140,-30,-60,2566,2552,5118,11877
170,-60,40,2590,2528,5118,12027
-60,70,-150,2556,2562,5118,11821
50,-80,-150,2602,2517,5119,11549
-170,80,-30,2536,2584,5120,11614
140,-50,-70,2550,2570,5120,11586
-10,70,-140,2580,2540,5120,12164
170,80,-10,2547,2573,5120,11567
-160,10,-40,2563,2558,5121,11947
-50,-30,170,2571,2550,5121,11562
-120,80,-80,2513,2608,5121,11596
-110,80,-90,2518,2603,5121,11644
170,-70,-50,2533,2589,5122,11821
140,70,20,2554,2568,5122,11736
-50,-30,140,2611,2511,5122,12005
-80,-70,150,2556,2567,5123,11706
-130,-60,60,2571,2552,5123,11717
-70,-50,120,2576,2547,5123,12121
50,60,120,2591,2533,5124,11707
130,30,30,2535,2589,5124,11750
-110,-60,80,2583,2542,5125,11786
180,-40,-50,2568,2558,5126,12043
-160,-10,10,2593,2533,5126,11996
-180,-40,-50,2568,2558,5126,12043
-170,30,-40,2578,2548,5126,11866
-10,60,150,2577,2549,5126,11819
-40,-30,140,2587,2539,5126,11865
-70,70,-140,2553,2574,5127,11765
-160,0,10,2596,2531,5127,12079
30,-50,-170,2587,2540,5127,11707
60,70,150,2579,2548,5127,11956
-70,80,-130,2560,2567,5127,11559
10,10,150,2579,2549,5128,11384
-130,80,-70,2509,2619,5128,11656
100,-70,-110,2552,2576,5128,11957
180,80,-20,2545,2583,5128,11558
100,-50,-60,2608,2520,5128,11890
-180,80,-20,2545,2583,5128,11558
170,80,0,2603,2525,5128,11700
-140,-70,10,2554,2574,5128,11900
150,30,-20,2576,2552,5128,12107
-170,-80,-20,2572,2557,5129,11874
-40,60,180,2575,2554,5129,11793
-40,60,-180,2575,2554,5129,11793
130,50,60,2570,2559,5129,11887
-170,10,30,2583,2546,5129,11950
160,80,10,2606,2524,5130,11775
130,-40,0,2558,2572,5130,11597
0,50,140,2580,2551,5131,11871
70,-60,-70,2557,2574,5131,11912
-90,80,-110,2532,2600,5132,11513
120,-50,-10,2535,2598,5133,11994
-20,20,-120,2578,2555,5133,12162
-80,60,-110,2539,2594,5133,11803
-180,-80,-30,2564,2569,5133,12046
-140,-50,30,2603,2530,5133,12033
180,-80,-30,2564,2569,5133,12046
10,20,-120,2570,2563,5133,12195
150,-40,-60,2582,2552,5134,11999
-170,40,-20,2581,2553,5134,11827
-20,0,-130,2584,2551,5135,11999
-160,60,-30,2582,2553,5135,12131
-10,40,-120,2544,2592,5136,12189
40,-20,-120,2562,2574,5136,11893
40,-60,-160,2604,2532,5136,11556
40,50,140,2574,2562,5136,11779
-160,-30,20,2582,2555,5137,11787
130,-20,-20,2593,2544,5137,11892
90,-50,-70,2597,2540,5137,11981
-90,60,-110,2589,2548,5137,11819
180,50,30,2574,2563,5137,12095
-180,50,30,2574,2563,5137,12095
-60,80,-130,2579,2560,5139,11879
30,-40,-170,2590,2549,5139,11597
-40,-10,-150,2587,2552,5139,12079
-60,80,-140,2570,2570,5140,11440
-170,60,-30,2565,2575,5140,11940
20,80,140,2565,2575,5140,11497
150,80,20,2591,2550,5141,11930
-30,-20,140,2565,2576,5141,11799
0,50,-130,2595,2547,5142,12040
-140,-60,0,2567,2575,5142,12004
-150,70,-50,2580,2562,5142,11834
-170,-40,40,2607,2535,5142,11610
40,0,-140,2593,2550,5143,11829
-140,-60,50,2599,2544,5143,11765
180,40,30,2596,2548,5144,11847
-180,40,30,2596,2548,5144,11847
-80,60,-90,2585,2559,5144,12255
-180,80,-10,2612,2532,5144,11799
-20,20,150,2565,2579,5144,11662
180,80,-10,2612,2532,5144,11799
-160,50,-20,2590,2555,5145,11916
-20,80,-130,2571,2574,5145,12100
60,-80,-140,2619,2526,5145,11753
-40,-30,-150,2610,2535,5145,12085
-60,70,-100,2588,2557,5145,12184
-160,-50,50,2612,2533,5145,11777
-50,80,-140,2578,2569,5147,11861
30,80,130,2557,2591,5148,11525
180,30,-40,2600,2548,5148,12146
-50,-60,120,2601,2547,5148,11857
-160,-10,-10,2624,2524,5148,11809
-180,30,-40,2600,2548,5148,12146
-100,70,-100,2590,2559,5149,11700
0,80,160,2577,2572,5149,11480
40,0,-160,2550,2602,5152,12057
-20,30,-120,2598,2554,5152,11998
-150,80,-50,2538,2614,5152,11810
-30,20,-130,2595,2558,5153,11937
110,-80,-100,2589,2564,5153,11920
-160,20,-40,2589,2564,5153,12073
-160,80,-40,2551,2602,5153,11780
-50,10,-160,2572,2582,5154,11868
-140,80,-60,2520,2634,5154,11780
-170,30,-20,2613,2542,5155,11806
0,40,-120,2586,2569,5155,12360
110,-60,-20,2583,2574,5157,12150
0,-60,160,2580,2577,5157,11773
-80,80,-110,2569,2589,5158,11806
100,-60,-30,2582,2576,5158,12148
-120,80,-40,2550,2608,5158,12077
-90,80,-100,2571,2587,5158,11875
-150,-60,60,2596,2562,5158,11848
150,-70,-70,2559,2600,5159,12041
-40,60,-120,2579,2581,5160,12282
10,-10,160,2607,2553,5160,11506
40,70,120,2579,2581,5160,11830
-150,-60,30,2588,2573,5161,11568
-180,80,30,2603,2558,5161,12201
-170,30,10,2596,2565,5161,11668
120,70,40,2542,2619,5161,11646
-130,-80,30,2571,2590,5161,11898
120,-30,-70,2569,2592,5161,12075
-50,70,-160,2589,2572,5161,11995
180,80,30,2603,2558,5161,12201
180,-20,-50,2607,2555,5162,12164
20,-20,-120,2618,2544,5162,12036
150,70,60,2588,2574,5162,12049
-180,-20,-50,2607,2555,5162,12164
130,-10,0,2542,2622,5164,12321
-20,80,180,2580,2585,5165,11523
-20,10,150,2590,2575,5165,11805
130,-20,-40,2558,2607,5165,11595
-20,80,-180,2580,2585,5165,11523
0,50,-140,2626,2539,5165,12099
0,-50,160,2638,2528,5166,12217
170,-70,40,2593,2573,5166,11976
-90,-60,100,2598,2568,5166,11969
160,0,30,2614,2552,5166,11767
-110,70,-60,2588,2578,5166,12037
-160,-10,-40,2583,2583,5166,12234
10,-60,170,2624,2542,5166,11928
-40,10,170,2634,2532,5166,11981
-60,50,-110,2620,2547,5167,12095
-140,-60,60,2607,2560,5167,11615
120,60,40,2575,2593,5168,11851
-110,80,-50,2550,2619,5169,12096
40,-30,-120,2604,2565,5169,11682
-100,-70,60,2572,2597,5169,11878
-160,10,-30,2598,2571,5169,11647
-80,60,-100,2617,2553,5170,12120
-150,-50,-20,2598,2572,5170,12196
130,70,30,2554,2616,5170,11836
0,20,-120,2587,2583,5170,12044
140,50,10,2546,2624,5170,12167
90,90,120,2599,2572,5171,12333
70,70,110,2600,2571,5171,11855
-140,90,-10,2599,2572,5171,12333
-160,90,10,2599,2572,5171,12333
-140,90,-50,2594,2577,5171,11698
180,90,-10,2594,2577,5171,11698
-110,90,-80,2594,2577,5171,11698
-70,90,-80,2599,2572,5171,12333
-20,90,-130,2599,2572,5171,12333
50,90,120,2594,2577,5171,11698
160,90,10,2594,2577,5171,11698
-120,90,-30,2599,2572,5171,12333
-90,90,-60,2599,2572,5171,12333
0,90,-150,2599,2572,5171,12333
160,90,50,2599,2572,5171,12333
-90,90,-100,2594,2577,5171,11698
-130,70,-40,2596,2575,5171,12194
70,90,100,2594,2577,5171,11698
100,90,110,2599,2572,5171,12333
150,90,60,2599,2572,5171,12333
-10,90,-140,2599,2572,5171,12333
-100,80,-90,2571,2600,5171,11871
20,90,-170,2599,2572,5171,12333
-160,90,-30,2594,2577,5171,11698
-170,90,-20,2594,2577,5171,11698
-170,90,20,2599,2572,5171,12333
30,90,-180,2599,2572,5171,12333
20,90,150,2594,2577,5171,11698
-50,90,-140,2594,2577,5171,11698
-50,90,-100,2599,2572,5171,12333
-180,90,-10,2594,2577,5171,11698
-40,90,-110,2599,2572,5171,12333
-20,90,-170,2594,2577,5171,11698
80,90,130,2599,2572,5171,12333
-120,90,-70,2594,2577,5171,11698
10,90,-160,2599,2572,5171,12333
-130,90,-60,2594,2577,5171,11698
-110,90,-40,2599,2572,5171,12333
10,90,160,2594,2577,5171,11698
180,90,30,2599,2572,5171,12333
-40,90,-150,2594,2577,5171,11698
-180,90,30,2599,2572,5171,12333
-10,90,-180,2594,2577,5171,11698
90,90,80,2594,2577,5171,11698
50,-60,-80,2587,2584,5171,12120
-100,90,-90,2594,2577,5171,11698
150,90,20,2594,2577,5171,11698
120,90,90,2599,2572,5171,12333
140,90,70,2599,2572,5171,12333
-150,90,-40,2594,2577,5171,11698
140,90,30,2594,2577,5171,11698
0,90,170,2594,2577,5171,11698
-70,90,-120,2594,2577,5171,11698
-80,90,-70,2599,2572,5171,12333
-30,90,-120,2599,2572,5171,12333
70,90,140,2599,2572,5171,12333
30,90,180,2599,2572,5171,12333
30,90,140,2594,2577,5171,11698
170,90,40,2599,2572,5171,12333
110,90,60,2594,2577,5171,11698
-150,90,0,2599,2572,5171,12333
-80,90,-110,2594,2577,5171,11698
110,90,100,2599,2572,5171,12333
130,90,80,2599,2572,5171,12333
-30,90,-160,2594,2577,5171,11698
-10,90,180,2594,2577,5171,11698
-100,90,-50,2599,2572,5171,12333
130,90,40,2594,2577,5171,11698
60,90,110,2594,2577,5171,11698
60,90,150,2599,2572,5171,12333
40,90,170,2599,2572,5171,12333
170,90,0,2594,2577,5171,11698
-60,90,-130,2594,2577,5171,11698
40,90,130,2594,2577,5171,11698
-130,90,-20,2599,2572,5171,12333
100,90,70,2594,2577,5171,11698
80,90,90,2594,2577,5171,11698
50,90,160,2599,2572,5171,12333
120,90,50,2594,2577,5171,11698
-60,90,-90,2599,2572,5171,12333
50,-50,-100,2605,2567,5172,11970
170,60,40,2608,2564,5172,12089
-30,60,170,2558,2615,5173,11910
180,50,-20,2598,2576,5174,12182
50,-60,-150,2617,2557,5174,11830
-180,50,-20,2598,2576,5174,12182
180,-10,-50,2601,2574,5175,12119
-180,-10,-50,2601,2574,5175,12119
-170,-50,50,2604,2571,5175,12121
60,70,120,2605,2571,5176,11845
130,30,40,2602,2574,5176,12131
20,60,130,2621,2555,5176,11938
90,-60,-60,2617,2559,5176,11820
-50,-30,160,2627,2550,5177,11957
100,-60,-50,2620,2559,5179,11866
90,70,110,2594,2585,5179,12295
160,70,0,2588,2592,5180,11917
-170,0,30,2641,2539,5180,11797
-90,80,-70,2563,2617,5180,12129
-140,-80,90,2605,2576,5181,12016
10,50,-150,2592,2589,5181,12189
140,-10,-30,2586,2595,5181,11687
-70,-50,130,2611,2570,5181,12025
50,60,130,2590,2591,5181,11711
120,60,70,2587,2594,5181,12066
70,-80,-130,2628,2554,5182,11901
-110,70,-80,2592,2590,5182,11965
-140,-80,20,2554,2629,5183,12015
-160,-50,10,2613,2570,5183,11700
110,70,90,2582,2601,5183,12241
-20,10,-130,2601,2582,5183,12227
-10,80,-140,2590,2594,5184,12210
-160,60,-20,2622,2562,5184,11920
-50,80,-150,2582,2603,5185,11537
10,10,-120,2605,2580,5185,12230
-130,80,-30,2559,2626,5185,12091
-120,70,-50,2602,2583,5185,12053
-170,70,-30,2581,2604,5185,11916
160,-10,30,2599,2586,5185,11924
-70,80,-120,2576,2609,5185,11909
120,-80,-90,2601,2585,5186,12110
110,-70,-100,2609,2577,5186,12014
-50,70,-110,2595,2591,5186,12214
110,60,70,2585,2602,5187,12035
-50,-40,180,2592,2595,5187,11706
-70,-70,160,2558,2629,5187,11938
-50,-40,-180,2592,2595,5187,11706
140,80,30,2619,2569,5188,11921
10,80,150,2589,2599,5188,11540
-150,-30,-30,2599,2589,5188,12163
-30,-20,150,2607,2581,5188,11948
-140,-30,-10,2609,2580,5189,12379
-180,50,-30,2606,2583,5189,11893
-100,80,-60,2565,2624,5189,12190
180,50,-30,2606,2583,5189,11893
90,-60,-50,2586,2604,5190,11938
-40,10,-150,2617,2573,5190,12185
-120,70,-70,2597,2594,5191,11983
-50,20,-160,2591,2600,5191,11915
-180,-30,40,2604,2588,5192,11838
-110,-70,50,2595,2597,5192,12036
140,-10,20,2597,2595,5192,12353
180,-30,40,2604,2588,5192,11838
-40,-20,-150,2611,2582,5193,12291
-160,-60,30,2612,2581,5193,12011
-110,80,-80,2592,2601,5193,11921
-10,30,-130,2603,2590,5193,12113
-20,-30,150,2648,2545,5193,11829
100,-60,-40,2601,2592,5193,12062
-20,0,150,2592,2601,5193,11910
50,60,140,2606,2588,5194,11866
-50,60,-170,2616,2578,5194,12170
-40,30,-140,2628,2566,5194,12072
40,-50,-100,2637,2557,5194,12159
120,-40,-40,2624,2570,5194,11881
-140,-50,20,2579,2616,5195,11979
100,70,100,2595,2600,5195,12168
160,-20,30,2610,2585,5195,11969
160,40,40,2607,2588,5195,11705
-100,-60,70,2579,2617,5196,12135
30,20,160,2598,2598,5196,11725
-140,-40,-10,2592,2605,5197,12353
-10,-60,-130,2610,2587,5197,12111
-120,-60,60,2616,2582,5198,12336
-150,-50,10,2602,2596,5198,12061
80,-50,-80,2616,2582,5198,11837
0,-30,-120,2594,2605,5199,12235
80,70,100,2593,2607,5200,12038
70,-50,-90,2606,2594,5200,12023
-10,40,-130,2591,2609,5200,12367
-40,80,-150,2593,2607,5200,11874
-150,-80,80,2610,2590,5200,12056
-10,30,-120,2610,2591,5201,12281
-170,40,10,2620,2581,5201,12037
70,70,120,2621,2581,5202,11908
70,80,100,2619,2583,5202,11786
-170,50,10,2621,2581,5202,12169
-100,70,-90,2594,2608,5202,12098
150,-20,-50,2586,2616,5202,12057
-10,-40,-130,2601,2602,5203,12333
-160,0,-40,2603,2601,5204,12047
170,70,-10,2578,2626,5204,12024
-90,70,-110,2608,2598,5206,11900
80,80,90,2584,2622,5206,11814
-170,50,-20,2622,2584,5206,12104
-80,80,-80,2572,2635,5207,12156
130,-20,0,2578,2629,5207,12276
-170,80,-20,2622,2585,5207,11949
-130,-80,100,2630,2577,5207,12064
-30,20,-140,2637,2570,5207,12268
130,-30,0,2608,2599,5207,12409
-20,60,160,2620,2588,5208,12071
-140,80,-20,2583,2625,5208,12154
-30,80,-170,2592,2616,5208,11482
170,-20,40,2564,2644,5208,11802
20,0,-120,2597,2611,5208,12346
90,80,80,2584,2624,5208,11856
-10,0,-120,2609,2600,5209,12208
-80,70,-120,2573,2636,5209,11993
80,70,110,2618,2592,5210,11942
130,80,40,2617,2593,5210,11932
-160,70,-40,2599,2611,5210,11940
150,0,30,2630,2580,5210,12169
20,50,-160,2615,2596,5211,11831
-160,70,0,2609,2602,5211,12048
-150,-70,0,2592,2619,5211,12159
180,70,-20,2588,2623,5211,11964
30,-30,-170,2623,2588,5211,11925
160,-70,-60,2562,2649,5211,12191
-60,40,-140,2623,2588,5211,12165
-180,70,-20,2588,2623,5211,11964
-40,-40,140,2628,2583,5211,11995
110,80,60,2583,2628,5211,11856
0,30,-120,2564,2647,5211,12202
90,70,100,2614,2597,5211,11969
-180,60,30,2608,2604,5212,12294
100,60,70,2596,2616,5212,11995
180,60,30,2608,2604,5212,12294
30,50,130,2618,2594,5212,12014
-70,60,-100,2632,2581,5213,12160
-40,70,-170,2602,2611,5213,12104
-20,-10,-140,2611,2602,5213,12254
-30,30,-130,2634,2580,5214,12069
20,-30,-120,2608,2606,5214,12028
20,50,130,2638,2576,5214,12129
-50,-40,140,2637,2578,5215,12225
130,-80,-80,2628,2588,5216,12175
60,-60,-140,2649,2567,5216,11993
170,-80,-40,2615,2602,5217,12244
-120,-60,40,2584,2633,5217,12359
80,-80,-120,2656,2561,5217,11979
30,-40,-110,2635,2582,5217,12220
-30,0,150,2605,2613,5218,12036
-70,70,-120,2621,2597,5218,11903
-30,20,160,2607,2611,5218,12107
-60,40,-150,2599,2619,5218,12266
60,80,110,2627,2591,5218,11864
30,0,170,2632,2587,5219,11979
120,-30,-50,2608,2612,5220,11951
90,-40,-80,2634,2586,5220,12189
160,-80,-50,2606,2614,5220,12156
-60,-50,130,2680,2540,5220,12350
0,80,-150,2615,2605,5220,12387
170,30,-30,2614,2607,5221,12154
-150,-80,10,2577,2644,5221,12102
-160,-60,60,2608,2614,5222,11876
-20,50,-130,2593,2629,5222,12036
170,-50,40,2611,2611,5222,12103
120,80,50,2602,2620,5222,11879
-80,60,-130,2594,2629,5223,12268
-40,80,-160,2600,2623,5223,11589
60,70,110,2584,2639,5223,12038
140,-80,-70,2615,2608,5223,12144
-140,-50,10,2620,2603,5223,12139
-100,70,-70,2614,2610,5224,12240
-160,80,-30,2631,2593,5224,11894
70,70,100,2578,2646,5224,12018
120,50,60,2598,2626,5224,12147
150,30,40,2607,2617,5224,12134
-20,40,-130,2624,2600,5224,12333
150,-80,-60,2613,2612,5225,12241
-140,-50,0,2600,2626,5226,12210
150,70,20,2625,2601,5226,11819
-130,70,-60,2615,2611,5226,12048
120,70,80,2598,2628,5226,12364
-150,80,-40,2627,2599,5226,11885
-170,-10,30,2647,2579,5226,12017
-120,-80,110,2625,2602,5227,12071
-60,50,-130,2616,2611,5227,12051
-80,-60,130,2649,2578,5227,12021
-130,-60,50,2610,2617,5227,11977
80,70,120,2617,2611,5228,12387
80,-60,-120,2662,2566,5228,11936
150,0,-30,2622,2606,5228,11780
130,-40,-70,2636,2592,5228,12225
20,-20,-130,2632,2597,5229,11996
-30,-10,150,2607,2623,5230,12219
160,70,10,2629,2601,5230,11910
-170,-50,-40,2608,2622,5230,12314
-10,-30,-130,2610,2620,5230,12407
-90,70,-100,2620,2611,5231,12114
40,60,130,2625,2606,5231,11806
-110,-60,70,2623,2608,5231,12260
-160,-40,0,2665,2567,5232,12097
-30,-50,140,2662,2570,5232,11860
100,80,70,2591,2641,5232,11776
-100,-60,80,2622,2610,5232,12167
-160,-80,70,2616,2617,5233,12172
20,-50,-180,2637,2596,5233,11745
20,-50,180,2637,2596,5233,11745
-80,-60,120,2647,2586,5233,12179
40,0,-150,2629,2604,5233,12131
-170,20,-30,2648,2586,5234,12146
-180,70,30,2630,2604,5234,12387
180,70,30,2630,2604,5234,12387
50,-70,-150,2642,2593,5235,11957
10,80,-160,2628,2607,5235,12509
160,-50,30,2609,2626,5235,12290
130,-60,-80,2646,2589,5235,11957
50,70,120,2590,2645,5235,12062
140,40,50,2592,2644,5236,12280
-60,-40,140,2645,2591,5236,12357
-170,-50,20,2640,2596,5236,12038
-90,-60,90,2640,2597,5237,12071
170,-10,-50,2615,2622,5237,12378
100,-40,-70,2640,2598,5238,12174
-40,-60,130,2659,2579,5238,12070
90,-80,-110,2654,2584,5238,12004
-30,70,-180,2623,2616,5239,12206
170,80,40,2647,2592,5239,12365
-30,70,180,2623,2616,5239,12206
170,20,-40,2627,2613,5240,12237
110,-50,-50,2640,2600,5240,12000
-160,60,-10,2607,2633,5240,12069
-140,-60,40,2640,2600,5240,11956
70,-30,-110,2639,2602,5241,12660
-170,20,-20,2672,2569,5241,11959
-50,-50,180,2608,2633,5241,12036
90,70,90,2633,2608,5241,12166
-50,-50,-180,2608,2633,5241,12036
10,70,140,2629,2613,5242,11864
-70,80,-90,2593,2649,5242,12166
140,20,-10,2569,2674,5243,12178
-170,20,0,2662,2582,5244,12252
50,70,130,2628,2616,5244,11873
20,30,140,2616,2628,5244,12298
-170,30,20,2650,2594,5244,12100
40,60,170,2623,2622,5245,12221
-130,80,-60,2626,2619,5245,11890
100,70,90,2613,2632,5245,12155
-140,80,-50,2634,2612,5246,11876
20,20,-130,2632,2614,5246,12354
-170,-80,60,2637,2610,5247,12328
-60,70,-130,2621,2626,5247,11923
-150,80,-10,2597,2650,5247,12367
-160,-50,-30,2628,2620,5248,12218
160,70,50,2648,2600,5248,12350
130,-50,0,2602,2647,5249,11953
-20,-20,-140,2623,2626,5249,12294
20,-10,-120,2640,2610,5250,12356
-160,-60,20,2658,2593,5251,11736
-120,80,-70,2616,2635,5251,11961
-80,70,-90,2629,2622,5251,12362
-60,60,-110,2643,2609,5252,12013
40,50,150,2605,2648,5253,11871
130,-30,-20,2681,2572,5253,12236
-170,60,10,2668,2585,5253,12242
100,-80,-100,2659,2594,5253,12097
110,-80,-90,2650,2603,5253,12166
-140,70,-40,2652,2602,5254,12281
160,-60,30,2645,2609,5254,12371
150,-50,20,2615,2639,5254,12382
140,10,30,2571,2683,5254,12422
70,-60,-130,2666,2588,5254,12049
-170,30,-10,2630,2625,5255,11991
-40,-60,-160,2625,2630,5255,12148
160,-40,30,2604,2651,5255,12136
-160,-30,-10,2698,2558,5256,11994
-110,-60,60,2638,2618,5256,12444
170,-40,40,2610,2647,5257,12275
140,0,-20,2630,2627,5257,12188
130,-40,-10,2632,2625,5257,12402
170,-30,-50,2647,2610,5257,12380
0,-40,160,2652,2605,5257,11891
140,60,20,2602,2656,5258,12193
40,60,120,2657,2601,5258,12108
-20,30,-130,2639,2619,5258,12281
-130,70,-50,2666,2592,5258,12321
60,-30,-110,2618,2641,5259,12417
-10,10,150,2647,2613,5260,11823
-90,70,-80,2632,2628,5260,12359
-170,-40,20,2628,2632,5260,11999
-110,-80,120,2640,2620,5260,12260
-80,-60,110,2645,2615,5260,12252
110,-50,-90,2666,2595,5261,12208
110,-60,-30,2647,2614,5261,12187
-30,80,-160,2645,2617,5262,11808
170,-30,40,2627,2635,5262,12144
-80,60,-120,2630,2632,5262,12249
30,-50,-100,2636,2627,5263,12600
-50,-30,150,2649,2614,5263,12347
70,70,130,2655,2609,5264,12495
-20,-60,-140,2631,2633,5264,12225
-150,-60,-10,2636,2630,5266,12383
0,40,140,2628,2639,5267,12547
20,0,160,2639,2628,5267,12040
-120,70,-60,2676,2591,5267,12363
130,-20,-10,2646,2621,5267,12318
150,50,0,2623,2644,5267,12138
20,-40,-110,2625,2642,5267,12632
-70,70,-130,2609,2658,5267,11930
150,40,-10,2639,2628,5267,12350
-160,-70,-10,2644,2624,5268,12209
0,10,150,2654,2614,5268,12233
-30,70,-170,2625,2643,5268,11715
-40,0,160,2655,2613,5268,12086
120,-50,-20,2640,2628,5268,12148
30,-20,-130,2647,2622,5269,11992
50,-20,-120,2629,2640,5269,12437
-140,70,-50,2647,2622,5269,12157
-180,40,-20,2626,2644,5270,12115
110,70,60,2599,2671,5270,12038
180,40,-20,2626,2644,5270,12115
30,-40,-120,2662,2608,5270,12310
110,60,60,2626,2644,5270,12226
-160,80,0,2620,2651,5271,12535
-60,80,-100,2599,2672,5271,12181
-160,-80,0,2611,2660,5271,12200
-150,-40,0,2672,2600,5272,12103
120,-70,-90,2653,2619,5272,12188
-60,50,-120,2645,2628,5273,12270
-180,-80,50,2662,2611,5273,12579
160,50,-10,2618,2655,5273,11867
-40,20,-150,2666,2607,5273,12241
180,-80,50,2662,2611,5273,12579
-60,-50,150,2681,2592,5273,12058
-40,-10,150,2631,2643,5274,12330
-70,60,-140,2624,2650,5274,12251
20,80,-170,2647,2627,5274,12601
40,-60,-90,2621,2653,5274,12479
180,30,30,2682,2592,5274,12260
90,-40,-100,2669,2605,5274,12592
-180,30,30,2682,2592,5274,12260
50,80,120,2647,2628,5275,12082
-100,-80,130,2639,2636,5275,12370
-30,-60,-150,2629,2647,5276,12229
80,70,90,2605,2671,5276,12179
-80,70,-110,2637,2639,5276,12113
-50,60,-160,2639,2637,5276,12089
160,0,-40,2642,2635,5277,12366
160,-60,-60,2646,2631,5277,12416
170,-40,-50,2646,2631,5277,12056
-40,70,-120,2646,2631,5277,12248
120,50,50,2613,2665,5278,12338
-140,-60,10,2626,2653,5279,12297
-170,30,0,2641,2638,5279,12305
20,30,-140,2658,2621,5279,12407
-150,-70,30,2683,2596,5279,11889
150,-40,20,2639,2641,5280,12337
60,-70,-140,2659,2621,5280,12007
-140,70,-30,2653,2627,5280,12349
-10,-50,-130,2653,2628,5281,12309
30,0,-130,2649,2633,5282,12279
10,-10,-130,2658,2624,5282,12416
-140,-70,40,2688,2595,5283,11901
100,-40,-90,2655,2628,5283,12435
140,-40,10,2617,2666,5283,12228
170,50,-20,2647,2637,5284,12160
170,-60,-50,2643,2641,5284,12429
130,-30,-10,2644,2641,5285,12569
-150,70,-40,2659,2626,5285,12271
-50,70,-140,2614,2672,5286,11841
80,-60,-70,2671,2615,5286,12163
-20,10,-140,2679,2607,5286,12272
110,-40,-60,2650,2636,5286,12075
-70,70,-100,2665,2621,5286,12525
-50,-50,130,2689,2597,5286,12022
0,70,-150,2632,2655,5287,12602
-80,-60,100,2659,2628,5287,12156
-40,-50,-160,2659,2628,5287,12588
150,60,50,2655,2632,5287,12464
-170,-60,20,2667,2620,5287,12072
120,-80,-80,2660,2628,5288,12325
-170,-30,30,2697,2591,5288,12128
30,10,-140,2656,2632,5288,12385
-50,70,-150,2646,2642,5288,11817
120,60,60,2661,2628,5289,12196
0,-20,-120,2659,2630,5289,12561
-40,40,-180,2666,2623,5289,12098
-40,40,180,2666,2623,5289,12098
-10,-20,-140,2681,2608,5289,12512
0,20,-130,2643,2646,5289,12421
10,30,140,2632,2657,5289,12360
30,70,130,2652,2638,5290,12141
130,40,30,2633,2658,5291,12259
-70,-70,100,2663,2628,5291,12306
-100,70,-80,2669,2623,5292,12400
10,-20,-120,2657,2635,5292,12698
130,40,50,2651,2641,5292,12335
30,-10,-130,2640,2653,5293,12230
130,-30,-30,2657,2636,5293,12183
-160,0,-20,2672,2621,5293,12199
-50,30,-160,2640,2653,5293,12341
-50,40,-140,2664,2630,5294,12360
-170,80,10,2650,2644,5294,12566
10,-50,170,2663,2631,5294,12265
100,70,80,2639,2656,5295,12374
-60,70,-140,2637,2658,5295,11889
-170,-20,30,2706,2589,5295,12359
150,-30,20,2635,2660,5295,12164
170,0,30,2682,2613,5295,11965
-20,20,-140,2669,2626,5295,12509
160,-30,30,2636,2659,5295,12177
-120,-70,40,2655,2640,5295,12160
160,80,50,2669,2627,5296,12337
130,70,70,2642,2654,5296,12678
40,-40,-120,2693,2604,5297,12375
-10,20,-120,2650,2647,5297,12278
60,-60,-80,2637,2660,5297,12216
-160,-20,-10,2670,2627,5297,11871
-80,-80,90,2672,2625,5297,12179
120,-50,-30,2644,2653,5297,12276
150,-20,20,2687,2610,5297,12264
-50,80,-110,2606,2691,5297,12326
-170,-50,10,2667,2631,5298,12228
-10,0,-130,2672,2626,5298,12297
-170,-80,-10,2638,2661,5299,12297
-100,-80,70,2678,2621,5299,12139
160,-70,30,2669,2630,5299,12412
-70,-80,100,2675,2625,5300,12201
130,60,60,2635,2665,5300,12318
-70,60,-110,2662,2638,5300,12506
0,40,-130,2686,2614,5300,12504
180,-40,40,2665,2636,5301,12260
-180,-40,40,2665,2636,5301,12260
140,-10,-20,2657,2644,5301,11847
-40,70,-160,2638,2664,5302,11758
-20,70,170,2664,2638,5302,12214
30,30,150,2680,2622,5302,12106
100,70,70,2627,2676,5303,12043
130,60,30,2625,2678,5303,12423
40,70,130,2624,2680,5304,12135
120,-60,-10,2641,2663,5304,12389
160,10,30,2673,2631,5304,12086
-40,80,-120,2610,2694,5304,12441
-90,-80,80,2667,2637,5304,12187
70,-70,-130,2676,2629,5305,12167
180,60,-20,2611,2694,5305,12267
-30,-30,150,2697,2608,5305,12336
-180,60,-20,2611,2694,5305,12267
-60,50,-150,2650,2655,5305,12346
-50,50,-120,2688,2618,5306,12421
140,-20,-50,2629,2678,5307,12216
-20,-40,150,2695,2612,5307,11888
160,20,-30,2655,2653,5308,12464
-60,60,-150,2660,2648,5308,12011
0,10,-120,2665,2643,5308,12605
-170,20,-10,2684,2625,5309,12141
-170,20,-40,2671,2638,5309,12524
30,40,140,2655,2655,5310,12347
-90,-80,140,2661,2649,5310,12491
30,-10,-180,2676,2634,5310,12228
-70,60,-120,2656,2654,5310,12214
30,-10,180,2676,2634,5310,12228
-20,70,180,2663,2648,5311,11855
-20,70,-180,2663,2648,5311,11855
-20,-30,-140,2652,2659,5311,12367
40,80,130,2647,2665,5312,12174
-20,80,-170,2649,2663,5312,11884
-30,40,-130,2664,2648,5312,12361
-90,70,-90,2686,2627,5313,12462
60,70,130,2676,2637,5313,12175
-170,20,10,2684,2629,5313,12260
130,-80,-70,2687,2626,5313,12358
-40,50,-170,2655,2659,5314,12096
-110,70,-70,2692,2622,5314,12465
-110,-70,110,2662,2652,5314,12277
-50,-80,120,2678,2636,5314,12225
20,-30,-130,2638,2676,5314,12332
-50,-40,170,2641,2673,5314,12410
40,60,160,2677,2638,5315,12437
-20,40,160,2702,2613,5315,12358
-150,-60,50,2678,2637,5315,12034
170,10,-40,2658,2657,5315,12450
170,70,40,2675,2641,5316,12532
170,70,0,2681,2635,5316,12337
-70,50,-130,2692,2624,5316,12546
90,-60,-110,2675,2642,5317,12337
-10,-20,-130,2677,2640,5317,12847
180,-80,-20,2675,2642,5317,12231
-180,-80,-20,2675,2642,5317,12231
-40,-80,-170,2639,2678,5317,12316
-50,60,-120,2697,2620,5317,12347
-160,-70,30,2670,2647,5317,12189
-180,-60,-40,2654,2664,5318,12481
110,-60,-40,2674,2644,5318,12057
-70,-60,150,2679,2639,5318,12248
-70,50,-140,2648,2670,5318,12551
180,-60,-40,2654,2664,5318,12481
90,70,80,2630,2688,5318,12205
140,40,10,2646,2672,5318,12589
-170,10,0,2688,2631,5319,12309
-10,20,-130,2697,2622,5319,12561
-80,-70,90,2667,2652,5319,12353
-150,70,-30,2673,2647,5320,12319
-160,0,-30,2698,2622,5320,12348
-10,60,-140,2663,2657,5320,12479
-170,-70,-20,2682,2639,5321,12420
150,60,10,2653,2668,5321,12272
-170,50,-10,2677,2644,5321,12265
-30,-80,-160,2641,2680,5321,12291
-20,20,-130,2692,2630,5322,12205
-40,-40,-160,2662,2660,5322,12545
170,-80,40,2674,2649,5323,12670
140,-30,10,2676,2647,5323,12363
-40,0,170,2691,2632,5323,12330
10,60,140,2661,2665,5326,12156
-170,10,-40,2666,2660,5326,12712
-60,-80,110,2693,2633,5326,12171
-40,-20,150,2668,2658,5326,12538
180,20,-40,2677,2650,5327,12545
-130,-70,50,2733,2594,5327,12164
120,60,50,2648,2679,5327,12206
-180,20,-40,2677,2650,5327,12545
80,-40,-110,2675,2652,5327,12806
-180,30,-30,2676,2652,5328,12520
140,-80,-60,2686,2642,5328,12401
170,-50,-50,2659,2669,5328,12382
-60,-70,110,2687,2641,5328,12469
-20,-40,-140,2666,2662,5328,12118
180,30,-30,2676,2652,5328,12520
-170,40,0,2678,2651,5329,12412
-10,50,150,2657,2672,5329,12450
120,70,50,2652,2677,5329,12293
-120,-60,50,2659,2671,5330,12675
0,30,-130,2671,2659,5330,12474
-110,-80,60,2688,2643,5331,12175
-170,-40,30,2712,2619,5331,11930
20,-10,-130,2697,2634,5331,12144
110,70,80,2650,2681,5331,12306
10,80,160,2660,2671,5331,12098
-60,70,-110,2676,2655,5331,12628
-60,80,-120,2702,2629,5331,12149
-150,-60,20,2679,2652,5331,12118
10,0,-120,2651,2680,5331,12416
-120,-70,100,2646,2686,5332,12330
-130,-60,30,2689,2643,5332,12562
10,40,-130,2684,2648,5332,12792
30,80,140,2660,2672,5332,12239
120,-60,-20,2669,2664,5333,12369
30,50,-180,2674,2659,5333,12423
120,70,60,2694,2639,5333,12163
10,40,-140,2668,2665,5333,12343
-160,-60,-20,2684,2649,5333,12362
30,50,180,2674,2659,5333,12423
30,30,-170,2664,2670,5334,12345
-20,0,-140,2693,2641,5334,12225
-60,-80,170,2653,2681,5334,12414
-170,60,-20,2661,2674,5335,12214
-30,50,170,2699,2636,5335,12378
-160,-70,20,2706,2629,5335,12133
-10,70,160,2646,2689,5335,12114
0,70,150,2685,2650,5335,12103
-40,-10,160,2693,2643,5336,12413
-30,50,-130,2684,2652,5336,12348
-90,80,-90,2707,2630,5337,12360
140,10,-10,2631,2706,5337,12622
-30,60,-130,2665,2673,5338,12355
-160,-50,0,2662,2676,5338,12421
150,-50,-60,2690,2648,5338,12404
0,80,170,2678,2661,5339,12050
40,70,140,2667,2673,5340,12136
-170,-60,10,2715,2626,5341,12169
-30,80,-130,2637,2705,5342,12588
20,80,150,2664,2678,5342,12191
-160,-60,10,2689,2653,5342,12087
-50,-40,160,2694,2648,5342,12238
30,80,-180,2676,2667,5343,12676
30,80,180,2676,2667,5343,12676
-150,-70,40,2696,2647,5343,12223
-60,-50,140,2708,2635,5343,12525
170,60,-10,2665,2678,5343,12430
-170,-40,0,2724,2621,5345,12241
-80,70,-100,2695,2650,5345,12492
40,-50,-110,2704,2642,5346,12509
-10,-10,-140,2707,2639,5346,12429
20,10,-130,2665,2681,5346,12910
-30,40,170,2703,2643,5346,12173
-170,-40,-40,2654,2693,5347,12638
170,-10,30,2697,2651,5348,12245
140,30,0,2670,2678,5348,12727
-50,-80,180,2657,2692,5349,12436
-50,-80,-180,2657,2692,5349,12436
-50,50,-160,2671,2678,5349,12274
-40,-80,130,2694,2655,5349,12267
140,30,40,2656,2694,5350,12555
-100,80,-80,2712,2638,5350,12288
-70,80,-110,2713,2638,5351,12255
-150,70,-20,2669,2682,5351,12547
-70,-60,110,2713,2638,5351,12415
150,80,60,2698,2654,5352,12498
-50,60,-140,2690,2662,5352,12420
-170,40,-10,2700,2653,5353,12516
170,-20,-50,2688,2665,5353,12600
0,-30,160,2714,2639,5353,12269
-130,-70,90,2690,2663,5353,12582
-10,10,-120,2688,2665,5353,12660
150,10,30,2667,2686,5353,12491
180,20,30,2702,2652,5354,12311
-180,20,30,2702,2652,5354,12311
20,20,150,2709,2646,5355,12158
30,40,-180,2691,2664,5355,12169
30,40,180,2691,2664,5355,12169
-130,-70,30,2661,2695,5356,12342
-30,30,170,2698,2658,5356,12238
-30,10,-150,2720,2636,5356,12309
-160,-60,50,2687,2669,5356,12380
-50,80,-130,2703,2654,5357,12245
10,0,-130,2684,2673,5357,12377
170,20,30,2710,2648,5358,12371
40,-10,-130,2664,2694,5358,12468
-20,50,160,2706,2652,5358,12293
30,-60,-100,2651,2708,5359,12721
80,-70,-120,2722,2637,5359,12488
30,20,170,2738,2621,5359,12038
-60,-70,170,2660,2699,5359,12202
90,80,120,2685,2675,5360,12722
-40,70,-150,2664,2696,5360,11997
-180,-70,-30,2725,2635,5360,12631
-40,80,-140,2717,2643,5360,12320
180,-70,-30,2725,2635,5360,12631
-60,60,-130,2698,2663,5361,12310
-120,80,-60,2721,2640,5361,12318
20,-50,-110,2667,2694,5361,12795
20,40,-160,2673,2689,5362,12202
-50,-60,-180,2664,2698,5362,12615
-30,-80,140,2685,2677,5362,12274
-150,-20,-20,2708,2654,5362,12511
-50,-60,180,2664,2698,5362,12615
160,60,0,2695,2667,5362,12419
-20,-80,150,2695,2668,5363,12275
80,-40,-90,2681,2682,5363,12664
150,-60,20,2657,2707,5364,12736
-110,80,-70,2728,2636,5364,12312
120,-50,-40,2706,2658,5364,12673
30,-50,-110,2722,2642,5364,12505
140,80,70,2700,2664,5364,12610
-10,-30,-140,2699,2665,5364,12463
-150,-70,10,2696,2668,5364,12568
-50,70,-120,2669,2696,5365,12451
110,80,100,2681,2684,5365,12701
50,70,160,2679,2686,5365,12576
-80,80,-100,2719,2647,5366,12322
-80,-80,150,2680,2686,5366,12498
40,-80,-90,2680,2687,5367,12356
10,-20,-130,2697,2670,5367,12527
160,40,-20,2676,2691,5367,12534
-90,-70,80,2678,2689,5367,12538
-170,-30,-40,2671,2696,5367,12542
-70,-80,160,2671,2696,5367,12469
60,70,140,2702,2665,5367,12793
-140,-70,20,2691,2677,5368,12428
20,-40,180,2715,2653,5368,12272
20,-40,-180,2715,2653,5368,12272
-10,20,150,2695,2673,5368,12238
140,0,20,2667,2701,5368,12651
-30,70,-130,2653,2715,5368,12374
100,80,110,2691,2677,5368,12677
-50,-40,150,2732,2636,5368,12631
110,70,70,2716,2653,5369,12105
20,30,-150,2700,2669,5369,12237
30,30,-180,2705,2664,5369,12116
-100,-70,120,2694,2675,5369,12412
-170,-40,10,2704,2665,5369,12328
30,30,180,2705,2664,5369,12116
170,-80,-30,2692,2678,5370,12276
-40,60,-170,2670,2701,5371,12189
0,-10,-120,2693,2678,5371,12827
-160,-60,40,2727,2645,5372,12156
160,-80,-40,2691,2683,5374,12334
-50,40,-160,2674,2701,5375,12675
-10,80,180,2672,2703,5375,11970
-170,-60,-30,2688,2687,5375,12428
160,50,40,2703,2672,5375,12561
40,60,140,2692,2683,5375,12129
-10,80,-180,2672,2703,5375,11970
-150,80,-30,2697,2679,5376,12475
160,-80,30,2697,2679,5376,12762
180,10,30,2689,2688,5377,12339
90,-70,-110,2735,2642,5377,12430
-130,80,-50,2715,2662,5377,12397
-180,80,20,2711,2666,5377,12681
-180,10,30,2689,2688,5377,12339
180,80,20,2711,2666,5377,12681
30,-80,-100,2689,2689,5378,12413
-140,-70,50,2714,2664,5378,12237
10,70,-160,2674,2704,5378,12876
140,30,10,2650,2729,5379,12704
130,-40,-20,2716,2663,5379,12528
-170,50,0,2694,2685,5379,12551
30,70,140,2665,2714,5379,12279
140,-50,10,2640,2739,5379,12475
80,-90,-50,2682,2698,5380,12558
-20,-90,-150,2682,2698,5380,12558
120,-90,-10,2682,2698,5380,12558
50,-80,-80,2687,2693,5380,12461
0,-90,-130,2682,2698,5380,12558
110,-90,-20,2682,2698,5380,12558
50,-90,-80,2682,2698,5380,12558
-100,-90,130,2682,2698,5380,12558
180,-90,50,2682,2698,5380,12558
-80,-90,150,2682,2698,5380,12558
170,-90,40,2682,2698,5380,12558
20,-90,-110,2682,2698,5380,12558
40,-90,-90,2682,2698,5380,12558
-130,-90,100,2682,2698,5380,12558
-90,-90,140,2682,2698,5380,12558
-160,-90,70,2682,2698,5380,12558
100,-90,-30,2682,2698,5380,12558
130,-90,0,2682,2698,5380,12558
-30,-90,-160,2682,2698,5380,12558
-60,-90,170,2682,2698,5380,12558
-110,-90,120,2682,2698,5380,12558
140,-90,10,2682,2698,5380,12558
70,-90,-60,2682,2698,5380,12558
-40,-90,-170,2682,2698,5380,12558
-10,-90,-140,2682,2698,5380,12558
90,-90,-40,2682,2698,5380,12558
30,-90,-100,2682,2698,5380,12558
-170,-90,60,2682,2698,5380,12558
-70,-90,160,2682,2698,5380,12558
-140,-90,90,2682,2698,5380,12558
-40,-30,-160,2710,2670,5380,12409
-180,-90,50,2682,2698,5380,12558
-50,-90,-180,2682,2698,5380,12558
10,-90,-120,2682,2698,5380,12558
60,-90,-70,2682,2698,5380,12558
-150,-90,80,2682,2698,5380,12558
150,-90,20,2682,2698,5380,12558
-50,-90,180,2682,2698,5380,12558
-120,-90,110,2682,2698,5380,12558
160,-90,30,2682,2698,5380,12558
-50,-70,120,2702,2679,5381,12642
20,70,140,2689,2692,5381,12304
0,0,-120,2700,2682,5382,12766
30,10,170,2697,2686,5383,12151
120,80,90,2696,2687,5383,12680
20,-80,-110,2678,2705,5383,12484
20,0,-130,2670,2714,5384,12495
-120,-80,50,2693,2691,5384,12379
-170,70,-20,2685,2700,5385,12647
30,50,140,2688,2698,5386,12174
70,-70,-60,2691,2695,5386,12762
-10,30,150,2709,2677,5386,12486
-150,-50,0,2705,2682,5387,12355
60,-30,-130,2696,2691,5387,12926
0,-80,170,2692,2695,5387,12319
-180,70,-10,2713,2676,5389,12557
170,-20,30,2710,2679,5389,12246
130,50,30,2656,2733,5389,12583
180,70,-10,2713,2676,5389,12557
60,-80,-70,2696,2693,5389,12556
-170,70,10,2675,2715,5390,12493
-170,-50,40,2699,2691,5390,12428
10,-10,-120,2711,2680,5391,13042
-40,40,-130,2730,2661,5391,12616
-160,80,-20,2712,2680,5392,12527
0,-30,-130,2753,2639,5392,12669
90,-70,-40,2680,2712,5392,12834
-160,-80,20,2731,2661,5392,12384
150,-80,20,2714,2678,5392,12781
40,60,150,2701,2691,5392,12483
-160,-10,-20,2761,2631,5392,12410
-140,-60,30,2697,2695,5392,12446
-10,-80,160,2708,2684,5392,12329
50,-90,-140,2741,2652,5393,12421
10,-90,180,2741,2652,5393,12421
-70,-90,100,2741,2652,5393,12421
-60,-90,110,2741,2652,5393,12421
30,-90,-160,2741,2652,5393,12421
-10,-90,160,2741,2652,5393,12421
160,-90,-30,2741,2652,5393,12421
-80,-90,90,2741,2652,5393,12421
40,-90,-150,2741,2652,5393,12421
-90,-90,80,2741,2652,5393,12421
100,-90,-90,2741,2652,5393,12421
-30,-90,140,2741,2652,5393,12421
150,-90,-40,2741,2652,5393,12421
-160,-90,10,2741,2652,5393,12421
-150,-90,20,2741,2652,5393,12421
-40,-90,130,2741,2652,5393,12421
60,-90,-130,2741,2652,5393,12421
170,-90,-20,2741,2652,5393,12421
130,-70,-80,2705,2688,5393,12591
-170,-90,0,2741,2652,5393,12421
10,-90,-180,2741,2652,5393,12421
-130,-90,40,2741,2652,5393,12421
-180,-90,-10,2741,2652,5393,12421
130,-90,-60,2741,2652,5393,12421
-20,-90,150,2741,2652,5393,12421
-110,-90,60,2741,2652,5393,12421
70,-90,-120,2741,2652,5393,12421
180,-90,-10,2741,2652,5393,12421
120,-90,-70,2741,2652,5393,12421
80,-90,-110,2741,2652,5393,12421
-140,-90,30,2741,2652,5393,12421
-120,-90,50,2741,2652,5393,12421
150,-80,-50,2707,2686,5393,12377
20,-90,-170,2741,2652,5393,12421
-50,-90,120,2741,2652,5393,12421
90,-90,-100,2741,2652,5393,12421
-100,-90,70,2741,2652,5393,12421
140,-90,-50,2741,2652,5393,12421
110,-90,-80,2741,2652,5393,12421
0,-90,170,2741,2652,5393,12421
-170,10,-10,2720,2674,5394,12034
140,50,50,2685,2710,5395,12490
30,0,180,2709,2686,5395,12317
-40,-20,-160,2719,2676,5395,12578
30,0,-180,2709,2686,5395,12317
60,80,120,2707,2688,5395,12098
-180,0,30,2695,2701,5396,12583
180,0,30,2695,2701,5396,12583
50,-60,-90,2707,2690,5397,12598
-160,-70,0,2711,2686,5397,12594
80,-70,-50,2681,2716,5397,12894
80,-80,-50,2694,2704,5398,12631
40,80,140,2700,2698,5398,12279
120,-30,-60,2680,2718,5398,12571
50,-70,-80,2673,2725,5398,12739
-60,60,-120,2687,2712,5399,12747
-30,80,-150,2723,2676,5399,12358
180,30,-20,2702,2697,5399,12408
-140,-80,40,2749,2650,5399,12240
150,20,-20,2697,2702,5399,12623
-180,30,-20,2702,2697,5399,12408
-170,-50,30,2740,2660,5400,12326
-160,70,-20,2723,2677,5400,12400
170,10,30,2720,2681,5401,12400
100,-60,-100,2729,2672,5401,12520
-150,-80,30,2749,2652,5401,12292
-160,70,-30,2715,2686,5401,12638
70,-60,-80,2744,2657,5401,12334
140,70,30,2705,2696,5401,12203
130,80,80,2698,2703,5401,12672
-70,-60,140,2737,2665,5402,12402
100,-70,-30,2674,2728,5402,12724
20,-40,-120,2716,2686,5402,12730
80,80,130,2694,2709,5403,12862
40,-70,-90,2665,2738,5403,12836
130,-80,0,2727,2676,5403,12817
-130,-80,50,2726,2678,5404,12226
-10,-80,-140,2666,2738,5404,12468
-10,80,-150,2680,2724,5404,12694
-120,-80,60,2735,2670,5405,12237
180,-50,40,2737,2668,5405,12341
-180,-50,40,2737,2668,5405,12341
60,-70,-70,2688,2717,5405,12695
-170,-60,50,2713,2693,5406,12362
-70,70,-110,2734,2672,5406,12557
-10,-10,-150,2714,2692,5406,12480
0,-20,-140,2732,2674,5406,12550
30,20,-160,2681,2725,5406,12446
0,0,-130,2748,2658,5406,12587
180,10,-40,2692,2715,5407,12854
-170,10,-20,2726,2681,5407,12294
130,-60,0,2676,2731,5407,12452
90,-80,-40,2706,2701,5407,12707
50,80,130,2705,2702,5407,12194
-180,10,-40,2692,2715,5407,12854
-10,40,150,2738,2670,5408,12662
30,60,130,2720,2688,5408,12616
10,-30,-120,2727,2681,5408,12972
130,70,40,2704,2704,5408,12398
30,-70,-160,2758,2651,5409,12226
130,-50,-10,2707,2703,5410,12349
-140,80,-40,2718,2692,5410,12486
30,70,150,2706,2705,5411,12379
-40,-30,150,2762,2649,5411,12948
70,-40,-120,2679,2732,5411,12784
-130,-60,40,2706,2705,5411,12853
-170,60,-10,2736,2676,5412,12661
-20,30,160,2709,2703,5412,12277
20,70,150,2681,2731,5412,12429
150,-70,20,2695,2718,5413,12695
40,80,170,2692,2721,5413,12789
-50,-70,-180,2677,2736,5413,12504
-10,50,-140,2706,2707,5413,12676
-50,-70,180,2677,2736,5413,12504
60,-50,-100,2739,2675,5414,12250
-40,-10,-160,2717,2698,5415,12764
140,70,60,2688,2727,5415,13104
10,20,150,2715,2700,5415,12405
20,-80,-170,2750,2665,5415,12546
-150,-60,10,2719,2697,5416,12501
30,80,150,2697,2719,5416,12376
-170,-30,20,2717,2699,5416,12381
110,-70,-20,2699,2717,5416,12819
130,-50,-30,2746,2670,5416,12540
140,-70,10,2693,2724,5417,12842
20,-70,-110,2715,2702,5417,12739
30,-80,-160,2743,2674,5417,12550
10,-50,-120,2747,2670,5417,12663
30,10,180,2748,2669,5417,12496
30,10,-180,2748,2669,5417,12496
-50,-50,170,2732,2685,5417,12712
0,-20,-130,2768,2649,5417,12826
-20,80,-140,2689,2729,5418,12739
30,-20,-170,2728,2690,5418,12504
170,90,10,2716,2703,5419,12570
60,90,120,2716,2703,5419,12570
-160,90,-20,2716,2703,5419,12570
90,90,90,2716,2703,5419,12570
-140,-70,80,2724,2695,5419,12693
40,90,140,2716,2703,5419,12570
-50,90,-130,2716,2703,5419,12570
-120,90,-60,2716,2703,5419,12570
120,90,60,2716,2703,5419,12570
-40,50,-130,2728,2691,5419,12713
20,90,160,2716,2703,5419,12570
10,90,170,2716,2703,5419,12570
-130,90,-50,2716,2703,5419,12570
-110,90,-70,2716,2703,5419,12570
-90,90,-90,2716,2703,5419,12570
130,90,50,2716,2703,5419,12570
-10,90,-170,2716,2703,5419,12570
50,90,130,2716,2703,5419,12570
100,90,80,2716,2703,5419,12570
180,90,0,2716,2703,5419,12570
70,90,110,2716,2703,5419,12570
-150,90,-30,2716,2703,5419,12570
0,90,180,2716,2703,5419,12570
80,90,100,2716,2703,5419,12570
160,90,20,2716,2703,5419,12570
150,90,30,2716,2703,5419,12570
140,90,40,2716,2703,5419,12570
0,90,-180,2716,2703,5419,12570
-60,90,-120,2716,2703,5419,12570
-170,90,-10,2716,2703,5419,12570
150,-10,-40,2698,2721,5419,12545
-20,90,-160,2716,2703,5419,12570
-80,90,-100,2716,2703,5419,12570
110,90,70,2716,2703,5419,12570
-180,90,0,2716,2703,5419,12570
-70,90,-110,2716,2703,5419,12570
-140,90,-40,2716,2703,5419,12570
-30,90,-150,2716,2703,5419,12570
30,90,150,2716,2703,5419,12570
-100,90,-80,2716,2703,5419,12570
-40,90,-140,2716,2703,5419,12570
-160,-40,-30,2736,2684,5420,12550
10,70,150,2704,2717,5421,12170
-120,-70,60,2767,2654,5421,12490
170,30,30,2709,2712,5421,12576
-30,10,160,2718,2703,5421,12558
130,60,40,2694,2727,5421,12671
120,-80,-70,2765,2656,5421,12672
-150,-60,0,2700,2722,5422,12594
70,80,110,2704,2718,5422,12184
-100,-70,70,2711,2711,5422,12747
-20,-80,-150,2679,2744,5423,12445
-50,30,-150,2705,2718,5423,12493
-160,-20,-30,2715,2709,5424,12726
120,70,70,2715,2709,5424,12701
10,-80,180,2725,2700,5425,12480
10,-80,-180,2725,2700,5425,12480
130,70,50,2742,2684,5426,12567
10,-70,-120,2726,2700,5426,12806
-170,80,-10,2740,2686,5426,12617
10,-80,-120,2678,2749,5427,12530
140,10,20,2738,2689,5427,12834
150,60,20,2718,2709,5427,12420
-100,80,-70,2716,2711,5427,12940
0,40,-140,2713,2715,5428,12903
-170,20,20,2736,2692,5428,12817
-30,30,-140,2779,2649,5428,12594
20,-20,170,2733,2695,5428,12423
90,80,90,2717,2712,5429,12272
140,-80,-50,2773,2656,5429,12767
140,40,20,2677,2752,5429,12380
140,-80,10,2740,2690,5430,12851
130,-80,-60,2779,2651,5430,12635
-10,70,170,2732,2698,5430,12002
10,-30,-130,2758,2672,5430,12840
-60,-60,120,2760,2670,5430,12580
50,70,140,2711,2719,5430,12632
-70,80,-100,2726,2705,5431,12693
-30,-10,-150,2754,2677,5431,12763
-130,-80,40,2719,2712,5431,12429
20,20,-140,2726,2705,5431,12637
100,80,80,2715,2716,5431,12498
-170,-30,0,2727,2704,5431,12461
170,40,-20,2717,2716,5433,12480
120,-50,-80,2738,2695,5433,12597
-10,10,-130,2725,2708,5433,12640
0,-20,160,2750,2683,5433,12308
0,-50,-130,2747,2686,5433,12755
-50,70,-130,2737,2696,5433,12500
170,80,30,2731,2702,5433,12806
-20,70,-140,2700,2734,5434,12733
0,-40,-130,2748,2686,5434,12618
-60,70,-120,2734,2701,5435,12609
150,20,30,2721,2714,5435,12718
-140,-60,20,2744,2691,5435,12793
130,40,40,2713,2723,5436,12754
-170,-80,10,2763,2673,5436,12369
-160,-10,-30,2762,2674,5436,12201
-140,80,-30,2748,2689,5437,12663
-130,-70,60,2722,2715,5437,12314
-90,80,-80,2733,2705,5438,12879
-30,0,-150,2752,2686,5438,12650
130,60,50,2724,2714,5438,12443
30,-30,-130,2733,2706,5439,12590
-50,-50,140,2776,2663,5439,12629
70,-80,-60,2719,2720,5439,12613
10,-40,-120,2755,2684,5439,12937
50,-80,-140,2762,2677,5439,12633
40,-60,-100,2748,2692,5440,12780
-10,-10,-130,2742,2699,5441,12784
80,80,100,2724,2717,5441,12252
-10,10,-140,2756,2685,5441,12675
160,30,-20,2710,2731,5441,12746
-90,-70,130,2725,2717,5442,12650
140,50,20,2674,2768,5442,12366
-170,-70,10,2747,2695,5442,12221
30,-70,-100,2711,2732,5443,12867
-170,-30,10,2745,2698,5443,12696
-60,80,-110,2737,2706,5443,12765
-150,-30,-20,2750,2693,5443,13032
-110,-80,70,2763,2680,5443,12371
-80,80,-90,2737,2706,5443,12796
140,-60,-70,2767,2678,5445,12641
0,-10,-140,2770,2675,5445,12738
-180,20,-30,2730,2715,5445,12641
-160,70,-10,2732,2713,5445,12531
70,-40,-100,2710,2735,5445,12838
180,20,-30,2730,2715,5445,12641
-150,-30,-10,2763,2683,5446,12619
70,80,140,2721,2725,5446,12973
50,80,160,2703,2743,5446,12913
-110,80,-60,2723,2723,5446,12898
-10,0,-140,2748,2698,5446,12587
-70,60,-130,2708,2738,5446,12706
10,40,-150,2746,2701,5447,12444
-20,80,-160,2748,2699,5447,12412
110,-40,-80,2701,2746,5447,13064
60,-60,-90,2754,2693,5447,12505
170,20,-30,2711,2737,5448,12570
0,80,-160,2713,2735,5448,12659
90,-60,-70,2765,2683,5448,12372
180,-10,30,2758,2691,5449,12422
150,-10,20,2740,2709,5449,12771
-180,-10,30,2758,2691,5449,12422
-30,70,-160,2685,2764,5449,12175
10,20,-130,2708,2742,5450,12718
-160,-20,-20,2786,2664,5450,12256
60,-30,-120,2718,2732,5450,13020
-30,-60,140,2770,2680,5450,12827
140,-60,10,2711,2739,5450,12654
-40,60,-130,2730,2720,5450,12665
-20,60,-140,2720,2731,5451,12669
-70,-60,120,2765,2686,5451,12703
-100,-80,80,2777,2675,5452,12447
-140,-80,30,2739,2713,5452,12612
30,20,-170,2719,2733,5452,12592
120,-80,-10,2724,2728,5452,12834
-170,-50,0,2769,2684,5453,12271
30,60,140,2714,2739,5453,12501
140,20,30,2714,2739,5453,12803
30,40,170,2746,2707,5453,12412
140,0,-10,2727,2726,5453,12776
-40,60,-160,2730,2724,5454,12628
0,60,-150,2728,2726,5454,12911
-150,-50,-10,2742,2712,5454,12725
-30,-50,-150,2717,2737,5454,12854
140,-30,0,2736,2718,5454,12641
-170,-70,20,2763,2692,5455,12199
140,-40,0,2715,2740,5455,12570
0,-10,160,2765,2690,5455,12693
30,30,170,2761,2694,5455,12493
10,-20,-140,2756,2700,5456,12560
20,-60,-110,2707,2749,5456,12830
40,70,150,2721,2735,5456,12900
0,-70,170,2771,2686,5457,12490
-40,0,-160,2760,2697,5457,12703
50,-20,-140,2764,2693,5457,13027
-30,60,-180,2722,2736,5458,12564
-30,60,180,2722,2736,5458,12564
50,-60,-100,2763,2695,5458,12557
0,0,-140,2753,2705,5458,12361
40,-70,-150,2764,2695,5459,12262
-40,60,-150,2713,2747,5460,12538
10,-70,180,2792,2668,5460,12522
10,-70,-180,2792,2668,5460,12522
120,-70,-10,2715,2745,5460,12900
-160,-30,-30,2733,2728,5461,12768
40,-80,-150,2770,2691,5461,12549
0,-10,-150,2701,2760,5461,12321
170,80,10,2753,2708,5461,12534
30,10,-150,2734,2727,5461,12601
170,-70,-40,2777,2685,5462,12679
110,80,70,2734,2728,5462,12625
110,-80,-80,2791,2672,5463,12734
140,-10,-10,2733,2730,5463,12715
20,-70,-170,2774,2690,5464,12274
-20,50,-140,2716,2748,5464,12615
0,70,160,2731,2733,5464,12265
180,60,-10,2735,2729,5464,12556
-180,60,-10,2735,2729,5464,12556
-70,-60,130,2745,2719,5464,12671
30,50,170,2742,2723,5465,12529
-40,-70,130,2757,2708,5465,12985
-150,-70,70,2742,2723,5465,12948
-40,40,-140,2775,2691,5466,12639
-40,70,-140,2735,2731,5466,12599
-130,80,-40,2732,2735,5467,12849
0,10,-140,2742,2725,5467,12690
50,-20,-130,2730,2737,5467,12899
180,80,0,2766,2701,5467,12614
-180,80,0,2766,2701,5467,12614
150,40,40,2748,2720,5468,12814
30,60,180,2726,2742,5468,12880
130,50,50,2724,2744,5468,12862
30,60,-180,2726,2742,5468,12880
60,-40,-110,2775,2693,5468,12735
-10,20,-140,2770,2699,5469,12725
-20,-50,-140,2747,2722,5469,12715
160,70,20,2757,2712,5469,12582
-170,-20,-40,2752,2717,5469,12965
-170,10,-30,2752,2717,5469,12586
30,-50,-120,2771,2698,5469,12790
150,-80,-40,2791,2679,5470,12631
100,-80,-30,2737,2733,5470,12805
-150,-40,-20,2765,2705,5470,12970
-150,-80,20,2749,2721,5470,12597
10,30,-140,2734,2736,5470,12650
20,-40,-130,2766,2704,5470,12724
-180,-60,10,2770,2700,5470,12430
180,-60,10,2770,2700,5470,12430
0,-10,-130,2786,2685,5471,12850
100,-80,-90,2797,2674,5471,12610
140,60,30,2714,2758,5472,12739
0,10,-130,2754,2718,5472,12974
-170,0,0,2775,2697,5472,12583
-170,-20,10,2763,2710,5473,12654
150,40,0,2721,2753,5474,12665
0,-30,-140,2776,2698,5474,12681
110,-80,-20,2727,2747,5474,12850
160,-30,-50,2769,2705,5474,12812
-10,80,-170,2750,2725,5475,12653
-50,60,-130,2755,2720,5475,12821
10,10,-130,2738,2738,5476,12905
-170,-10,-40,2729,2748,5477,12981
-160,-60,0,2743,2734,5477,12546
140,-20,10,2733,2744,5477,12960
160,-80,-30,2775,2703,5478,12553
10,-60,-120,2723,2757,5480,12821
100,-70,-100,2800,2680,5480,12636
0,-80,-130,2686,2794,5480,12514
160,20,30,2751,2729,5480,12661
-120,80,-50,2732,2748,5480,12962
160,80,40,2759,2722,5481,12943
130,50,40,2707,2774,5481,12637
-170,-70,-10,2752,2729,5481,12591
0,20,150,2767,2715,5482,12488
-150,80,-20,2771,2711,5482,12671
-170,60,0,2749,2733,5482,12666
130,-30,-60,2684,2798,5482,12588
80,-40,-100,2736,2746,5482,12729
170,30,-20,2750,2732,5482,12759
-10,-40,-140,2744,2739,5483,12593
130,-50,-20,2741,2742,5483,12699
60,80,150,2725,2758,5483,12897
-40,70,-130,2736,2747,5483,12531
170,-30,30,2753,2730,5483,12560
10,30,-130,2776,2707,5483,13222
-50,50,-140,2736,2747,5483,12472
170,50,-10,2726,2758,5484,12850
0,-70,-130,2747,2737,5484,12907
150,50,10,2730,2755,5485,12924
-20,70,-170,2710,2775,5485,12153
-30,-70,-160,2713,2772,5485,12584
170,0,-40,2763,2722,5485,13061
-160,-80,10,2761,2725,5486,12510
10,80,170,2738,2748,5486,12690
-60,-60,160,2772,2715,5487,12633
90,-70,-50,2749,2738,5487,12629
-40,30,180,2750,2737,5487,12614
20,80,160,2736,2751,5487,12638
100,-60,-60,2795,2692,5487,12399
-40,30,-180,2750,2737,5487,12614
170,-80,-20,2769,2718,5487,12437
-10,-80,-150,2739,2749,5488,12772
-160,80,-10,2765,2723,5488,12763
-10,-70,160,2771,2717,5488,12616
30,-50,-160,2794,2695,5489,12437
140,-40,-60,2778,2711,5489,12737
10,-40,170,2773,2716,5489,12660
-10,0,-150,2796,2694,5490,12599
-90,-80,90,2799,2691,5490,12501
-20,-50,150,2782,2708,5490,12625
-170,0,-40,2752,2739,5491,13094
-180,-80,0,2791,2701,5492,12393
-10,40,-140,2753,2739,5492,12778
0,80,-180,2733,2759,5492,12659
180,-80,0,2791,2701,5492,12393
30,70,160,2753,2739,5492,12857
0,80,180,2733,2759,5492,12659
20,70,-170,2737,2755,5492,12948
160,-30,20,2760,2733,5493,12580
160,10,-30,2738,2755,5493,12836
0,-80,-140,2746,2748,5494,12817
10,80,-170,2740,2754,5494,12817
-180,-80,-10,2761,2734,5495,12360
-150,-80,40,2774,2721,5495,12720
180,-80,-10,2761,2734,5495,12360
100,-40,-80,2737,2758,5495,12878
140,70,40,2781,2715,5496,12676
50,-30,-120,2745,2751,5496,12766
-20,30,-140,2758,2738,5496,12915
-40,40,-170,2766,2730,5496,12834
30,40,150,2749,2747,5496,12449
50,70,150,2755,2741,5496,13016
-160,-70,60,2766,2730,5496,12620
-100,-70,110,2776,2721,5497,12511
-30,20,-150,2779,2718,5497,12647
60,-80,-130,2792,2705,5497,12687
10,-10,-140,2741,2756,5497,12616
100,-70,-40,2744,2753,5497,12548
-110,-70,100,2781,2716,5497,12514
10,-30,-140,2770,2728,5498,12662
-40,20,180,2769,2729,5498,12690
-40,20,-180,2769,2729,5498,12690
-140,-80,80,2764,2734,5498,12528
-120,-70,80,2755,2743,5498,12437
-130,-80,90,2761,2737,5498,12658
-140,-80,50,2781,2718,5499,12868
10,-40,-130,2774,2725,5499,12702
-180,70,20,2737,2762,5499,12899
-10,-20,-150,2763,2736,5499,12574
180,70,20,2737,2762,5499,12899
130,-70,0,2727,2773,5500,12856
130,70,60,2757,2743,5500,12824
40,70,170,2730,2770,5500,13144
90,-80,-100,2807,2694,5501,12642
-160,-80,30,2771,2730,5501,12684
-50,50,-130,2768,2733,5501,13033
-40,-70,-170,2723,2778,5501,12760
-50,90,-110,2735,2767,5502,12957
160,90,40,2735,2767,5502,12957
20,90,180,2735,2767,5502,12957
-110,90,-50,2735,2767,5502,12957
-180,90,20,2735,2767,5502,12957
180,90,20,2735,2767,5502,12957
-170,90,10,2735,2767,5502,12957
-160,90,0,2735,2767,5502,12957
130,90,70,2735,2767,5502,12957
-60,90,-100,2735,2767,5502,12957
-130,90,-30,2735,2767,5502,12957
80,90,120,2735,2767,5502,12957
50,90,150,2735,2767,5502,12957
-90,90,-70,2735,2767,5502,12957
-40,90,-120,2735,2767,5502,12957
100,90,100,2735,2767,5502,12957
0,30,-140,2735,2767,5502,13070
30,90,170,2735,2767,5502,12957
140,90,60,2735,2767,5502,12957
60,90,140,2735,2767,5502,12957
170,90,30,2735,2767,5502,12957
-20,90,-140,2735,2767,5502,12957
-150,90,-10,2735,2767,5502,12957
110,90,90,2735,2767,5502,12957
120,90,80,2735,2767,5502,12957
-30,90,-130,2735,2767,5502,12957
40,90,160,2735,2767,5502,12957
-140,90,-20,2735,2767,5502,12957
10,90,-170,2735,2767,5502,12957
90,90,110,2735,2767,5502,12957
20,90,-180,2735,2767,5502,12957
-10,90,-150,2735,2767,5502,12957
-120,90,-40,2735,2767,5502,12957
150,90,50,2735,2767,5502,12957
0,90,-160,2735,2767,5502,12957
-70,90,-90,2735,2767,5502,12957
70,90,130,2735,2767,5502,12957
-80,90,-80,2735,2767,5502,12957
-100,90,-60,2735,2767,5502,12957
-130,-70,80,2757,2746,5503,12898
-110,-80,110,2772,2731,5503,12775
-50,80,-120,2756,2748,5504,12896
-120,-80,100,2761,2743,5504,12763
-40,10,-160,2755,2749,5504,12878
0,60,150,2761,2743,5504,12808
-30,-20,-150,2744,2760,5504,12881
10,40,140,2768,2736,5504,12779
10,50,140,2792,2713,5505,12987
-170,-60,30,2746,2759,5505,12439
-120,-70,90,2777,2728,5505,12687
180,50,-10,2774,2731,5505,12729
30,30,160,2795,2710,5505,12663
-180,50,-10,2774,2731,5505,12729
10,60,-160,2729,2777,5506,13066
170,40,30,2741,2765,5506,13102
20,-50,-120,2772,2735,5507,13102
150,10,-20,2737,2770,5507,12803
120,80,60,2766,2742,5508,12758
20,20,-150,2780,2728,5508,12672
-180,-60,40,2756,2752,5508,12825
-170,80,0,2781,2727,5508,12740
180,-60,40,2756,2752,5508,12825
30,-40,-160,2783,2725,5508,12744
140,60,50,2724,2785,5509,12983
-10,70,-150,2739,2770,5509,12805
-180,-70,10,2796,2713,5509,12486
180,-70,10,2796,2713,5509,12486
-110,-70,60,2745,2764,5509,13114
140,20,10,2724,2786,5510,12897
160,-10,-40,2770,2740,5510,12573
10,20,-140,2731,2779,5510,12651
-170,-20,20,2737,2773,5510,12834
170,-80,-10,2794,2717,5511,12546
140,10,10,2737,2774,5511,12921
140,80,40,2778,2733,5511,12776
140,20,0,2726,2785,5511,12994
140,-70,-70,2747,2764,5511,12845
70,-80,-120,2809,2702,5511,12689
-40,10,180,2775,2738,5513,13151
-40,10,-180,2775,2738,5513,13151
-10,70,180,2742,2771,5513,12362
30,80,160,2785,2728,5513,12729
150,-60,-60,2796,2717,5513,12773
-10,70,-180,2742,2771,5513,12362
150,70,30,2783,2731,5514,12808
-30,70,-150,2754,2761,5515,12717
-170,-80,0,2768,2747,5515,12454
50,-50,-140,2781,2734,5515,12720
-60,50,-140,2761,2755,5516,12934
130,80,50,2776,2740,5516,12776
-10,-70,-140,2742,2774,5516,12665
-90,-70,120,2788,2729,5517,12678
90,-40,-90,2769,2749,5518,12871
160,80,20,2782,2736,5518,12608
30,70,-180,2732,2786,5518,13032
80,-80,-110,2811,2707,5518,12698
30,70,180,2732,2786,5518,13032
-30,60,-170,2769,2749,5518,12505
170,70,10,2793,2726,5519,12604
50,-50,-110,2782,2737,5519,12760
160,-70,-50,2783,2736,5519,12879
160,60,40,2775,2744,5519,12968
-120,-70,70,2769,2750,5519,12560
80,-60,-80,2783,2736,5519,12543
30,-10,-170,2808,2712,5520,12734
-20,20,160,2762,2758,5520,12413
-30,20,170,2775,2746,5521,12637
130,-60,-10,2733,2788,5521,12930
140,-30,-10,2797,2724,5521,12715
-30,-40,150,2827,2694,5521,12838
140,30,20,2759,2762,5521,12677
20,10,-140,2776,2746,5522,12917
-40,-10,170,2781,2741,5522,12672
110,-60,-90,2785,2738,5523,12677
-170,-70,50,2781,2742,5523,12698
180,-30,30,2796,2728,5524,12755
30,20,180,2815,2709,5524,12788
-180,-30,30,2796,2728,5524,12755
-40,-50,140,2803,2721,5524,12587
30,20,-180,2815,2709,5524,12788
10,30,-150,2778,2746,5524,12865
180,80,10,2768,2757,5525,12854
30,-40,-130,2803,2722,5525,12770
-180,80,10,2768,2757,5525,12854
130,-40,-30,2770,2756,5526,12638
-180,-50,10,2783,2743,5526,12604
180,-50,10,2783,2743,5526,12604
-20,10,-150,2820,2706,5526,12810
40,-50,-150,2810,2716,5526,12672
-150,-80,70,2791,2735,5526,12609
-160,-60,-10,2781,2747,5528,12691
80,-70,-60,2784,2744,5528,12709
160,50,0,2751,2777,5528,12742
-50,60,-150,2755,2773,5528,12900
120,-40,-50,2785,2744,5529,12560
-80,-70,140,2774,2755,5529,12775
150,80,30,2791,2739,5530,12574
30,-60,-110,2802,2728,5530,13040
30,0,-170,2791,2739,5530,12717
-30,70,-140,2765,2765,5530,12832
140,-90,0,2763,2768,5531,12899
30,-90,-110,2763,2768,5531,12899
130,-90,-10,2763,2768,5531,12899
-130,-90,90,2763,2768,5531,12899
-60,-90,160,2763,2768,5531,12899
-110,-90,110,2763,2768,5531,12899
-160,-90,60,2763,2768,5531,12899
180,-70,0,2791,2740,5531,12251
170,-90,30,2763,2768,5531,12899
-40,-90,-180,2763,2768,5531,12899
90,-90,-50,2763,2768,5531,12899
40,-90,-100,2763,2768,5531,12899
10,-90,-130,2763,2768,5531,12899
-50,-90,170,2763,2768,5531,12899
-170,-90,50,2763,2768,5531,12899
100,-90,-40,2763,2768,5531,12899
-140,-90,80,2763,2768,5531,12899
20,-90,-120,2763,2768,5531,12899
-100,-90,120,2763,2768,5531,12899
0,-90,-140,2763,2768,5531,12899
80,-90,-60,2763,2768,5531,12899
-10,-90,-150,2763,2768,5531,12899
-150,-90,70,2763,2768,5531,12899
-90,-90,130,2763,2768,5531,12899
150,-90,10,2763,2768,5531,12899
110,-90,-30,2763,2768,5531,12899
180,-90,40,2763,2768,5531,12899
60,-90,-80,2763,2768,5531,12899
-120,-90,100,2763,2768,5531,12899
150,80,50,2773,2758,5531,13108
-70,-90,150,2763,2768,5531,12899
-180,-90,40,2763,2768,5531,12899
70,-90,-70,2763,2768,5531,12899
120,-90,-20,2763,2768,5531,12899
-40,-90,180,2763,2768,5531,12899
60,-70,-80,2781,2750,5531,12677
160,-90,20,2763,2768,5531,12899
-80,-90,140,2763,2768,5531,12899
-30,-90,-170,2763,2768,5531,12899
-20,-90,-160,2763,2768,5531,12899
-180,-70,0,2791,2740,5531,12251
50,-90,-90,2763,2768,5531,12899
0,0,-150,2762,2770,5532,12641
110,-60,-50,2812,2720,5532,12754
150,0,20,2751,2781,5532,12912
0,20,-140,2776,2757,5533,12950
-10,-20,160,2782,2751,5533,12633
-40,30,-150,2775,2759,5534,12954
0,-60,-130,2775,2759,5534,12621
140,40,40,2746,2788,5534,12779
20,80,170,2795,2739,5534,12708
-160,-40,-10,2811,2724,5535,12816
-20,-70,-150,2746,2789,5535,12595
120,-60,-30,2773,2762,5535,12749
120,90,70,2764,2772,5536,12951
-50,90,-120,2764,2772,5536,12951
-160,90,-10,2764,2772,5536,12951
-120,90,-50,2764,2772,5536,12951
-130,90,-40,2764,2772,5536,12951
20,90,170,2764,2772,5536,12951
-10,90,-160,2764,2772,5536,12951
50,90,140,2764,2772,5536,12951
90,90,100,2764,2772,5536,12951
-100,90,-70,2764,2772,5536,12951
150,90,40,2764,2772,5536,12951
20,70,160,2784,2752,5536,12738
30,90,160,2764,2772,5536,12951
80,90,110,2764,2772,5536,12951
10,90,-180,2764,2772,5536,12951
10,90,180,2764,2772,5536,12951
60,90,130,2764,2772,5536,12951
70,90,120,2764,2772,5536,12951
-90,90,-80,2764,2772,5536,12951
-60,90,-110,2764,2772,5536,12951
-180,90,10,2764,2772,5536,12951
-20,90,-150,2764,2772,5536,12951
-110,90,-60,2764,2772,5536,12951
30,10,-170,2801,2735,5536,12854
-140,90,-30,2764,2772,5536,12951
-80,90,-90,2764,2772,5536,12951
140,90,50,2764,2772,5536,12951
170,90,20,2764,2772,5536,12951
130,90,60,2764,2772,5536,12951
-170,90,0,2764,2772,5536,12951
180,90,10,2764,2772,5536,12951
-70,90,-100,2764,2772,5536,12951
-30,90,-140,2764,2772,5536,12951
40,90,150,2764,2772,5536,12951
110,90,80,2764,2772,5536,12951
0,90,-170,2764,2772,5536,12951
-40,90,-130,2764,2772,5536,12951
100,80,90,2795,2741,5536,12672
100,90,90,2764,2772,5536,12951
-150,90,-20,2764,2772,5536,12951
160,90,30,2764,2772,5536,12951
150,-70,-60,2782,2755,5537,12825
-170,70,-10,2797,2740,5537,12843
-110,-70,70,2807,2730,5537,12843
50,-70,-140,2832,2706,5538,12511
130,-30,-40,2799,2739,5538,12525
10,-80,-130,2780,2758,5538,13031
-180,50,20,2765,2774,5539,13031
180,50,20,2765,2774,5539,13031
160,70,40,2785,2754,5539,13253
90,80,100,2784,2756,5540,12655
-30,-70,140,2800,2741,5541,13057
160,-40,20,2778,2764,5542,12694
10,70,160,2766,2776,5542,12686
-160,-80,60,2803,2739,5542,12816
40,-20,-130,2778,2764,5542,12841
-110,-70,90,2783,2759,5542,12642
-100,-80,120,2791,2752,5543,12798
180,-70,-20,2780,2763,5543,12858
-50,-60,170,2772,2771,5543,12652
-180,-70,-20,2780,2763,5543,12858
140,-50,0,2739,2804,5543,12848
90,-50,-100,2756,2788,5544,12852
-20,-70,150,2796,2749,5545,12910
140,-20,-20,2810,2735,5545,12660
-40,-40,150,2822,2723,5545,12799
-40,60,-140,2766,2779,5545,12726
60,-40,-130,2789,2757,5546,13077
-30,50,180,2776,2770,5546,12848
-20,0,-150,2793,2753,5546,12952
-30,50,-180,2776,2770,5546,12848
-180,40,-10,2793,2754,5547,12696
-10,-50,-140,2776,2771,5547,12671
180,40,-10,2793,2754,5547,12696
-130,-70,70,2770,2777,5547,12579
-110,-70,80,2778,2769,5547,12851
70,-70,-70,2784,2764,5548,12647
40,-40,-150,2820,2728,5548,12843
-120,-70,50,2777,2772,5549,13108
-180,-30,-40,2784,2765,5549,12967
180,-30,-40,2784,2765,5549,12967
30,-60,-160,2824,2725,5549,12528
-170,-10,0,2791,2758,5549,12827
120,80,70,2808,2742,5550,12695
140,10,0,2766,2784,5550,12878
-40,-20,160,2801,2749,5550,12804
180,60,20,2779,2771,5550,13090
-180,60,20,2779,2771,5550,13090
-170,-60,40,2793,2757,5550,12653
180,-50,-40,2792,2758,5550,12879
-180,-50,-40,2792,2758,5550,12879
-170,-80,20,2826,2725,5551,12697
20,30,150,2795,2756,5551,12707
110,-70,-30,2765,2786,5551,12895
-30,60,-140,2754,2798,5552,12714
-180,70,0,2798,2754,5552,12938
180,70,0,2798,2754,5552,12938
40,-80,-100,2797,2755,5552,13097
-30,-30,-150,2754,2798,5552,12983
-170,-60,-20,2817,2735,5552,12895
50,-40,-120,2784,2769,5553,12951
-170,-20,0,2815,2738,5553,12922
50,-40,-140,2843,2711,5554,12882
-40,80,-130,2784,2770,5554,12944
30,-80,-110,2810,2745,5555,13152
-60,60,-140,2750,2805,5555,12817
10,-40,-140,2800,2755,5555,12720
-170,10,10,2821,2734,5555,13099
20,-60,-170,2852,2704,5556,12566
-170,-80,50,2830,2726,5556,12936
-170,-50,-30,2816,2740,5556,12951
-80,-80,100,2823,2733,5556,12721
10,80,180,2816,2741,5557,12956
-170,-60,0,2796,2761,5557,12726
10,80,-180,2816,2741,5557,12956
50,80,140,2788,2769,5557,12825
160,-20,20,2762,2796,5558,12895
-130,-80,60,2822,2736,5558,12818
-80,-70,130,2807,2751,5558,12794
40,-10,-150,2801,2757,5558,12966
-180,-40,-40,2807,2752,5559,12907
110,80,80,2819,2740,5559,12766
130,80,60,2813,2746,5559,12861
180,-40,-40,2807,2752,5559,12907
20,80,180,2772,2788,5560,13002
140,-20,-30,2794,2766,5560,12600
20,80,-180,2772,2788,5560,13002
110,-70,-90,2823,2738,5561,12848
80,80,110,2797,2764,5561,12698
170,60,0,2778,2783,5561,12799
0,80,-170,2807,2754,5561,13077
20,-80,-120,2804,2757,5561,13141
160,60,10,2794,2768,5562,12725
-10,30,-140,2785,2777,5562,13001
-180,-20,30,2816,2746,5562,12612
0,70,170,2774,2788,5562,12620
180,-20,30,2816,2746,5562,12612
140,60,40,2825,2737,5562,12746
40,80,150,2799,2764,5563,12761
170,70,30,2791,2772,5563,13172
30,0,-140,2813,2750,5563,12829
-170,-40,-10,2832,2731,5563,12797
-20,70,-150,2780,2784,5564,12835
180,40,20,2771,2793,5564,13179
-180,40,20,2771,2793,5564,13179
30,60,170,2782,2783,5565,12987
110,-40,-70,2753,2812,5565,12876
150,70,50,2772,2794,5566,13212
-30,-60,-160,2789,2777,5566,13001
170,50,30,2785,2782,5567,13246
140,-20,-10,2788,2779,5567,12739
-170,0,-10,2830,2737,5567,12740
-100,-70,100,2806,2762,5568,12976
40,-60,-110,2837,2731,5568,12752
-130,-70,40,2769,2800,5569,13102
60,-80,-80,2816,2753,5569,13308
130,80,70,2807,2762,5569,13207
170,80,20,2777,2793,5570,12981
40,-10,-140,2815,2756,5571,13054
170,-40,30,2782,2789,5571,12698
160,-40,-50,2802,2769,5571,12953
-20,70,-160,2782,2789,5571,12778
20,50,-170,2799,2772,5571,12956
170,70,20,2808,2764,5572,13084
10,0,160,2784,2789,5573,12726
-90,-80,130,2811,2762,5573,12893
180,-70,40,2796,2778,5574,12979
40,-60,-150,2823,2751,5574,12753
-10,-10,160,2774,2800,5574,12620
-140,-70,70,2823,2751,5574,13042
-180,-70,40,2796,2778,5574,12979
-30,40,-140,2820,2755,5575,13045
140,50,30,2786,2790,5576,12971
-70,-80,110,2828,2749,5577,12711
-170,-60,-10,2814,2763,5577,12797
-20,-80,-160,2792,2785,5577,12812
-160,-50,-20,2808,2769,5577,13012
30,80,170,2759,2818,5577,13130
-10,20,-150,2795,2782,5577,12707
50,-80,-90,2814,2763,5577,13174
0,-20,-150,2814,2764,5578,12611
170,-70,-10,2818,2760,5578,12612
20,40,140,2808,2770,5578,13206
90,80,110,2798,2781,5579,13211
110,80,90,2797,2782,5579,13329
-30,-40,-150,2773,2807,5580,13146
140,-20,0,2821,2759,5580,13076
-20,20,-150,2870,2711,5581,12587
-50,-50,160,2831,2750,5581,12747
20,30,-160,2814,2767,5581,12731
120,80,80,2806,2775,5581,13240
-10,10,-150,2852,2729,5581,12776
160,40,-10,2778,2803,5581,12749
20,70,170,2814,2768,5582,12834
70,80,120,2791,2791,5582,12713
170,-70,-30,2777,2805,5582,13060
180,-60,20,2770,2813,5583,12539
-180,-60,20,2770,2813,5583,12539
70,-80,-70,2818,2765,5583,13226
90,-50,-80,2798,2785,5583,12825
80,-80,-60,2808,2776,5584,13115
-150,-70,20,2774,2810,5584,12966
10,0,-140,2758,2826,5584,13024
20,-50,-170,2859,2725,5584,12611
-20,-20,-150,2784,2800,5584,12989
140,-10,10,2777,2807,5584,13291
-10,70,-170,2778,2807,5585,12783
-20,60,-150,2796,2789,5585,12812
-40,-50,-170,2769,2817,5586,13167
170,60,30,2786,2800,5586,13119
170,-60,30,2762,2824,5586,12984
30,50,150,2765,2822,5587,12704
150,50,20,2782,2805,5587,12744
160,60,20,2817,2770,5587,13077
-160,-70,40,2791,2796,5587,12653
90,-80,-50,2804,2784,5588,13147
150,-80,10,2794,2794,5588,13019
-140,-70,60,2777,2811,5588,12769
-170,70,0,2779,2809,5588,12984
20,-30,-180,2821,2768,5589,12787
0,-40,-140,2809,2780,5589,12644
20,-30,180,2821,2768,5589,12787
10,-50,-130,2836,2753,5589,12996
-170,-70,0,2762,2827,5589,13049
140,20,20,2805,2784,5589,13057
60,80,130,2798,2793,5591,12803
180,-60,0,2805,2786,5591,12644
-180,-60,0,2805,2786,5591,12644
-40,50,-150,2844,2748,5592,12884
-20,60,-180,2785,2807,5592,12786
-20,-10,-150,2799,2793,5592,13024
-20,60,180,2785,2807,5592,12786
-10,80,-160,2821,2772,5593,13194
-170,10,20,2820,2774,5594,13128
-10,-30,-150,2816,2778,5594,12761
40,70,160,2796,2798,5594,13268
150,30,-10,2801,2793,5594,13027
80,80,120,2799,2795,5594,13237
140,-40,-10,2797,2798,5595,12986
160,80,30,2798,2797,5595,13103
-40,-30,-170,2834,2761,5595,13101
180,20,-20,2828,2768,5596,12891
170,-80,30,2836,2760,5596,13070
-170,0,-20,2816,2780,5596,13088
-180,20,-20,2828,2768,5596,12891
140,80,60,2798,2798,5596,13202
150,-40,10,2788,2809,5597,13027
140,-10,0,2805,2792,5597,13223
20,-10,-140,2813,2784,5597,13186
40,-30,-130,2808,2789,5597,13019
100,80,100,2809,2791,5600,13270
-150,-40,-10,2839,2761,5600,13056
-80,-80,140,2817,2784,5601,12925
160,-80,-20,2851,2750,5601,12707
-40,20,-160,2804,2798,5602,12798
-10,70,-160,2822,2780,5602,13120
160,70,30,2838,2764,5602,13078
-40,-60,-170,2782,2821,5603,13082
-150,-70,60,2810,2793,5603,13162
180,70,10,2798,2805,5603,13194
140,70,50,2801,2802,5603,13050
-180,70,10,2798,2805,5603,13194
50,-70,-90,2834,2769,5603,12927
150,-30,-50,2816,2788,5604,12947
-150,-70,50,2785,2819,5604,12669
-30,-80,-170,2788,2816,5604,12875
-40,50,-160,2800,2804,5604,13207
-180,-40,30,2824,2781,5605,12933
180,-40,30,2824,2781,5605,12933
-170,-10,10,2807,2798,5605,13068
-30,50,-140,2816,2789,5605,13212
-50,40,-150,2782,2824,5606,13034
160,-50,-50,2835,2771,5606,12849
140,80,50,2828,2778,5606,12966
-160,-90,20,2837,2770,5607,12760
170,-90,-10,2837,2770,5607,12760
150,-90,-30,2837,2770,5607,12760
-120,-90,60,2837,2770,5607,12760
180,-90,0,2837,2770,5607,12760
130,-90,-50,2837,2770,5607,12760
-150,-90,30,2837,2770,5607,12760
120,-90,-60,2837,2770,5607,12760
-110,-90,70,2837,2770,5607,12760
-50,-90,130,2837,2770,5607,12760
80,-90,-100,2837,2770,5607,12760
-10,-90,170,2837,2770,5607,12760
110,-90,-70,2837,2770,5607,12760
150,40,10,2775,2832,5607,13006
-140,-90,40,2837,2770,5607,12760
30,-90,-150,2837,2770,5607,12760
140,-90,-40,2837,2770,5607,12760
50,-90,-130,2837,2770,5607,12760
-130,-90,50,2837,2770,5607,12760
-20,-90,160,2837,2770,5607,12760
10,-90,-170,2837,2770,5607,12760
-80,-90,100,2837,2770,5607,12760
0,-90,-180,2837,2770,5607,12760
-40,-90,140,2837,2770,5607,12760
70,-90,-110,2837,2770,5607,12760
-90,-90,90,2837,2770,5607,12760
-180,-90,0,2837,2770,5607,12760
-30,-90,150,2837,2770,5607,12760
-170,-90,10,2837,2770,5607,12760
100,-90,-80,2837,2770,5607,12760
-70,-90,110,2837,2770,5607,12760
20,-90,-160,2837,2770,5607,12760
40,-90,-140,2837,2770,5607,12760
60,-90,-120,2837,2770,5607,12760
-100,-90,80,2837,2770,5607,12760
0,-90,180,2837,2770,5607,12760
90,-90,-90,2837,2770,5607,12760
-60,-90,120,2837,2770,5607,12760
160,-90,-20,2837,2770,5607,12760
180,-80,40,2824,2784,5608,13014
70,80,130,2802,2806,5608,13295
0,70,-160,2774,2834,5608,13112
-180,-80,40,2824,2784,5608,13014
60,-70,-130,2881,2727,5608,12763
60,-50,-130,2846,2762,5608,12987
70,-50,-120,2831,2777,5608,13089
-40,50,-140,2826,2782,5608,13042
-30,80,-140,2787,2821,5608,13015
-20,-30,-150,2816,2794,5610,12996
-180,0,-40,2825,2785,5610,13360
180,0,-40,2825,2785,5610,13360
-140,-70,30,2797,2813,5610,13043
20,60,140,2833,2777,5610,12888
-20,80,-150,2821,2790,5611,13075
-20,50,-150,2821,2790,5611,13054
140,0,10,2811,2800,5611,13381
140,-20,-40,2761,2851,5612,12772
140,-80,0,2810,2802,5612,12963
20,50,140,2834,2779,5613,12909
0,-30,-150,2821,2792,5613,12860
180,-80,10,2868,2745,5613,12851
-180,-80,10,2868,2745,5613,12851
140,0,0,2805,2808,5613,13065
20,-40,-140,2858,2757,5615,13087
150,50,40,2837,2778,5615,13147
170,-70,30,2824,2791,5615,13117
20,-70,-120,2849,2766,5615,13180
0,30,150,2838,2777,5615,13137
-40,-80,180,2816,2799,5615,12803
-100,-70,80,2827,2788,5615,13159
-40,-80,-180,2816,2799,5615,12803
160,20,-20,2777,2838,5615,13003
120,-70,-80,2864,2752,5616,13121
160,-80,20,2836,2780,5616,13064
10,70,170,2800,2816,5616,12986
-20,40,-150,2829,2787,5616,13031
-40,-20,180,2804,2813,5617,12922
20,-60,-120,2852,2765,5617,13188
140,-50,-10,2834,2783,5617,12917
-40,-20,-180,2804,2813,5617,12922
-120,-80,70,2840,2778,5618,12835
180,30,20,2801,2817,5618,13024
-160,-70,10,2780,2838,5618,12956
-180,30,20,2801,2817,5618,13024
-100,-70,90,2819,2800,5619,13232
140,30,30,2819,2800,5619,13188
20,60,-170,2796,2823,5619,13466
150,80,40,2823,2796,5619,13140
50,80,150,2818,2802,5620,13308
-70,-80,150,2797,2823,5620,12989
80,-60,-110,2862,2759,5621,12904
10,70,-180,2825,2796,5621,12967
10,70,180,2825,2796,5621,12967
140,50,40,2845,2776,5621,13066
40,80,160,2801,2820,5621,13213
30,-70,-110,2854,2768,5622,13202
150,-30,10,2802,2820,5622,13111
150,70,40,2846,2776,5622,13201
-160,-50,-10,2860,2762,5622,12957
80,-50,-110,2810,2813,5623,13100
-50,50,-150,2804,2819,5623,13338
70,-60,-90,2829,2795,5624,12926
100,-50,-70,2814,2810,5624,12855
130,-80,-10,2807,2817,5624,12972
-170,-70,30,2794,2830,5624,12672
0,70,-180,2817,2808,5625,12825
0,70,180,2817,2808,5625,12825
150,-10,-30,2798,2828,5626,12579
40,-30,-150,2867,2759,5626,13240
110,-80,-30,2794,2832,5626,13095
180,-60,-30,2859,2768,5627,13094
-180,-60,-30,2859,2768,5627,13094
160,-10,20,2848,2780,5628,13039
-50,-80,170,2810,2819,5629,12898
0,10,-150,2804,2825,5629,13028
-30,60,-150,2821,2809,5630,12967
10,-60,180,2896,2734,5630,12685
10,-60,-180,2896,2734,5630,12685
-10,-60,-140,2819,2812,5631,12944
-10,-70,-150,2821,2810,5631,13311
170,-60,0,2865,2766,5631,12877
-20,60,170,2816,2815,5631,12882
120,-60,-40,2843,2788,5631,12974
140,40,30,2816,2817,5633,12849
150,0,-20,2821,2812,5633,12789
30,-60,-120,2870,2763,5633,13050
-170,-10,20,2816,2818,5634,13225
-20,40,-140,2834,2800,5634,13106
130,-50,-70,2852,2782,5634,13247
-60,-80,160,2796,2840,5636,12955
120,-80,-20,2823,2813,5636,12967
30,-30,-160,2838,2798,5636,13098
140,-70,-60,2842,2795,5637,13198
160,-60,-50,2846,2791,5637,12978
180,-50,0,2853,2784,5637,12925
-180,-50,0,2853,2784,5637,12925
60,80,140,2830,2807,5637,13371
160,30,30,2805,2832,5637,13268
-60,-60,150,2844,2794,5638,13032
100,-80,-40,2819,2821,5640,13197
-30,-90,160,2855,2787,5642,12682
70,-90,-100,2855,2787,5642,12682
-180,-90,10,2855,2787,5642,12682
160,-50,20,2785,2857,5642,12997
-60,-90,130,2855,2787,5642,12682
100,-90,-70,2855,2787,5642,12682
-90,-90,100,2855,2787,5642,12682
-170,-90,20,2855,2787,5642,12682
60,-90,-110,2855,2787,5642,12682
160,-70,-40,2808,2834,5642,13225
-40,-90,150,2855,2787,5642,12682
90,-90,-80,2855,2787,5642,12682
110,-90,-60,2855,2787,5642,12682
140,-90,-30,2855,2787,5642,12682
-20,-90,170,2855,2787,5642,12682
-140,-90,50,2855,2787,5642,12682
180,-90,10,2855,2787,5642,12682
150,-90,-20,2855,2787,5642,12682
0,-90,-170,2855,2787,5642,12682
30,-90,-140,2855,2787,5642,12682
20,-90,-150,2855,2787,5642,12682
-70,-90,120,2855,2787,5642,12682
120,-90,-50,2855,2787,5642,12682
130,-90,-40,2855,2787,5642,12682
50,-90,-120,2855,2787,5642,12682
-150,-90,40,2855,2787,5642,12682
10,-90,-160,2855,2787,5642,12682
-100,-90,90,2855,2787,5642,12682
40,-90,-130,2855,2787,5642,12682
160,-90,-10,2855,2787,5642,12682
170,-90,0,2855,2787,5642,12682
-160,-90,30,2855,2787,5642,12682
-130,-90,60,2855,2787,5642,12682
-10,-90,-180,2855,2787,5642,12682
80,-90,-90,2855,2787,5642,12682
-10,-90,180,2855,2787,5642,12682
-50,-90,140,2855,2787,5642,12682
-80,-90,110,2855,2787,5642,12682
-110,-90,80,2855,2787,5642,12682
-120,-90,70,2855,2787,5642,12682
10,10,-140,2789,2854,5643,13180
30,60,150,2805,2840,5645,12823
-170,0,-30,2849,2796,5645,13063
-170,-50,-10,2859,2787,5646,12983
10,-20,-150,2826,2820,5646,13046
180,60,10,2839,2807,5646,13422
-180,60,10,2839,2807,5646,13422
-20,-60,-150,2826,2820,5646,12971
-60,-80,120,2857,2790,5647,12844
-70,-70,150,2823,2824,5647,13020
-180,-70,20,2797,2850,5647,12961
180,-70,20,2797,2850,5647,12961
-30,50,-170,2812,2836,5648,13132
-40,-20,170,2829,2819,5648,13195
-40,-40,-170,2820,2829,5649,13117
40,-40,-130,2836,2813,5649,12969
-160,-40,-20,2834,2816,5650,12978
30,60,160,2823,2827,5650,13278
30,40,160,2857,2793,5650,12995
-90,-70,90,2843,2807,5650,13134
-160,-30,-20,2847,2803,5650,13000
150,-80,-30,2871,2779,5650,12857
-180,-50,20,2839,2812,5651,12992
180,-50,20,2839,2812,5651,12992
-170,-30,-10,2863,2788,5651,12880
170,-70,0,2877,2774,5651,12788
160,-70,-20,2869,2783,5652,12804
40,-50,-120,2853,2799,5652,13190
-30,0,160,2833,2819,5652,12956
-20,-20,160,2853,2799,5652,12994
50,-30,-140,2870,2783,5653,13441
140,-50,-20,2858,2795,5653,13229
-30,60,-160,2803,2850,5653,12989
0,-70,-140,2814,2839,5653,13421
-30,50,-150,2852,2801,5653,13133
-110,-80,80,2858,2798,5656,12858
130,-60,-20,2853,2803,5656,13102
0,50,-150,2827,2830,5657,13287
10,-70,-130,2846,2812,5658,13280
20,0,-140,2834,2824,5658,13243
80,-50,-90,2843,2816,5659,13030
-170,-40,-30,2858,2801,5659,12977
-60,-70,160,2815,2845,5660,13174
90,-70,-60,2840,2820,5660,13253
170,-50,30,2813,2848,5661,13093
0,-80,180,2874,2787,5661,12835
20,-50,-130,2886,2775,5661,13243
0,-80,-180,2874,2787,5661,12835
170,-80,0,2883,2779,5662,13036
40,-70,-100,2847,2815,5662,13177
-10,-30,160,2872,2790,5662,12869
10,-40,-150,2866,2796,5662,12953
30,-20,-140,2872,2791,5663,13205
-10,60,160,2853,2811,5664,13259
-50,-60,130,2861,2803,5664,13082
-180,60,0,2851,2814,5665,13185
180,60,0,2851,2814,5665,13185
0,40,150,2873,2792,5665,13084
0,50,150,2874,2791,5665,13090
-40,0,-180,2869,2797,5666,13415
-90,-70,110,2854,2812,5666,13213
180,30,-10,2836,2830,5666,13045
50,-60,-140,2913,2753,5666,13095
-40,0,180,2869,2797,5666,13415
-40,-20,-170,2879,2787,5666,13410
-180,30,-10,2836,2830,5666,13045
20,10,160,2834,2833,5667,12956
-40,-50,-180,2853,2815,5668,12975
-40,-60,180,2833,2835,5668,12928
-40,-50,180,2853,2815,5668,12975
-40,-60,-180,2833,2835,5668,12928
150,10,20,2805,2865,5670,13292
70,-50,-100,2843,2827,5670,13190
170,-60,-40,2864,2807,5671,12903
90,-70,-100,2877,2794,5671,13202
-170,-40,-20,2903,2768,5671,12881
-160,-70,50,2856,2815,5671,13136
10,-80,-170,2861,2811,5672,12852
70,-60,-120,2887,2785,5672,13196
-50,-80,130,2863,2809,5672,12931
10,20,-150,2814,2859,5673,13193
160,0,-30,2823,2850,5673,13205
150,-70,-50,2846,2827,5673,13323
150,60,30,2879,2794,5673,13163
170,20,-20,2860,2814,5674,13187
30,-20,-160,2810,2865,5675,13186
30,-80,-150,2884,2791,5675,13035
120,-70,-20,2810,2865,5675,13337
150,-50,10,2832,2844,5676,13194
10,70,-170,2838,2838,5676,13259
30,10,-160,2827,2849,5676,13236
160,-80,-10,2891,2785,5676,12937
30,70,170,2833,2844,5677,13549
-170,-30,-30,2843,2834,5677,13418
-30,-80,180,2873,2804,5677,13142
-20,-60,150,2889,2788,5677,13138
160,-60,20,2835,2842,5677,13091
-30,-80,-180,2873,2804,5677,13142
0,-40,-150,2859,2818,5677,13166
-180,-50,30,2836,2842,5678,12981
180,-50,30,2836,2842,5678,12981
-50,-50,150,2853,2825,5678,13213
10,-10,-150,2826,2852,5678,13142
20,-60,-130,2884,2794,5678,13232
130,-70,-70,2891,2788,5679,13206
140,-80,-40,2883,2796,5679,13118
-80,-70,100,2871,2808,5679,13054
30,-10,-140,2853,2826,5679,13093
10,-50,-140,2886,2794,5680,12933
20,-30,-140,2829,2851,5680,13320
-180,-20,-40,2877,2805,5682,13445
180,-20,-40,2877,2805,5682,13445
120,-40,-70,2834,2849,5683,13498
10,50,-160,2830,2854,5684,13435
-30,-20,-160,2866,2818,5684,13161
160,0,20,2898,2787,5685,13121
60,-50,-110,2865,2820,5685,13460
-20,-70,-160,2849,2836,5685,13264
110,-50,-60,2850,2836,5686,13000
20,-20,-140,2818,2870,5688,13263
30,0,-150,2856,2832,5688,13332
-150,-80,60,2858,2830,5688,13088
-20,10,160,2867,2822,5689,12867
-50,-70,170,2855,2835,5690,13135
-20,60,-170,2847,2843,5690,12898
170,60,20,2863,2827,5690,13736
-20,-80,-170,2870,2820,5690,13039
0,70,-170,2838,2852,5690,13378
30,50,160,2822,2868,5690,13197
150,30,0,2857,2834,5691,13093
-180,50,0,2884,2807,5691,13209
150,60,40,2864,2827,5691,13535
20,-80,-160,2892,2799,5691,12906
180,50,0,2884,2807,5691,13209
150,-80,-20,2889,2803,5692,13078
100,-60,-70,2914,2778,5692,13164
80,-70,-110,2875,2818,5693,13240
20,-50,-140,2873,2820,5693,13057
-40,-80,170,2881,2813,5694,13178
150,-70,-30,2889,2805,5694,13099
30,-50,-130,2853,2841,5694,12811
-170,0,20,2862,2833,5695,13413
20,60,150,2811,2885,5696,13021
-10,60,-150,2830,2866,5696,13224
-40,30,-160,2857,2839,5696,13134
70,-70,-120,2905,2792,5697,13072
30,-10,-160,2841,2857,5698,13228
20,-80,-140,2880,2818,5698,13344
-170,0,10,2849,2849,5698,13194
150,-40,0,2856,2842,5698,13223
30,-30,-140,2844,2854,5698,13542
0,0,160,2872,2826,5698,13101
-60,-60,130,2900,2799,5699,13348
-30,-10,-160,2892,2807,5699,13226
-10,50,-150,2843,2856,5699,13346
-20,30,-150,2893,2806,5699,12949
60,-60,-130,2903,2797,5700,13326
40,-20,-150,2891,2809,5700,13515
100,-70,-50,2863,2837,5700,13288
-10,-80,-160,2866,2834,5700,13038
170,-60,10,2862,2840,5702,13086
140,-30,-20,2896,2806,5702,13133
-170,-20,-10,2878,2824,5702,13291
20,70,-180,2839,2864,5703,13596
20,70,180,2839,2864,5703,13596
10,-30,-150,2874,2829,5703,13194
-40,40,-160,2861,2842,5703,13418
140,-40,-20,2889,2814,5703,13181
30,-80,-130,2871,2833,5704,13219
130,-60,-30,2864,2840,5704,13262
120,-60,-80,2853,2851,5704,13010
180,50,10,2855,2850,5705,13464
20,60,180,2853,2852,5705,13571
20,60,-180,2853,2852,5705,13571
160,10,20,2879,2826,5705,13239
-180,50,10,2855,2850,5705,13464
-100,-80,90,2886,2819,5705,12979
-30,50,-160,2860,2846,5706,13201
150,-20,10,2857,2849,5706,13444
-10,-80,170,2919,2787,5706,13068
-170,-10,-10,2884,2823,5707,13073
60,-60,-100,2891,2817,5708,13352
170,60,10,2860,2848,5708,13203
-30,-10,160,2848,2860,5708,13204
170,-70,10,2863,2846,5709,13151
180,-60,30,2864,2845,5709,13153
-20,-80,160,2899,2810,5709,13115
-140,-80,70,2873,2836,5709,12964
40,-80,-130,2880,2829,5709,13105
-180,-60,30,2864,2845,5709,13153
170,-10,-40,2834,2875,5709,13668
-160,-80,50,2866,2844,5710,13221
90,-80,-90,2913,2797,5710,13311
0,40,-150,2862,2848,5710,13328
-40,-80,140,2880,2830,5710,13059
-180,40,0,2890,2821,5711,13422
90,-70,-90,2887,2824,5711,13183
180,20,20,2842,2869,5711,13202
180,40,0,2890,2821,5711,13422
-180,20,20,2842,2869,5711,13202
70,-80,-110,2914,2798,5712,13151
170,40,-10,2856,2856,5712,13461
100,-70,-90,2915,2797,5712,13110
150,30,30,2837,2875,5712,13391
60,-80,-120,2904,2808,5712,13121
-140,-90,70,2876,2837,5713,13290
10,-90,-140,2876,2837,5713,13290
-60,-90,150,2876,2837,5713,13290
-150,-90,60,2876,2837,5713,13290
0,-90,-150,2876,2837,5713,13290
-120,-90,90,2876,2837,5713,13290
30,-90,-120,2876,2837,5713,13290
-110,-90,100,2876,2837,5713,13290
-90,-90,120,2876,2837,5713,13290
20,-90,-130,2876,2837,5713,13290
-180,-90,30,2876,2837,5713,13290
-30,-70,-170,2848,2865,5713,13436
170,-90,20,2876,2837,5713,13290
-70,-90,140,2876,2837,5713,13290
-10,-90,-160,2876,2837,5713,13290
90,-90,-60,2876,2837,5713,13290
40,-90,-110,2876,2837,5713,13290
110,-90,-40,2876,2837,5713,13290
-50,-90,160,2876,2837,5713,13290
160,-90,10,2876,2837,5713,13290
-170,-80,40,2859,2854,5713,13387
80,-90,-70,2876,2837,5713,13290
-130,-90,80,2876,2837,5713,13290
100,-90,-50,2876,2837,5713,13290
-40,-90,170,2876,2837,5713,13290
-30,-90,180,2876,2837,5713,13290
150,-90,0,2876,2837,5713,13290
-80,-90,130,2876,2837,5713,13290
-100,-90,110,2876,2837,5713,13290
120,-90,-30,2876,2837,5713,13290
10,-80,-150,2876,2837,5713,13397
140,-90,-10,2876,2837,5713,13290
180,-90,30,2876,2837,5713,13290
50,-90,-100,2876,2837,5713,13290
-170,-90,40,2876,2837,5713,13290
-20,-90,-170,2876,2837,5713,13290
-160,-90,50,2876,2837,5713,13290
-30,-90,-180,2876,2837,5713,13290
70,-90,-80,2876,2837,5713,13290
60,-90,-90,2876,2837,5713,13290
130,-90,-20,2876,2837,5713,13290
-130,-80,80,2883,2831,5714,13106
0,-60,-140,2873,2842,5715,13278
160,50,10,2839,2876,5715,13365
100,-80,-80,2924,2792,5716,13384
-40,-30,160,2909,2808,5717,13334
-180,10,-10,2891,2827,5718,13309
180,10,-10,2891,2827,5718,13309
100,-50,-90,2847,2872,5719,13527
-180,-40,10,2881,2838,5719,13196
180,-40,10,2881,2838,5719,13196
90,-60,-100,2882,2838,5720,13234
10,-60,-130,2897,2823,5720,13274
-30,-80,150,2901,2819,5720,13052
60,-40,-120,2876,2844,5720,13443
0,-80,-150,2885,2837,5722,13183
-10,60,-160,2864,2858,5722,13280
80,-80,-100,2919,2803,5722,13302
-170,-20,-30,2874,2848,5722,13391
110,-60,-60,2887,2836,5723,13216
-40,-70,-180,2853,2871,5724,13338
-40,-30,-180,2876,2848,5724,13100
-40,-30,180,2876,2848,5724,13100
-30,10,170,2884,2840,5724,13218
-160,-80,40,2875,2849,5724,13059
30,-80,-140,2894,2830,5724,13172
-40,-70,180,2853,2871,5724,13338
-170,-70,40,2884,2841,5725,13393
180,-40,20,2889,2836,5725,13362
-10,60,170,2849,2876,5725,13100
-180,-40,20,2889,2836,5725,13362
-40,-10,-170,2916,2809,5725,13642
180,-70,-10,2847,2879,5726,13284
10,30,150,2885,2841,5726,13222
-180,-70,-10,2847,2879,5726,13284
110,-80,-70,2910,2816,5726,13255
80,-70,-70,2883,2844,5727,13334
170,-50,20,2868,2859,5727,13228
-170,-80,30,2867,2860,5727,13069
-70,-70,110,2894,2833,5727,13198
130,-80,-50,2898,2830,5728,13181
0,60,-160,2866,2862,5728,13298
-60,-60,140,2914,2814,5728,13361
30,-40,-150,2910,2818,5728,13591
-90,-70,100,2878,2850,5728,13516
-180,-80,20,2866,2863,5729,13247
180,-80,20,2866,2863,5729,13247
0,30,-150,2843,2886,5729,13492
-180,-60,-20,2871,2858,5729,13380
180,-60,-20,2871,2858,5729,13380
90,-60,-80,2925,2805,5730,13388
160,40,0,2860,2870,5730,13207
170,-50,-40,2876,2854,5730,13205
-20,60,-160,2868,2862,5730,13096
-10,60,-170,2866,2864,5730,13193
-20,40,170,2858,2872,5730,13432
170,50,0,2848,2882,5730,13242
-70,-70,140,2900,2831,5731,13127
40,-80,-140,2912,2819,5731,13267
170,-80,10,2867,2864,5731,13221
-150,-80,50,2884,2847,5731,13029
-20,-40,-150,2890,2841,5731,13259
30,0,-160,2873,2859,5732,13203
50,-80,-130,2925,2807,5732,13255
20,50,150,2814,2918,5732,13093
-170,-10,-20,2902,2831,5733,13185
-10,-40,160,2910,2823,5733,13041
40,-80,-120,2891,2843,5734,13227
-170,-30,-20,2918,2817,5735,13112
170,-70,20,2873,2862,5735,13341
70,-40,-110,2901,2834,5735,13523
20,10,-150,2872,2863,5735,13341
130,-60,-70,2890,2846,5736,13288
-40,-10,-180,2899,2837,5736,13364
-40,-10,180,2899,2837,5736,13364
-40,0,-170,2910,2826,5736,13562
0,20,-150,2842,2895,5737,13292
-180,-50,-30,2866,2871,5737,13142
180,-50,-30,2866,2871,5737,13142
-20,-10,160,2860,2878,5738,13083
50,-30,-130,2848,2891,5739,13696
140,-70,0,2870,2869,5739,13848
-90,-80,100,2910,2829,5739,13031
-170,-50,-20,2878,2861,5739,13092
10,-80,-140,2908,2831,5739,13194
130,-40,-40,2884,2856,5740,13149
150,30,10,2850,2890,5740,13451
-10,30,-150,2883,2858,5741,13195
180,-10,-40,2887,2854,5741,13636
-180,-10,-40,2887,2854,5741,13636
160,60,30,2878,2864,5742,13671
10,-70,-170,2921,2822,5743,13248
-30,40,-180,2860,2883,5743,13326
-30,40,180,2860,2883,5743,13326
160,40,30,2872,2871,5743,13556
0,-70,-150,2895,2848,5743,13003
0,-60,-150,2872,2872,5744,13189
40,-20,-140,2905,2839,5744,13584
180,20,-10,2884,2861,5745,13365
-180,20,-10,2884,2861,5745,13365
10,-60,-140,2901,2844,5745,13194
20,-10,170,2867,2880,5747,13406
-80,-80,110,2921,2826,5747,13026
10,-50,180,2941,2806,5747,13227
10,-50,-180,2941,2806,5747,13227
160,-70,-10,2898,2850,5748,13143
100,-70,-80,2939,2809,5748,13119
170,-30,20,2912,2836,5748,13402
-30,30,-150,2899,2850,5749,13426
10,60,-170,2884,2866,5750,13556
160,-70,20,2890,2860,5750,13408
-80,-70,110,2906,2844,5750,13523
170,-40,20,2886,2864,5750,13036
110,-70,-70,2932,2819,5751,13200
10,60,150,2877,2874,5751,13213
-70,-80,120,2930,2822,5752,12908
-50,-80,160,2903,2849,5752,13309
20,-80,-150,2910,2843,5753,13174
-20,50,170,2895,2858,5753,13459
100,-60,-90,2883,2871,5754,13322
170,-50,10,2910,2844,5754,13392
-30,-20,160,2883,2872,5755,13312
150,20,-10,2855,2900,5755,13600
120,-80,-60,2926,2830,5756,13208
140,-80,-20,2886,2870,5756,13245
0,-80,-160,2891,2865,5756,13283
20,40,-170,2887,2869,5756,13331
150,-80,0,2884,2872,5756,13157
170,-80,20,2877,2879,5756,13438
180,-70,30,2877,2882,5759,13532
-10,60,-180,2881,2878,5759,13056
150,-70,10,2894,2865,5759,13533
-10,-60,160,2924,2835,5759,13541
-10,60,180,2881,2878,5759,13056
-10,50,160,2908,2851,5759,13226
-180,-70,30,2877,2882,5759,13532
160,-60,0,2890,2870,5760,13318
-140,-80,60,2882,2878,5760,13234
10,-70,-140,2913,2848,5761,13220
140,-80,-10,2901,2860,5761,13230
-40,40,-150,2894,2867,5761,13624
160,-50,10,2894,2867,5761,13467
-180,-60,-10,2884,2878,5762,13068
20,-40,-170,2931,2831,5762,13433
20,-70,-130,2919,2843,5762,13367
180,-60,-10,2884,2878,5762,13068
30,-10,-150,2880,2882,5762,13572
10,-80,-160,2934,2829,5763,13153
110,-70,-60,2900,2864,5764,13356
-30,-50,150,2943,2821,5764,13377
140,-80,-30,2919,2845,5764,13178
0,-50,-150,2910,2855,5765,13197
110,-70,-80,2952,2813,5765,13270
150,-60,10,2864,2901,5765,13457
-40,-40,180,2890,2877,5767,13163
-40,-40,-180,2890,2877,5767,13163
170,10,-30,2872,2895,5767,13640
-180,40,10,2896,2871,5767,13661
180,40,10,2896,2871,5767,13661
30,-70,-120,2917,2851,5768,13500
170,-60,20,2859,2909,5768,13359
160,-80,0,2887,2881,5768,13250
-40,30,-170,2915,2854,5769,13705
80,-60,-90,2950,2819,5769,13389
80,-70,-100,2913,2856,5769,13382
140,-60,0,2854,2915,5769,13609
160,-90,0,2894,2876,5770,13365
100,-90,-60,2894,2876,5770,13365
150,-90,-10,2894,2876,5770,13365
90,-90,-70,2894,2876,5770,13365
-10,-90,-170,2894,2876,5770,13365
180,-30,20,2910,2860,5770,13411
-80,-90,120,2894,2876,5770,13365
20,-90,-140,2894,2876,5770,13365
-110,-90,90,2894,2876,5770,13365
-140,-90,60,2894,2876,5770,13365
120,-90,-40,2894,2876,5770,13365
110,-80,-60,2905,2865,5770,13299
40,-90,-120,2894,2876,5770,13365
10,-90,-150,2894,2876,5770,13365
80,-90,-80,2894,2876,5770,13365
180,-90,20,2894,2876,5770,13365
130,-90,-30,2894,2876,5770,13365
-30,-90,170,2894,2876,5770,13365
-20,-90,-180,2894,2876,5770,13365
130,-80,-40,2930,2840,5770,13166
-100,-90,100,2894,2876,5770,13365
110,-90,-50,2894,2876,5770,13365
30,-90,-130,2894,2876,5770,13365
-20,-90,180,2894,2876,5770,13365
-40,-90,160,2894,2876,5770,13365
60,-90,-100,2894,2876,5770,13365
160,-80,10,2880,2890,5770,13290
-180,-30,20,2910,2860,5770,13411
-180,-90,20,2894,2876,5770,13365
0,-90,-160,2894,2876,5770,13365
70,-90,-90,2894,2876,5770,13365
-170,-90,30,2894,2876,5770,13365
-150,-90,50,2894,2876,5770,13365
-70,-90,130,2894,2876,5770,13365
-120,-90,80,2894,2876,5770,13365
-90,-90,110,2894,2876,5770,13365
170,-90,10,2894,2876,5770,13365
140,-90,-20,2894,2876,5770,13365
-160,-90,40,2894,2876,5770,13365
-60,-90,140,2894,2876,5770,13365
-130,-90,70,2894,2876,5770,13365
-50,-90,150,2894,2876,5770,13365
50,-90,-110,2894,2876,5770,13365
-40,-50,170,2915,2855,5770,13134
160,-40,10,2905,2866,5771,13578
170,-20,20,2901,2870,5771,13403
10,-30,170,2900,2871,5771,13272
110,-70,-40,2892,2879,5771,13502
-180,-50,-10,2929,2842,5771,13171
180,-50,-10,2929,2842,5771,13171
-30,-50,-160,2877,2895,5772,13630
-20,-50,-150,2862,2910,5772,13373
0,-80,-170,2944,2828,5772,13133
170,-20,-40,2907,2866,5773,13554
160,50,30,2899,2874,5773,13673
-10,-70,-160,2893,2880,5773,13116
150,-80,-10,2883,2890,5773,13253
10,0,-150,2860,2914,5774,13455
50,-80,-120,2915,2859,5774,13269
-180,-80,30,2893,2882,5775,13506
180,-80,30,2893,2882,5775,13506
-50,-60,160,2902,2873,5775,13396
120,-70,-70,2963,2812,5775,13380
120,-80,-50,2924,2852,5776,13265
150,-20,0,2904,2872,5776,13577
20,50,180,2899,2877,5776,13452
20,50,-180,2899,2877,5776,13452
-170,-20,-20,2926,2851,5777,13135
160,-60,10,2885,2892,5777,13440
130,-70,-10,2875,2903,5778,13741
-20,0,160,2893,2886,5779,13215
20,-80,-130,2916,2863,5779,13350
10,60,160,2874,2905,5779,13150
60,-80,-110,2906,2873,5779,13485
0,-50,-140,2910,2870,5780,13400
-60,-80,150,2901,2879,5780,13358
0,-60,170,2947,2833,5780,13197
50,-80,-110,2917,2864,5781,13265
0,60,160,2889,2893,5782,13528
60,-80,-100,2905,2877,5782,13229
20,-70,-150,2892,2891,5783,13297
-10,40,160,2914,2869,5783,13406
140,-60,-20,2943,2841,5784,13668
0,-70,-180,2941,2844,5785,13431
0,-70,180,2941,2844,5785,13431
-60,-80,130,2937,2849,5786,13039
70,-70,-80,2919,2868,5787,13426
120,-60,-50,2931,2856,5787,13285
-120,-80,90,2907,2880,5787,13302
-40,-80,150,2920,2867,5787,13102
130,-80,-30,2889,2899,5788,13294
150,50,30,2927,2861,5788,13631
170,50,20,2898,2890,5788,13842
70,-80,-90,2893,2896,5789,13267
160,50,20,2929,2860,5789,13696
70,-80,-100,2913,2877,5790,13553
70,-60,-110,2936,2854,5790,13502
160,-70,0,2890,2902,5792,13258
-30,-30,-160,2932,2860,5792,13551
30,-20,-150,2900,2892,5792,13613
120,-70,-50,2921,2871,5792,13222
160,-70,-30,2929,2864,5793,13329
130,-30,-50,2862,2931,5793,13701
170,-70,-20,2905,2888,5793,13474
20,-60,-160,2964,2830,5794,13539
90,-70,-70,2918,2876,5794,13415
150,-70,-20,2930,2865,5795,13278
-30,0,-160,2924,2872,5796,13605
100,-70,-70,2913,2883,5796,13511
-40,-40,170,2929,2867,5796,13568
20,-70,-160,2933,2864,5797,13185
-50,-80,140,2927,2871,5798,13049
180,10,-20,2908,2890,5798,13295
-180,10,-20,2908,2890,5798,13295
-30,-80,160,2939,2860,5799,13175
160,-70,10,2911,2888,5799,13300
-70,-80,140,2911,2889,5800,13500
-180,-40,0,2941,2860,5801,13564
10,40,-160,2908,2893,5801,13468
-10,-80,-170,2917,2884,5801,13261
150,-50,0,2933,2868,5801,13556
-20,-80,170,2952,2849,5801,13116
20,20,-160,2895,2906,5801,13361
150,-30,0,2918,2883,5801,13509
180,-40,0,2941,2860,5801,13564
140,-30,-30,2941,2861,5802,13236
50,-70,-100,2928,2874,5802,13540
-180,-40,-10,2918,2884,5802,13300
180,-40,-10,2918,2884,5802,13300
30,-40,-140,2925,2877,5802,13704
140,-70,-40,2927,2875,5802,13209
70,-80,-80,2923,2879,5802,13488
-60,-70,150,2927,2876,5803,13484
130,-80,-20,2919,2884,5803,13277
70,-70,-110,2955,2848,5803,13400
20,-40,-160,2910,2893,5803,13604
-20,-70,-170,2936,2869,5805,13305
70,-60,-100,2962,2843,5805,13251
70,-50,-110,2930,2877,5807,13646
140,-60,-10,2937,2870,5807,13692
-130,-80,70,2878,2929,5807,13474
-60,-70,120,2925,2883,5808,13468
80,-80,-90,2908,2900,5808,13490
130,-70,-40,2923,2886,5809,13126
-30,-40,-160,2919,2890,5809,13741
50,-80,-100,2928,2881,5809,13344
-110,-80,100,2918,2893,5811,13413
40,-70,-110,2934,2877,5811,13587
-10,-50,160,2919,2892,5811,13739
-10,0,160,2915,2897,5812,13115
30,-70,-130,2946,2866,5812,13258
60,-70,-90,2913,2899,5812,13488
170,-60,-10,2940,2872,5812,13306
-20,50,180,2902,2910,5812,13429
-20,50,-180,2902,2910,5812,13429
-180,0,-10,2931,2882,5813,13294
180,0,-10,2931,2882,5813,13294
-110,-80,90,2898,2915,5813,13559
-70,-70,120,2945,2868,5813,13609
100,-80,-60,2907,2908,5815,13274
-80,-80,130,2933,2882,5815,13484
-40,10,-170,2911,2904,5815,13724
-180,30,0,2928,2888,5816,13666
80,-80,-80,2918,2898,5816,13323
-10,-80,180,2963,2853,5816,13102
-10,-80,-180,2963,2853,5816,13102
0,60,170,2916,2900,5816,13086
-80,-70,120,2938,2878,5816,13428
180,30,0,2928,2888,5816,13666
20,-30,-150,2948,2869,5817,13693
180,-30,10,2922,2897,5819,13489
-180,-30,10,2922,2897,5819,13489
-20,50,-170,2921,2898,5819,13418
30,-80,-120,2942,2878,5820,13378
60,-60,-110,2962,2859,5821,13368
110,-60,-80,2907,2914,5821,13359
-30,40,-150,2935,2886,5821,13434
180,10,-30,2919,2902,5821,13658
-180,10,-30,2919,2902,5821,13658
-120,-80,80,2897,2925,5822,13566
120,-70,-60,2956,2866,5822,13218
-10,-40,-150,2921,2901,5822,13317
50,-50,-120,2914,2908,5822,13712
150,40,20,2899,2923,5822,13681
150,-70,-10,2912,2911,5823,13370
120,-40,-60,2861,2962,5823,13584
60,-70,-120,2951,2872,5823,13510
140,-70,-30,2943,2880,5823,13268
150,-70,-40,2978,2845,5823,13486
10,-70,-160,2931,2893,5824,13235
150,0,10,2947,2877,5824,13875
60,-50,-120,2958,2866,5824,13668
0,50,-160,2882,2942,5824,13660
120,-80,-40,2896,2929,5825,13299
70,-70,-90,2943,2883,5826,13419
180,10,20,2905,2921,5826,13911
80,-70,-80,2939,2887,5826,13473
90,-80,-80,2929,2897,5826,13466
-180,10,20,2905,2921,5826,13911
60,-60,-120,2939,2887,5826,13587
160,10,-20,2894,2933,5827,13561
20,-70,-140,2959,2868,5827,13311
100,-80,-70,2934,2893,5827,13434
20,40,150,2926,2902,5828,13576
10,10,-150,2914,2914,5828,13793
40,-80,-110,2939,2890,5829,13436
60,-80,-90,2938,2891,5829,13382
-10,-60,-150,2955,2874,5829,13738
130,-70,-50,2951,2879,5830,13180
120,-80,-30,2932,2898,5830,13357
-40,20,-170,2930,2901,5831,13752
40,-70,-120,2926,2905,5831,13376
160,-20,-40,2964,2867,5831,13752
180,30,10,2924,2908,5832,13813
-90,-80,120,2946,2886,5832,13592
-180,30,10,2924,2908,5832,13813
110,-70,-50,2925,2907,5832,13491
80,-80,-70,2937,2896,5833,13473
120,-50,-50,2978,2855,5833,13242
50,-40,-130,2929,2904,5833,13667
-180,20,0,2928,2905,5833,13652
180,20,0,2928,2905,5833,13652
-20,-80,180,2934,2900,5834,13281
170,10,-20,2908,2926,5834,13485
140,-70,-50,2980,2854,5834,13473
150,-10,0,2941,2893,5834,13645
-20,-80,-180,2934,2900,5834,13281
40,-70,-140,2965,2869,5834,13784
170,-30,-40,2953,2881,5834,13592
90,-70,-80,2970,2865,5835,13574
180,10,0,2957,2878,5835,13734
30,-30,-150,2931,2904,5835,13851
140,-70,-20,2935,2900,5835,13750
-180,10,0,2957,2878,5835,13734
50,-60,-110,2952,2884,5836,13616
100,-70,-60,2943,2893,5836,13389
80,-50,-100,2895,2941,5836,13828
170,50,10,2923,2913,5836,13636
20,-50,-160,2947,2889,5836,13624
20,60,170,2920,2917,5837,13849
170,30,-10,2911,2926,5837,13496
140,-70,-10,2914,2923,5837,13583
80,-70,-90,2996,2841,5837,13745
-20,-30,160,2960,2877,5837,13614
120,-70,-30,2923,2914,5837,13622
30,-60,-130,2953,2886,5839,13417
-10,40,-150,2936,2903,5839,13686
150,20,0,2908,2931,5839,13519
150,-60,-10,2958,2881,5839,13668
-180,-30,0,2949,2891,5840,13701
-40,-30,170,2974,2866,5840,13491
180,-30,0,2949,2891,5840,13701
40,-30,-140,2938,2902,5840,13782
-100,-80,110,2948,2892,5840,13569
-20,50,-160,2940,2900,5840,13602
40,-60,-120,2957,2884,5841,13553
20,20,160,2922,2919,5841,13422
160,30,-10,2915,2926,5841,13262
20,-40,-150,2933,2908,5841,13674
150,-10,10,2942,2900,5842,13715
30,-70,-140,2925,2917,5842,13499
120,-70,-40,2935,2907,5842,13803
-100,-80,100,2926,2916,5842,13675
170,20,20,2934,2908,5842,13892
160,-60,-10,2982,2860,5842,13371
-30,40,-170,2918,2924,5842,13726
170,-50,0,2967,2875,5842,13544
130,-70,-60,2994,2849,5843,13482
170,-10,20,2954,2890,5844,13460
90,-80,-70,2928,2916,5844,13359
40,-70,-130,2923,2921,5844,13457
-180,-10,20,2946,2898,5844,13783
180,-10,20,2946,2898,5844,13783
110,-80,-50,2915,2930,5845,13292
70,-70,-100,2973,2872,5845,13632
-10,-70,170,2962,2883,5845,13546
90,-80,-60,2951,2894,5845,13500
-10,-70,-170,2978,2868,5846,13540
50,-70,-120,2945,2901,5846,13753
180,0,-20,2936,2910,5846,13179
-180,0,-20,2936,2910,5846,13179
-10,50,-160,2939,2909,5848,13321
20,0,-150,2924,2925,5849,13644
30,-60,-150,2984,2865,5849,14011
20,-20,-150,2951,2898,5849,13776
-40,-40,160,2934,2916,5850,13658
180,20,10,2949,2901,5850,13650
180,0,-30,2919,2931,5850,13833
-180,0,-30,2919,2931,5850,13833
-180,20,10,2949,2901,5850,13650
20,-60,-140,2943,2908,5851,13539
-30,-30,160,2974,2877,5851,13556
0,-70,-170,2953,2899,5852,13367
-180,-20,20,2947,2905,5852,13529
180,-20,20,2947,2905,5852,13529
-30,-70,-180,2958,2895,5853,13532
-30,-70,180,2958,2895,5853,13532
110,-80,-40,2960,2894,5854,13413
170,0,20,2957,2897,5854,13758
140,-60,-60,2948,2907,5855,13644
170,10,20,2935,2920,5855,13838
160,40,10,2913,2942,5855,13629
150,20,10,2901,2955,5856,13600
20,60,160,2911,2945,5856,13458
150,-60,-20,2980,2878,5858,13638
100,-80,-50,2962,2896,5858,13537
-20,30,170,2948,2913,5861,13587
10,-50,-150,2921,2940,5861,13581
20,-20,-180,2951,2911,5862,13616
20,-20,180,2951,2911,5862,13616
150,-10,-20,2936,2926,5862,13374
-30,-50,-170,2953,2909,5862,13668
-30,-40,-170,2958,2904,5862,13669
-40,-50,150,2958,2904,5862,13753
-10,10,160,2947,2916,5863,13425
-50,-70,160,2984,2879,5863,13588
40,-40,-140,2965,2898,5863,13705
0,-70,-160,2972,2891,5863,13648
20,-30,-160,2975,2889,5864,13858
-90,-80,110,2950,2914,5864,13739
-180,-50,-20,2947,2918,5865,13614
150,-60,0,2963,2902,5865,13776
170,0,-30,2926,2939,5865,13374
180,-50,-20,2947,2918,5865,13614
-170,-10,-30,2944,2922,5866,13717
150,-40,-50,2916,2950,5866,13509
150,-40,-10,2979,2887,5866,13389
30,-70,-150,2980,2887,5867,13648
10,60,170,2914,2953,5867,13403
20,-10,-150,2935,2933,5868,13937
-10,30,160,2956,2913,5869,13542
150,-60,-50,2945,2924,5869,13809
170,-60,-30,2914,2955,5869,13605
30,-50,-150,2991,2879,5870,14117
150,10,-10,2948,2922,5870,13553
-30,-60,-170,2950,2920,5870,13569
-10,20,160,2967,2904,5871,13469
130,-60,-40,2948,2923,5871,13449
-20,-20,-160,2972,2899,5871,13732
-20,-60,-160,2948,2925,5873,13935
160,-50,0,2941,2932,5873,13622
160,-30,10,2943,2931,5874,13835
-80,-80,120,2961,2914,5875,13790
50,-70,-130,2965,2910,5875,13756
10,-20,170,2968,2909,5877,13641
150,-70,0,2925,2953,5878,13495
-30,40,-160,2922,2959,5881,13708
170,10,-10,2937,2944,5881,13576
160,-10,-30,2894,2987,5881,13479
-30,10,-160,2953,2928,5881,13784
-30,30,180,2954,2929,5883,13686
-30,30,-180,2954,2929,5883,13686
-30,-80,170,2957,2927,5884,13335
130,-70,-30,2941,2943,5884,13906
80,-60,-100,2983,2901,5884,13671
-20,0,-160,2976,2910,5886,13713
-50,-70,130,2982,2904,5886,13611
150,-20,-10,2971,2916,5887,13696
130,-50,-40,2988,2899,5887,13413
170,-40,-40,2967,2920,5887,13876
150,20,20,2945,2944,5889,13876
10,-60,-170,3008,2881,5889,13620
170,40,20,2955,2935,5890,13999
170,40,0,2963,2928,5891,13805
-50,-60,150,3010,2881,5891,13847
160,20,20,2937,2955,5892,13852
130,-70,-20,2956,2936,5892,13752
60,-70,-100,2960,2934,5894,13531
10,-70,-150,2993,2902,5895,13489
140,-50,-60,2965,2931,5896,13935
-30,0,170,2969,2927,5896,13830
-10,-60,-160,2976,2921,5897,13418
150,-50,-10,2985,2913,5898,13862
140,-30,-50,2910,2989,5899,13851
100,-60,-80,2968,2931,5899,13977
170,-40,10,2949,2950,5899,13670
10,-30,-160,2980,2920,5900,13803
180,0,0,2970,2930,5900,13872
-180,0,0,2970,2930,5900,13872
150,0,-10,2954,2947,5901,13798
160,30,10,2974,2928,5902,13648
90,-60,-90,2955,2947,5902,14042
110,-50,-80,2947,2956,5903,14372
10,10,160,2944,2959,5903,13586
-10,-50,-150,2974,2930,5904,13732
160,30,0,2946,2958,5904,13709
0,60,-180,2942,2965,5907,13457
-40,-60,140,2976,2931,5907,13738
50,-60,-130,3002,2905,5907,13729
-40,-70,170,3006,2901,5907,13726
60,-70,-110,2988,2919,5907,13687
0,60,180,2942,2965,5907,13457
-20,-10,-160,3003,2905,5908,13861
150,30,20,2948,2961,5909,14055
170,20,-10,2965,2946,5911,13639
10,60,-180,2962,2949,5911,13747
10,60,180,2962,2949,5911,13747
160,0,-20,2954,2958,5912,13675
160,-60,-40,2965,2948,5913,13747
130,-40,-60,2899,3015,5914,13792
10,50,150,2980,2935,5915,13556
50,-50,-130,3017,2900,5917,13838
50,-70,-110,2955,2962,5917,13613
160,30,20,2996,2921,5917,14038
40,-50,-140,3030,2889,5919,13973
-180,-30,-30,2998,2922,5920,13689
180,-30,-30,2998,2922,5920,13689
-180,-40,-30,2989,2931,5920,13729
180,-40,-30,2989,2931,5920,13729
150,-20,-40,2922,2999,5921,13758
0,-20,-160,2960,2962,5922,13547
160,40,20,2994,2928,5922,14238
150,40,30,2954,2968,5922,14029
-40,-60,170,2993,2930,5923,13588
-70,-70,130,2970,2953,5923,13531
-20,-70,160,2996,2927,5923,13843
-40,-70,140,2991,2933,5924,13764
140,-60,-30,2998,2927,5925,13562
50,-60,-120,2993,2933,5926,13772
-10,-50,-160,2965,2961,5926,13815
-10,-10,-160,2984,2943,5927,13763
-70,-80,130,2986,2941,5927,13788
0,60,-170,2974,2954,5928,13691
150,0,0,2976,2954,5930,13918
90,-50,-90,2941,2989,5930,13886
-40,-50,160,2995,2935,5930,13881
170,30,20,2977,2954,5931,14153
-10,40,-160,2964,2967,5931,13413
20,40,-180,2935,2999,5934,13626
20,40,180,2935,2999,5934,13626
0,-40,-160,2999,2935,5934,13558
0,-50,170,3024,2910,5934,13477
40,-60,-140,3040,2895,5935,14220
150,10,10,2971,2967,5938,14282
0,10,160,2997,2942,5939,13750
-60,-80,140,2992,2948,5940,13721
10,-20,-160,2990,2957,5947,13945
20,-20,-160,2994,2953,5947,14073
-20,10,-160,2992,2956,5948,13827
-180,0,20,2993,2955,5948,14130
180,0,20,2993,2955,5948,14130
160,-20,10,3017,2932,5949,13943
170,40,10,2980,2970,5950,13982
0,-60,-180,3054,2897,5951,14054
-20,40,-180,3014,2937,5951,13744
-20,40,180,3014,2937,5951,13744
0,-60,180,3054,2897,5951,14054
180,-10,0,3004,2949,5953,13833
10,50,-170,2961,2992,5953,13821
-180,-10,0,3004,2949,5953,13833
-50,-80,150,2994,2959,5953,13712
0,40,-160,2975,2980,5955,14050
20,-10,-180,3006,2949,5955,13895
20,-10,180,3006,2949,5955,13895
-40,-80,160,3015,2941,5956,13628
-20,-30,-160,2990,2966,5956,13852
100,-50,-80,2926,3030,5956,13860
-50,-60,140,3035,2922,5957,14136
180,-30,-10,2998,2959,5957,13773
-180,-30,-10,2998,2959,5957,13773
180,-20,0,3007,2951,5958,13911
-180,-20,0,3007,2951,5958,13911
140,-40,-30,3019,2940,5959,13922
10,-40,-180,3039,2920,5959,13771
10,-40,180,3039,2920,5959,13771
-20,-60,-170,3026,2933,5959,13765
-30,-30,-170,3009,2952,5961,13744
-180,-10,-30,3015,2946,5961,14025
180,-10,-30,3015,2946,5961,14025
-60,-70,130,3027,2935,5962,13811
20,-30,-170,3030,2934,5964,13818
10,-60,-150,3009,2955,5964,13857
20,30,-170,3001,2965,5966,13962
20,-60,-150,2997,2969,5966,13532
-10,-20,-160,2999,2968,5967,13805
0,-30,-160,3020,2947,5967,13810
-20,-50,-160,2986,2982,5968,14187
-30,-50,180,3013,2955,5968,13684
-30,-70,150,3017,2951,5968,13880
30,-60,-140,3002,2966,5968,14031
150,-60,-30,3023,2945,5968,13816
-30,-50,-180,3013,2955,5968,13684
140,-50,-30,2999,2969,5968,13892
20,-50,-150,3003,2967,5970,13783
10,40,150,2979,2992,5971,13848
0,-60,-160,3010,2961,5971,13756
150,-10,-10,2991,2981,5972,13932
110,-50,-70,2957,3016,5973,13666
160,20,10,3023,2952,5975,14064
110,-60,-70,3011,2966,5977,13839
120,-50,-60,2955,3025,5980,13641
30,-50,-140,3025,2955,5980,14190
160,-60,-20,3043,2939,5982,13750
150,-30,-10,3044,2941,5985,13893
150,-20,-20,3026,2960,5986,13978
-10,10,-160,3001,2987,5988,14017
150,10,0,2983,3006,5989,14011
160,10,10,3033,2957,5990,14028
-10,50,170,3004,2987,5991,13773
-10,0,-160,3031,2961,5992,14010
-20,-70,180,3016,2976,5992,13685
-20,-70,-180,3016,2976,5992,13685
-180,10,10,3031,2962,5993,13955
0,20,160,3044,2949,5993,13917
180,10,10,3031,2962,5993,13955
20,50,160,2947,3049,5996,13654
170,30,0,3020,2976,5996,13980
170,-30,10,3007,2989,5996,13952
20,10,-160,3018,2979,5997,13939
170,10,10,3041,2956,5997,14116
170,10,0,3013,2985,5998,14136
-30,-40,180,3025,2975,6000,13630
-30,-40,-180,3025,2975,6000,13630
-20,40,-160,3016,2985,6001,13817
-20,30,-160,3047,2955,6002,14012
-30,20,-160,3025,2977,6002,14078
-180,-20,10,2987,3016,6003,14302
180,-20,10,2987,3016,6003,14302
-10,-70,180,3027,2977,6004,13681
-30,-60,180,3026,2978,6004,13806
-30,-60,-180,3026,2978,6004,13806
-10,-70,-180,3027,2977,6004,13681
10,-40,-160,3007,2998,6005,13799
120,-60,-60,3024,2982,6006,13703
40,-60,-130,3037,2969,6006,14071
20,-20,-170,3063,2944,6007,14003
-30,-60,150,3048,2959,6007,14173
-30,-40,160,3055,2953,6008,14288
180,-10,-10,3027,2981,6008,13935
-180,-10,-10,3027,2981,6008,13935
170,-60,-20,3006,3003,6009,13758
-10,30,-160,3007,3002,6009,13732
10,-60,-160,3022,2988,6010,13863
20,30,160,3040,2972,6012,13752
10,30,-160,2975,3037,6012,13757
160,20,0,2996,3017,6013,13916
170,-10,-30,2999,3014,6013,13931
-10,20,-160,3033,2981,6014,13688
170,20,0,3059,2956,6015,14212
-20,20,-160,3023,2994,6017,13981
40,-50,-130,3021,2996,6017,14212
-10,-40,-160,3037,2983,6020,14057
170,20,10,3042,2979,6021,14421
170,30,10,3043,2978,6021,14344
160,-40,0,3038,2985,6023,14312
-10,-30,-160,3050,2976,6026,14145
160,-10,10,3083,2944,6027,14430
0,-50,-160,3071,2957,6028,13811
180,-10,-20,3026,3003,6029,14023
160,-50,-10,3051,2978,6029,13909
-180,-10,-20,3026,3003,6029,14023
10,20,160,3007,3024,6031,13970
160,0,10,3058,2974,6032,14179
-20,40,-170,3016,3016,6032,14001
-30,-70,170,3045,2989,6034,14062
-180,0,10,3033,3001,6034,14332
180,0,10,3033,3001,6034,14332
170,0,0,3050,2984,6034,14253
20,-10,-170,3078,2957,6035,14361
-60,-70,140,3028,3007,6035,13883
160,20,-10,3020,3017,6037,14199
160,10,-10,3010,3027,6037,14185
170,0,-20,3010,3027,6037,14008
20,0,170,3052,2990,6042,14222
160,-30,0,3065,2977,6042,14311
10,-50,-170,3071,2971,6042,14206
20,-10,-160,3025,3019,6044,14356
0,10,-160,3027,3017,6044,13842
-20,-40,160,3071,2974,6045,14362
-10,-60,-170,3063,2982,6045,13980
170,-50,-10,3058,2987,6045,13998
-30,30,-170,3054,2992,6046,14208
160,0,0,3034,3013,6047,14191
170,-40,0,3038,3009,6047,14089
120,-60,-70,3060,2993,6053,13939
160,0,-10,3039,3020,6059,14074
-30,30,-160,3025,3034,6059,14381
-10,50,-180,3028,3033,6061,13974
-20,-40,-160,3047,3014,6061,14046
-10,50,180,3028,3033,6061,13974
20,50,170,3006,3055,6061,14439
120,-50,-70,3068,2998,6066,14609
-30,-20,-170,3084,2982,6066,14188
20,40,160,3027,3040,6067,13809
-40,-70,160,3053,3014,6067,14313
150,-50,-20,3059,3008,6067,14316
0,-40,170,3085,2982,6067,14209
0,50,160,3027,3040,6067,13829
10,20,-160,3006,3062,6068,13961
20,20,170,3032,3036,6068,13969
-30,-10,170,3015,3053,6068,14204
-20,-70,170,3046,3023,6069,14229
-10,50,-170,3026,3044,6070,14015
10,-40,-170,3063,3008,6071,14469
-50,-70,150,3053,3019,6072,14123
0,50,-170,3062,3010,6072,14027
170,-50,-20,3051,3022,6073,14318
0,0,-160,3046,3030,6076,14024
-50,-70,140,3088,2988,6076,14152
-10,40,170,3054,3023,6077,14030
10,-10,-160,3055,3024,6079,14112
150,-20,-30,3027,3054,6081,13937
0,-10,-160,3045,3037,6082,13839
0,-60,-170,3054,3029,6083,14134
-40,-60,160,3075,3010,6085,14135
10,-50,-160,3066,3020,6086,14141
150,-50,-50,3046,3040,6086,14244
160,-20,0,3112,2974,6086,14307
-180,-20,-30,3064,3023,6087,14136
180,-10,10,3055,3032,6087,14644
140,-60,-40,3068,3019,6087,13968
180,-20,-30,3064,3023,6087,14136
-180,-10,10,3055,3032,6087,14644
160,-30,-40,3041,3046,6087,14136
-30,-10,-170,3092,2996,6088,14411
160,10,0,3051,3037,6088,14455
170,-20,10,3067,3022,6089,14341
-20,-60,160,3078,3013,6091,14206
10,50,160,3010,3081,6091,13973
180,-40,-20,3078,3015,6093,14092
-180,-40,-20,3078,3015,6093,14092
170,0,-10,3059,3036,6095,14084
0,20,-160,3000,3097,6097,14071
0,30,-160,3055,3043,6098,14368
160,-60,-30,3044,3059,6103,14077
150,-30,-20,3082,3021,6103,13982
180,-20,-10,3057,3047,6104,14337
-180,-20,-10,3057,3047,6104,14337
10,-30,180,3115,2990,6105,14299
10,-30,-180,3115,2990,6105,14299
-20,-50,-170,3085,3022,6107,14130
-180,-20,-20,3068,3040,6108,14038
180,-20,-20,3068,3040,6108,14038
130,-40,-50,2978,3132,6110,14092
20,0,-170,3105,3008,6113,14434
170,-10,0,3094,3021,6115,14522
-20,20,170,3072,3043,6115,14166
20,0,-160,3074,3045,6119,14352
160,-10,0,3086,3034,6120,14311
130,-60,-50,3071,3050,6121,13983
20,0,180,3085,3037,6122,14303
20,0,-180,3085,3037,6122,14303
-180,-30,-20,3069,3057,6126,14323
180,-30,-20,3069,3057,6126,14323
20,20,-170,3048,3085,6133,14266
-10,-60,170,3124,3009,6133,14328
0,30,160,3100,3034,6134,14313
-30,-30,-180,3076,3059,6135,14537
-30,-30,180,3076,3059,6135,14537
-20,-60,-180,3101,3038,6139,14417
-20,-60,180,3101,3038,6139,14417
10,-10,170,3102,3038,6140,14380
20,10,170,3071,3070,6141,14293
0,40,160,3110,3031,6141,14451
0,-30,170,3147,2998,6145,14449
-40,-70,150,3110,3041,6151,14685
170,-40,-10,3140,3012,6152,14363
-30,-20,170,3063,3090,6153,14317
20,30,-180,3085,3069,6154,14295
20,30,180,3085,3069,6154,14295
20,40,170,3066,3089,6155,14412
150,-40,-20,3127,3030,6157,14366
-30,20,-180,3085,3072,6157,14472
-30,20,180,3085,3072,6157,14472
20,10,-170,3087,3073,6160,14565
130,-60,-60,3124,3041,6165,14159
0,50,180,3087,3078,6165,14239
0,50,-180,3087,3078,6165,14239
170,-10,-20,3083,3082,6165,14155
150,-60,-40,3073,3096,6169,14055
-40,-60,150,3146,3024,6170,14448
-10,-60,180,3108,3063,6171,14265
-10,-60,-180,3108,3063,6171,14265
140,-60,-50,3098,3074,6172,14112
140,-30,-40,3059,3114,6173,14489
10,30,160,3107,3068,6175,14266
170,-50,-30,3089,3086,6175,14313
10,50,170,3107,3071,6178,14252
170,-20,-30,3104,3075,6179,14408
-30,-70,160,3118,3062,6180,14658
0,50,170,3082,3101,6183,14244
20,30,170,3108,3079,6187,14393
10,0,-160,3085,3103,6188,14653
-20,-20,-170,3128,3065,6193,14518
-30,-50,170,3153,3040,6193,14371
170,0,10,3107,3086,6193,14586
160,-10,-10,3098,3096,6194,14175
-30,-60,170,3119,3076,6195,14282
-30,-10,180,3129,3067,6196,14435
160,-10,-20,3101,3095,6196,14488
-30,-10,-180,3129,3067,6196,14435
170,-10,-10,3124,3073,6197,14403
10,10,-160,3065,3136,6201,14418
160,-50,-40,3117,3086,6203,14474
0,-50,180,3155,3051,6206,14472
0,-50,-180,3155,3051,6206,14472
-20,-50,160,3173,3038,6211,14699
10,-30,-170,3133,3081,6214,14619
-30,0,-180,3119,3103,6222,14771
-30,0,180,3119,3103,6222,14771
170,-20,0,3146,3079,6225,14649
170,-30,0,3125,3100,6225,14637
-30,10,180,3135,3094,6229,14771
-30,10,-180,3135,3094,6229,14771
130,-50,-50,3093,3139,6232,14268
10,50,180,3115,3117,6232,14787
-10,40,-170,3104,3128,6232,14356
10,50,-180,3115,3117,6232,14787
10,40,-170,3080,3155,6235,14729
160,-40,-40,3118,3120,6238,14628
140,-40,-50,3059,3180,6239,14425
0,-50,-170,3138,3102,6240,14679
170,-40,-20,3120,3123,6243,14330
-20,10,170,3132,3112,6244,14361
-30,-20,180,3127,3117,6244,14697
-30,-30,170,3154,3090,6244,14634
-30,-20,-180,3127,3117,6244,14697
130,-50,-60,3111,3135,6246,14616
160,-40,-10,3142,3104,6246,14761
-20,-40,-170,3125,3122,6247,14573
170,-10,10,3136,3113,6249,14797
-30,20,-170,3175,3079,6254,14882
-30,0,-170,3149,3108,6257,14875
160,-50,-20,3168,3095,6263,14543
-10,-50,-170,3174,3092,6266,14660
0,40,-170,3096,3173,6269,14524
170,-20,-10,3151,3122,6273,14718
-20,-30,-170,3146,3137,6283,14535
0,-20,170,3177,3108,6285,14580
-30,-50,160,3185,3102,6287,15030
-10,40,180,3139,3149,6288,14378
20,10,-180,3186,3102,6288,14922
-10,40,-180,3139,3149,6288,14378
20,10,180,3186,3102,6288,14922
20,20,180,3173,3117,6290,14931
20,20,-180,3173,3117,6290,14931
-20,-10,-170,3174,3116,6290,14887
170,-20,-20,3157,3135,6292,14907
10,40,160,3132,3163,6295,14580
160,-30,-10,3202,3095,6297,14896
10,-20,-170,3179,3122,6301,14863
-20,-60,170,3214,3090,6304,14727
160,-20,-10,3153,3152,6305,14716
0,-40,-170,3167,3144,6311,14808
10,40,170,3183,3129,6312,14909
-30,-40,170,3176,3137,6313,14785
-30,10,-170,3203,3111,6314,15049
150,-30,-40,3107,3208,6315,14776
170,-30,-10,3195,3122,6317,14881
-10,30,170,3188,3139,6327,14931
-20,30,-170,3166,3162,6328,14847
0,40,170,3152,3178,6330,14665
140,-50,-50,3116,3215,6331,14976
160,-50,-30,3184,3152,6336,14881
160,-20,-30,3169,3175,6344,14649
0,-10,170,3213,3133,6346,14899
-10,-50,170,3226,3124,6350,15091
-20,30,180,3222,3129,6351,15064
-20,30,-180,3222,3129,6351,15064
0,-40,-180,3268,3083,6351,14853
0,-40,180,3268,3083,6351,14853
-10,30,-170,3193,3163,6356,14842
0,40,180,3161,3201,6362,14984
0,40,-180,3161,3201,6362,14984
-20,-20,170,3170,3193,6363,15018
-10,-30,-170,3212,3151,6363,14925
0,0,170,3188,3176,6364,14767
10,0,170,3234,3130,6364,14951
-10,-20,170,3213,3152,6365,14973
170,-40,-30,3198,3168,6366,15154
-10,-40,-170,3220,3149,6369,14845
140,-40,-40,3179,3198,6377,14799
-30,-60,160,3220,3158,6378,14901
0,20,-170,3186,3193,6379,14778
10,-10,-170,3231,3150,6381,15126
10,-20,180,3223,3158,6381,15027
10,-20,-180,3223,3158,6381,15027
10,0,-170,3229,3152,6381,15180
160,-40,-20,3231,3160,6391,14967
0,-30,-170,3222,3170,6392,14960
150,-50,-30,3212,3181,6393,14935
140,-50,-40,3177,3217,6394,14775
-10,0,170,3230,3169,6399,14698
0,30,-170,3183,3218,6401,15038
-20,20,-170,3216,3187,6403,15147
-20,-50,180,3214,3191,6405,14750
-20,-50,-180,3214,3191,6405,14750
10,40,180,3170,3236,6406,15089
10,40,-180,3170,3236,6406,15089
-10,10,170,3234,3175,6409,14829
-10,20,170,3224,3186,6410,15374
170,-30,-30,3236,3183,6419,14985
10,30,170,3186,3234,6420,14962
-10,-40,170,3241,3181,6422,15281
150,-50,-40,3193,3231,6424,14997
-20,10,-170,3249,3178,6427,15113
160,-30,-20,3246,3185,6431,15073
-20,-10,170,3223,3216,6439,14974
-10,10,-170,3216,3227,6443,15092
-20,-30,170,3258,3188,6446,15515
-10,-20,-170,3239,3207,6446,15150
-10,-30,170,3277,3172,6449,15023
160,-20,-20,3206,3248,6454,14890
10,10,-170,3246,3211,6457,15197
10,30,-170,3148,3311,6459,15362
-10,20,-170,3261,3208,6469,15235
150,-30,-30,3209,3264,6473,15232
170,-30,-20,3266,3212,6478,14994
-20,0,-170,3285,3195,6480,15400
-20,0,170,3282,3208,6490,15239
-20,-40,180,3264,3229,6493,15236
-20,-40,-180,3264,3229,6493,15236
-10,30,180,3230,3265,6495,15202
-10,30,-180,3230,3265,6495,15202
10,30,-180,3240,3259,6499,15359
0,-30,180,3274,3225,6499,15023
10,30,180,3240,3259,6499,15359
0,-30,-180,3274,3225,6499,15023
10,20,-170,3231,3270,6501,15201
0,30,170,3242,3263,6505,15024
0,10,170,3260,3248,6508,15278
-20,-50,170,3288,3222,6510,15421
-10,-50,-180,3287,3231,6518,15152
-10,-50,180,3287,3231,6518,15152
-20,-10,180,3274,3249,6523,15363
-20,-10,-180,3274,3249,6523,15363
10,10,170,3293,3233,6526,15558
0,-20,-170,3271,3257,6528,15476
-10,0,-170,3290,3241,6531,15519
0,20,170,3276,3255,6531,15337
-20,-20,180,3308,3224,6532,15463
-20,-20,-180,3308,3224,6532,15463
-20,-30,-180,3290,3249,6539,15472
-20,-30,180,3290,3249,6539,15472
-20,-40,170,3308,3254,6562,15568
-20,20,-180,3321,3245,6566,15661
0,0,-170,3285,3281,6566,15309
-20,20,180,3321,3245,6566,15661
150,-40,-30,3304,3263,6567,15509
10,20,170,3305,3267,6572,15211
10,-10,-180,3333,3243,6576,15291
10,-10,180,3333,3243,6576,15291
0,10,-170,3288,3297,6585,15177
150,-40,-40,3253,3334,6587,15368
160,-40,-30,3300,3289,6589,15108
-10,-10,170,3280,3311,6591,15261
-10,-10,-170,3301,3302,6603,15671
-20,10,-180,3337,3280,6617,15627
-20,10,180,3337,3280,6617,15627
0,30,180,3292,3333,6625,15440
0,30,-180,3292,3333,6625,15440
0,-10,-170,3325,3302,6627,15636
-20,0,180,3319,3310,6629,15627
-20,0,-180,3319,3310,6629,15627
0,-20,180,3343,3290,6633,15857
0,-20,-180,3343,3290,6633,15857
-10,-30,-180,3336,3321,6657,15676
-10,-30,180,3336,3321,6657,15676
10,0,-180,3368,3300,6668,15828
10,0,180,3368,3300,6668,15828
160,-30,-30,3328,3363,6691,15706
-10,-40,-180,3403,3329,6732,15974
-10,-40,180,3403,3329,6732,15974
10,20,180,3370,3368,6738,16042
10,20,-180,3370,3368,6738,16042
0,-10,-180,3402,3342,6744,15727
0,-10,180,3402,3342,6744,15727
-10,-20,-180,3399,3349,6748,15984
-10,-20,180,3399,3349,6748,15984
-10,20,-180,3404,3355,6759,15952
-10,20,180,3404,3355,6759,15952
-10,0,180,3394,3370,6764,16029
-10,0,-180,3394,3370,6764,16029
10,10,-180,3439,3358,6797,16098
10,10,180,3439,3358,6797,16098
0,10,-180,3436,3380,6816,16137
0,10,180,3436,3380,6816,16137
-10,10,180,3428,3411,6839,16128
-10,10,-180,3428,3411,6839,16128
0,20,-180,3423,3422,6845,16069
0,20,180,3423,3422,6845,16069
-10,-10,-180,3462,3385,6847,16142
-10,-10,180,3462,3385,6847,16142
0,0,180,3448,3409,6857,16016
0,0,-180,3448,3409,6857,16016
